gene,chr,start,end,gene_biotype,coding_strand,length,genomic_position
0610005C13Rik,7,45567794,45575327,antisense,-1,7533,chr7_45567794_45575327
0610009B22Rik,11,51685386,51688874,protein_coding,-1,3488,chr11_51685386_51688874
0610009E02Rik,2,26445696,26459390,processed_transcript,1,13694,chr2_26445696_26459390
0610009L18Rik,11,120348678,120351190,bidirectional_promoter_lncRNA,1,2512,chr11_120348678_120351190
0610010F05Rik,11,23564961,23633639,protein_coding,-1,68678,chr11_23564961_23633639
0610010K14Rik,11,70235206,70237914,protein_coding,-1,2708,chr11_70235206_70237914
0610012G03Rik,16,31947050,31948494,protein_coding,-1,1444,chr16_31947050_31948494
0610025J13Rik,4,98321398,98331791,antisense,1,10393,chr4_98321398_98331791
0610030E20Rik,6,72347316,72353148,protein_coding,1,5832,chr6_72347316_72353148
0610038B21Rik,8,77517056,77523898,antisense,1,6842,chr8_77517056_77523898
0610039K10Rik,2,163644850,163645801,antisense,1,951,chr2_163644850_163645801
0610040B10Rik,5,143329247,143332704,antisense,1,3457,chr5_143329247_143332704
0610040F04Rik,6,108577039,108660934,antisense,-1,83895,chr6_108577039_108660934
0610040J01Rik,5,63812363,63899625,protein_coding,1,87262,chr5_63812363_63899625
0610043K17Rik,4,101353783,101399181,lincRNA,1,45398,chr4_101353783_101399181
1110002J07Rik,10,66912489,66920258,lincRNA,-1,7769,chr10_66912489_66920258
1110002L01Rik,12,3403878,3427011,antisense,-1,23133,chr12_3403878_3427011
1110002O04Rik,1,35879845,35881119,lincRNA,1,1274,chr1_35879845_35881119
1110004F10Rik,7,116039397,116105210,protein_coding,1,65813,chr7_116039397_116105210
1110006O24Rik,5,115631049,115631816,lincRNA,-1,767,chr5_115631049_115631816
1110008P14Rik,2,32377097,32381938,protein_coding,-1,4841,chr2_32377097_32381938
1110012L19Rik,X,70385877,70389417,protein_coding,1,3540,chrX_70385877_70389417
1110017D15Rik,4,41505009,41517333,protein_coding,-1,12324,chr4_41505009_41517333
1110018N20Rik,2,167188702,167192808,processed_transcript,1,4106,chr2_167188702_167192808
1110019D14Rik,6,13871526,14044385,lincRNA,1,172859,chr6_13871526_14044385
1110020A21Rik,17,84917182,84957710,bidirectional_promoter_lncRNA,-1,40528,chr17_84917182_84957710
1110028F11Rik,11,87701396,87705331,sense_intronic,1,3935,chr11_87701396_87705331
1110032A03Rik,9,50762828,50775520,protein_coding,-1,12692,chr9_50762828_50775520
1110032F04Rik,3,68869586,68872163,protein_coding,1,2577,chr3_68869586_68872163
1110038B12Rik,17,34950238,34952471,processed_transcript,-1,2233,chr17_34950238_34952471
1110038F14Rik,15,76948506,76950979,protein_coding,1,2473,chr15_76948506_76950979
1110046J04Rik,13,33935567,33960181,antisense,1,24614,chr13_33935567_33960181
1110051M20Rik,2,91275068,91444704,protein_coding,-1,169636,chr2_91275068_91444704
1110059E24Rik,19,21581202,21652976,protein_coding,-1,71774,chr19_21581202_21652976
1110059G10Rik,9,122945089,122951000,protein_coding,-1,5911,chr9_122945089_122951000
1110065P20Rik,4,124849080,124851196,protein_coding,-1,2116,chr4_124849080_124851196
1190005I06Rik,8,120608602,120647632,protein_coding,-1,39030,chr8_120608602_120647632
1190007I07Rik,10,82619851,82623228,protein_coding,-1,3377,chr10_82619851_82623228
1300002E11Rik,16,21794318,21809040,lincRNA,1,14722,chr16_21794318_21809040
1300017J02Rik,9,103250521,103305082,protein_coding,-1,54561,chr9_103250521_103305082
1500002F19Rik,7,132874739,132931197,processed_transcript,-1,56458,chr7_132874739_132931197
1500004A13Rik,3,88782943,88832547,processed_transcript,-1,49604,chr3_88782943_88832547
1500009C09Rik,15,82252397,82260753,protein_coding,1,8356,chr15_82252397_82260753
1500009L16Rik,10,83722865,83762762,protein_coding,1,39897,chr10_83722865_83762762
1500011B03Rik,5,114808196,114823468,protein_coding,-1,15272,chr5_114808196_114823468
1500012K07Rik,7,75308696,75331419,processed_transcript,1,22723,chr7_75308696_75331419
1500015A07Rik,18,61726390,61735917,antisense,1,9527,chr18_61726390_61735917
1500015L24Rik,19,20324856,20444883,lincRNA,1,120027,chr19_20324856_20444883
1500026H17Rik,10,89686371,89700866,bidirectional_promoter_lncRNA,1,14495,chr10_89686371_89700866
1500035N22Rik,5,24985842,24998168,lincRNA,1,12326,chr5_24985842_24998168
1520401A03Rik,17,23704488,23722783,protein_coding,-1,18295,chr17_23704488_23722783
1600002D24Rik,16,95756541,95929077,lincRNA,-1,172536,chr16_95756541_95929077
1600010M07Rik,7,109998376,110151202,antisense,-1,152826,chr7_109998376_110151202
1600012H06Rik,17,14943184,14959570,protein_coding,1,16386,chr17_14943184_14959570
1600014C10Rik,7,38183217,38197568,protein_coding,1,14351,chr7_38183217_38197568
1600014C23Rik,17,45732864,45733844,protein_coding,-1,980,chr17_45732864_45733844
1600019K03Rik,16,35503170,35509419,lincRNA,-1,6249,chr16_35503170_35509419
1600020E01Rik,6,86526247,86582466,antisense,1,56219,chr6_86526247_86582466
1600027J07Rik,8,103343878,103347534,lincRNA,-1,3656,chr8_103343878_103347534
1600029O15Rik,9,58202897,58208808,transcribed_processed_pseudogene,1,5911,chr9_58202897_58208808
1700001C19Rik,17,47412733,47437376,protein_coding,-1,24643,chr17_47412733_47437376
1700001D01Rik,8,61281522,61288872,antisense,-1,7350,chr8_61281522_61288872
1700001G01Rik,18,17019051,17137559,lincRNA,1,118508,chr18_17019051_17137559
1700001G11Rik,14,66295334,66297129,processed_transcript,-1,1795,chr14_66295334_66297129
1700001J03Rik,5,146182441,146185304,protein_coding,-1,2863,chr5_146182441_146185304
1700001J11Rik,9,40050365,40053028,transcribed_processed_pseudogene,1,2663,chr9_40050365_40053028
1700001K19Rik,12,110667688,110682619,protein_coding,-1,14931,chr12_110667688_110682619
1700001K23Rik,19,53248736,53265405,lincRNA,-1,16669,chr19_53248736_53265405
1700001L05Rik,15,83353847,83367282,lincRNA,-1,13435,chr15_83353847_83367282
1700001L19Rik,13,68597421,68614231,protein_coding,1,16810,chr13_68597421_68614231
1700001O22Rik,2,30794769,30803661,protein_coding,-1,8892,chr2_30794769_30803661
1700001P01Rik,11,97771481,97775918,protein_coding,-1,4437,chr11_97771481_97775918
1700003D09Rik,11,98350718,98358283,processed_transcript,-1,7565,chr11_98350718_98358283
1700003E16Rik,6,83156404,83162945,protein_coding,1,6541,chr6_83156404_83162945
1700003F12Rik,2,154547085,154550003,protein_coding,1,2918,chr2_154547085_154550003
1700003G18Rik,7,116081759,116093159,processed_transcript,-1,11400,chr7_116081759_116093159
1700003L19Rik,16,12800579,12848653,lincRNA,1,48074,chr16_12800579_12848653
1700003M07Rik,4,129960374,129963657,lincRNA,1,3283,chr4_129960374_129963657
1700003O11Rik,18,76014211,76015677,antisense,-1,1466,chr18_76014211_76015677
1700006F04Rik,14,119749225,119751564,sense_intronic,1,2339,chr14_119749225_119751564
1700007E05Rik,16,31376506,31379133,transcribed_processed_pseudogene,-1,2627,chr16_31376506_31379133
1700007F19Rik,3,58141707,58163807,lincRNA,-1,22100,chr3_58141707_58163807
1700007J10Rik,11,59725917,59740154,processed_transcript,-1,14237,chr11_59725917_59740154
1700007K13Rik,2,28462001,28466332,protein_coding,-1,4331,chr2_28462001_28466332
1700007L15Rik,16,33379854,33380727,bidirectional_promoter_lncRNA,-1,873,chr16_33379854_33380727
1700007P06Rik,1,187125138,187127852,antisense,1,2714,chr1_187125138_187127852
1700008J07Rik,7,127510438,127512869,antisense,-1,2431,chr7_127510438_127512869
1700008K24Rik,17,49112263,49113535,lincRNA,-1,1272,chr17_49112263_49113535
1700008O03Rik,7,44360043,44385820,protein_coding,-1,25777,chr7_44360043_44385820
1700009C05Rik,6,81900464,81910800,lincRNA,-1,10336,chr6_81900464_81910800
1700009N14Rik,4,39450295,39451776,protein_coding,1,1481,chr4_39450295_39451776
1700010H22Rik,5,98553629,98567004,lincRNA,-1,13375,chr5_98553629_98567004
1700010I14Rik,17,8988333,9011949,protein_coding,1,23616,chr17_8988333_9011949
1700010K23Rik,16,66657118,66664626,antisense,1,7508,chr16_66657118_66664626
1700010L04Rik,7,82851599,82859849,lincRNA,1,8250,chr7_82851599_82859849
1700010N08Rik,7,38791661,38860532,transcribed_processed_pseudogene,1,68871,chr7_38791661_38860532
1700012C14Rik,6,30460128,30463313,lincRNA,1,3185,chr6_30460128_30463313
1700012D14Rik,7,111083064,111122684,processed_transcript,-1,39620,chr7_111083064_111122684
1700012D16Rik,3,153296504,153298649,sense_intronic,-1,2145,chr3_153296504_153298649
1700012I11Rik,15,67226769,67377094,lincRNA,1,150325,chr15_67226769_67377094
1700013F07Rik,3,108534150,108544723,protein_coding,1,10573,chr3_108534150_108544723
1700015C15Rik,13,64427780,64432402,antisense,-1,4622,chr13_64427780_64432402
1700015F17Rik,5,5437827,5479143,protein_coding,-1,41316,chr5_5437827_5479143
1700016C15Rik,1,177729814,177753324,protein_coding,1,23510,chr1_177729814_177753324
1700016D06Rik,8,11654924,11701063,protein_coding,-1,46139,chr8_11654924_11701063
1700016G22Rik,13,5855508,5858092,lincRNA,-1,2584,chr13_5855508_5858092
1700016H13Rik,5,103648039,103656010,protein_coding,-1,7971,chr5_103648039_103656010
1700016J18Rik,10,42018216,42018810,bidirectional_promoter_lncRNA,1,594,chr10_42018216_42018810
1700016K19Rik,11,75999912,76003569,protein_coding,1,3657,chr11_75999912_76003569
1700017B05Rik,9,57253117,57262612,protein_coding,-1,9495,chr9_57253117_57262612
1700017M07Rik,3,35256462,35276131,lincRNA,-1,19669,chr3_35256462_35276131
1700017N19Rik,10,100590484,100618401,protein_coding,1,27917,chr10_100590484_100618401
1700018A23Rik,6,126822377,126825177,antisense,1,2800,chr6_126822377_126825177
1700018B08Rik,8,121530780,121544320,protein_coding,-1,13540,chr8_121530780_121544320
1700018G05Rik,X,102928372,102929094,protein_coding,1,722,chrX_102928372_102929094
1700018L02Rik,19,29046245,29048729,antisense,1,2484,chr19_29046245_29048729
1700019A02Rik,1,53158577,53187636,protein_coding,-1,29059,chr1_53158577_53187636
1700019D03Rik,1,52922324,53020179,protein_coding,-1,97855,chr1_52922324_53020179
1700019G24Rik,6,5963909,5977393,antisense,-1,13484,chr6_5963909_5977393
1700019J19Rik,9,14089620,14118301,lincRNA,1,28681,chr9_14089620_14118301
1700019N19Rik,19,58785803,58794461,protein_coding,-1,8658,chr19_58785803_58794461
1700019P21Rik,1,138876272,138876951,lincRNA,-1,679,chr1_138876272_138876951
1700020A23Rik,2,130405259,130406074,protein_coding,1,815,chr2_130405259_130406074
1700020D05Rik,19,5502767,5503787,protein_coding,-1,1020,chr19_5502767_5503787
1700020D12Rik,12,26572108,26602309,lincRNA,-1,30201,chr12_26572108_26602309
1700020L24Rik,11,83437677,83441233,protein_coding,1,3556,chr11_83437677_83441233
1700021L23Rik,4,124302837,124311461,lincRNA,-1,8624,chr4_124302837_124311461
1700021N21Rik,4,134448766,134450171,antisense,-1,1405,chr4_134448766_134450171
1700022H01Rik,10,61674789,61680255,bidirectional_promoter_lncRNA,-1,5466,chr10_61674789_61680255
1700022I11Rik,4,42969604,42983640,protein_coding,1,14036,chr4_42969604_42983640
1700022N22Rik,17,25985808,25991030,antisense,1,5222,chr17_25985808_25991030
1700023F02Rik,10,66120605,66254223,lincRNA,-1,133618,chr10_66120605_66254223
1700024B18Rik,14,123987635,124015684,antisense,1,28049,chr14_123987635_124015684
1700025D23Rik,11,114091406,114095336,lincRNA,1,3930,chr11_114091406_114095336
1700025F24Rik,10,119413444,119426864,lincRNA,1,13420,chr10_119413444_119426864
1700025G04Rik,1,151852403,152090125,protein_coding,-1,237722,chr1_151852403_152090125
1700025J12Rik,7,121589903,121591591,lincRNA,1,1688,chr7_121589903_121591591
1700025K24Rik,17,54352583,54370074,lincRNA,-1,17491,chr17_54352583_54370074
1700025N23Rik,6,39063878,39067598,antisense,-1,3720,chr6_39063878_39067598
1700026D11Rik,2,132490634,132524057,antisense,1,33423,chr2_132490634_132524057
1700026J14Rik,6,48536582,48537474,lincRNA,-1,892,chr6_48536582_48537474
1700027H10Rik,3,45416584,45439310,antisense,-1,22726,chr3_45416584_45439310
1700027I24Rik,9,36668856,36693189,bidirectional_promoter_lncRNA,-1,24333,chr9_36668856_36693189
1700028B04Rik,7,28492550,28497713,transcribed_processed_pseudogene,1,5163,chr7_28492550_28497713
1700028E10Rik,5,151368675,151432118,processed_transcript,1,63443,chr5_151368675_151432118
1700028J19Rik,7,44229811,44246695,protein_coding,-1,16884,chr7_44229811_44246695
1700028K03Rik,5,107534709,107551542,protein_coding,1,16833,chr5_107534709_107551542
1700028P14Rik,19,23558753,23652812,protein_coding,-1,94059,chr19_23558753_23652812
1700029H14Rik,8,13550733,13562461,protein_coding,-1,11728,chr8_13550733_13562461
1700029I15Rik,2,92382538,92385708,protein_coding,1,3170,chr2_92382538_92385708
1700029J07Rik,8,45953606,45975440,protein_coding,-1,21834,chr8_45953606_45975440
1700030A11Rik,17,28905265,28906771,antisense,1,1506,chr17_28905265_28906771
1700030C10Rik,12,20804381,20815779,processed_transcript;transcribed_unprocessed_pseudogene,-1,11398,chr12_20804381_20815779
1700030C14Rik,2,152652883,152654330,antisense,-1,1447,chr2_152652883_152654330
1700030E10Rik,10,67708588,67718039,lincRNA,-1,9451,chr10_67708588_67718039
1700030F04Rik,6,117646693,117751769,lincRNA,-1,105076,chr6_117646693_117751769
1700030J22Rik,8,116969594,116978959,protein_coding,-1,9365,chr8_116969594_116978959
1700030K09Rik,8,72443880,72461001,protein_coding,1,17121,chr8_72443880_72461001
1700030L20Rik,3,136435270,136449349,lincRNA,-1,14079,chr3_136435270_136449349
1700030L22Rik,12,53303352,53309846,antisense,-1,6494,chr12_53303352_53309846
1700031A10Rik,17,36923792,36933432,antisense,1,9640,chr17_36923792_36933432
1700034G24Rik,5,112582936,112589996,lincRNA,-1,7060,chr5_112582936_112589996
1700034H15Rik,CHR_MG3999_PATCH,191886130,191907527,antisense;lncRNA,-1,21397,chrCHR_MG3999_PATCH_191886130_191907527
1700034I23Rik,3,40800477,40902543,protein_coding,-1,102066,chr3_40800477_40902543
1700034J05Rik,6,146950329,146954422,protein_coding,-1,4093,chr6_146950329_146954422
1700034P13Rik,1,9747648,9791924,antisense,1,44276,chr1_9747648_9791924
1700037C18Rik,16,3895179,3908689,protein_coding,-1,13510,chr16_3895179_3908689
1700037H04Rik,2,131146324,131160081,protein_coding,-1,13757,chr2_131146324_131160081
1700039E22Rik,19,44828493,44835938,antisense,-1,7445,chr19_44828493_44835938
1700039M10Rik,14,57571614,57572368,bidirectional_promoter_lncRNA,1,754,chr14_57571614_57572368
1700040D17Rik,3,94409395,94412919,lincRNA,-1,3524,chr3_94409395_94412919
1700041B01Rik,15,78670785,78676114,antisense,1,5329,chr15_78670785_78676114
1700042G15Rik,4,57360868,57364292,lincRNA,-1,3424,chr4_57360868_57364292
1700045H11Rik,4,150828225,150854949,antisense,-1,26724,chr4_150828225_150854949
1700047A11Rik,8,26082609,26096522,antisense,1,13913,chr8_26082609_26096522
1700047E10Rik,14,44191607,44213237,antisense,-1,21630,chr14_44191607_44213237
1700047G03Rik,15,11964276,11970086,lincRNA,1,5810,chr15_11964276_11970086
1700047M11Rik,1,182287990,182303325,lincRNA,1,15335,chr1_182287990_182303325
1700048F04Rik,5,125928770,125952630,lincRNA,1,23860,chr5_125928770_125952630
1700048M11Rik,16,92308716,92312468,antisense,-1,3752,chr16_92308716_92312468
1700048O20Rik,9,121937223,121947016,lincRNA,1,9793,chr9_121937223_121947016
1700049E15Rik,6,147690241,147702374,lincRNA,1,12133,chr6_147690241_147702374
1700051A21Rik,11,72266421,72268575,processed_transcript,1,2154,chr11_72266421_72268575
1700052K11Rik,11,105177726,105181433,antisense,-1,3707,chr11_105177726_105181433
1700054A03Rik,19,53033648,53084516,processed_transcript,1,50868,chr19_53033648_53084516
1700054M17Rik,2,118304914,118308166,antisense,1,3252,chr2_118304914_118308166
1700055D18Rik,4,45011687,45015406,antisense,1,3719,chr4_45011687_45015406
1700056E22Rik,1,184033030,184034301,protein_coding,-1,1271,chr1_184033030_184034301
1700061I17Rik,3,117060522,117077765,lincRNA,-1,17243,chr3_117060522_117077765
1700063D05Rik,9,41192446,41217990,lincRNA,1,25544,chr9_41192446_41217990
1700064M15Rik,12,99626053,99627974,lincRNA,-1,1921,chr12_99626053_99627974
1700065D16Rik,9,95855418,95858322,antisense,-1,2904,chr9_95855418_95858322
1700065J18Rik,1,192841661,192842740,lincRNA,1,1079,chr1_192841661_192842740
1700065L07Rik,6,73436986,73471021,lincRNA,-1,34035,chr6_73436986_73471021
1700066B17Rik,1,39839175,39847334,lincRNA,-1,8159,chr1_39839175_39847334
1700066B19Rik,18,35703225,35730869,protein_coding,1,27644,chr18_35703225_35730869
1700066C05Rik,16,79999376,80000546,lincRNA,1,1170,chr16_79999376_80000546
1700066J03Rik,13,58146949,58149692,processed_transcript,1,2743,chr13_58146949_58149692
1700066M21Rik,1,57377620,57385423,protein_coding,1,7803,chr1_57377620_57385423
1700067K01Rik,8,84001502,84004770,protein_coding,1,3268,chr8_84001502_84004770
1700067P10Rik,17,48088914,48090918,protein_coding,1,2004,chr17_48088914_48090918
1700071G01Rik,5,73157014,73157884,antisense,1,870,chr5_73157014_73157884
1700071K01Rik,11,81572655,81573473,processed_pseudogene,-1,818,chr11_81572655_81573473
1700071M16Rik,17,43588340,43592442,antisense,-1,4102,chr17_43588340_43592442
1700073E17Rik,6,145387596,145402179,transcribed_processed_pseudogene,1,14583,chr6_145387596_145402179
1700074H08Rik,13,119680040,119681588,lincRNA,1,1548,chr13_119680040_119681588
1700080N15Rik,2,4132063,4141141,antisense,-1,9078,chr2_4132063_4141141
1700081B01Rik,5,126706914,126736252,lincRNA,1,29338,chr5_126706914_126736252
1700084E18Rik,2,30236795,30238223,antisense,-1,1428,chr2_30236795_30238223
1700084J12Rik,15,33403985,33405976,transcribed_processed_pseudogene,-1,1991,chr15_33403985_33405976
1700085C21Rik,12,82932520,82939155,antisense,-1,6635,chr12_82932520_82939155
1700086D15Rik,11,65151910,65159891,protein_coding,-1,7981,chr11_65151910_65159891
1700086L19Rik,12,74284242,74295945,transcribed_unitary_pseudogene,1,11703,chr12_74284242_74295945
1700086O06Rik,18,38238405,38250565,lincRNA,-1,12160,chr18_38238405_38250565
1700086P04Rik,4,129050097,129057983,lincRNA,-1,7886,chr4_129050097_129057983
1700087I21Rik,14,103424905,103449867,lincRNA,1,24962,chr14_103424905_103449867
1700087M22Rik,14,30770681,30778004,antisense,-1,7323,chr14_30770681_30778004
1700088E04Rik,15,79129349,79141253,protein_coding,-1,11904,chr15_79129349_79141253
1700092K14Rik,11,114198258,114199199,processed_transcript,1,941,chr11_114198258_114199199
1700092M07Rik,19,8740718,8741225,protein_coding,1,507,chr19_8740718_8741225
1700093K21Rik,11,23516203,23521155,protein_coding,-1,4952,chr11_23516203_23521155
1700094D03Rik,3,90062796,90068347,protein_coding,1,5551,chr3_90062796_90068347
1700094J05Rik,10,76389015,76401507,antisense,1,12492,chr10_76389015_76401507
1700094M23Rik,3,153162728,153182815,lincRNA,-1,20087,chr3_153162728_153182815
1700095J12Rik,4,138137595,138138518,antisense,-1,923,chr4_138137595_138138518
1700096J18Rik,11,109346839,109353651,lincRNA,1,6812,chr11_109346839_109353651
1700096K18Rik,5,25530013,25531466,lincRNA,1,1453,chr5_25530013_25531466
1700099I09Rik,13,102760255,102761896,antisense,1,1641,chr13_102760255_102761896
1700100I10Rik,14,114940227,114945948,lincRNA,-1,5721,chr14_114940227_114945948
1700100L14Rik,13,70573241,70576110,antisense,1,2869,chr13_70573241_70576110
1700101I11Rik,6,129531950,129533817,processed_transcript,-1,1867,chr6_129531950_129533817
1700102H20Rik,17,3557824,3559862,lincRNA,1,2038,chr17_3557824_3559862
1700102P08Rik,9,108392805,108410934,protein_coding,1,18129,chr9_108392805_108410934
1700105P06Rik,19,7382537,7383561,antisense,1,1024,chr19_7382537_7383561
1700108F19Rik,14,76672963,76687169,processed_transcript,1,14206,chr14_76672963_76687169
1700109G14Rik,14,61292980,61318146,antisense,-1,25166,chr14_61292980_61318146
1700109H08Rik,5,3571566,3584356,protein_coding,1,12790,chr5_3571566_3584356
1700109K24Rik,15,77084398,77096314,antisense,1,11916,chr15_77084398_77096314
1700110C19Rik,17,10324602,10329307,lincRNA,1,4705,chr17_10324602_10329307
1700110I01Rik,14,3262340,3305832,lincRNA,1,43492,chr14_3262340_3305832
1700110I07Rik,7,41060617,41089843,lincRNA,-1,29226,chr7_41060617_41089843
1700110K17Rik,9,40323426,40343564,antisense,1,20138,chr9_40323426_40343564
1700111N16Rik,X,69929259,70143588,antisense,-1,214329,chrX_69929259_70143588
1700112D23Rik,3,28702667,28781108,antisense,-1,78441,chr3_28702667_28781108
1700112H15Rik,1,184527841,184557691,lincRNA,-1,29850,chr1_184527841_184557691
1700112J05Rik,5,77006449,77018863,lincRNA,-1,12414,chr5_77006449_77018863
1700112J16Rik,7,67204082,67222536,lincRNA,-1,18454,chr7_67204082_67222536
1700113A16Rik,3,88171556,88177785,antisense,-1,6229,chr3_88171556_88177785
1700113B09Rik,10,71181036,71204487,lincRNA,1,23451,chr10_71181036_71204487
1700113H08Rik,10,87058045,87230589,protein_coding,1,172544,chr10_87058045_87230589
1700116H05Rik,17,88294505,88306887,lincRNA,-1,12382,chr17_88294505_88306887
1700120C14Rik,15,99249511,99262044,processed_transcript,1,12533,chr15_99249511_99262044
1700120E14Rik,18,74525140,74531124,antisense,-1,5984,chr18_74525140_74531124
1700120G07Rik,7,135191764,135196002,lincRNA,-1,4238,chr7_135191764_135196002
1700120K04Rik,7,127603900,127604445,antisense,-1,545,chr7_127603900_127604445
1700122E12Rik,8,84847188,84848415,processed_transcript,1,1227,chr8_84847188_84848415
1700122H20Rik,17,6895940,6901718,antisense,1,5778,chr17_6895940_6901718
1700123J17Rik,7,126224247,126248238,lincRNA,-1,23991,chr7_126224247_126248238
1700123K08Rik,5,138561840,138564712,protein_coding,-1,2872,chr5_138561840_138564712
1700123L14Rik,6,96164497,96166243,protein_coding,-1,1746,chr6_96164497_96166243
1700123M08Rik,4,11966565,11994280,processed_transcript,1,27715,chr4_11966565_11994280
1700123O20Rik,14,54686216,54690741,protein_coding,1,4525,chr14_54686216_54690741
1700123O21Rik,16,5975585,5998496,sense_intronic,1,22911,chr16_5975585_5998496
1700124L16Rik,6,83761756,83762865,antisense,-1,1109,chr6_83761756_83762865
1700125G02Rik,4,124890888,124894782,antisense,-1,3894,chr4_124890888_124894782
1700125G22Rik,3,27154026,27157019,lincRNA,1,2993,chr3_27154026_27157019
1700125H03Rik,8,68368434,68375710,antisense,1,7276,chr8_68368434_68375710
1700125H20Rik,11,85170404,85181145,protein_coding,1,10741,chr11_85170404_85181145
1700128F08Rik,9,8221889,8241987,transcribed_processed_pseudogene,1,20098,chr9_8221889_8241987
1810007C17Rik,12,49476991,49480862,lincRNA,-1,3871,chr12_49476991_49480862
1810007D17Rik,19,58606329,58629753,lincRNA,1,23424,chr19_58606329_58629753
1810009A15Rik,19,8888853,8890881,protein_coding,1,2028,chr19_8888853_8890881
1810010H24Rik,11,107025681,107030443,protein_coding,1,4762,chr11_107025681_107030443
1810012K08Rik,2,26138546,26139543,lincRNA,1,997,chr2_26138546_26139543
1810012K16Rik,8,22398721,22399596,lincRNA,1,875,chr8_22398721_22399596
1810013D15Rik,3,157925220,157938355,antisense,1,13135,chr3_157925220_157938355
1810013L24Rik,16,8830100,8858922,protein_coding,1,28822,chr16_8830100_8858922
1810014B01Rik,10,86685525,86694806,transcribed_unprocessed_pseudogene,1,9281,chr10_86685525_86694806
1810018F18Rik,19,58698917,58715770,transcribed_unprocessed_pseudogene,1,16853,chr19_58698917_58715770
1810019D21Rik,8,106135400,106138525,processed_transcript,1,3125,chr8_106135400_106138525
1810019N24Rik,7,12948592,12961768,lincRNA,-1,13176,chr7_12948592_12961768
1810020O05Rik,6,87675590,87722801,protein_coding,-1,47211,chr6_87675590_87722801
1810021B22Rik,15,89071196,89075852,antisense,-1,4656,chr15_89071196_89075852
1810024B03Rik,2,127186355,127208280,protein_coding,-1,21925,chr2_127186355_127208280
1810026B05Rik,7,73539801,73558395,processed_transcript,-1,18594,chr7_73539801_73558395
1810030O07Rik,X,12654879,12673668,protein_coding,-1,18789,chrX_12654879_12673668
1810034E14Rik,13,64248700,64271852,antisense,1,23152,chr13_64248700_64271852
1810037I17Rik,3,122924203,122926184,protein_coding,1,1981,chr3_122924203_122926184
1810041H14Rik,14,121876725,121879409,antisense,-1,2684,chr14_121876725_121879409
1810044D09Rik,6,91440987,91441755,lincRNA,1,768,chr6_91440987_91441755
1810046K07Rik,9,51289686,51328924,protein_coding,-1,39238,chr9_51289686_51328924
1810055G02Rik,19,3708293,3717881,protein_coding,1,9588,chr19_3708293_3717881
1810058I24Rik,6,35252654,35263496,protein_coding,1,10842,chr6_35252654_35263496
1810062G17Rik,3,36475937,36482299,protein_coding,1,6362,chr3_36475937_36482299
1810062O18Rik,14,20546079,20570687,antisense,1,24608,chr14_20546079_20570687
1810064F22Rik,9,22196963,22213860,antisense,-1,16897,chr9_22196963_22213860
2010001A14Rik,11,57795499,57801417,processed_transcript,-1,5918,chr11_57795499_57801417
2010001M07Rik,9,60334142,60334968,antisense,1,826,chr9_60334142_60334968
2010009K17Rik,2,158070367,158091797,antisense,-1,21430,chr2_158070367_158091797
2010010A06Rik,18,75288655,75297329,transcribed_processed_pseudogene,-1,8674,chr18_75288655_75297329
2010016I18Rik,3,106481982,106485913,processed_transcript,-1,3931,chr3_106481982_106485913
2010106C02Rik,17,86285164,86287178,antisense,-1,2014,chr17_86285164_86287178
2010109A12Rik,5,93206518,93213475,protein_coding,1,6957,chr5_93206518_93213475
2010110K18Rik,18,34751809,34758685,lincRNA,1,6876,chr18_34751809_34758685
2010204K13Rik,X,7411817,7445143,processed_transcript,-1,33326,chrX_7411817_7445143
2010300C02Rik,1,37611677,37720085,protein_coding,-1,108408,chr1_37611677_37720085
2010308F09Rik,X,13234641,13247736,lincRNA,-1,13095,chrX_13234641_13247736
2010310C07Rik,6,42370671,42381215,antisense,1,10544,chr6_42370671_42381215
2010315B03Rik,9,124291804,124312696,protein_coding,-1,20892,chr9_124291804_124312696
2010320M18Rik,8,70776810,70777823,lincRNA;lncRNA,1,1013,chr8_70776810_70777823
2010320O07Rik,18,38209772,38229145,lincRNA,1,19373,chr18_38209772_38229145
2200002D01Rik,7,29246561,29248466,protein_coding,-1,1905,chr7_29246561_29248466
2200002J24Rik,7,30698926,30700536,protein_coding,1,1610,chr7_30698926_30700536
2210016F16Rik,13,58379817,58385225,protein_coding,-1,5408,chr13_58379817_58385225
2210016L21Rik,5,114942158,114949783,protein_coding,1,7625,chr5_114942158_114949783
2210406O10Rik,5,36447611,36464853,lincRNA,-1,17242,chr5_36447611_36464853
2210408F21Rik,6,31220351,31337404,processed_transcript,1,117053,chr6_31220351_31337404
2210408I21Rik,13,77135540,77613784,protein_coding,1,478244,chr13_77135540_77613784
2210409D07Rik,18,57632079,57638585,antisense,-1,6506,chr18_57632079_57638585
2210409E12Rik,11,88972657,88973002,transcribed_processed_pseudogene,1,345,chr11_88972657_88973002
2210420H20Rik,18,82754505,82759041,lincRNA,-1,4536,chr18_82754505_82759041
2300009A05Rik,9,63394447,63399246,protein_coding,-1,4799,chr9_63394447_63399246
2310001H17Rik,6,129208412,129238725,lincRNA,-1,30313,chr6_129208412_129238725
2310001K24Rik,2,163471957,163473005,antisense,1,1048,chr2_163471957_163473005
2310002D06Rik,12,80507206,80517954,lincRNA,1,10748,chr12_80507206_80517954
2310002F09Rik,7,43695209,43797958,processed_transcript,-1,102749,chr7_43695209_43797958
2310003N18Rik,9,50232523,50233182,lincRNA,-1,659,chr9_50232523_50233182
2310005A03Rik,2,155097789,155100081,lincRNA,-1,2292,chr2_155097789_155100081
2310008N11Rik,8,26814593,26884380,lincRNA,-1,69787,chr8_26814593_26884380
2310009B15Rik,1,138851983,138856852,protein_coding,-1,4869,chr1_138851983_138856852
2310010J17Rik,7,90124822,90129984,bidirectional_promoter_lncRNA,-1,5162,chr7_90124822_90129984
2310011J03Rik,10,80318254,80320537,protein_coding,-1,2283,chr10_80318254_80320537
2310014F06Rik,7,112612560,112680081,bidirectional_promoter_lncRNA,-1,67521,chr7_112612560_112680081
2310015A10Rik,12,80120546,80132844,processed_transcript,-1,12298,chr12_80120546_80132844
2310015D24Rik,16,13514131,13521107,lincRNA,-1,6976,chr16_13514131_13521107
2310015K22Rik,1,80225044,80228792,lincRNA,1,3748,chr1_80225044_80228792
2310016G11Rik,7,44668233,44678235,antisense,1,10002,chr7_44668233_44678235
2310020H05Rik,13,99076526,99087921,lincRNA,-1,11395,chr13_99076526_99087921
2310022A10Rik,7,27553233,27582099,protein_coding,1,28866,chr7_27553233_27582099
2310022B05Rik,8,124635756,124663369,protein_coding,-1,27613,chr8_124635756_124663369
2310026I22Rik,18,32915826,32939229,antisense,-1,23403,chr18_32915826_32939229
2310030A07Rik,1,150320681,150346771,antisense,-1,26090,chr1_150320681_150346771
2310030G06Rik,9,50739691,50746536,protein_coding,-1,6845,chr9_50739691_50746536
2310033P09Rik,11,59208321,59210738,protein_coding,1,2417,chr11_59208321_59210738
2310034G01Rik,19,46348201,46350302,protein_coding,-1,2101,chr19_46348201_46350302
2310034O05Rik,5,100210692,100218049,lincRNA,1,7357,chr5_100210692_100218049
2310039H08Rik,17,46772635,46773396,protein_coding,1,761,chr17_46772635_46773396
2310039L15Rik,10,95336276,95366202,lincRNA,1,29926,chr10_95336276_95366202
2310040G24Rik,6,86483376,86488227,lincRNA,-1,4851,chr6_86483376_86488227
2310047D07Rik,5,149231332,149237984,lincRNA,1,6652,chr5_149231332_149237984
2310057M21Rik,7,131338220,131362759,protein_coding,-1,24539,chr7_131338220_131362759
2310061I04Rik,17,35892677,35897431,protein_coding,-1,4754,chr17_35892677_35897431
2310065F04Rik,11,67112461,67120080,lincRNA,-1,7619,chr11_67112461_67120080
2310068J16Rik,15,99972158,99973287,antisense,-1,1129,chr15_99972158_99973287
2310075C17Rik,9,112227579,112228242,lincRNA,1,663,chr9_112227579_112228242
2400006E01Rik,3,41521247,41528474,lincRNA,-1,7227,chr3_41521247_41528474
2410002F23Rik,7,44246722,44252319,protein_coding,1,5597,chr7_44246722_44252319
2410003L11Rik,11,97598511,97622893,processed_transcript,1,24382,chr11_97598511_97622893
2410004B18Rik,3,145938014,145944829,protein_coding,1,6815,chr3_145938014_145944829
2410004I01Rik,11,102958300,102964387,lincRNA,-1,6087,chr11_102958300_102964387
2410004P03Rik,12,17003319,17011727,protein_coding,-1,8408,chr12_17003319_17011727
2410006H16Rik,11,62602877,62604807,processed_transcript,1,1930,chr11_62602877_62604807
2410012E07Rik,14,70852933,70873954,lincRNA,1,21021,chr14_70852933_70873954
2410017I17Rik,17,36145018,36163176,lincRNA,1,18158,chr17_36145018_36163176
2410018L13Rik,12,22953997,23010284,lincRNA,-1,56287,chr12_22953997_23010284
2410021H03Rik,17,69275362,69277208,antisense,-1,1846,chr17_69275362_69277208
2410022M11Rik,14,56811989,56813899,bidirectional_promoter_lncRNA,1,1910,chr14_56811989_56813899
2410131K14Rik,5,118245227,118266093,protein_coding,1,20866,chr5_118245227_118266093
2410137M14Rik,17,36977701,36981237,protein_coding,-1,3536,chr17_36977701_36981237
2500002B13Rik,8,57488054,57508877,processed_transcript,1,20823,chr8_57488054_57508877
2500004C02Rik,2,153341157,153346073,processed_transcript,-1,4916,chr2_153341157_153346073
2510002D24Rik,16,18836578,18840160,protein_coding,1,3582,chr16_18836578_18840160
2510009E07Rik,16,21649045,21694665,protein_coding,-1,45620,chr16_21649045_21694665
2510039O18Rik,4,147940895,147947314,protein_coding,1,6419,chr4_147940895_147947314
2610001J05Rik,6,13867735,13871518,protein_coding,-1,3783,chr6_13867735_13871518
2610002M06Rik,X,107782751,107816334,protein_coding,-1,33583,chrX_107782751_107816334
2610005L07Rik,8,20385782,20424814,transcribed_unprocessed_pseudogene,-1,39032,chr8_20385782_20424814
2610008E11Rik,10,79064374,79097600,protein_coding,-1,33226,chr10_79064374_79097600
2610016A17Rik,19,25671134,25672253,antisense,-1,1119,chr19_25671134_25672253
2610020C07Rik,16,11203366,11246201,antisense,1,42835,chr16_11203366_11246201
2610027F03Rik,1,120621740,120690403,lincRNA,1,68663,chr1_120621740_120690403
2610027K06Rik,11,85791661,85832223,processed_transcript,-1,40562,chr11_85791661_85832223
2610028E06Rik,4,125887851,125922417,lincRNA,-1,34566,chr4_125887851_125922417
2610028H24Rik,10,76449081,76461110,protein_coding,1,12029,chr10_76449081_76461110
2610035D17Rik,11,113043895,113201838,lincRNA,-1,157943,chr11_113043895_113201838
2610037D02Rik,15,96134819,96284495,lincRNA,-1,149676,chr15_96134819_96284495
2610042L04Rik,14,4334763,4354688,protein_coding,1,19925,chr14_4334763_4354688
2610044O15Rik8,8,129216354,129234406,protein_coding,-1,18052,chr8_129216354_129234406
2610203C22Rik,1,9560832,9631175,processed_transcript,-1,70343,chr1_9560832_9631175
2610206C17Rik,7,84689640,84779053,antisense,1,89413,chr7_84689640_84779053
2610300M13Rik,6,66451949,66465738,lincRNA,-1,13789,chr6_66451949_66465738
2610301B20Rik,4,10874498,10899425,protein_coding,1,24927,chr4_10874498_10899425
2610306M01Rik,6,86848399,86849440,bidirectional_promoter_lncRNA,-1,1041,chr6_86848399_86849440
2610307P16Rik,13,28460034,28885620,processed_transcript,-1,425586,chr13_28460034_28885620
2610316D01Rik,3,45280437,45378260,processed_transcript,-1,97823,chr3_45280437_45378260
2610318N02Rik,16,17113398,17125167,protein_coding,-1,11769,chr16_17113398_17125167
2610507B11Rik,11,78261752,78290623,protein_coding,1,28871,chr11_78261752_78290623
2610507I01Rik,11,59199836,59202385,processed_transcript,-1,2549,chr11_59199836_59202385
2610528A11Rik,14,37102140,37114022,protein_coding,-1,11882,chr14_37102140_37114022
2610528J11Rik,4,118526999,118530228,protein_coding,1,3229,chr4_118526999_118530228
2700038G22Rik,5,23850597,23855038,lincRNA,1,4441,chr5_23850597_23855038
2700046A07Rik,18,62751674,62756347,lincRNA,-1,4673,chr18_62751674_62756347
2700046G09Rik,19,32389216,32391190,bidirectional_promoter_lncRNA,1,1974,chr19_32389216_32391190
2700049A03Rik,12,71136848,71243303,protein_coding,1,106455,chr12_71136848_71243303
2700054A10Rik,17,13482553,13668891,lincRNA,-1,186338,chr17_13482553_13668891
2700062C07Rik,18,24470850,24477798,protein_coding,1,6948,chr18_24470850_24477798
2700068H02Rik,4,106554669,106557897,antisense,-1,3228,chr4_106554669_106557897
2700069I18Rik,3,5177586,5220841,antisense,-1,43255,chr3_5177586_5220841
2700081O15Rik,19,7417625,7425904,protein_coding,1,8279,chr19_7417625_7425904
2700089I24Rik,19,59493136,59559391,lincRNA,1,66255,chr19_59493136_59559391
2700097O09Rik,12,55045661,55080110,protein_coding,-1,34449,chr12_55045661_55080110
2700099C18Rik,17,94750100,94775132,transcribed_unprocessed_pseudogene,1,25032,chr17_94750100_94775132
2810001G20Rik,11,64079484,64083259,antisense,1,3775,chr11_64079484_64083259
2810002D19Rik,2,94406151,94411682,processed_transcript,1,5531,chr2_94406151_94411682
2810004N23Rik,8,124836945,124863120,protein_coding,-1,26175,chr8_124836945_124863120
2810006K23Rik,5,124328089,124341844,protein_coding,1,13755,chr5_124328089_124341844
2810013P06Rik,8,123042466,123044602,bidirectional_promoter_lncRNA,1,2136,chr8_123042466_123044602
2810021J22Rik,11,58867216,58883288,protein_coding,1,16072,chr11_58867216_58883288
2810025M15Rik,1,157412352,157420236,transcribed_processed_pseudogene,1,7884,chr1_157412352_157420236
2810029C07Rik,12,111572317,111574402,bidirectional_promoter_lncRNA,-1,2085,chr12_111572317_111574402
2810030D12Rik,8,13200720,13207714,bidirectional_promoter_lncRNA,1,6994,chr8_13200720_13207714
2810032G03Rik,12,5375870,5416631,lincRNA,1,40761,chr12_5375870_5416631
2810039B14Rik,15,75642129,75653643,transcribed_unitary_pseudogene,1,11514,chr15_75642129_75653643
2810049E08Rik,13,83891208,83928710,lincRNA,1,37502,chr13_83891208_83928710
2810403D21Rik,X,108833800,108974906,processed_transcript,1,141106,chrX_108833800_108974906
2810404M03Rik,8,41827267,42046202,lincRNA,1,218935,chr8_41827267_42046202
2810407A14Rik,16,87784075,87839293,lincRNA,1,55218,chr16_87784075_87839293
2810408A11Rik,11,69897352,69900987,protein_coding,-1,3635,chr11_69897352_69900987
2810408I11Rik,1,64679871,64690659,processed_transcript,-1,10788,chr1_64679871_64690659
2810410L24Rik,11,120185400,120189852,processed_transcript,-1,4452,chr11_120185400_120189852
2810429I04Rik,13,3478230,3501393,lincRNA,1,23163,chr13_3478230_3501393
2810433D01Rik,11,102619796,102624416,lincRNA,-1,4620,chr11_102619796_102624416
2810442N19Rik,1,162004969,162016494,antisense,1,11525,chr1_162004969_162016494
2810454H06Rik,6,134897961,134901108,antisense,1,3147,chr6_134897961_134901108
2810459M11Rik,1,86045863,86055456,protein_coding,1,9593,chr1_86045863_86055456
2900005J15Rik,5,25100983,25110109,processed_transcript,1,9126,chr5_25100983_25110109
2900009J06Rik,1,127753616,127774092,antisense,-1,20476,chr1_127753616_127774092
2900026A02Rik,5,113086323,113221236,protein_coding,-1,134913,chr5_113086323_113221236
2900041M22Rik,11,117611247,117613857,processed_transcript,1,2610,chr11_117611247_117613857
2900052N01Rik,9,46913493,46927366,lincRNA,1,13873,chr9_46913493_46927366
2900057B20Rik,18,76091557,76098471,antisense,-1,6914,chr18_76091557_76098471
2900060B14Rik,1,118458652,118459267,antisense,-1,615,chr1_118458652_118459267
2900076A07Rik,7,81523550,81531498,lincRNA,1,7948,chr7_81523550_81531498
2900079G21Rik,9,112234277,112348925,lincRNA,1,114648,chr9_112234277_112348925
2900089D17Rik,5,144241690,144256186,antisense,-1,14496,chr5_144241690_144256186
2900092C05Rik,7,12512517,12556323,protein_coding,1,43806,chr7_12512517_12556323
2900097C17Rik,2,156388065,156392979,lincRNA,-1,4914,chr2_156388065_156392979
3000002C10Rik,9,109827943,109832706,transcribed_processed_pseudogene,-1,4763,chr9_109827943_109832706
3010001F23Rik,X,152368573,152416698,processed_transcript,1,48125,chrX_152368573_152416698
3010003L21Rik,6,148944867,148947129,antisense,1,2262,chr6_148944867_148947129
3100003L05Rik,7,124625670,124708935,lincRNA,-1,83265,chr7_124625670_124708935
3110001I22Rik,16,13671929,13678388,protein_coding,1,6459,chr16_13671929_13678388
3110009E18Rik,1,120121187,120188189,protein_coding,1,67002,chr1_120121187_120188189
3110009F21Rik,12,110151654,110158077,lincRNA,-1,6423,chr12_110151654_110158077
3110009M11Rik,7,83864590,83865481,processed_pseudogene,-1,891,chr7_83864590_83865481
3110015C05Rik,13,111211467,111229431,lincRNA,-1,17964,chr13_111211467_111229431
3110021N24Rik,4,108719649,108781904,protein_coding,1,62255,chr4_108719649_108781904
3110039M20Rik,12,49389652,49407360,lincRNA,1,17708,chr12_49389652_49407360
3110040N11Rik,7,81782182,81789478,protein_coding,-1,7296,chr7_81782182_81789478
3110045C21Rik,1,169969409,169972396,antisense,1,2987,chr1_169969409_169972396
3110053B16Rik,12,20874125,20921262,transcribed_unprocessed_pseudogene,-1,47137,chr12_20874125_20921262
3110056K07Rik,12,70991615,71015832,processed_transcript,-1,24217,chr12_70991615_71015832
3110070M22Rik,13,119487252,119488384,antisense,-1,1132,chr13_119487252_119488384
3110082I17Rik,5,139359739,139460527,protein_coding,-1,100788,chr5_139359739_139460527
3110082J24Rik,5,30103584,30106086,protein_coding,-1,2502,chr5_30103584_30106086
3200001D21Rik,12,88365314,88377323,antisense,-1,12009,chr12_88365314_88377323
3300002A11Rik,12,99341154,99361827,antisense,1,20673,chr12_99341154_99361827
3300002I08Rik,2,150310935,150362765,protein_coding,-1,51830,chr2_150310935_150362765
3300002P13Rik,7,3420181,3423445,lincRNA;lncRNA,-1,3264,chr7_3420181_3423445
3425401B19Rik,14,32659119,32685293,protein_coding,-1,26174,chr14_32659119_32685293
3632454L22Rik,X,135022734,135060336,processed_transcript,-1,37602,chrX_135022734_135060336
3830403N18Rik,X,56136572,56153498,protein_coding,1,16926,chrX_56136572_56153498
3830406C13Rik,14,12284173,12303231,protein_coding,1,19058,chr14_12284173_12303231
3830408C21Rik,13,107022553,107055497,processed_transcript,1,32944,chr13_107022553_107055497
3830432H09Rik,1,119529480,119536165,lincRNA,-1,6685,chr1_119529480_119536165
3930402G23Rik,8,10924427,10928696,lincRNA,-1,4269,chr8_10924427_10928696
4430402I18Rik,19,28893042,28967800,protein_coding,-1,74758,chr19_28893042_28967800
4631405J19Rik,2,93027956,93044732,antisense,1,16776,chr2_93027956_93044732
4632404H12Rik,3,89767511,89773240,lincRNA,-1,5729,chr3_89767511_89773240
4632415L05Rik,3,19894886,19901033,transcribed_unprocessed_pseudogene,1,6147,chr3_19894886_19901033
4632427E13Rik,7,92734166,92741468,bidirectional_promoter_lncRNA,-1,7302,chr7_92734166_92741468
4632428C04Rik,16,30008667,30021430,lincRNA,1,12763,chr16_30008667_30021430
4732414G09Rik,11,73015856,73018841,lincRNA,-1,2985,chr11_73015856_73018841
4732419C18Rik,8,123744631,123754726,lincRNA,-1,10095,chr8_123744631_123754726
4732440D04Rik,1,6209866,6215293,antisense,-1,5427,chr1_6209866_6215293
4732471J01Rik,7,25376819,25566417,antisense,1,189598,chr7_25376819_25566417
4732490B19Rik,11,113203315,113209669,lincRNA,-1,6354,chr11_113203315_113209669
4732491K20Rik,17,12318853,12327250,bidirectional_promoter_lncRNA,1,8397,chr17_12318853_12327250
4831440D22Rik,8,91449521,91474598,antisense,-1,25077,chr8_91449521_91474598
4833411C07Rik,8,10899922,10903893,processed_transcript,1,3971,chr8_10899922_10903893
4833412C05Rik,7,67784538,67804139,lincRNA,-1,19601,chr7_67784538_67804139
4833415N18Rik,16,11778429,11781500,lincRNA,1,3071,chr16_11778429_11781500
4833417C18Rik,11,95858865,95861044,processed_transcript,1,2179,chr11_95858865_95861044
4833418N02Rik,17,87274886,87282814,processed_transcript,-1,7928,chr17_87274886_87282814
4833419F23Rik,18,4353558,4368920,lincRNA,1,15362,chr18_4353558_4368920
4833420G17Rik,13,119462768,119486120,protein_coding,1,23352,chr13_119462768_119486120
4833422C13Rik,13,91701665,91741872,antisense,-1,40207,chr13_91701665_91741872
4833422M21Rik,15,96231870,96254684,processed_transcript,-1,22814,chr15_96231870_96254684
4833427F10Rik,17,35772450,35780687,lincRNA,1,8237,chr17_35772450_35780687
4833427G06Rik,9,51081115,51102078,protein_coding,-1,20963,chr9_51081115_51102078
4833428L15Rik,9,45416626,45431730,antisense,-1,15104,chr9_45416626_45431730
4833438C02Rik,19,46303591,46305611,bidirectional_promoter_lncRNA,-1,2020,chr19_46303591_46305611
4833439L19Rik,13,54551218,54565435,protein_coding,-1,14217,chr13_54551218_54565435
4921504A21Rik,5,19202368,19226555,antisense,-1,24187,chr5_19202368_19226555
4921504E06Rik,2,19462837,19553914,protein_coding,-1,91077,chr2_19462837_19553914
4921507G05Rik,12,110841029,110843804,bidirectional_promoter_lncRNA,1,2775,chr12_110841029_110843804
4921507P07Rik,6,50573302,50596632,protein_coding,-1,23330,chr6_50573302_50596632
4921508D12Rik,2,132424741,132452499,lincRNA,1,27758,chr2_132424741_132452499
4921509C19Rik,2,151470542,151476153,protein_coding,-1,5611,chr2_151470542_151476153
4921511C10Rik,3,79212919,79253913,antisense,1,40994,chr3_79212919_79253913
4921511I17Rik,12,12351522,12392615,antisense,-1,41093,chr12_12351522_12392615
4921513I03Rik,10,120765732,120778886,lincRNA,1,13154,chr10_120765732_120778886
4921515E04Rik,15,18078118,18369627,processed_transcript,-1,291509,chr15_18078118_18369627
4921517D16Rik,16,57331951,57335432,antisense,1,3481,chr16_57331951_57335432
4921517D22Rik,13,59687402,59694108,protein_coding,-1,6706,chr13_59687402_59694108
4921518K17Rik,12,57585975,57618602,antisense,-1,32627,chr12_57585975_57618602
4921524J17Rik,8,85408759,85432833,protein_coding,-1,24074,chr8_85408759_85432833
4921524L21Rik,18,6603629,6638970,protein_coding,1,35341,chr18_6603629_6638970
4921528I07Rik,9,114237697,114317028,processed_transcript,-1,79331,chr9_114237697_114317028
4921531C22Rik,2,179975993,179979013,processed_transcript,1,3020,chr2_179975993_179979013
4921533I20Rik,18,17234324,17319730,transcribed_processed_pseudogene,-1,85406,chr18_17234324_17319730
4921534H16Rik,9,98003420,98012175,antisense,1,8755,chr9_98003420_98012175
4921536K21Rik,11,3886088,3895098,protein_coding,-1,9010,chr11_3886088_3895098
4921539E11Rik,4,103230445,103290863,protein_coding,-1,60418,chr4_103230445_103290863
4921539H07Rik,3,58117053,58167616,lincRNA,1,50563,chr3_58117053_58167616
4922502N22Rik,6,139315597,139322576,lincRNA,-1,6979,chr6_139315597_139322576
4930401C15Rik,10,25779314,25837437,lincRNA,-1,58123,chr10_25779314_25837437
4930401G09Rik,5,115358700,115360123,lincRNA,-1,1423,chr5_115358700_115360123
4930402H24Rik,2,130706200,130906406,protein_coding,-1,200206,chr2_130706200_130906406
4930403D09Rik,11,34299707,34308113,antisense,1,8406,chr11_34299707_34308113
4930404H11Rik,12,71488285,71556133,lincRNA,1,67848,chr12_71488285_71556133
4930404H24Rik,2,153492790,153493841,protein_coding,1,1051,chr2_153492790_153493841
4930404I05Rik,16,91011249,91016743,processed_transcript,1,5494,chr16_91011249_91016743
4930404K13Rik,14,119798978,119817574,sense_intronic,1,18596,chr14_119798978_119817574
4930405A21Rik,2,156714540,156720909,processed_transcript,-1,6369,chr2_156714540_156720909
4930405J17Rik,10,20199240,20201838,antisense,-1,2598,chr10_20199240_20201838
4930405O22Rik,17,63305446,63312973,sense_intronic,-1,7527,chr17_63305446_63312973
4930407G08Rik,4,107953932,107960721,lincRNA,1,6789,chr4_107953932_107960721
4930412B13Rik,2,117821928,117909136,lincRNA,1,87208,chr2_117821928_117909136
4930412C18Rik,4,9770585,9823411,processed_transcript,1,52826,chr4_9770585_9823411
4930412L05Rik,4,53205066,53217857,processed_transcript,-1,12791,chr4_53205066_53217857
4930413F20Rik,15,34675073,34679204,antisense,1,4131,chr15_34675073_34679204
4930414F18Rik,16,12629084,12945935,lincRNA,-1,316851,chr16_12629084_12945935
4930414N06Rik,19,44960373,44984550,antisense,-1,24177,chr19_44960373_44984550
4930415O20Rik,15,98571004,98589580,protein_coding,1,18576,chr15_98571004_98589580
4930417H01Rik,CHR_MG3836_PATCH,122702047,122732895,lncRNA;processed_transcript,1,30848,chrCHR_MG3836_PATCH_122702047_122732895
4930417O22Rik,11,101952421,101960573,antisense,1,8152,chr11_101952421_101960573
4930419G24Rik,3,33024777,33088607,antisense,1,63830,chr3_33024777_33088607
4930423M02Rik,4,5632328,5642284,lincRNA,1,9956,chr4_5632328_5642284
4930425L21Rik,6,135658913,135684527,lincRNA,1,25614,chr6_135658913_135684527
4930425O10Rik,3,138711535,138726984,lincRNA,-1,15449,chr3_138711535_138726984
4930426D05Rik,18,21651448,21656105,antisense,1,4657,chr18_21651448_21656105
4930426I24Rik,12,76402751,76403982,lincRNA,-1,1231,chr12_76402751_76403982
4930426L09Rik,2,18998343,18999804,bidirectional_promoter_lncRNA,1,1461,chr2_18998343_18999804
4930428E07Rik,12,38552808,38614521,antisense,-1,61713,chr12_38552808_38614521
4930428O21Rik,5,107698212,107703480,lincRNA,-1,5268,chr5_107698212_107703480
4930429D17Rik,5,103230375,103299029,lincRNA,-1,68654,chr5_103230375_103299029
4930429F24Rik,9,79793641,79803235,lincRNA,1,9594,chr9_79793641_79803235
4930429P21Rik,9,107351276,107353986,lincRNA,-1,2710,chr9_107351276_107353986
4930430F08Rik,10,100572265,100590423,protein_coding,-1,18158,chr10_100572265_100590423
4930430F21Rik,15,31039128,31043331,lincRNA,1,4203,chr15_31039128_31043331
4930431F10Rik,10,44730769,44738900,lincRNA,-1,8131,chr10_44730769_44738900
4930431F12Rik,5,44966200,44978805,lincRNA,1,12605,chr5_44966200_44978805
4930431P03Rik,14,44955215,44961326,processed_transcript,-1,6111,chr14_44955215_44961326
4930431P22Rik,14,76760131,76762217,lincRNA,1,2086,chr14_76760131_76762217
4930432J09Rik,14,103977628,104027142,lincRNA,-1,49514,chr14_103977628_104027142
4930432K21Rik,8,84148025,84172590,protein_coding,1,24565,chr8_84148025_84172590
4930432L08Rik,5,76331238,76341885,processed_transcript,1,10647,chr5_76331238_76341885
4930433N12Rik,9,3133847,3199799,processed_transcript,-1,65952,chr9_3133847_3199799
4930434J06Rik,14,71856702,71920439,lincRNA,1,63737,chr14_71856702_71920439
4930435F18Rik,13,116802095,116838178,lincRNA,-1,36083,chr13_116802095_116838178
4930439A04Rik,1,37329667,37334172,antisense,-1,4505,chr1_37329667_37334172
4930440C22Rik,1,94797083,94802472,lincRNA,1,5389,chr1_94797083_94802472
4930440I19Rik,2,78051177,78194430,lincRNA,1,143253,chr2_78051177_78194430
4930441J16Rik,2,74298940,74307717,lincRNA,-1,8777,chr2_74298940_74307717
4930443O20Rik,2,85073614,85086461,processed_transcript,-1,12847,chr2_85073614_85086461
4930444A19Rik,1,54681729,54767524,antisense,1,85795,chr1_54681729_54767524
4930444F02Rik,10,18796806,18831930,lincRNA,-1,35124,chr10_18796806_18831930
4930444P10Rik,1,16065979,16093325,protein_coding,-1,27346,chr1_16065979_16093325
4930445E18Rik,15,25285802,25332659,lincRNA,-1,46857,chr15_25285802_25332659
4930445N18Rik,18,82855894,82870604,lincRNA,1,14710,chr18_82855894_82870604
4930447A16Rik,15,37425554,37440644,protein_coding,1,15090,chr15_37425554_37440644
4930447C04Rik,12,72881109,72940774,protein_coding,-1,59665,chr12_72881109_72940774
4930447F24Rik,9,108133718,108138567,processed_transcript,1,4849,chr9_108133718_108138567
4930447K03Rik,13,34084155,34113272,processed_transcript,-1,29117,chr13_34084155_34113272
4930447M23Rik,2,19344317,19351050,lincRNA,1,6733,chr2_19344317_19351050
4930447N08Rik,3,122761955,122802048,processed_transcript,-1,40093,chr3_122761955_122802048
4930448F12Rik,13,18084947,18100202,lincRNA,-1,15255,chr13_18084947_18100202
4930448I18Rik,5,50151333,50156095,lincRNA,1,4762,chr5_50151333_50156095
4930448K20Rik,4,9915965,9917635,transcribed_processed_pseudogene,-1,1670,chr4_9915965_9917635
4930449C09Rik,15,63717818,63737680,lincRNA,1,19862,chr15_63717818_63737680
4930449E01Rik,14,105498788,105505629,processed_transcript,1,6841,chr14_105498788_105505629
4930449E18Rik,19,57273960,57277052,antisense,1,3092,chr19_57273960_57277052
4930451E10Rik,13,55775136,55784505,antisense,-1,9369,chr13_55775136_55784505
4930451G09Rik,16,4964289,4978962,transcribed_unitary_pseudogene,1,14673,chr16_4964289_4978962
4930451I11Rik,7,126830468,126831639,protein_coding,-1,1171,chr7_126830468_126831639
4930452B06Rik,14,8431192,8666240,protein_coding,-1,235048,chr14_8431192_8666240
4930452G13Rik,14,79702920,79714464,lincRNA,1,11544,chr14_79702920_79714464
4930452N14Rik,1,154241521,154256906,lincRNA,-1,15385,chr1_154241521_154256906
4930453L07Rik,8,9144669,9149050,lincRNA,1,4381,chr8_9144669_9149050
4930453N24Rik,16,64751751,64771161,protein_coding,-1,19410,chr16_64751751_64771161
4930455B14Rik,14,8666386,8673378,lincRNA,1,6992,chr14_8666386_8673378
4930455C13Rik,10,21319088,21342057,antisense,-1,22969,chr10_21319088_21342057
4930455G09Rik,CHR_MG51_PATCH,142017898,142028996,antisense;lncRNA,1,11098,chrCHR_MG51_PATCH_142017898_142028996
4930455H04Rik,3,116968267,116984406,protein_coding,1,16139,chr3_116968267_116984406
4930456L15Rik,4,103290959,103311832,lincRNA,1,20873,chr4_103290959_103311832
4930461C15Rik,16,58404878,58408276,lincRNA,-1,3398,chr16_58404878_58408276
4930461G14Rik,9,58455122,58469635,lincRNA,1,14513,chr9_58455122_58469635
4930463O16Rik,10,84488293,84497435,lincRNA,1,9142,chr10_84488293_84497435
4930465K10Rik,18,77714210,77715449,pseudogene,1,1239,chr18_77714210_77715449
4930467D21Rik,5,97392417,97642179,lincRNA,1,249762,chr5_97392417_97642179
4930467E23Rik,8,19729576,19753527,protein_coding,1,23951,chr8_19729576_19753527
4930467K11Rik,10,57478381,57486351,lincRNA,-1,7970,chr10_57478381_57486351
4930470H14Rik,17,4044658,4082995,lincRNA,-1,38337,chr17_4044658_4082995
4930470O06Rik,8,59825649,59844723,lincRNA,1,19074,chr8_59825649_59844723
4930470P17Rik,2,170579418,170602017,protein_coding,-1,22599,chr2_170579418_170602017
4930471C04Rik,14,64099295,64104235,lincRNA,-1,4940,chr14_64099295_64104235
4930471G03Rik,18,36105651,36109977,antisense,1,4326,chr18_36105651_36109977
4930471M09Rik,6,91428308,91440912,transcribed_processed_pseudogene,-1,12604,chr6_91428308_91440912
4930473A02Rik,2,130543791,130563749,antisense,-1,19958,chr2_130543791_130563749
4930473H19Rik,12,88434113,88442254,antisense,-1,8141,chr12_88434113_88442254
4930474M22Rik,17,14389113,14398942,antisense,-1,9829,chr17_14389113_14398942
4930474N09Rik,12,99161277,99162808,lincRNA,-1,1531,chr12_99161277_99162808
4930477N07Rik,10,119320234,119331862,lincRNA,1,11628,chr10_119320234_119331862
4930478L05Rik,16,78560316,78564869,antisense,1,4553,chr16_78560316_78564869
4930479D17Rik,6,146657218,146665403,lincRNA,1,8185,chr6_146657218_146665403
4930479H17Rik,7,30347645,30353321,lincRNA,-1,5676,chr7_30347645_30353321
4930480K15Rik,17,90861169,90867102,antisense,1,5933,chr17_90861169_90867102
4930481A15Rik,19,5406740,5422847,antisense,1,16107,chr19_5406740_5422847
4930483J18Rik,15,81190774,81192763,processed_transcript,1,1989,chr15_81190774_81192763
4930483K19Rik,10,76545871,76562226,antisense,-1,16355,chr10_76545871_76562226
4930483O08Rik,7,133128251,133142457,lincRNA,1,14206,chr7_133128251_133142457
4930484H19Rik,10,126788864,126793710,lincRNA,-1,4846,chr10_126788864_126793710
4930486F22Rik,10,86095859,86113586,antisense,1,17727,chr10_86095859_86113586
4930486I03Rik,1,20356452,20392300,antisense,1,35848,chr1_20356452_20392300
4930488L21Rik,8,93750147,93813722,antisense,-1,63575,chr8_93750147_93813722
4930488N24Rik,17,14104924,14106450,unprocessed_pseudogene,-1,1526,chr17_14104924_14106450
4930500A05Rik,17,84545947,84566824,antisense,-1,20877,chr17_84545947_84566824
4930500H12Rik,16,73072338,73423667,processed_transcript,1,351329,chr16_73072338_73423667
4930502E09Rik,11,84829178,84830868,processed_transcript,1,1690,chr11_84829178_84830868
4930503B20Rik,3,146645193,146651317,protein_coding,-1,6124,chr3_146645193_146651317
4930503E14Rik,14,44163169,44213254,protein_coding,-1,50085,chr14_44163169_44213254
4930503E24Rik,10,124469074,124524488,transcribed_processed_pseudogene,1,55414,chr10_124469074_124524488
4930503H13Rik,X,156539151,156540120,processed_pseudogene,1,969,chrX_156539151_156540120
4930503L19Rik,18,70452212,70472509,protein_coding,-1,20297,chr18_70452212_70472509
4930503O07Rik,1,194212187,194222759,lincRNA,-1,10572,chr1_194212187_194222759
4930504C09Rik,15,69270533,69274720,lincRNA,1,4187,chr15_69270533_69274720
4930505A04Rik,11,30426006,30471827,protein_coding,-1,45821,chr11_30426006_30471827
4930505K13Rik,7,120156115,120166000,lincRNA,1,9885,chr7_120156115_120166000
4930505N22Rik,19,45998137,46013386,bidirectional_promoter_lncRNA,1,15249,chr19_45998137_46013386
4930506C21Rik,17,8293366,8311080,processed_transcript,-1,17714,chr17_8293366_8311080
4930507D05Rik,10,62449489,62451353,bidirectional_promoter_lncRNA,1,1864,chr10_62449489_62451353
4930507D10Rik,11,80850381,80858300,antisense,-1,7919,chr11_80850381_80858300
4930509E16Rik,9,72518250,72531858,lincRNA,-1,13608,chr9_72518250_72531858
4930509J09Rik,3,73351206,73481651,lincRNA,-1,130445,chr3_73351206_73481651
4930509K18Rik,4,40313232,40317719,lincRNA,1,4487,chr4_40313232_40317719
4930511A02Rik,12,11438227,11444812,lincRNA,1,6585,chr12_11438227_11444812
4930511M06Rik,18,57373455,57552397,antisense,-1,178942,chr18_57373455_57552397
4930512B01Rik,12,69790288,69840479,processed_transcript,1,50191,chr12_69790288_69840479
4930512J16Rik,6,89269511,89285725,lincRNA,-1,16214,chr6_89269511_89285725
4930513D17Rik,5,39461749,39603574,lincRNA,-1,141825,chr5_39461749_39603574
4930513L16Rik,15,84906642,84913731,lincRNA,1,7089,chr15_84906642_84913731
4930513N10Rik,8,95806744,95821728,antisense,1,14984,chr8_95806744_95821728
4930515G01Rik,5,114773737,114774983,antisense,-1,1246,chr5_114773737_114774983
4930517E11Rik,2,124123636,124129956,lincRNA,-1,6320,chr2_124123636_124129956
4930517O19Rik,14,100213142,100245339,antisense,1,32197,chr14_100213142_100245339
4930518J21Rik,8,56465622,56484968,lincRNA,-1,19346,chr8_56465622_56484968
4930519F09Rik,10,28880921,28923507,transcribed_processed_pseudogene,-1,42586,chr10_28880921_28923507
4930519F16Rik,X,103182971,103311782,transcribed_unitary_pseudogene,-1,128811,chrX_103182971_103311782
4930519F24Rik,9,100022300,100034672,lincRNA,1,12372,chr9_100022300_100034672
4930519G04Rik,5,114853664,114883880,protein_coding,1,30216,chr5_114853664_114883880
4930520O04Rik,9,114368303,114377229,processed_transcript,1,8926,chr9_114368303_114377229
4930521E06Rik,1,44739676,44744949,antisense,-1,5273,chr1_44739676_44744949
4930522L14Rik,5,109735990,109751886,protein_coding,-1,15896,chr5_109735990_109751886
4930523C07Rik,1,160044382,160080208,protein_coding,1,35826,chr1_160044382_160080208
4930524B15Rik,11,31965592,31979651,protein_coding,1,14059,chr11_31965592_31979651
4930525C09Rik,10,97714772,97753702,lincRNA,1,38930,chr10_97714772_97753702
4930525G20Rik,13,67796594,67830985,antisense,-1,34391,chr13_67796594_67830985
4930526A20Rik,17,28075050,28076677,transcribed_processed_pseudogene,-1,1627,chr17_28075050_28076677
4930526F13Rik,13,54926763,54930256,lincRNA,-1,3493,chr13_54926763_54930256
4930526L06Rik,19,11196817,11299886,antisense,1,103069,chr19_11196817_11299886
4930527F14Rik,14,45530358,45562933,bidirectional_promoter_lncRNA,1,32575,chr14_45530358_45562933
4930528D03Rik,13,59733630,59739185,lincRNA,1,5555,chr13_59733630_59739185
4930528G23Rik,6,148659978,148678000,lincRNA,-1,18022,chr6_148659978_148678000
4930529C04Rik,3,91071662,91075195,processed_pseudogene,1,3533,chr3_91071662_91075195
4930532I03Rik,10,106555195,106602480,antisense,-1,47285,chr10_106555195_106602480
4930533B01Rik,2,113691053,113708550,antisense,-1,17497,chr2_113691053_113708550
4930533I22Rik,6,57476697,57497671,antisense,1,20974,chr6_57476697_57497671
4930533K18Rik,10,70868644,70934324,antisense,1,65680,chr10_70868644_70934324
4930533N22Rik,7,75030194,75075164,lincRNA,1,44970,chr7_75030194_75075164
4930535L15Rik,9,107998116,108002404,antisense,-1,4288,chr9_107998116_108002404
4930538E20Rik,11,24160528,24172824,antisense,-1,12296,chr11_24160528_24172824
4930539J05Rik,3,135436209,135438665,antisense,-1,2456,chr3_135436209_135438665
4930539M17Rik,3,9061964,9071074,lincRNA,1,9110,chr3_9061964_9071074
4930545L23Rik,2,135169573,135215616,antisense,-1,46043,chr2_135169573_135215616
4930546K05Rik,9,42176592,42209231,lincRNA,-1,32639,chr9_42176592_42209231
4930547E08Rik,2,103804452,103810622,processed_transcript,-1,6170,chr2_103804452_103810622
4930547E14Rik,16,59636945,59672999,processed_transcript,1,36054,chr16_59636945_59672999
4930548H24Rik,5,31485740,31488476,protein_coding,1,2736,chr5_31485740_31488476
4930548J01Rik,17,4119446,4122113,processed_transcript,-1,2667,chr17_4119446_4122113
4930549C15Rik,12,26346717,26371748,antisense,1,25031,chr12_26346717_26371748
4930549G23Rik,18,67768299,67799971,antisense,-1,31672,chr18_67768299_67799971
4930550C14Rik,9,53402325,53434402,protein_coding,1,32077,chr9_53402325_53434402
4930553P18Rik,6,86004380,86009355,lincRNA,1,4975,chr6_86004380_86009355
4930554H23Rik,7,63344690,63444529,lincRNA,-1,99839,chr7_63344690_63444529
4930555B11Rik,2,57181831,57188257,processed_transcript,1,6426,chr2_57181831_57188257
4930555G01Rik,14,5050629,5059243,protein_coding,1,8614,chr14_5050629_5059243
4930556G01Rik,4,30664596,30796663,lincRNA,1,132067,chr4_30664596_30796663
4930556M19Rik,15,10714836,10790123,processed_transcript,1,75287,chr15_10714836_10790123
4930556N13Rik,11,88851604,88881395,antisense,1,29791,chr11_88851604_88881395
4930557J02Rik,5,34118740,34135339,antisense,1,16599,chr5_34118740_34135339
4930557K07Rik,6,125010173,125049851,antisense,-1,39678,chr6_125010173_125049851
4930558G05Rik,X,129064297,129067146,lincRNA,1,2849,chrX_129064297_129067146
4930558J18Rik,1,57359222,57377544,lincRNA,-1,18322,chr1_57359222_57377544
4930558K02Rik,1,161942086,161979636,protein_coding,-1,37550,chr1_161942086_161979636
4930562C15Rik,16,4835416,4867686,protein_coding,1,32270,chr16_4835416_4867686
4930562F07Rik,1,160074735,160077985,lincRNA,-1,3250,chr1_160074735_160077985
4930562F17Rik,1,159134272,159166387,lincRNA,1,32115,chr1_159134272_159166387
4930563E18Rik,18,10706860,10711832,bidirectional_promoter_lncRNA,1,4972,chr18_10706860_10711832
4930563E22Rik,11,72215138,72218444,protein_coding,1,3306,chr11_72215138_72218444
4930563F08Rik,CHR_MG171_PATCH,131880269,131883769,antisense;lncRNA,1,3500,chrCHR_MG171_PATCH_131880269_131883769
4930563I02Rik,14,60087071,60096093,antisense,1,9022,chr14_60087071_60096093
4930564C03Rik,17,44879770,44880295,processed_pseudogene,-1,525,chr17_44879770_44880295
4930565D16Rik,3,84349376,84379921,lincRNA,-1,30545,chr3_84349376_84379921
4930565N06Rik,16,36880519,36897189,antisense,-1,16670,chr16_36880519_36897189
4930567K12Rik,7,92092206,92119511,antisense,-1,27305,chr7_92092206_92119511
4930567K20Rik,10,10748930,10778370,antisense,1,29440,chr10_10748930_10778370
4930568A12Rik,1,34477167,34485933,lincRNA,-1,8766,chr1_34477167_34485933
4930568G15Rik,1,165064024,165091928,lincRNA,-1,27904,chr1_165064024_165091928
4930570G19Rik,3,156546753,156561746,lincRNA,-1,14993,chr3_156546753_156561746
4930572G02Rik,14,48537991,48571888,lincRNA,1,33897,chr14_48537991_48571888
4930572K03Rik,5,127170560,127184356,lincRNA,1,13796,chr5_127170560_127184356
4930572O13Rik,14,25139795,25143241,lincRNA,-1,3446,chr14_25139795_25143241
4930573H18Rik,3,97046656,97092785,antisense,-1,46129,chr3_97046656_97092785
4930578E11Rik,18,29396716,29496569,lincRNA,-1,99853,chr18_29396716_29496569
4930578M01Rik,15,98983348,98996446,processed_transcript,1,13098,chr15_98983348_98996446
4930579C12Rik,9,89113111,89177887,lincRNA,-1,64776,chr9_89113111_89177887
4930579D09Rik,6,143533965,143535508,lincRNA,-1,1543,chr6_143533965_143535508
4930579G18Rik,14,54650511,54654607,antisense,1,4096,chr14_54650511_54654607
4930579G24Rik,3,79629079,79632820,protein_coding,1,3741,chr3_79629079_79632820
4930579H20Rik,10,27389866,27397225,antisense,1,7359,chr10_27389866_27397225
4930579K19Rik,9,98562229,98563611,processed_transcript,-1,1382,chr9_98562229_98563611
4930581F22Rik,9,35116728,35130922,processed_transcript,1,14194,chr9_35116728_35130922
4930583I09Rik,17,64832523,64836071,protein_coding,-1,3548,chr17_64832523_64836071
4930583K01Rik,7,118243865,118245551,bidirectional_promoter_lncRNA,1,1686,chr7_118243865_118245551
4930583P06Rik,2,124217679,124222331,lincRNA,-1,4652,chr2_124217679_124222331
4930586N03Rik,13,23313525,23385799,antisense,1,72274,chr13_23313525_23385799
4930587E11Rik,6,102266100,102336674,antisense,1,70574,chr6_102266100_102336674
4930588J15Rik,15,92702886,92705955,antisense,-1,3069,chr15_92702886_92705955
4930588K23Rik,16,18591992,18609751,lincRNA,1,17759,chr16_18591992_18609751
4930589L23Rik,3,79568192,79572580,lincRNA,1,4388,chr3_79568192_79572580
4930590J08Rik,6,91902809,91950725,protein_coding,1,47916,chr6_91902809_91950725
4930590L20Rik,1,140570176,140656404,antisense,-1,86228,chr1_140570176_140656404
4930592A05Rik,15,33593881,33653436,antisense,-1,59555,chr15_33593881_33653436
4930592I03Rik,18,82918403,82920560,processed_transcript,-1,2157,chr18_82918403_82920560
4930593A02Rik,3,58692589,58797331,lincRNA,1,104742,chr3_58692589_58797331
4930593C16Rik,9,120924452,120930804,antisense,-1,6352,chr9_120924452_120930804
4930594M22Rik,14,122913030,122956343,antisense;processed_transcript,1,43313,chr14_122913030_122956343
4930594O21Rik,3,37613913,37615276,lincRNA,1,1363,chr3_37613913_37615276
4930595D18Rik,12,111159850,111184491,protein_coding,-1,24641,chr12_111159850_111184491
4930595L18Rik,6,98535246,98552107,lincRNA,-1,16861,chr6_98535246_98552107
4930596I21Rik,1,138977656,138979246,sense_intronic,1,1590,chr1_138977656_138979246
4930599N23Rik,6,39118473,39148312,antisense,1,29839,chr6_39118473_39148312
4931403E22Rik,19,26768801,26823907,antisense,-1,55106,chr19_26768801_26823907
4931406B18Rik,7,43492044,43505940,protein_coding,-1,13896,chr7_43492044_43505940
4931406C07Rik,9,15283337,15306448,protein_coding,-1,23111,chr9_15283337_15306448
4931406P16Rik,7,34236707,34313551,protein_coding,-1,76844,chr7_34236707_34313551
4931413K12Rik,11,75589665,75594771,processed_transcript,-1,5106,chr11_75589665_75594771
4931414P19Rik,14,54583663,54605993,protein_coding,-1,22330,chr14_54583663_54605993
4931419H13Rik,3,55055242,55084002,antisense,1,28760,chr3_55055242_55084002
4931422A03Rik,2,103966943,104028361,protein_coding,-1,61418,chr2_103966943_104028361
4931428F04Rik,8,105280409,105289864,protein_coding,-1,9455,chr8_105280409_105289864
4931429L15Rik,9,46303361,46319986,protein_coding,-1,16625,chr9_46303361_46319986
4931431B13Rik,7,128192050,128203328,processed_transcript,-1,11278,chr7_128192050_128203328
4931431C16Rik,5,35581227,35588763,antisense,-1,7536,chr5_35581227_35588763
4931439C15Rik,18,78476878,78480713,antisense,1,3835,chr18_78476878_78480713
4931440P22Rik,3,65507257,65529379,transcribed_processed_pseudogene,-1,22122,chr3_65507257_65529379
4932412D23Rik,16,42725702,42875762,lincRNA,-1,150060,chr16_42725702_42875762
4932413F04Rik,9,103557090,103565891,antisense,1,8801,chr9_103557090_103565891
4932414J04Rik,11,21494730,21511178,lincRNA,-1,16448,chr11_21494730_21511178
4932414N04Rik,2,68656486,68748467,protein_coding,1,91981,chr2_68656486_68748467
4932415M13Rik,17,53716509,53733843,transcribed_processed_pseudogene,1,17334,chr17_53716509_53733843
4932431P20Rik,7,29524543,29538055,transcribed_unitary_pseudogene,1,13512,chr7_29524543_29538055
4932435O22Rik,11,114413401,114448860,lincRNA,-1,35459,chr11_114413401_114448860
4932438A13Rik,3,36863104,37053033,protein_coding,1,189929,chr3_36863104_37053033
4932438H23Rik,16,91053935,91095122,protein_coding,-1,41187,chr16_91053935_91095122
4932441J04Rik,5,57570082,57720201,processed_transcript,-1,150119,chr5_57570082_57720201
4932443L11Rik,8,4162522,4206882,antisense,-1,44360,chr8_4162522_4206882
4932702P03Rik,13,24905593,24914272,antisense,1,8679,chr13_24905593_24914272
4933400C23Rik,9,92717456,92795711,lincRNA,1,78255,chr9_92717456_92795711
4933400F21Rik,1,89650529,89683908,processed_transcript,-1,33379,chr1_89650529_89683908
4933401D09Rik,17,15631763,15641104,lincRNA,1,9341,chr17_15631763_15641104
4933401H06Rik,3,135833701,135840269,processed_transcript,-1,6568,chr3_135833701_135840269
4933402C06Rik,7,40674737,40691273,lincRNA,1,16536,chr7_40674737_40691273
4933402D24Rik,1,63754907,63769267,protein_coding,-1,14360,chr1_63754907_63769267
4933402J15Rik,14,74355527,74369741,lincRNA,1,14214,chr14_74355527_74369741
4933404K08Rik,13,23278350,23282267,lincRNA,1,3917,chr13_23278350_23282267
4933404O12Rik,5,136919146,136937112,lincRNA,1,17966,chr5_136919146_136937112
4933405D12Rik,3,122864737,122924116,antisense,-1,59379,chr3_122864737_122924116
4933405L10Rik,8,105707655,105710246,protein_coding,1,2591,chr8_105707655_105710246
4933405O20Rik,7,50599190,50600530,protein_coding,1,1340,chr7_50599190_50600530
4933406B17Rik,8,95496430,95503718,lincRNA,1,7288,chr8_95496430_95503718
4933406C10Rik,12,32919384,32953789,lincRNA,-1,34405,chr12_32919384_32953789
4933406I18Rik,7,114315479,114415161,lincRNA,-1,99682,chr7_114315479_114415161
4933406J10Rik,7,82743368,82755644,antisense,-1,12276,chr7_82743368_82755644
4933406K04Rik,12,106685607,106716362,lincRNA,-1,30755,chr12_106685607_106716362
4933407E24Rik,4,124569190,124574645,lincRNA,1,5455,chr4_124569190_124574645
4933407I05Rik,9,51914427,51927003,lincRNA,1,12576,chr9_51914427_51927003
4933407I08Rik,18,42935470,42938887,antisense,1,3417,chr18_42935470_42938887
4933407K13Rik,X,75706932,75764699,processed_transcript,-1,57767,chrX_75706932_75764699
4933407L21Rik,1,85928483,85940624,protein_coding,1,12141,chr1_85928483_85940624
4933408J17Rik,10,93589413,93605245,lincRNA,1,15832,chr10_93589413_93605245
4933408N05Rik,8,114341160,114351479,antisense,-1,10319,chr8_114341160_114351479
4933409F18Rik,12,26814371,26834873,lincRNA,-1,20502,chr12_26814371_26834873
4933412E12Rik,10,116949757,116963279,bidirectional_promoter_lncRNA,1,13522,chr10_116949757_116963279
4933412O06Rik,13,15781664,15802630,lincRNA,-1,20966,chr13_15781664_15802630
4933413J09Rik,14,26356574,26400456,lincRNA,1,43882,chr14_26356574_26400456
4933413L06Rik,13,117706764,117720011,antisense,-1,13247,chr13_117706764_117720011
4933416I08Rik,X,53599727,53690919,unprocessed_pseudogene,1,91192,chrX_53599727_53690919
4933416M07Rik,8,27142910,27146304,antisense,1,3394,chr8_27142910_27146304
4933417D19Rik,8,123235091,123242359,antisense,1,7268,chr8_123235091_123242359
4933417G07Rik,3,55847105,55848400,transcribed_processed_pseudogene,1,1295,chr3_55847105_55848400
4933417O13Rik,7,143322773,143364625,antisense,-1,41852,chr7_143322773_143364625
4933421O10Rik,4,33027142,33031323,processed_transcript,-1,4181,chr4_33027142_33031323
4933422A05Rik,9,35281105,35285423,lincRNA,1,4318,chr9_35281105_35285423
4933424G05Rik,18,14988995,15047987,antisense,1,58992,chr18_14988995_15047987
4933424G06Rik,1,36710149,36757953,protein_coding,1,47804,chr1_36710149_36757953
4933424M12Rik,4,107783720,107789921,lincRNA,1,6201,chr4_107783720_107789921
4933427D06Rik,6,88950683,89110031,lincRNA,1,159348,chr6_88950683_89110031
4933427D14Rik,11,72153929,72207459,protein_coding,-1,53530,chr11_72153929_72207459
4933427E11Rik,15,74709161,74710374,antisense,1,1213,chr15_74709161_74710374
4933427E13Rik,11,25232626,25367137,lincRNA,1,134511,chr11_25232626_25367137
4933427G23Rik,5,23815618,23831897,antisense,-1,16279,chr5_23815618_23831897
4933427I22Rik,4,139926111,139943519,lincRNA,-1,17408,chr4_139926111_139943519
4933428C19Rik,4,40482840,40525548,lincRNA,-1,42708,chr4_40482840_40525548
4933428G20Rik,11,97490783,97500340,protein_coding,-1,9557,chr11_97490783_97500340
4933429O19Rik,14,48878586,48887112,processed_transcript,1,8526,chr14_48878586_48887112
4933430H16Rik,7,82937936,82940688,lincRNA,-1,2752,chr7_82937936_82940688
4933430I17Rik,4,62525369,62547993,protein_coding,1,22624,chr4_62525369_62547993
4933430M04Rik,11,24481909,24569952,lincRNA,1,88043,chr11_24481909_24569952
4933431E20Rik,3,107888850,107896213,antisense,-1,7363,chr3_107888850_107896213
4933431G14Rik,6,72120213,72123197,antisense,-1,2984,chr6_72120213_72123197
4933432I03Rik,14,102987412,103033803,lincRNA,-1,46391,chr14_102987412_103033803
4933432I09Rik,16,18207822,18213863,lincRNA;lncRNA,-1,6041,chr16_18207822_18213863
4933432K03Rik,7,121468844,121609334,antisense,-1,140490,chr7_121468844_121609334
4933433G15Rik,9,75410184,75417709,lincRNA,1,7525,chr9_75410184_75417709
4933433G19Rik,13,66996819,67032408,antisense,-1,35589,chr13_66996819_67032408
4933434E20Rik,3,90051636,90066069,protein_coding,1,14433,chr3_90051636_90066069
4933436I20Rik,1,83659550,83911644,lincRNA,-1,252094,chr1_83659550_83911644
4933438K21Rik,4,147063366,147068436,antisense,-1,5070,chr4_147063366_147068436
4933439C10Rik,11,59505662,59513647,processed_transcript,1,7985,chr11_59505662_59513647
4933439K11Rik,1,172538133,172558129,processed_transcript,-1,19996,chr1_172538133_172558129
4933440M02Rik,7,125284025,125349788,lincRNA,-1,65763,chr7_125284025_125349788
5031410I06Rik,5,26098668,26105362,protein_coding,-1,6694,chr5_26098668_26105362
5031425E22Rik,5,23382308,23434269,lincRNA,-1,51961,chr5_23382308_23434269
5031425F14Rik,2,166447451,166459232,lincRNA,1,11781,chr2_166447451_166459232
5031434C07Rik,6,112285593,112288837,antisense,-1,3244,chr6_112285593_112288837
5031434O11Rik,3,51560035,51567117,processed_transcript,1,7082,chr3_51560035_51567117
5031439G07Rik,15,84943936,84988551,protein_coding,-1,44615,chr15_84943936_84988551
5033403F01Rik,13,38960619,38966605,antisense,1,5986,chr13_38960619_38966605
5033406O09Rik,12,111941991,111944484,lincRNA,-1,2493,chr12_111941991_111944484
5033417F24Rik,1,92908378,92910764,antisense,-1,2386,chr1_92908378_92910764
5033421B08Rik,12,8511201,8562681,antisense,1,51480,chr12_8511201_8562681
5033428I22Rik,8,57332118,57354580,lincRNA,1,22462,chr8_57332118_57354580
5033430I15Rik,13,45965253,45966508,lincRNA,1,1255,chr13_45965253_45966508
5330411J11Rik,2,59382502,59387471,processed_transcript,-1,4969,chr2_59382502_59387471
5330413P13Rik,2,131820006,131847683,lincRNA,-1,27677,chr2_131820006_131847683
5330416C01Rik,13,97733498,97747411,lincRNA,-1,13913,chr13_97733498_97747411
5330417C22Rik,3,108455694,108536536,protein_coding,-1,80842,chr3_108455694_108536536
5330434G04Rik,X,105348282,105391776,lincRNA,-1,43494,chrX_105348282_105391776
5330438D12Rik,10,116509052,116583515,processed_transcript,1,74463,chr10_116509052_116583515
5330439A09Rik,8,54568550,54600987,antisense,-1,32437,chr8_54568550_54600987
5430401H09Rik,12,32096613,32123702,lincRNA,-1,27089,chr12_32096613_32123702
5430402O13Rik,6,50566643,50594865,antisense,1,28222,chr6_50566643_50594865
5430405H02Rik,2,156844351,156862963,processed_transcript,-1,18612,chr2_156844351_156862963
5430416N02Rik,5,100420842,100429535,lincRNA,-1,8693,chr5_100420842_100429535
5430421F17Rik,8,25302650,25306270,lincRNA,-1,3620,chr8_25302650_25306270
5430425K12Rik,13,80940411,80948597,lincRNA,1,8186,chr13_80940411_80948597
5430427M07Rik,12,91045848,91079907,antisense,1,34059,chr12_91045848_91079907
5430427O19Rik,X,85870354,85891499,protein_coding,1,21145,chrX_85870354_85891499
5430431A17Rik,7,44473538,44486138,lincRNA,1,12600,chr7_44473538_44486138
5430435K18Rik,5,151252305,151259264,lincRNA,1,6959,chr5_151252305_151259264
5430437J10Rik,15,5496266,5594984,transcribed_processed_pseudogene,1,98718,chr15_5496266_5594984
5430440P10Rik,14,105427559,105437716,lincRNA,1,10157,chr14_105427559_105437716
5530401A14Rik,11,81860673,81894582,protein_coding,1,33909,chr11_81860673_81894582
5530601H04Rik,X,105037197,105079609,processed_transcript,-1,42412,chrX_105037197_105079609
5730403I07Rik,9,77366412,77399418,lincRNA,-1,33006,chr9_77366412_77399418
5730405O15Rik,X,13042015,13045297,processed_transcript,1,3282,chrX_13042015_13045297
5730409E04Rik,4,126609818,126614371,protein_coding,1,4553,chr4_126609818_126614371
5730412P04Rik,X,136104603,136115420,processed_transcript,1,10817,chrX_136104603_136115420
5730416F02Rik,X,109001485,109002296,processed_pseudogene,1,811,chrX_109001485_109002296
5730419F03Rik,1,78595031,78609508,lincRNA,-1,14477,chr1_78595031_78609508
5730420D15Rik,10,95417375,95428640,bidirectional_promoter_lncRNA,1,11265,chr10_95417375_95428640
5730435O14Rik,10,41568016,41576476,processed_transcript,1,8460,chr10_41568016_41576476
5730455P16Rik,11,80360492,80378034,protein_coding,-1,17542,chr11_80360492_80378034
5730460C07Rik,3,153789305,153792087,lincRNA,-1,2782,chr3_153789305_153792087
5730480H06Rik,5,48327952,48414294,protein_coding,1,86342,chr5_48327952_48414294
5730507C01Rik,12,18514510,18535254,protein_coding,1,20744,chr12_18514510_18535254
5730522E02Rik,11,25602763,26210763,protein_coding,-1,608000,chr11_25602763_26210763
5830416I19Rik,5,64044978,64050228,lincRNA,1,5250,chr5_64044978_64050228
5830417I10Rik,3,88775216,88825587,unprocessed_pseudogene,1,50371,chr3_88775216_88825587
5830418P13Rik,9,103423578,103461260,antisense,1,37682,chr9_103423578_103461260
5830432E09Rik,7,135635931,135652314,antisense,-1,16383,chr7_135635931_135652314
5830444B04Rik,4,155398763,155421704,processed_transcript,-1,22941,chr4_155398763_155421704
5830454E08Rik,9,120577331,120578074,lincRNA,1,743,chr9_120577331_120578074
5930430L01Rik,5,148990056,148995223,lincRNA,-1,5167,chr5_148990056_148995223
5930438M14Rik,13,101232127,101247551,lincRNA,1,15424,chr13_101232127_101247551
6030407O03Rik,1,73618088,73864466,lincRNA,-1,246378,chr1_73618088_73864466
6030440G07Rik,12,110994398,111013869,lincRNA,1,19471,chr12_110994398_111013869
6030443J06Rik,5,22550432,22807850,lincRNA,1,257418,chr5_22550432_22807850
6030458C11Rik,15,12808177,12824649,protein_coding,-1,16472,chr15_12808177_12824649
6030468B19Rik,11,117797660,117807301,protein_coding,1,9641,chr11_117797660_117807301
6030498E09Rik,X,38772671,38962686,protein_coding,1,190015,chrX_38772671_38962686
6230400D17Rik,14,20687236,20703028,antisense,-1,15792,chr14_20687236_20703028
6330403K07Rik,11,71031941,71033513,protein_coding,-1,1572,chr11_71031941_71033513
6330409D20Rik,2,32732620,32741016,protein_coding,-1,8396,chr2_32732620_32741016
6330410L21Rik,3,129753758,129763884,antisense,1,10126,chr3_129753758_129763884
6330415G19Rik,17,23550799,23565291,antisense,1,14492,chr17_23550799_23565291
6330418K02Rik,5,138264043,138266661,antisense,1,2618,chr5_138264043_138266661
6330420H09Rik,7,135853682,135855710,lincRNA,1,2028,chr7_135853682_135855710
6330549D23Rik,3,96606659,96629820,transcribed_processed_pseudogene,-1,23161,chr3_96606659_96629820
6430503K07Rik,2,147187424,147188407,antisense,1,983,chr2_147187424_147188407
6430548M08Rik,8,120114152,120165306,protein_coding,1,51154,chr8_120114152_120165306
6430550D23Rik,2,155973279,156007977,protein_coding,-1,34698,chr2_155973279_156007977
6430553K19Rik,16,48122072,48158499,lincRNA,-1,36427,chr16_48122072_48158499
6430562O15Rik,13,99396924,99412876,processed_transcript,-1,15952,chr13_99396924_99412876
6430571L13Rik,9,107340602,107352422,protein_coding,1,11820,chr9_107340602_107352422
6430584L05Rik,6,55396887,55412285,lincRNA,1,15398,chr6_55396887_55412285
6430590A07Rik,CHR_MG89_PATCH,40786178,40894193,lncRNA;processed_transcript,-1,108015,chrCHR_MG89_PATCH_40786178_40894193
6430710C18Rik,2,72745846,72813717,lincRNA,-1,67871,chr2_72745846_72813717
6530402F18Rik,2,29245107,29253006,processed_transcript,-1,7899,chr2_29245107_29253006
6530403H02Rik,3,120604109,120886733,lincRNA,-1,282624,chr3_120604109_120886733
6530411M01Rik,17,9147719,9167836,lincRNA,-1,20117,chr17_9147719_9167836
6720468P15Rik,19,57497390,57512784,lincRNA,1,15394,chr19_57497390_57512784
6720483E21Rik,1,20888650,20890473,lincRNA,-1,1823,chr1_20888650_20890473
6720489N17Rik,13,62603013,62624182,protein_coding,-1,21169,chr13_62603013_62624182
6820408C15Rik,2,152415587,152444330,protein_coding,1,28743,chr2_152415587_152444330
6820431F20Rik,8,20262613,20297432,transcribed_unprocessed_pseudogene,-1,34819,chr8_20262613_20297432
7420701I03Rik,12,11047813,11078742,lincRNA,1,30929,chr12_11047813_11078742
7530416G11Rik,15,85492736,85503227,protein_coding,-1,10491,chr15_85492736_85503227
7530428D23Rik,3,21753529,21800773,transcribed_processed_pseudogene,-1,47244,chr3_21753529_21800773
7630403G23Rik,9,34042369,34059019,lincRNA,1,16650,chr9_34042369_34059019
8030423F21Rik,5,52607550,52619012,lincRNA,-1,11462,chr5_52607550_52619012
8030423J24Rik,13,70882948,70884503,lincRNA,1,1555,chr13_70882948_70884503
8030442B05Rik,2,11338366,11398501,lincRNA,-1,60135,chr2_11338366_11398501
8030443G20Rik,4,108942843,108972077,antisense,-1,29234,chr4_108942843_108972077
8030451A03Rik,4,63979854,64149924,processed_transcript,1,170070,chr4_63979854_64149924
8030451O07Rik,16,72226383,72234327,lincRNA,-1,7944,chr16_72226383_72234327
8030453O22Rik,6,39527513,39544486,processed_transcript,1,16973,chr6_39527513_39544486
8030462N17Rik,18,77631497,77714486,protein_coding,-1,82989,chr18_77631497_77714486
8030474K03Rik,X,101794656,101798642,protein_coding,1,3986,chrX_101794656_101798642
8430423G03Rik,5,148950250,148951658,lincRNA,1,1408,chr5_148950250_148951658
8430426J06Rik,15,81242657,81312866,lincRNA,-1,70209,chr15_81242657_81312866
8430429K09Rik,11,3452365,3479831,processed_transcript,1,27466,chr11_3452365_3479831
8430430B14Rik,17,83998554,84013408,lincRNA,1,14854,chr17_83998554_84013408
8430436N08Rik,4,7560688,7573801,lincRNA,1,13113,chr4_7560688_7573801
9030025P20Rik,17,14978468,14991572,protein_coding,1,13104,chr17_14978468_14991572
9030204H09Rik,2,35819190,35823385,antisense,1,4195,chr2_35819190_35823385
9030404E10Rik,16,30021842,30039479,lincRNA,-1,17637,chr16_30021842_30039479
9030612E09Rik,10,43174699,43176562,bidirectional_promoter_lncRNA,1,1863,chr10_43174699_43176562
9030622O22Rik,2,147944740,148040203,lincRNA,-1,95463,chr2_147944740_148040203
9030624G23Rik,12,24043202,24097246,protein_coding,-1,54044,chr12_24043202_24097246
9030625G05Rik,18,74972764,74981547,lincRNA,-1,8783,chr18_74972764_74981547
9130008F23Rik,17,40875482,40880559,protein_coding,-1,5077,chr17_40875482_40880559
9130015A21Rik,12,35672282,35695118,lincRNA,-1,22836,chr12_35672282_35695118
9130019O22Rik,7,127382260,127387166,protein_coding,-1,4906,chr7_127382260_127387166
9130019P16Rik,6,54269681,54430221,processed_transcript,-1,160540,chr6_54269681_54430221
9130023H24Rik,7,128234458,128238031,protein_coding,-1,3573,chr7_128234458_128238031
9130024F11Rik,1,56971412,57050084,processed_transcript,1,78672,chr1_56971412_57050084
9130208D14Rik,7,105824223,105831515,unprocessed_pseudogene,-1,7292,chr7_105824223_105831515
9130209A04Rik,18,47452668,47476331,lincRNA,1,23663,chr18_47452668_47476331
9130221F21Rik,6,72013896,72042528,lincRNA,-1,28632,chr6_72013896_72042528
9130221H12Rik,7,25228687,25230263,antisense,1,1576,chr7_25228687_25230263
9130227L01Rik,1,55931241,55972328,lincRNA,1,41087,chr1_55931241_55972328
9130401M01Rik,15,58022259,58034325,protein_coding,-1,12066,chr15_58022259_58034325
9130409I23Rik,1,181051237,181060667,protein_coding,1,9430,chr1_181051237_181060667
9230102K24Rik,10,110596266,110615961,lincRNA,1,19695,chr10_110596266_110615961
9230105E05Rik,10,120389523,120392793,antisense,1,3270,chr10_120389523_120392793
9230112D13Rik,14,34511621,34522801,protein_coding,-1,11180,chr14_34511621_34522801
9230112J17Rik,9,60523967,60545882,lincRNA,-1,21915,chr9_60523967_60545882
9230114K14Rik,5,52190672,52279034,processed_transcript,1,88362,chr5_52190672_52279034
9230116L04Rik,12,79088705,79103939,lincRNA,-1,15234,chr12_79088705_79103939
9230116N13Rik,1,136411916,136415519,processed_transcript,-1,3603,chr1_136411916_136415519
9230117E06Rik,16,22511480,22517681,antisense,1,6201,chr16_22511480_22517681
9330020H09Rik,15,98567324,98569583,antisense,1,2259,chr15_98567324_98569583
9330102E08Rik,6,128169704,128183803,translated_unprocessed_pseudogene,-1,14099,chr6_128169704_128183803
9330104G04Rik,7,16871347,16874886,lincRNA,-1,3539,chr7_16871347_16874886
9330111N05Rik,13,80962888,81128864,antisense,1,165976,chr13_80962888_81128864
9330117O12Rik,18,54611744,54639870,lincRNA,1,28126,chr18_54611744_54639870
9330136K24Rik,17,21528194,21535878,lincRNA,-1,7684,chr17_21528194_21535878
9330151L19Rik,12,69197211,69199867,bidirectional_promoter_lncRNA,1,2656,chr12_69197211_69199867
9330154J02Rik,9,85820241,85844323,processed_transcript,-1,24082,chr9_85820241_85844323
9330154K18Rik,15,57736563,57738666,antisense,-1,2103,chr15_57736563_57738666
9330158H04Rik,6,36209620,36390191,lincRNA,-1,180571,chr6_36209620_36390191
9330159F19Rik,10,29211606,29230779,protein_coding,1,19173,chr10_29211606_29230779
9330159M07Rik,9,88840236,88858870,processed_transcript,-1,18634,chr9_88840236_88858870
9330162012Rik,13,24937401,24941417,bidirectional_promoter_lncRNA,1,4016,chr13_24937401_24941417
9330162B11Rik,1,188006576,188008990,antisense,-1,2414,chr1_188006576_188008990
9330175M20Rik,1,51218386,51333779,antisense,-1,115393,chr1_51218386_51333779
9330179D12Rik,6,127149389,127212411,antisense,1,63022,chr6_127149389_127212411
9330182L06Rik,5,9266118,9481825,protein_coding,1,215707,chr5_9266118_9481825
9330188P03Rik,14,105589476,105632054,processed_transcript,1,42578,chr14_105589476_105632054
9330198N18Rik,2,30629655,30689210,lincRNA,1,59555,chr2_30629655_30689210
9330199G10Rik,13,19462847,19504367,lincRNA,-1,41520,chr13_19462847_19504367
9430014N10Rik,15,93904856,93927111,lincRNA,-1,22255,chr15_93904856_93927111
9430015G10Rik,4,156109982,156127265,protein_coding,1,17283,chr4_156109982_156127265
9430018G01Rik,6,43467979,43474318,antisense,1,6339,chr6_43467979_43474318
9430021M05Rik,2,162661163,162667109,processed_transcript,1,5946,chr2_162661163_162667109
9430024E24Rik,2,33716361,33718899,lincRNA,-1,2538,chr2_33716361_33718899
9430037G07Rik,9,88595325,88599516,lincRNA,-1,4191,chr9_88595325_88599516
9430038I01Rik,7,137375574,137410762,protein_coding,-1,35188,chr7_137375574_137410762
9430041J12Rik,7,4074125,4120728,antisense,-1,46603,chr7_4074125_4120728
9430060I03Rik,1,92933526,92950590,antisense,-1,17064,chr1_92933526_92950590
9430065F17Rik,13,67553035,67564010,antisense,1,10975,chr13_67553035_67564010
9430069I07Rik,15,34349051,34357872,protein_coding,-1,8821,chr15_34349051_34357872
9430078K24Rik,12,79917019,79936264,lincRNA,-1,19245,chr12_79917019_79936264
9430085M18Rik,5,101703586,101705850,lincRNA,1,2264,chr5_101703586_101705850
9430091E24Rik,8,111128886,111145480,processed_transcript,-1,16594,chr8_111128886_111145480
9430097D07Rik,2,32574184,32575684,antisense,-1,1500,chr2_32574184_32575684
9530003J23Rik,10,117232237,117238703,protein_coding,-1,6466,chr10_117232237_117238703
9530020I12Rik,12,11185993,11204502,lincRNA,-1,18509,chr12_11185993_11204502
9530026P05Rik,6,92940329,93272979,antisense,1,332650,chr6_92940329_93272979
9530034E10Rik,4,117975036,117993972,antisense,1,18936,chr4_117975036_117993972
9530036M11Rik,6,54146887,54150937,antisense,-1,4050,chr6_54146887_54150937
9530036O11Rik,5,28458274,28933995,antisense,1,475721,chr5_28458274_28933995
9530051G07Rik,X,153037629,153072915,processed_transcript,1,35286,chrX_153037629_153072915
9530052C20Rik,3,142882495,142892921,lincRNA,1,10426,chr3_142882495_142892921
9530052E02Rik,8,11007850,11054541,processed_transcript,1,46691,chr8_11007850_11054541
9530053A07Rik,7,28129466,28164811,protein_coding,1,35345,chr7_28129466_28164811
9530059O14Rik,9,122572499,122679596,lincRNA,1,107097,chr9_122572499_122679596
9530062K07Rik,6,116199408,116207993,bidirectional_promoter_lncRNA,-1,8585,chr6_116199408_116207993
9530068E07Rik,11,52396428,52408728,protein_coding,1,12300,chr11_52396428_52408728
9530077C05Rik,9,22411513,22444681,protein_coding,1,33168,chr9_22411513_22444681
9530080O11Rik,4,95959715,95967655,processed_transcript,-1,7940,chr4_95959715_95967655
9530082P21Rik,17,23743234,23754065,antisense,1,10831,chr17_23743234_23754065
9630001P10Rik,5,45638699,45645469,antisense,1,6770,chr5_45638699_45645469
9630002D21Rik,12,71577748,71718696,lincRNA,1,140948,chr12_71577748_71718696
9630013A20Rik,14,84458639,84476424,antisense,-1,17785,chr14_84458639_84476424
9630013D21Rik,4,109651529,109657853,processed_transcript,-1,6324,chr4_109651529_109657853
9630013K17Rik,11,63964226,63968040,antisense,1,3814,chr11_63964226_63968040
9630015K15Rik,14,64116314,64127605,antisense,1,11291,chr14_64116314_64127605
9630028B13Rik,1,185429355,185441819,lincRNA,-1,12464,chr1_185429355_185441819
9630028I04Rik,17,27235075,27248066,lincRNA,-1,12991,chr17_27235075_27248066
9830132P13Rik,3,127916172,127955220,lincRNA,1,39048,chr3_127916172_127955220
9830166K06Rik,19,8651799,8663335,lincRNA,-1,11536,chr19_8651799_8663335
9930012K11Rik,14,70154405,70159502,protein_coding,-1,5097,chr14_70154405_70159502
9930014A18Rik,15,60822271,60831793,processed_transcript,1,9522,chr15_60822271_60831793
9930021J03Rik,19,29714402,29805989,protein_coding,-1,91587,chr19_29714402_29805989
9930104L06Rik,4,124937048,124944656,protein_coding,1,7608,chr4_124937048_124944656
9930111J21Rik1,11,48946150,48979398,protein_coding,-1,33248,chr11_48946150_48979398
9930111J21Rik2,11,49015874,49051242,protein_coding,-1,35368,chr11_49015874_49051242
A130010J15Rik,1,193168046,193177832,protein_coding,1,9786,chr1_193168046_193177832
A130030D18Rik,2,82375372,82392202,lincRNA,-1,16830,chr2_82375372_82392202
A130051J06Rik,15,95787856,95791642,antisense,-1,3786,chr15_95787856_95791642
A130077B15Rik,10,122565023,122569891,lincRNA,-1,4868,chr10_122565023_122569891
A1cf,19,31868764,31948995,protein_coding,1,80231,chr19_31868764_31948995
A230001M10Rik,3,102262405,102445132,lincRNA,1,182727,chr3_102262405_102445132
A230006K03Rik,7,61127996,61311721,lincRNA,-1,183725,chr7_61127996_61311721
A230009B12Rik,17,10456216,10493057,antisense,1,36841,chr17_10456216_10493057
A230020J21Rik,1,191025350,191029781,antisense,1,4431,chr1_191025350_191029781
A230051N06Rik,17,56241716,56242805,lincRNA,1,1089,chr17_56241716_56242805
A230056P14Rik,7,55962531,55980868,processed_transcript,1,18337,chr7_55962531_55980868
A230057D06Rik,7,61704519,61928690,lincRNA,-1,224171,chr7_61704519_61928690
A230072C01Rik,X,20961684,20986737,processed_transcript,1,25053,chrX_20961684_20986737
A230072E10Rik,X,151291974,151344846,antisense,-1,52872,chrX_151291974_151344846
A230072I06Rik,8,12278819,12280657,protein_coding,1,1838,chr8_12278819_12280657
A230077H06Rik,7,40818476,40900937,antisense,-1,82461,chr7_40818476_40900937
A230083G16Rik,6,124916863,124925844,antisense,1,8981,chr6_124916863_124925844
A230087F16Rik,12,111284762,111293988,antisense,1,9226,chr12_111284762_111293988
A230103J11Rik,8,85053160,85060460,processed_transcript,-1,7300,chr8_85053160_85060460
A230103O09Rik,13,39791438,39844840,processed_transcript,1,53402,chr13_39791438_39844840
A230107N01Rik,13,84219581,84222175,antisense,-1,2594,chr13_84219581_84222175
A230108P19Rik,2,6193251,6321611,antisense,1,128360,chr2_6193251_6321611
A2m,6,121635376,121679227,protein_coding,1,43851,chr6_121635376_121679227
A330008L17Rik,8,99416642,99733438,lincRNA,1,316796,chr8_99416642_99733438
A330009N23Rik,15,101221195,101225186,antisense,-1,3991,chr15_101221195_101225186
A330015K06Rik,3,65133060,65302685,antisense,-1,169625,chr3_65133060_65302685
A330023F24Rik,1,194976375,195037904,processed_transcript,1,61529,chr1_194976375_195037904
A330032B11Rik,19,37173843,37196541,antisense,1,22698,chr19_37173843_37196541
A330033J07Rik,13,48044231,48262623,antisense,-1,218392,chr13_48044231_48262623
A330035P11Rik,14,122103430,122106974,lincRNA,-1,3544,chr14_122103430_122106974
A330040F15Rik,19,12517915,12596566,processed_transcript,-1,78651,chr19_12517915_12596566
A330041J22Rik,9,86695460,86701253,antisense,1,5793,chr9_86695460_86701253
A330048O09Rik,13,48272413,48273884,lincRNA,-1,1471,chr13_48272413_48273884
A330049N07Rik,10,72973303,73086705,lincRNA,-1,113402,chr10_72973303_73086705
A330069K06Rik,3,80054892,80213085,lincRNA,1,158193,chr3_80054892_80213085
A330070K13Rik,5,130378778,130384631,protein_coding,-1,5853,chr5_130378778_130384631
A330074K22Rik,8,120204434,120228230,lincRNA,-1,23796,chr8_120204434_120228230
A330076C08Rik,13,44185760,44216487,lincRNA,-1,30727,chr13_44185760_44216487
A330076H08Rik,7,61930137,61982358,processed_transcript,-1,52221,chr7_61930137_61982358
A330084C13Rik,18,64884475,64888491,antisense,-1,4016,chr18_64884475_64888491
A330093E20Rik,18,45683487,46045260,antisense,-1,361773,chr18_45683487_46045260
A330102I10Rik,13,29014399,29040336,lincRNA,1,25937,chr13_29014399_29040336
A3galt2,4,128755364,128769298,protein_coding,1,13934,chr4_128755364_128769298
A430005L14Rik,4,153957237,153961925,protein_coding,1,4688,chr4_153957237_153961925
A430010J10Rik,6,67115673,67168426,processed_transcript,1,52753,chr6_67115673_67168426
A430033K04Rik,5,138622859,138652414,protein_coding,1,29555,chr5_138622859_138652414
A430035B10Rik,6,8488795,8510430,processed_transcript,-1,21635,chr6_8488795_8510430
A430057M04Rik,14,21847578,21856931,antisense,1,9353,chr14_21847578_21856931
A430072P03Rik,5,107725157,107728801,processed_transcript,1,3644,chr5_107725157_107728801
A430078I02Rik,6,86470277,86480830,antisense,-1,10553,chr6_86470277_86480830
A430088P11Rik,15,80691025,80697610,antisense,-1,6585,chr15_80691025_80697610
A430090L17Rik,13,114124348,114151592,antisense,-1,27244,chr13_114124348_114151592
A430093F15Rik,19,10740947,10786043,processed_transcript,1,45096,chr19_10740947_10786043
A430105J06Rik,1,186749396,186752921,lincRNA,1,3525,chr1_186749396_186752921
A430108G06Rik,11,53564688,53567313,processed_transcript,-1,2625,chr11_53564688_53567313
A430110L20Rik,1,181225986,181228498,lincRNA,1,2512,chr1_181225986_181228498
A4galt,15,83226722,83251774,protein_coding,-1,25052,chr15_83226722_83251774
A4gnt,9,99612502,99622367,protein_coding,1,9865,chr9_99612502_99622367
A530001N23Rik,13,60483504,60488808,lincRNA,-1,5304,chr13_60483504_60488808
A530006G24Rik,2,147710693,147717632,lincRNA,1,6939,chr2_147710693_147717632
A530010L16Rik,8,122760045,122763021,lincRNA,-1,2976,chr8_122760045_122763021
A530013C23Rik,2,167691177,167729172,lincRNA,1,37995,chr2_167691177_167729172
A530016L24Rik,12,112489448,112499927,protein_coding,1,10479,chr12_112489448_112499927
A530020G20Rik,3,121531619,121536206,antisense,1,4587,chr3_121531619_121536206
A530021J07Rik,7,83061783,83179429,lincRNA,1,117646,chr7_83061783_83179429
A530032D15Rik,1,85083069,85109853,protein_coding,-1,26784,chr1_85083069_85109853
A530046M15Rik,13,15807243,15827537,lincRNA,1,20294,chr13_15807243_15827537
A530058N18Rik,2,114013563,114068324,processed_transcript,1,54761,chr2_114013563_114068324
A530064D06Rik,17,48149083,48167275,protein_coding,-1,18192,chr17_48149083_48167275
A530065N20Rik,13,60029711,60116669,lincRNA,1,86958,chr13_60029711_60116669
A530072M11Rik,4,16164110,16266225,processed_transcript,1,102115,chr4_16164110_16266225
A530088E08Rik,17,32396778,32412926,antisense,1,16148,chr17_32396778_32412926
A530095I07Rik,13,69543046,69544023,antisense,-1,977,chr13_69543046_69544023
A630001G21Rik,1,85717083,85778643,protein_coding,-1,61560,chr1_85717083_85778643
A630010A05Rik,16,14562317,14634108,protein_coding,1,71791,chr16_14562317_14634108
A630019I02Rik,13,93094833,93098968,antisense,1,4135,chr13_93094833_93098968
A630023P12Rik,5,110514923,110525980,lincRNA,1,11057,chr5_110514923_110525980
A630031M04Rik,4,127474848,127570502,lincRNA,1,95654,chr4_127474848_127570502
A630072L19Rik,12,100941742,100949875,antisense,1,8133,chr12_100941742_100949875
A630072M18Rik,5,20950989,20956398,antisense,1,5409,chr5_20950989_20956398
A630076J17Rik,3,107230614,107234723,protein_coding,1,4109,chr3_107230614_107234723
A630089N07Rik,16,98001310,98082450,protein_coding,-1,81140,chr16_98001310_98082450
A630095N17Rik,1,75220095,75232102,protein_coding,-1,12007,chr1_75220095_75232102
A730006G06Rik,CHR_MG4200_PATCH,48064789,48090378,antisense;lncRNA,-1,25589,chrCHR_MG4200_PATCH_48064789_48090378
A730009L09Rik,16,84515121,84523888,protein_coding,1,8767,chr16_84515121_84523888
A730011C13Rik,3,94994410,94997350,antisense,-1,2940,chr3_94994410_94997350
A730017L22Rik,2,130873059,130906396,processed_transcript,-1,33337,chr2_130873059_130906396
A730018C14Rik,12,112411023,112423212,processed_transcript,-1,12189,chr12_112411023_112423212
A730020E08Rik,6,61172293,61180810,bidirectional_promoter_lncRNA,-1,8517,chr6_61172293_61180810
A730020M07Rik,3,121634936,121643485,lincRNA,-1,8549,chr3_121634936_121643485
A730036I17Rik,2,129218969,129235604,lincRNA,1,16635,chr2_129218969_129235604
A730043L09Rik,9,62242596,62244100,lincRNA,-1,1504,chr9_62242596_62244100
A730046J19Rik,X,144153695,144166274,protein_coding,1,12579,chrX_144153695_144166274
A730049H05Rik,6,92816478,92847174,protein_coding,1,30696,chr6_92816478_92847174
A730056A06Rik,7,73314003,73375774,antisense,-1,61771,chr7_73314003_73375774
A730063M14Rik,10,127070375,127074796,lincRNA,1,4421,chr10_127070375_127074796
A730085K08Rik,9,122380575,122398801,antisense,-1,18226,chr9_122380575_122398801
A730090N16Rik,3,65324776,65349429,antisense,-1,24653,chr3_65324776_65349429
A830005F24Rik,13,48513570,48514859,protein_coding,1,1289,chr13_48513570_48514859
A830009L08Rik,13,91368990,91388085,lincRNA,-1,19095,chr13_91368990_91388085
A830011K09Rik,6,138423105,138429592,antisense,1,6487,chr6_138423105_138429592
A830012C17Rik,4,4138321,4188703,processed_transcript,1,50382,chr4_4138321_4188703
A830018L16Rik,1,11414105,11975901,protein_coding,1,561796,chr1_11414105_11975901
A830019L24Rik,3,143243055,143259884,lincRNA,1,16829,chr3_143243055_143259884
A830019P07Rik,19,35835217,35924578,lincRNA,-1,89361,chr19_35835217_35924578
A830021F12Rik,18,15351934,15362306,lincRNA,1,10372,chr18_15351934_15362306
A830029E22Rik,3,81802025,81805161,lincRNA,1,3136,chr3_81802025_81805161
A830035A12Rik,11,107531757,107548373,processed_transcript,-1,16616,chr11_107531757_107548373
A830035O19Rik,9,45954101,45955998,antisense,1,1897,chr9_45954101_45955998
A830052D11Rik,18,32359053,32378278,lincRNA,-1,19225,chr18_32359053_32378278
A830082K12Rik,13,78198017,78279391,antisense,1,81374,chr13_78198017_78279391
A830082N09Rik,10,33987216,33995055,processed_transcript,-1,7839,chr10_33987216_33995055
A830092H15Rik,3,26331150,26333377,antisense,1,2227,chr3_26331150_26333377
A930001A20Rik,3,14971201,15002727,lincRNA,1,31526,chr3_14971201_15002727
A930001C03Rik,19,4439003,4448973,processed_transcript,1,9970,chr19_4439003_4448973
A930002C04Rik,13,47143942,47148670,antisense,-1,4728,chr13_47143942_47148670
A930003A15Rik,16,19876567,19884274,protein_coding,-1,7707,chr16_19876567_19884274
A930003O13Rik,5,22738910,22746907,lincRNA,-1,7997,chr5_22738910_22746907
A930004D18Rik,2,18025193,18037737,protein_coding,-1,12544,chr2_18025193_18037737
A930005H10Rik,3,115881581,115888130,processed_transcript,-1,6549,chr3_115881581_115888130
A930006K02Rik,16,91465025,91470128,processed_transcript,1,5103,chr16_91465025_91470128
A930007A09Rik,16,13754566,13758537,protein_coding,1,3971,chr16_13754566_13758537
A930007I19Rik,19,29464750,29523159,antisense,-1,58409,chr19_29464750_29523159
A930009A15Rik,10,115569986,115582448,protein_coding,1,12462,chr10_115569986_115582448
A930012L18Rik,18,44661665,44676271,antisense,1,14606,chr18_44661665_44676271
A930012O16Rik,2,57236227,57238508,processed_transcript,-1,2281,chr2_57236227_57238508
A930015D03Rik,17,35994453,36038435,antisense,1,43982,chr17_35994453_36038435
A930016O22Rik,7,19417466,19421417,antisense,-1,3951,chr7_19417466_19421417
A930017K11Rik,17,25946387,25952565,protein_coding,-1,6178,chr17_25946387_25952565
A930017M01Rik,15,44752280,44884740,transcribed_processed_pseudogene,1,132460,chr15_44752280_44884740
A930018P22Rik,2,104122769,104124749,protein_coding,1,1980,chr2_104122769_104124749
A930019D19Rik,2,146259286,146267160,antisense,1,7874,chr2_146259286_146267160
A930024E05Rik,5,122989354,122998345,antisense,1,8991,chr5_122989354_122998345
A930028N01Rik,19,40297971,40299555,antisense,1,1584,chr19_40297971_40299555
A930029G22Rik,17,69416660,69439304,lincRNA,-1,22644,chr17_69416660_69439304
A930033H14Rik,10,69209762,69213098,protein_coding,-1,3336,chr10_69209762_69213098
A930038B10Rik,14,34759402,34770553,lincRNA,1,11151,chr14_34759402_34770553
A930041C12Rik,5,107630250,107633850,antisense,-1,3600,chr5_107630250_107633850
AA387200,2,152074855,152076808,antisense,-1,1953,chr2_152074855_152076808
AA387883,19,52923181,52941209,lincRNA,1,18028,chr19_52923181_52941209
AA388235,17,33981494,33982777,lincRNA,1,1283,chr17_33981494_33982777
AA413626,11,4918510,4919003,processed_pseudogene,1,493,chr11_4918510_4919003
AA414768,X,12936872,12938128,processed_pseudogene,1,1256,chrX_12936872_12938128
AA465934,11,83291699,83294632,processed_transcript,1,2933,chr11_83291699_83294632
AA467197,2,122636986,122652630,protein_coding,1,15644,chr2_122636986_122652630
AA536875,14,123043282,123265002,processed_transcript,1,221720,chr14_123043282_123265002
AA543401,9,107192793,107194061,processed_pseudogene,1,1268,chr9_107192793_107194061
AA792892,5,94339749,94385079,protein_coding,1,45330,chr5_94339749_94385079
AA986860,1,130731976,130744622,protein_coding,1,12646,chr1_130731976_130744622
AB124611,9,21526176,21545333,protein_coding,1,19157,chr9_21526176_21545333
AF357399,7,28351508,28351632,snoRNA,1,124,chr7_28351508_28351632
AF357425,12,109636012,109636592,snoRNA,1,580,chr12_109636012_109636592
AF366264,8,13835233,13838389,protein_coding,-1,3156,chr8_13835233_13838389
AI115009,3,152666913,152681432,antisense,1,14519,chr3_152666913_152681432
AI182371,2,35081861,35101543,protein_coding,-1,19682,chr2_35081861_35101543
AI197445,13,107469822,107482718,lincRNA,1,12896,chr13_107469822_107482718
AI314278,7,89426306,89441928,lincRNA,1,15622,chr7_89426306_89441928
AI413582,17,27563573,27565756,protein_coding,-1,2183,chr17_27563573_27565756
AI429214,8,36993604,36995533,protein_coding,1,1929,chr8_36993604_36995533
AI463170,12,76546972,76547943,antisense,-1,971,chr12_76546972_76547943
AI463229,13,37657022,37667734,lincRNA,-1,10712,chr13_37657022_37667734
AI467606,7,127091359,127093986,protein_coding,1,2627,chr7_127091359_127093986
AI504432,3,107039504,107054347,lincRNA,1,14843,chr3_107039504_107054347
AI506816,5,23698296,23712667,processed_transcript,-1,14371,chr5_23698296_23712667
AI507597,4,141614026,141615604,antisense,1,1578,chr4_141614026_141615604
AI593442,9,52673042,52679780,protein_coding,-1,6738,chr9_52673042_52679780
AI597479,1,43098710,43115947,protein_coding,1,17237,chr1_43098710_43115947
AI662270,11,83223576,83226604,processed_transcript,1,3028,chr11_83223576_83226604
AI837181,19,5425144,5427313,protein_coding,1,2169,chr19_5425144_5427313
AI839979,5,31569595,31571397,lincRNA,-1,1802,chr5_31569595_31571397
AI847159,2,129158666,129180667,antisense,-1,22001,chr2_129158666_129180667
AI854703,6,48626764,48633689,protein_coding,1,6925,chr6_48626764_48633689
AI987944,7,41372923,41393379,protein_coding,-1,20456,chr7_41372923_41393379
AK157302,13,21495223,21497146,protein_coding,1,1923,chr13_21495223_21497146
AU015228,2,130100524,130101843,processed_pseudogene,1,1319,chr2_130100524_130101843
AU018091,7,3154498,3169203,protein_coding,-1,14705,chr7_3154498_3169203
AU019990,2,132598195,132653068,lincRNA,1,54873,chr2_132598195_132653068
AU021092,16,5211823,5222299,protein_coding,-1,10476,chr16_5211823_5222299
AU022252,4,119203570,119232712,protein_coding,-1,29142,chr4_119203570_119232712
AU022751,X,6081219,6083419,protein_coding,-1,2200,chrX_6081219_6083419
AU022754,15,85580252,85593708,antisense,1,13456,chr15_85580252_85593708
AU022793,15,39962649,39967024,lincRNA,1,4375,chr15_39962649_39967024
AU023762,9,113496746,113611783,lincRNA,-1,115037,chr9_113496746_113611783
AU040320,4,126753544,126870070,protein_coding,1,116526,chr4_126753544_126870070
AU040972,11,79481719,79484031,antisense,-1,2312,chr11_79481719_79484031
AU041133,10,82128013,82153065,protein_coding,1,25052,chr10_82128013_82153065
AV039307,2,120850705,120866689,processed_transcript,1,15984,chr2_120850705_120866689
AW011738,4,156203270,156210563,processed_transcript,1,7293,chr4_156203270_156210563
AW046200,8,57651757,57663430,bidirectional_promoter_lncRNA,1,11673,chr8_57651757_57663430
AW047730,3,88200623,88203481,processed_transcript,1,2858,chr3_88200623_88203481
AW112010,19,11047612,11055808,lincRNA,-1,8196,chr19_11047612_11055808
AW146154,7,41478874,41499890,protein_coding,-1,21016,chr7_41478874_41499890
AW209491,13,14630154,14639096,protein_coding,1,8942,chr13_14630154_14639096
AW495222,13,93706182,93719175,antisense,-1,12993,chr13_93706182_93719175
AW549877,15,3982035,3995744,protein_coding,-1,13709,chr15_3982035_3995744
AW551984,9,39587396,39604403,protein_coding,-1,17007,chr9_39587396_39604403
AW554918,18,25168999,25467321,protein_coding,1,298322,chr18_25168999_25467321
AW822252,X,53695855,53716773,transcribed_unprocessed_pseudogene,-1,20918,chrX_53695855_53716773
AY074887,9,54950230,54950998,protein_coding,-1,768,chr9_54950230_54950998
AY512931,8,45060702,45065418,lincRNA,-1,4716,chr8_45060702_45065418
Aaas,15,102338252,102350771,protein_coding,-1,12519,chr15_102338252_102350771
Aacs,5,125475814,125517410,protein_coding,1,41596,chr5_125475814_125517410
Aadat,8,60505932,60545677,protein_coding,1,39745,chr8_60505932_60545677
Aagab,9,63602660,63644588,protein_coding,1,41928,chr9_63602660_63644588
Aak1,6,86849517,87003223,protein_coding,1,153706,chr6_86849517_87003223
Aamdc,7,97550331,97579497,protein_coding,-1,29166,chr7_97550331_97579497
Aamp,1,74279840,74284738,protein_coding,-1,4898,chr1_74279840_74284738
Aanat,11,116586432,116597680,protein_coding,1,11248,chr11_116586432_116597680
Aar2,2,156547584,156568972,protein_coding,1,21388,chr2_156547584_156568972
Aard,15,52040107,52045722,protein_coding,1,5615,chr15_52040107_52045722
Aars,8,111033144,111057664,protein_coding,1,24520,chr8_111033144_111057664
Aars2,17,45506841,45520843,protein_coding,1,14002,chr17_45506841_45520843
Aarsd1,11,101406839,101417615,protein_coding,-1,10776,chr11_101406839_101417615
Aasdh,5,76873659,76905514,protein_coding,-1,31855,chr5_76873659_76905514
Aasdhppt,9,4294793,4309471,protein_coding,-1,14678,chr9_4294793_4309471
Aass,6,23072173,23132986,protein_coding,-1,60813,chr6_23072173_23132986
Aatf,11,84422855,84513522,protein_coding,-1,90667,chr11_84422855_84513522
Aatk,11,120007313,120047167,protein_coding,-1,39854,chr11_120007313_120047167
Abat,16,8513429,8621568,protein_coding,1,108139,chr16_8513429_8621568
Abca1,4,53030787,53159895,protein_coding,-1,129108,chr4_53030787_53159895
Abca12,1,71242276,71414910,protein_coding,-1,172634,chr1_71242276_71414910
Abca13,11,9191942,9684259,protein_coding,1,492317,chr11_9191942_9684259
Abca14,7,120203961,120325352,protein_coding,1,121391,chr7_120203961_120325352
Abca15,7,120328670,120407687,protein_coding,1,79017,chr7_120328670_120407687
Abca17,17,24264259,24351068,protein_coding,-1,86809,chr17_24264259_24351068
Abca2,2,25428703,25448540,protein_coding,1,19837,chr2_25428703_25448540
Abca3,17,24351950,24410201,protein_coding,1,58251,chr17_24351950_24410201
Abca4,3,122044443,122180123,protein_coding,1,135680,chr3_122044443_122180123
Abca5,11,110269369,110337716,protein_coding,-1,68347,chr11_110269369_110337716
Abca6,11,110176820,110251776,protein_coding,-1,74956,chr11_110176820_110251776
Abca7,10,79996494,80015572,protein_coding,1,19078,chr10_79996494_80015572
Abca8a,11,110025634,110095978,protein_coding,-1,70344,chr11_110025634_110095978
Abca8b,11,109932190,109995845,protein_coding,-1,63655,chr11_109932190_109995845
Abca9,11,110100749,110168196,protein_coding,-1,67447,chr11_110100749_110168196
Abcb10,8,123952459,123983122,protein_coding,-1,30663,chr8_123952459_123983122
Abcb11,2,69238282,69342616,protein_coding,-1,104334,chr2_69238282_69342616
Abcb1a,5,8660077,8748575,protein_coding,1,88498,chr5_8660077_8748575
Abcb1b,5,8798147,8866315,protein_coding,1,68168,chr5_8798147_8866315
Abcb4,5,8893717,8959231,protein_coding,1,65514,chr5_8893717_8959231
Abcb5,12,118867824,118966421,protein_coding,-1,98597,chr12_118867824_118966421
Abcb6,1,75171717,75180392,protein_coding,-1,8675,chr1_75171717_75180392
Abcb7,X,104280657,104413856,protein_coding,-1,133199,chrX_104280657_104413856
Abcb8,5,24393663,24410054,protein_coding,1,16391,chr5_24393663_24410054
Abcb9,5,124061530,124095798,protein_coding,-1,34268,chr5_124061530_124095798
Abcc1,16,14361558,14475737,protein_coding,1,114179,chr16_14361558_14475737
Abcc10,17,46303221,46328352,protein_coding,-1,25131,chr17_46303221_46328352
Abcc12,8,86482260,86580686,protein_coding,-1,98426,chr8_86482260_86580686
Abcc2,19,43782192,43840740,protein_coding,1,58548,chr19_43782192_43840740
Abcc3,11,94343295,94392997,protein_coding,-1,49702,chr11_94343295_94392997
Abcc4,14,118482692,118706219,protein_coding,-1,223527,chr14_118482692_118706219
Abcc5,16,20331303,20426394,protein_coding,-1,95091,chr16_20331303_20426394
Abcc6,7,45967555,46030302,protein_coding,-1,62747,chr7_45967555_46030302
Abcc8,7,46104523,46180033,protein_coding,-1,75510,chr7_46104523_46180033
Abcc9,6,142587862,142702315,protein_coding,-1,114453,chr6_142587862_142702315
Abcd1,X,73716597,73738534,protein_coding,1,21937,chrX_73716597_73738534
Abcd2,15,91145871,91191799,protein_coding,-1,45928,chr15_91145871_91191799
Abcd3,3,121758774,121815302,protein_coding,-1,56528,chr3_121758774_121815302
Abcd4,12,84601464,84617413,protein_coding,-1,15949,chr12_84601464_84617413
Abce1,8,79683462,79711740,protein_coding,-1,28278,chr8_79683462_79711740
Abcf1,17,35956819,35969761,protein_coding,-1,12942,chr17_35956819_35969761
Abcf2,5,24565345,24577467,protein_coding,-1,12122,chr5_24565345_24577467
Abcf3,16,20548577,20561379,protein_coding,1,12802,chr16_20548577_20561379
Abcg1,17,31057675,31117988,protein_coding,1,60313,chr17_31057675_31117988
Abcg2,6,58584523,58695676,protein_coding,1,111153,chr6_58584523_58695676
Abcg3,5,104935057,104982718,protein_coding,-1,47661,chr5_104935057_104982718
Abcg4,9,44273188,44288615,protein_coding,-1,15427,chr9_44273188_44288615
Abcg5,17,84658234,84683011,protein_coding,-1,24777,chr17_84658234_84683011
Abhd1,5,30950066,30955091,polymorphic_pseudogene,1,5025,chr5_30950066_30955091
Abhd10,16,45729725,45742955,protein_coding,-1,13230,chr16_45729725_45742955
Abhd11,5,135009152,135012175,protein_coding,1,3023,chr5_135009152_135012175
Abhd11os,5,135012114,135013253,transcribed_unitary_pseudogene,-1,1139,chr5_135012114_135013253
Abhd12,2,150832493,150904741,protein_coding,-1,72248,chr2_150832493_150904741
Abhd12b,12,70154142,70183887,protein_coding,1,29745,chr12_70154142_70183887
Abhd13,8,9977707,9992155,protein_coding,1,14448,chr8_9977707_9992155
Abhd14a,9,106440051,106447678,protein_coding,-1,7627,chr9_106440051_106447678
Abhd14b,9,106447459,106452923,protein_coding,1,5464,chr9_106447459_106452923
Abhd15,11,77515121,77538607,protein_coding,1,23486,chr11_77515121_77538607
Abhd16a,17,35089263,35102987,protein_coding,1,13724,chr17_35089263_35102987
Abhd16b,2,181493206,181494980,protein_coding,1,1774,chr2_181493206_181494980
Abhd17a,10,80583654,80590341,protein_coding,-1,6687,chr10_80583654_80590341
Abhd17b,19,21653185,21685637,protein_coding,1,32452,chr19_21653185_21685637
Abhd17c,7,84109356,84151893,protein_coding,-1,42537,chr7_84109356_84151893
Abhd2,7,79273199,79365508,protein_coding,1,92309,chr7_79273199_79365508
Abhd3,18,10642092,10706771,protein_coding,-1,64679,chr18_10642092_10706771
Abhd4,14,54254188,54270637,protein_coding,1,16449,chr14_54254188_54270637
Abhd5,9,122351608,122381524,protein_coding,1,29916,chr9_122351608_122381524
Abhd6,14,8002902,8056763,protein_coding,1,53861,chr14_8002902_8056763
Abhd8,8,71456705,71463655,protein_coding,-1,6950,chr8_71456705_71463655
Abi1,2,22940073,23040241,protein_coding,-1,100168,chr2_22940073_23040241
Abi2,1,60409619,60481158,protein_coding,1,71539,chr1_60409619_60481158
Abi3,11,95830074,95842476,protein_coding,-1,12402,chr11_95830074_95842476
Abi3bp,16,56477878,56690135,protein_coding,1,212257,chr16_56477878_56690135
Abl1,2,31688376,31804227,protein_coding,1,115851,chr2_31688376_31804227
Abl2,1,156558786,156649568,protein_coding,1,90782,chr1_156558786_156649568
Ablim1,19,57032733,57314919,protein_coding,-1,282186,chr19_57032733_57314919
Ablim2,5,35757880,35884973,protein_coding,1,127093,chr5_35757880_35884973
Ablim3,18,61799392,61911824,protein_coding,-1,112432,chr18_61799392_61911824
Abr,11,76416734,76623558,protein_coding,-1,206824,chr11_76416734_76623558
Abra,15,41864076,41869720,protein_coding,-1,5644,chr15_41864076_41869720
Abracl,10,18011260,18023288,protein_coding,-1,12028,chr10_18011260_18023288
Abt1,13,23418361,23423866,protein_coding,-1,5505,chr13_23418361_23423866
Abtb1,6,88835914,88841984,protein_coding,-1,6070,chr6_88835914_88841984
Abtb2,2,103566310,103718423,protein_coding,1,152113,chr2_103566310_103718423
Acaa1a,9,119339676,119350299,protein_coding,1,10623,chr9_119339676_119350299
Acaa1b,9,119148023,119157093,protein_coding,-1,9070,chr9_119148023_119157093
Acaa2,18,74779197,74806208,protein_coding,1,27011,chr18_74779197_74806208
Acaca,11,84129672,84401651,protein_coding,1,271979,chr11_84129672_84401651
Acacb,5,114146535,114250761,protein_coding,1,104226,chr5_114146535_114250761
Acad10,5,121621026,121660514,protein_coding,-1,39488,chr5_121621026_121660514
Acad11,9,104063377,104127725,protein_coding,1,64348,chr9_104063377_104127725
Acad12,5,121596775,121618938,protein_coding,-1,22163,chr5_121596775_121618938
Acad8,9,26974135,26999566,protein_coding,-1,25431,chr9_26974135_26999566
Acad9,3,36065979,36092853,protein_coding,1,26874,chr3_36065979_36092853
Acadl,1,66830839,66863277,protein_coding,-1,32438,chr1_66830839_66863277
Acadm,3,153922357,153944632,protein_coding,-1,22275,chr3_153922357_153944632
Acads,5,115110299,115119346,protein_coding,-1,9047,chr5_115110299_115119346
Acadsb,7,131410601,131448944,protein_coding,1,38343,chr7_131410601_131448944
Acadvl,11,70010183,70015411,protein_coding,-1,5228,chr11_70010183_70015411
Acan,7,79053483,79115099,protein_coding,1,61616,chr7_79053483_79115099
Acap1,11,69881567,69895539,protein_coding,-1,13972,chr11_69881567_69895539
Acap2,16,31092412,31201245,protein_coding,-1,108833,chr16_31092412_31201245
Acap3,4,155891822,155907251,protein_coding,1,15429,chr4_155891822_155907251
Acat1,9,53580522,53610382,protein_coding,-1,29860,chr9_53580522_53610382
Acat2,17,12942890,12960747,protein_coding,-1,17857,chr17_12942890_12960747
Acat3,17,12923813,12940600,protein_coding,-1,16787,chr17_12923813_12940600
Acbd3,1,180726043,180754204,protein_coding,1,28161,chr1_180726043_180754204
Acbd4,11,103101682,103112200,protein_coding,1,10518,chr11_103101682_103112200
Acbd5,2,23068167,23115558,protein_coding,1,47391,chr2_23068167_23115558
Acbd6,1,155558120,155691330,protein_coding,1,133210,chr1_155558120_155691330
Acbd7,2,3336168,3340993,protein_coding,1,4825,chr2_3336168_3340993
Accs,2,93833467,93849943,protein_coding,-1,16476,chr2_93833467_93849943
Accsl,2,93855361,93869157,protein_coding,-1,13796,chr2_93855361_93869157
Acd,8,105695860,105701102,protein_coding,-1,5242,chr8_105695860_105701102
Ace,11,105967945,105989964,protein_coding,1,22019,chr11_105967945_105989964
Ace2,X,164139332,164188420,protein_coding,1,49088,chrX_164139332_164188420
Ace3,11,105994675,106005443,protein_coding,1,10768,chr11_105994675_106005443
Acer1,17,56953490,56982126,protein_coding,-1,28636,chr17_56953490_56982126
Acer2,4,86874396,86934822,protein_coding,1,60426,chr4_86874396_86934822
Acer3,7,98206389,98321208,protein_coding,-1,114819,chr7_98206389_98321208
Ache,5,137287519,137294466,protein_coding,1,6947,chr5_137287519_137294466
Acin1,14,54642161,54686931,protein_coding,-1,44770,chr14_54642161_54686931
Ackr1,1,173331886,173333750,protein_coding,-1,1864,chr1_173331886_173333750
Ackr2,9,121898355,121911074,protein_coding,1,12719,chr9_121898355_121911074
Ackr3,1,90203980,90216751,protein_coding,1,12771,chr1_90203980_90216751
Ackr4,9,104084157,104126933,protein_coding,-1,42776,chr9_104084157_104126933
Acly,11,100476353,100528000,protein_coding,-1,51647,chr11_100476353_100528000
Acmsd,1,127729413,127767978,protein_coding,1,38565,chr1_127729413_127767978
Acnat1,4,49447105,49473912,protein_coding,-1,26807,chr4_49447105_49473912
Acnat2,4,49379840,49408151,protein_coding,-1,28311,chr4_49379840_49408151
Aco1,4,40143081,40198338,protein_coding,1,55257,chr4_40143081_40198338
Aco2,15,81872309,81915133,protein_coding,1,42824,chr15_81872309_81915133
Acot1,12,84009490,84018371,protein_coding,1,8881,chr12_84009490_84018371
Acot10,15,20665214,20666750,protein_coding,-1,1536,chr15_20665214_20666750
Acot11,4,106744555,106804998,protein_coding,-1,60443,chr4_106744555_106804998
Acot12,13,91741512,91786148,protein_coding,1,44636,chr13_91741512_91786148
Acot13,13,24817948,24831540,protein_coding,-1,13592,chr13_24817948_24831540
Acot2,12,83987861,83993873,protein_coding,1,6012,chr12_83987861_83993873
Acot3,12,84052144,84060402,protein_coding,1,8258,chr12_84052144_84060402
Acot4,12,84038379,84048601,protein_coding,1,10222,chr12_84038379_84048601
Acot5,12,84069325,84076020,protein_coding,1,6695,chr12_84069325_84076020
Acot6,12,84100654,84111349,protein_coding,1,10695,chr12_84100654_84111349
Acot7,4,152178134,152271855,protein_coding,1,93721,chr4_152178134_152271855
Acot8,2,164792765,164804882,protein_coding,-1,12117,chr2_164792765_164804882
Acot9,X,155262443,155297654,protein_coding,1,35211,chrX_155262443_155297654
Acox1,11,116171888,116199045,protein_coding,-1,27157,chr11_116171888_116199045
Acox2,14,8225511,8259353,protein_coding,-1,33842,chr14_8225511_8259353
Acox3,5,35583040,35615352,protein_coding,1,32312,chr5_35583040_35615352
Acoxl,2,127838876,128123873,protein_coding,1,284997,chr2_127838876_128123873
Acp1,12,30893326,30911589,protein_coding,-1,18263,chr12_30893326_30911589
Acp2,2,91202885,91214098,protein_coding,1,11213,chr2_91202885_91214098
Acp5,9,22126727,22135711,protein_coding,-1,8984,chr9_22126727_22135711
Acp6,3,97158777,97177299,protein_coding,1,18522,chr3_97158777_97177299
Acr,15,89568326,89574585,protein_coding,1,6259,chr15_89568326_89574585
Acrbp,6,125049689,125063267,protein_coding,1,13578,chr6_125049689_125063267
Acsbg1,9,54604877,54661870,protein_coding,-1,56993,chr9_54604877_54661870
Acsbg2,17,56843103,56874447,protein_coding,-1,31344,chr17_56843103_56874447
Acsf2,11,94557102,94601871,protein_coding,-1,44769,chr11_94557102_94601871
Acsf3,8,122775486,122817880,protein_coding,1,42394,chr8_122775486_122817880
Acsl1,8,46471037,46536051,protein_coding,1,65014,chr8_46471037_46536051
Acsl3,1,78657825,78707743,protein_coding,1,49918,chr1_78657825_78707743
Acsl4,X,142317993,142390535,protein_coding,-1,72542,chrX_142317993_142390535
Acsl5,19,55251938,55297720,protein_coding,1,45782,chr19_55251938_55297720
Acsl6,11,54303798,54364756,protein_coding,1,60958,chr11_54303798_54364756
Acsm2,7,119554340,119600690,protein_coding,1,46350,chr7_119554340_119600690
Acsm3,7,119760923,119787513,protein_coding,1,26590,chr7_119760923_119787513
Acsm4,7,119690026,119714565,protein_coding,1,24539,chr7_119690026_119714565
Acss1,2,150618105,150668500,protein_coding,-1,50395,chr2_150618105_150668500
Acss2,2,155517948,155585724,protein_coding,1,67776,chr2_155517948_155585724
Acss2os,2,155547040,155556930,antisense,-1,9890,chr2_155547040_155556930
Acss3,10,106933517,107123668,protein_coding,-1,190151,chr10_106933517_107123668
Acta1,8,123891769,123894751,protein_coding,-1,2982,chr8_123891769_123894751
Acta2,19,34241090,34255590,protein_coding,-1,14500,chr19_34241090_34255590
Actb,5,142903115,142906754,protein_coding,-1,3639,chr5_142903115_142906754
Actbl2,13,111255013,111257749,protein_coding,1,2736,chr13_111255013_111257749
Actc1,2,114047282,114053548,protein_coding,-1,6266,chr2_114047282_114053548
Actg-ps1,8,46228994,46230117,processed_pseudogene,1,1123,chr8_46228994_46230117
Actg1,11,120345690,120348542,protein_coding,-1,2852,chr11_120345690_120348542
Actg2,6,83512905,83536265,protein_coding,-1,23360,chr6_83512905_83536265
Actl10,2,154551776,154553276,protein_coding,1,1500,chr2_154551776_154553276
Actl6a,3,32706298,32726973,protein_coding,1,20675,chr3_32706298_32726973
Actl6b,5,137553517,137569582,protein_coding,1,16065,chr5_137553517_137569582
Actl7a,4,56743413,56744925,protein_coding,1,1512,chr4_56743413_56744925
Actl7b,4,56740005,56741443,protein_coding,-1,1438,chr4_56740005_56741443
Actl9,17,33432896,33434268,protein_coding,1,1372,chr17_33432896_33434268
Actn1,12,80167547,80260371,protein_coding,-1,92824,chr12_80167547_80260371
Actn2,13,12269426,12340760,protein_coding,-1,71334,chr13_12269426_12340760
Actn3,19,4861216,4877909,protein_coding,-1,16693,chr19_4861216_4877909
Actn4,7,28893248,28962340,protein_coding,-1,69092,chr7_28893248_28962340
Actr10,12,70937857,70964718,protein_coding,1,26861,chr12_70937857_70964718
Actr1a,19,46376811,46395748,protein_coding,-1,18937,chr19_46376811_46395748
Actr1b,1,36698114,36714422,protein_coding,-1,16308,chr1_36698114_36714422
Actr2,11,20062304,20112913,protein_coding,-1,50609,chr11_20062304_20112913
Actr3,1,125392905,125435727,protein_coding,-1,42822,chr1_125392905_125435727
Actr3b,5,25759997,25850688,protein_coding,1,90691,chr5_25759997_25850688
Actr5,2,158624888,158639211,protein_coding,1,14323,chr2_158624888_158639211
Actr6,10,89711971,89732295,protein_coding,-1,20324,chr10_89711971_89732295
Actr8,14,29978337,30006354,protein_coding,1,28017,chr14_29978337_30006354
Actrt3,3,30597073,30599939,protein_coding,-1,2866,chr3_30597073_30599939
Acvr1,2,58388644,58567157,protein_coding,-1,178513,chr2_58388644_58567157
Acvr1b,15,101174067,101213684,protein_coding,1,39617,chr15_101174067_101213684
Acvr1c,2,58267453,58357895,protein_coding,-1,90442,chr2_58267453_58357895
Acvr2a,2,48814109,48903269,protein_coding,1,89160,chr2_48814109_48903269
Acvr2b,9,119402118,119434995,protein_coding,1,32877,chr9_119402118_119434995
Acvrl1,15,101128522,101145336,protein_coding,1,16814,chr15_101128522_101145336
Acy1,9,106432981,106438319,protein_coding,-1,5338,chr9_106432981_106438319
Acy3,19,3986570,3990007,protein_coding,1,3437,chr19_3986570_3990007
Acyp1,12,85272398,85288438,protein_coding,-1,16040,chr12_85272398_85288438
Acyp2,11,30505991,30649587,protein_coding,-1,143596,chr11_30505991_30649587
Ada,2,163726584,163750239,protein_coding,-1,23655,chr2_163726584_163750239
Adad1,3,37063527,37121930,protein_coding,1,58403,chr3_37063527_37121930
Adad2,8,119612747,119616924,protein_coding,1,4177,chr8_119612747_119616924
Adal,2,121140428,121156680,protein_coding,1,16252,chr2_121140428_121156680
Adam10,9,70678997,70780229,protein_coding,1,101232,chr9_70678997_70780229
Adam11,11,102761439,102780262,protein_coding,1,18823,chr11_102761439_102780262
Adam12,7,133883199,134232146,protein_coding,-1,348947,chr7_133883199_134232146
Adam15,3,89338542,89349996,protein_coding,-1,11454,chr3_89338542_89349996
Adam17,12,21323509,21373632,protein_coding,-1,50123,chr12_21323509_21373632
Adam18,8,24602246,24674755,protein_coding,-1,72509,chr8_24602246_24674755
Adam19,11,46055992,46147343,protein_coding,1,91351,chr11_46055992_46147343
Adam1a,5,121518576,121545482,protein_coding,-1,26906,chr5_121518576_121545482
Adam1b,5,121500098,121503435,protein_coding,-1,3337,chr5_121500098_121503435
Adam21,12,81558584,81568474,protein_coding,-1,9890,chr12_81558584_81568474
Adam22,5,8072352,8368160,protein_coding,-1,295808,chr5_8072352_8368160
Adam23,1,63445891,63596276,protein_coding,1,150385,chr1_63445891_63596276
Adam24,8,40675077,40682199,protein_coding,1,7122,chr8_40675077_40682199
Adam28,14,68606027,68655842,protein_coding,-1,49815,chr14_68606027_68655842
Adam3,8,24677225,24725852,protein_coding,-1,48627,chr8_24677225_24725852
Adam32,8,24836140,24948804,protein_coding,-1,112664,chr8_24836140_24948804
Adam33,2,131050591,131063814,protein_coding,-1,13223,chr2_131050591_131063814
Adam4,12,81419443,81421946,protein_coding,-1,2503,chr12_81419443_81421946
Adam5,8,24727093,24824369,protein_coding,-1,97276,chr8_24727093_24824369
Adam7,14,68497336,68533741,protein_coding,-1,36405,chr14_68497336_68533741
Adam8,7,139978932,139992562,protein_coding,-1,13630,chr7_139978932_139992562
Adam9,8,24949611,25016927,protein_coding,-1,67316,chr8_24949611_25016927
Adamts1,16,85793827,85803113,protein_coding,-1,9286,chr16_85793827_85803113
Adamts10,17,33524204,33553782,protein_coding,1,29578,chr17_33524204_33553782
Adamts12,15,11064790,11349231,protein_coding,1,284441,chr15_11064790_11349231
Adamts13,2,26973416,27009628,protein_coding,1,36212,chr2_26973416_27009628
Adamts14,10,61197112,61273438,protein_coding,-1,76326,chr10_61197112_61273438
Adamts15,9,30899155,30922452,protein_coding,-1,23297,chr9_30899155_30922452
Adamts16,13,70727802,70841811,protein_coding,-1,114009,chr13_70727802_70841811
Adamts17,7,66839735,67153171,protein_coding,1,313436,chr7_66839735_67153171
Adamts18,8,113697126,113848738,protein_coding,-1,151612,chr8_113697126_113848738
Adamts19,18,58836667,59054060,protein_coding,1,217393,chr18_58836667_59054060
Adamts2,11,50602084,50807573,protein_coding,1,205489,chr11_50602084_50807573
Adamts20,15,94270163,94465418,protein_coding,-1,195255,chr15_94270163_94465418
Adamts3,5,89677087,89883334,protein_coding,-1,206247,chr5_89677087_89883334
Adamts4,1,171250421,171260637,protein_coding,1,10216,chr1_171250421_171260637
Adamts5,16,85856173,85901828,protein_coding,-1,45655,chr16_85856173_85901828
Adamts6,13,104287835,104496695,protein_coding,1,208860,chr13_104287835_104496695
Adamts7,9,90163069,90208071,protein_coding,1,45002,chr9_90163069_90208071
Adamts8,9,30942562,30963838,protein_coding,1,21276,chr9_30942562_30963838
Adamts9,6,92772699,92943492,protein_coding,-1,170793,chr6_92772699_92943492
Adamtsl1,4,85514172,86428385,protein_coding,1,914213,chr4_85514172_86428385
Adamtsl2,2,27079379,27108981,protein_coding,1,29602,chr2_27079379_27108981
Adamtsl3,7,82335694,82614450,protein_coding,1,278756,chr7_82335694_82614450
Adamtsl4,3,95676201,95687917,protein_coding,-1,11716,chr3_95676201_95687917
Adamtsl5,10,80339110,80348412,protein_coding,-1,9302,chr10_80339110_80348412
Adap1,5,139271876,139325622,protein_coding,-1,53746,chr5_139271876_139325622
Adap2,11,80154105,80178958,protein_coding,1,24853,chr11_80154105_80178958
Adar,3,89715022,89753446,protein_coding,1,38424,chr3_89715022_89753446
Adarb1,10,77290726,77418270,protein_coding,-1,127544,chr10_77290726_77418270
Adarb2,13,8202866,8768747,protein_coding,1,565881,chr13_8202866_8768747
Adat1,8,111966908,111992302,protein_coding,-1,25394,chr8_111966908_111992302
Adat2,10,13552894,13563376,protein_coding,1,10482,chr10_13552894_13563376
Adat3,10,80602880,80607654,protein_coding,1,4774,chr10_80602880_80607654
Adck1,12,88360554,88461724,protein_coding,1,101170,chr12_88360554_88461724
Adck2,6,39573873,39588769,protein_coding,1,14896,chr6_39573873_39588769
Adck5,15,76576358,76595816,protein_coding,1,19458,chr15_76576358_76595816
Adcy1,11,7063489,7178506,protein_coding,1,115017,chr11_7063489_7178506
Adcy10,1,165485183,165576774,protein_coding,1,91591,chr1_165485183_165576774
Adcy2,13,68620043,68999541,protein_coding,-1,379498,chr13_68620043_68999541
Adcy3,12,4133103,4213525,protein_coding,1,80422,chr12_4133103_4213525
Adcy4,14,55769057,55784095,protein_coding,-1,15038,chr14_55769057_55784095
Adcy5,16,35154877,35305738,protein_coding,1,150861,chr16_35154877_35305738
Adcy6,15,98589973,98610076,protein_coding,-1,20103,chr15_98589973_98610076
Adcy7,8,88272403,88329962,protein_coding,1,57559,chr8_88272403_88329962
Adcy8,15,64697084,64922296,protein_coding,-1,225212,chr15_64697084_64922296
Adcy9,16,4287529,4420498,protein_coding,-1,132969,chr16_4287529_4420498
Adcyap1,17,93199017,93206537,protein_coding,1,7520,chr17_93199017_93206537
Adcyap1r1,6,55451978,55501451,protein_coding,1,49473,chr6_55451978_55501451
Add1,5,34573664,34632308,protein_coding,1,58644,chr5_34573664_34632308
Add2,6,86028681,86124409,protein_coding,1,95728,chr6_86028681_86124409
Add3,19,53140443,53247399,protein_coding,1,106956,chr19_53140443_53247399
Adgb,10,10335703,10472326,protein_coding,-1,136623,chr10_10335703_10472326
Adh5,3,138443093,138455499,protein_coding,1,12406,chr3_138443093_138455499
Adh6-ps1,3,138374121,138395002,transcribed_unprocessed_pseudogene,1,20881,chr3_138374121_138395002
Adh7,3,138217760,138233382,protein_coding,1,15622,chr3_138217760_138233382
Adhfe1,1,9547948,9580673,protein_coding,1,32725,chr1_9547948_9580673
Adi1,12,28675231,28682175,protein_coding,1,6944,chr12_28675231_28682175
Adig,2,158502612,158508198,protein_coding,1,5586,chr2_158502612_158508198
Adipor1,1,134415378,134433351,protein_coding,1,17973,chr1_134415378_134433351
Adipor2,6,119353150,119417704,protein_coding,-1,64554,chr6_119353150_119417704
Adk,14,21052574,21448569,protein_coding,1,395995,chr14_21052574_21448569
Adm,7,110627661,110629820,protein_coding,1,2159,chr7_110627661_110629820
Adm2,15,89322720,89324731,protein_coding,1,2011,chr15_89322720_89324731
Adnp,2,168180986,168207112,protein_coding,-1,26126,chr2_168180986_168207112
Adnp2,18,80126311,80151482,protein_coding,-1,25171,chr18_80126311_80151482
Ado,10,67544511,67549097,protein_coding,-1,4586,chr10_67544511_67549097
Adora1,1,134199223,134235431,protein_coding,-1,36208,chr1_134199223_134235431
Adora2a,10,75316877,75334784,protein_coding,1,17907,chr10_75316877_75334784
Adora2b,11,62248984,62266453,protein_coding,1,17469,chr11_62248984_62266453
Adora3,3,105870858,105908926,protein_coding,1,38068,chr3_105870858_105908926
Adpgk,9,59291558,59324052,protein_coding,1,32494,chr9_59291558_59324052
Adprh,16,38444030,38452703,protein_coding,-1,8673,chr16_38444030_38452703
Adprhl1,8,13221663,13254162,protein_coding,-1,32499,chr8_13221663_13254162
Adprhl2,4,126316047,126321703,protein_coding,-1,5656,chr4_126316047_126321703
Adprm,11,67037905,67052594,protein_coding,-1,14689,chr11_67037905_67052594
Adra1a,14,66635251,66771168,protein_coding,1,135917,chr14_66635251_66771168
Adra1b,11,43774606,43901210,protein_coding,-1,126604,chr11_43774606_43901210
Adra1d,2,131545850,131562283,protein_coding,-1,16433,chr2_131545850_131562283
Adra2a,19,54044151,54048982,protein_coding,1,4831,chr19_54044151_54048982
Adra2b,2,127363208,127367221,protein_coding,1,4013,chr2_127363208_127367221
Adra2c,5,35278319,35281763,protein_coding,1,3444,chr5_35278319_35281763
Adrb1,19,56722199,56733113,protein_coding,1,10914,chr19_56722199_56733113
Adrb2,18,62177816,62179959,protein_coding,-1,2143,chr18_62177816_62179959
Adrb3,8,27225776,27250616,protein_coding,-1,24840,chr8_27225776_27250616
Adrm1,2,180171485,180176286,protein_coding,1,4801,chr2_180171485_180176286
Adsl,15,80948490,80970946,protein_coding,1,22456,chr15_80948490_80970946
Adss,1,177762962,177796511,protein_coding,-1,33549,chr1_177762962_177796511
Adssl1,12,112620045,112641360,protein_coding,1,21315,chr12_112620045_112641360
Adtrp,13,41763148,41847684,protein_coding,-1,84536,chr13_41763148_41847684
Aebp1,11,5861947,5872088,protein_coding,1,10141,chr11_5861947_5872088
Aebp2,6,140622663,140678472,protein_coding,1,55809,chr6_140622663_140678472
Aen,7,78895854,78911209,protein_coding,1,15355,chr7_78895854_78911209
Afap1,5,35893319,36003923,protein_coding,1,110604,chr5_35893319_36003923
Afap1l1,18,61730261,61786702,protein_coding,-1,56441,chr18_61730261_61786702
Afap1l2,19,56912361,57008228,protein_coding,-1,95867,chr19_56912361_57008228
Aff1,5,103692374,103855322,protein_coding,1,162948,chr5_103692374_103855322
Aff2,X,69360294,69868037,protein_coding,1,507743,chrX_69360294_69868037
Aff3,1,38177326,38664955,protein_coding,-1,487629,chr1_38177326_38664955
Aff4,11,53350833,53421830,protein_coding,1,70997,chr11_53350833_53421830
Afg3l1,8,123477903,123503916,protein_coding,1,26013,chr8_123477903_123503916
Afg3l2,18,67404764,67449172,protein_coding,-1,44408,chr18_67404764_67449172
Afm,5,90518932,90553543,protein_coding,1,34611,chr5_90518932_90553543
Afmid,11,117825924,117839908,protein_coding,1,13984,chr11_117825924_117839908
Afp,5,90490737,90508907,protein_coding,1,18170,chr5_90490737_90508907
Aftph,11,20685084,20741589,protein_coding,-1,56505,chr11_20685084_20741589
Aga,8,53511727,53523421,protein_coding,1,11694,chr8_53511727_53523421
Agap1,1,89454806,89897617,protein_coding,1,442811,chr1_89454806_89897617
Agap2,10,127075284,127093169,protein_coding,1,17885,chr10_127075284_127093169
Agap3,5,24452177,24502047,protein_coding,1,49870,chr5_24452177_24502047
Agbl1,7,76229887,77124698,protein_coding,1,894811,chr7_76229887_77124698
Agbl2,2,90782727,90834437,protein_coding,1,51710,chr2_90782727_90834437
Agbl3,6,34780432,34859459,protein_coding,1,79027,chr6_34780432_34859459
Agbl4,4,110397661,111664324,protein_coding,1,1266663,chr4_110397661_111664324
Agbl5,5,30888694,30906965,protein_coding,1,18271,chr5_30888694_30906965
Ager,17,34597862,34600936,protein_coding,1,3074,chr17_34597862_34600936
Agfg1,1,82839483,82901182,protein_coding,1,61699,chr1_82839483_82901182
Agfg2,5,137650463,137684726,protein_coding,-1,34263,chr5_137650463_137684726
Aggf1,13,95350683,95375352,protein_coding,-1,24669,chr13_95350683_95375352
Agk,6,40325172,40396762,protein_coding,1,71590,chr6_40325172_40396762
Agl,3,116739999,116808166,protein_coding,-1,68167,chr3_116739999_116808166
Agmat,4,141746672,141759263,protein_coding,1,12591,chr4_141746672_141759263
Agmo,12,37241641,37582202,protein_coding,1,340561,chr12_37241641_37582202
Ago1,4,126435012,126468583,protein_coding,-1,33571,chr4_126435012_126468583
Ago2,15,73095844,73184935,protein_coding,-1,89091,chr15_73095844_73184935
Ago3,4,126331704,126429556,protein_coding,-1,97852,chr4_126331704_126429556
Ago4,4,126489541,126533472,protein_coding,-1,43931,chr4_126489541_126533472
Agpat1,17,34604262,34613449,protein_coding,1,9187,chr17_34604262_34613449
Agpat2,2,26593057,26604417,protein_coding,-1,11360,chr2_26593057_26604417
Agpat3,10,78269178,78352489,protein_coding,-1,83311,chr10_78269178_78352489
Agpat4,17,12118704,12219645,protein_coding,1,100941,chr17_12118704_12219645
Agpat5,8,18846277,18891361,protein_coding,1,45084,chr8_18846277_18891361
Agps,2,75832177,75931350,protein_coding,1,99173,chr2_75832177_75931350
Agr2,12,35992907,36004087,protein_coding,1,11180,chr12_35992907_36004087
Agr3,12,35925620,35949736,protein_coding,1,24116,chr12_35925620_35949736
Agrn,4,156165290,156197488,protein_coding,-1,32198,chr4_156165290_156197488
Agrp,8,105566698,105637393,protein_coding,-1,70695,chr8_105566698_105637393
Agt,8,124556534,124569706,protein_coding,-1,13172,chr8_124556534_124569706
Agtpbp1,13,59445742,59585227,protein_coding,-1,139485,chr13_59445742_59585227
Agtr1a,13,30336441,30382867,protein_coding,1,46426,chr13_30336441_30382867
Agtr1b,3,20314473,20367177,protein_coding,-1,52704,chr3_20314473_20367177
Agtr2,X,21484544,21489164,protein_coding,1,4620,chrX_21484544_21489164
Agtrap,4,148077061,148088031,protein_coding,-1,10970,chr4_148077061_148088031
Agxt,1,93135240,93145421,protein_coding,1,10181,chr1_93135240_93145421
Agxt2,15,10358532,10410153,protein_coding,1,51621,chr15_10358532_10410153
Ahctf1,1,179744894,179803680,protein_coding,-1,58786,chr1_179744894_179803680
Ahcy,2,155059310,155074497,protein_coding,-1,15187,chr2_155059310_155074497
Ahcyl1,3,107663118,107696560,protein_coding,-1,33442,chr3_107663118_107696560
Ahcyl2,6,29768011,29912310,protein_coding,1,144299,chr6_29768011_29912310
Ahdc1,4,133011260,133078110,protein_coding,1,66850,chr4_133011260_133078110
Ahi1,10,20952547,21080429,protein_coding,1,127882,chr10_20952547_21080429
Ahnak,19,8989284,9076914,protein_coding,1,87630,chr19_8989284_9076914
Ahnak2,12,112772194,112802657,protein_coding,-1,30463,chr12_112772194_112802657
Ahr,12,35497974,35535038,protein_coding,-1,37064,chr12_35497974_35535038
Ahrr,13,74211118,74292331,protein_coding,-1,81213,chr13_74211118_74292331
Ahsa1,12,87266479,87273998,protein_coding,1,7519,chr12_87266479_87273998
Ahsa2,11,23487882,23498030,protein_coding,-1,10148,chr11_23487882_23498030
Aicda,6,122553801,122564180,protein_coding,1,10379,chr6_122553801_122564180
Aida,1,183296590,183325476,protein_coding,1,28886,chr1_183296590_183325476
Aif1,17,35170991,35176068,protein_coding,-1,5077,chr17_35170991_35176068
Aif1l,2,31950139,31973442,protein_coding,1,23303,chr2_31950139_31973442
Aifm1,X,48474944,48513563,protein_coding,-1,38619,chrX_48474944_48513563
Aifm2,10,61715263,61739260,protein_coding,1,23997,chr10_61715263_61739260
Aifm3,16,17489611,17507485,protein_coding,1,17874,chr16_17489611_17507485
Aig1,10,13647054,13868980,protein_coding,-1,221926,chr10_13647054_13868980
Aim2,1,173350879,173466040,protein_coding,1,115161,chr1_173350879_173466040
Aimp1,3,132660481,132684370,protein_coding,-1,23889,chr3_132660481_132684370
Aimp2,5,143902704,143909847,protein_coding,-1,7143,chr5_143902704_143909847
Aip,19,4114446,4125858,protein_coding,-1,11412,chr19_4114446_4125858
Aipl1,11,72027963,72037509,protein_coding,-1,9546,chr11_72027963_72037509
Aire,10,78030022,78043610,protein_coding,-1,13588,chr10_78030022_78043610
Airn,17,12741311,12860136,antisense,1,118825,chr17_12741311_12860136
Ajap1,4,153373221,153482811,protein_coding,-1,109590,chr4_153373221_153482811
Ajuba,14,54567472,54577558,protein_coding,-1,10086,chr14_54567472_54577558
Ak1,2,32621758,32635058,protein_coding,1,13300,chr2_32621758_32635058
Ak2,4,128991958,129011529,protein_coding,1,19571,chr4_128991958_129011529
Ak3,19,29020833,29047961,protein_coding,-1,27128,chr19_29020833_29047961
Ak3l2-ps,2,72633936,72634607,processed_pseudogene,1,671,chr2_72633936_72634607
Ak4,4,101419277,101466995,protein_coding,1,47718,chr4_101419277_101466995
Ak5,3,152462815,152668360,protein_coding,-1,205545,chr3_152462815_152668360
Ak6,13,100650979,100666359,protein_coding,1,15380,chr13_100650979_100666359
Ak7,12,105705976,105782447,protein_coding,1,76471,chr12_105705976_105782447
Ak8,2,28700164,28813165,protein_coding,1,113001,chr2_28700164_28813165
Ak9,10,41303980,41434534,protein_coding,1,130554,chr10_41303980_41434534
Akap1,11,88830792,88864586,protein_coding,-1,33794,chr11_88830792_88864586
Akap10,11,61871307,61930252,protein_coding,-1,58945,chr11_61871307_61930252
Akap11,14,78492246,78536808,protein_coding,-1,44562,chr14_78492246_78536808
Akap12,10,4266380,4359470,protein_coding,1,93090,chr10_4266380_4359470
Akap13,7,75455534,75754609,protein_coding,1,299075,chr7_75455534_75754609
Akap14,X,37150698,37168842,protein_coding,-1,18144,chrX_37150698_37168842
Akap17b,X,36608314,36645395,protein_coding,-1,37081,chrX_36608314_36645395
Akap3,6,126853098,126874308,protein_coding,1,21210,chr6_126853098_126874308
Akap5,12,76324891,76334153,protein_coding,1,9262,chr12_76324891_76334153
Akap6,12,52699383,53155599,protein_coding,1,456216,chr12_52699383_53155599
Akap7,10,25169090,25307870,protein_coding,-1,138780,chr10_25169090_25307870
Akap8,17,32303672,32321238,protein_coding,-1,17566,chr17_32303672_32321238
Akap8l,17,32321424,32350607,protein_coding,-1,29183,chr17_32321424_32350607
Akap9,5,3928054,4081310,protein_coding,1,153256,chr5_3928054_4081310
Akip1,7,109703690,109712189,protein_coding,1,8499,chr7_109703690_109712189
Akirin1,4,123734559,123750345,protein_coding,-1,15786,chr4_123734559_123750345
Akirin1-ps,11,85216597,85217054,processed_pseudogene,1,457,chr11_85216597_85217054
Akirin2,4,34550937,34566908,protein_coding,1,15971,chr4_34550937_34566908
Akna,4,63367125,63403354,protein_coding,-1,36229,chr4_63367125_63403354
Aknad1,3,108739658,108782309,protein_coding,1,42651,chr3_108739658_108782309
Akp-ps1,1,87067672,87071098,transcribed_unprocessed_pseudogene,1,3426,chr1_87067672_87071098
Akr1a1,4,116636510,116651680,protein_coding,-1,15170,chr4_116636510_116651680
Akr1b10,6,34384218,34396950,protein_coding,1,12732,chr6_34384218_34396950
Akr1b3,6,34302434,34317478,protein_coding,-1,15044,chr6_34302434_34317478
Akr1b8,6,34354119,34368463,protein_coding,1,14344,chr6_34354119_34368463
Akr1c14,13,4049011,4090688,protein_coding,1,41677,chr13_4049011_4090688
Akr1c18,13,4132615,4150654,protein_coding,-1,18039,chr13_4132615_4150654
Akr1c19,13,4228700,4252843,protein_coding,1,24143,chr13_4228700_4252843
Akr1c21,13,4574075,4586541,protein_coding,1,12466,chr13_4574075_4586541
Akr1d1,6,37530173,37568815,protein_coding,1,38642,chr6_37530173_37568815
Akr1e1,13,4590750,4609174,protein_coding,-1,18424,chr13_4590750_4609174
Akr7a5,4,139310744,139318426,protein_coding,1,7682,chr4_139310744_139318426
Akt1,12,112653821,112674884,protein_coding,-1,21063,chr12_112653821_112674884
Akt1s1,7,44848991,44855421,protein_coding,1,6430,chr7_44848991_44855421
Akt2,7,27591552,27640826,protein_coding,1,49274,chr7_27591552_27640826
Akt2-ps,11,16514533,16515981,processed_pseudogene,1,1448,chr11_16514533_16515981
Akt3,1,177020073,177258203,protein_coding,-1,238130,chr1_177020073_177258203
Aktip,8,91111784,91199976,protein_coding,-1,88192,chr8_91111784_91199976
Alad,4,62509169,62519918,protein_coding,-1,10749,chr4_62509169_62519918
Alas1,9,106233455,106248654,protein_coding,-1,15199,chr9_106233455_106248654
Alas2,X,150547375,150570638,protein_coding,1,23263,chrX_150547375_150570638
Alb,5,90460897,90476602,protein_coding,1,15705,chr5_90460897_90476602
Alcam,16,52248996,52454074,protein_coding,-1,205078,chr16_52248996_52454074
Aldh16a1,7,45140684,45154584,protein_coding,-1,13900,chr7_45140684_45154584
Aldh18a1,19,40550257,40588463,protein_coding,-1,38206,chr19_40550257_40588463
Aldh1a1,19,20492715,20643465,protein_coding,1,150750,chr19_20492715_20643465
Aldh1a2,9,71215789,71296243,protein_coding,1,80454,chr9_71215789_71296243
Aldh1a3,7,66390890,66427517,protein_coding,-1,36627,chr7_66390890_66427517
Aldh1a7,19,20692953,20727562,protein_coding,-1,34609,chr19_20692953_20727562
Aldh1b1,4,45799022,45804604,protein_coding,1,5582,chr4_45799022_45804604
Aldh1l1,6,90486427,90600203,protein_coding,1,113776,chr6_90486427_90600203
Aldh1l2,10,83487450,83534140,protein_coding,-1,46690,chr10_83487450_83534140
Aldh2,5,121566027,121593824,protein_coding,-1,27797,chr5_121566027_121593824
Aldh3a1,11,61207537,61218421,protein_coding,1,10884,chr11_61207537_61218421
Aldh3a2,11,61223417,61267464,protein_coding,-1,44047,chr11_61223417_61267464
Aldh3b1,19,3913491,3929808,protein_coding,-1,16317,chr19_3913491_3929808
Aldh3b2,19,3972328,3981646,protein_coding,1,9318,chr19_3972328_3981646
Aldh4a1,4,139622866,139649690,protein_coding,1,26824,chr4_139622866_139649690
Aldh5a1,13,24907579,24937661,protein_coding,-1,30082,chr13_24907579_24937661
Aldh6a1,12,84430717,84451004,protein_coding,-1,20287,chr12_84430717_84451004
Aldh7a1,18,56509687,56572951,protein_coding,-1,63264,chr18_56509687_56572951
Aldh8a1,10,21377291,21396585,protein_coding,1,19294,chr10_21377291_21396585
Aldh9a1,1,167349991,167368532,protein_coding,1,18541,chr1_167349991_167368532
Aldoa,7,126795234,126809108,protein_coding,-1,13874,chr7_126795234_126809108
Aldoart1,4,72850583,72852634,protein_coding,-1,2051,chr4_72850583_72852634
Aldoart2,12,55565239,55566896,protein_coding,1,1657,chr12_55565239_55566896
Aldob,4,49535995,49549546,protein_coding,-1,13551,chr4_49535995_49549546
Aldoc,11,78322968,78327781,protein_coding,1,4813,chr11_78322968_78327781
Alg1,16,5233621,5244912,protein_coding,1,11291,chr16_5233621_5244912
Alg10b,15,90224311,90233471,protein_coding,1,9160,chr15_90224311_90233471
Alg11,8,22060721,22071627,protein_coding,1,10906,chr8_22060721_22071627
Alg12,15,88805244,88819318,protein_coding,-1,14074,chr15_88805244_88819318
Alg13,X,144317804,144374450,protein_coding,1,56646,chrX_144317804_144374450
Alg14,3,121291773,121363094,protein_coding,1,71321,chr3_121291773_121363094
Alg2,4,47465067,47474333,protein_coding,-1,9266,chr4_47465067_47474333
Alg3,16,20605374,20611735,protein_coding,-1,6361,chr16_20605374_20611735
Alg5,3,54735539,54751318,protein_coding,1,15779,chr3_54735539_54751318
Alg6,4,99715664,99763460,protein_coding,1,47796,chr4_99715664_99763460
Alg8,7,97371606,97392185,protein_coding,1,20579,chr7_97371606_97392185
Alg9,9,50775019,50843542,protein_coding,1,68523,chr9_50775019_50843542
Alk,17,71868972,72604627,protein_coding,-1,735655,chr17_71868972_72604627
Alkbh1,12,87425840,87444017,protein_coding,-1,18177,chr12_87425840_87444017
Alkbh2,5,114123926,114128218,protein_coding,-1,4292,chr5_114123926_114128218
Alkbh3,2,93980550,94010807,protein_coding,-1,30257,chr2_93980550_94010807
Alkbh4,5,136136146,136141615,protein_coding,1,5469,chr5_136136146_136141615
Alkbh5,11,60536381,60558512,protein_coding,1,22131,chr11_60536381_60558512
Alkbh6,7,30308717,30314304,protein_coding,1,5587,chr7_30308717_30314304
Alkbh7,17,56997339,56999322,protein_coding,1,1983,chr17_56997339_56999322
Alkbh8,9,3335140,3391154,protein_coding,1,56014,chr9_3335140_3391154
Allc,12,28553755,28582523,protein_coding,-1,28768,chr12_28553755_28582523
Alms1,6,85587531,85702753,protein_coding,1,115222,chr6_85587531_85702753
Alms1-ps1,6,85721925,85756526,unprocessed_pseudogene,1,34601,chr6_85721925_85756526
Alms1-ps2,6,85774393,85804057,transcribed_unprocessed_pseudogene,1,29664,chr6_85774393_85804057
Alox12,11,70241457,70255353,protein_coding,-1,13896,chr11_70241457_70255353
Alox12b,11,69156989,69169792,protein_coding,1,12803,chr11_69156989_69169792
Alox12e,11,70315610,70322628,protein_coding,-1,7018,chr11_70315610_70322628
Alox15,11,70344152,70352031,protein_coding,-1,7879,chr11_70344152_70352031
Alox5,6,116410077,116461178,protein_coding,-1,51101,chr6_116410077_116461178
Alox5ap,5,149264767,149288153,protein_coding,1,23386,chr5_149264767_149288153
Alox8,11,69183932,69197843,protein_coding,-1,13911,chr11_69183932_69197843
Aloxe3,11,69125896,69149115,protein_coding,1,23219,chr11_69125896_69149115
Alpk1,3,127670310,127780527,protein_coding,-1,110217,chr3_127670310_127780527
Alpk2,18,65265529,65394066,protein_coding,-1,128537,chr18_65265529_65394066
Alpk3,7,81057600,81105612,protein_coding,1,48012,chr7_81057600_81105612
Alpl,4,137741733,137796384,protein_coding,-1,54651,chr4_137741733_137796384
Alppl2,1,87086694,87089928,protein_coding,-1,3234,chr1_87086694_87089928
Als2,1,59162926,59237231,protein_coding,-1,74305,chr1_59162926_59237231
Als2cl,9,110879870,110900530,protein_coding,1,20660,chr9_110879870_110900530
Alx4,2,93642384,93681339,protein_coding,1,38955,chr2_93642384_93681339
Alyref,11,120592121,120598365,protein_coding,-1,6244,chr11_120592121_120598365
Alyref2,1,171503478,171504750,protein_coding,1,1272,chr1_171503478_171504750
Amacr,15,10981756,10996626,protein_coding,1,14870,chr15_10981756_10996626
Ambra1,2,91730134,91918849,protein_coding,1,188715,chr2_91730134_91918849
Amd-ps1,X,155155195,155156188,processed_pseudogene,1,993,chrX_155155195_155156188
Amd-ps3,18,64448685,64449689,processed_pseudogene,-1,1004,chr18_64448685_64449689
Amd-ps4,4,51253025,51254027,processed_pseudogene,-1,1002,chr4_51253025_51254027
Amd-ps6,9,24826343,24827345,processed_pseudogene,-1,1002,chr9_24826343_24827345
Amd-ps7,17,94803193,94803818,processed_pseudogene,1,625,chr17_94803193_94803818
Amd1,10,40287458,40302188,protein_coding,-1,14730,chr10_40287458_40302188
Amd2,10,35708675,35711892,protein_coding,-1,3217,chr10_35708675_35711892
Amdhd1,10,93523338,93540033,protein_coding,-1,16695,chr10_93523338_93540033
Amdhd2,17,24155833,24163766,protein_coding,-1,7933,chr17_24155833_24163766
Amelx,X,169176114,169187200,protein_coding,-1,11086,chrX_169176114_169187200
Amer1,X,95420318,95444872,protein_coding,-1,24554,chrX_95420318_95444872
Amer2,14,60373259,60388197,protein_coding,1,14938,chr14_60373259_60388197
Amer3,1,34579657,34590944,protein_coding,1,11287,chr1_34579657_34590944
Amfr,8,93971588,94012842,protein_coding,-1,41254,chr8_93971588_94012842
Amh,10,80805243,80807648,protein_coding,1,2405,chr10_80805243_80807648
Amhr2,15,102445367,102454633,protein_coding,1,9266,chr15_102445367_102454633
Amigo1,3,108186335,108192286,protein_coding,1,5951,chr3_108186335_108192286
Amigo2,15,97244125,97247287,protein_coding,-1,3162,chr15_97244125_97247287
Amigo3,9,108053159,108055701,protein_coding,1,2542,chr9_108053159_108055701
Ammecr1,X,142851146,142966728,protein_coding,-1,115582,chrX_142851146_142966728
Ammecr1l,18,31759826,31782743,protein_coding,1,22917,chr18_31759826_31782743
Amn,12,111271095,111276426,protein_coding,1,5331,chr12_111271095_111276426
Amn1,6,149157147,149188712,protein_coding,-1,31565,chr6_149157147_149188712
Amot,X,145446425,145505181,protein_coding,-1,58756,chrX_145446425_145505181
Amotl1,9,14541966,14645056,protein_coding,-1,103090,chr9_14541966_14645056
Amotl2,9,102716672,102733418,protein_coding,1,16746,chr9_102716672_102733418
Ampd1,3,103074014,103099720,protein_coding,1,25706,chr3_103074014_103099720
Ampd2,3,108074062,108086651,protein_coding,-1,12589,chr3_108074062_108086651
Ampd3,7,110768206,110812405,protein_coding,1,44199,chr7_110768206_110812405
Amph,13,18948205,19150921,protein_coding,1,202716,chr13_18948205_19150921
Amt,9,108296853,108302302,protein_coding,1,5449,chr9_108296853_108302302
Amy1,3,113555710,113606699,protein_coding,-1,50989,chr3_113555710_113606699
Amy2-ps1,3,113182249,113206697,unprocessed_pseudogene,-1,24448,chr3_113182249_113206697
Amy2a1,3,113529403,113532428,protein_coding,-1,3025,chr3_113529403_113532428
Amy2b,3,113147656,113156727,unprocessed_pseudogene,-1,9071,chr3_113147656_113156727
Amz1,5,140724127,140761439,protein_coding,1,37312,chr5_140724127_140761439
Amz2,11,109425946,109452813,protein_coding,1,26867,chr11_109425946_109452813
Anapc1,2,128610104,128687391,protein_coding,-1,77287,chr2_128610104_128687391
Anapc10,8,79711820,79779059,protein_coding,1,67239,chr8_79711820_79779059
Anapc11,11,120598421,120608198,protein_coding,1,9777,chr11_120598421_120608198
Anapc13,9,102626296,102634425,protein_coding,1,8129,chr9_102626296_102634425
Anapc15,7,101863715,101901849,protein_coding,1,38134,chr7_101863715_101901849
Anapc15-ps,10,95672991,95673451,protein_coding,-1,460,chr10_95672991_95673451
Anapc16,10,59987409,60003135,protein_coding,-1,15726,chr10_59987409_60003135
Anapc2,2,25272478,25285915,protein_coding,1,13437,chr2_25272478_25285915
Anapc4,5,52834012,52867797,protein_coding,1,33785,chr5_52834012_52867797
Anapc5,5,122787459,122821339,protein_coding,-1,33880,chr5_122787459_122821339
Anapc7,5,122421693,122444912,protein_coding,1,23219,chr5_122421693_122444912
Ang,14,51091150,51102009,protein_coding,1,10859,chr14_51091150_51102009
Ang-ps1,14,44056983,44057418,unprocessed_pseudogene,-1,435,chr14_44056983_44057418
Ang2,14,51195324,51199148,protein_coding,-1,3824,chr14_51195324_51199148
Ang4,14,51763878,51773590,protein_coding,-1,9712,chr14_51763878_51773590
Angel1,12,86700502,86726460,protein_coding,-1,25958,chr12_86700502_86726460
Angel2,1,190925112,190946962,protein_coding,1,21850,chr1_190925112_190946962
Angpt1,15,42424723,42676977,protein_coding,-1,252254,chr15_42424723_42676977
Angpt2,8,18690263,18741562,protein_coding,-1,51299,chr8_18690263_18741562
Angpt4,2,151911210,151945337,protein_coding,1,34127,chr2_151911210_151945337
Angptl1,1,156838562,156861078,protein_coding,1,22516,chr1_156838562_156861078
Angptl2,2,33216069,33247717,protein_coding,1,31648,chr2_33216069_33247717
Angptl3,4,99030954,99046111,protein_coding,1,15157,chr4_99030954_99046111
Angptl4,17,33773750,33781830,protein_coding,-1,8080,chr17_33773750_33781830
Angptl6,9,20873808,20879727,protein_coding,-1,5919,chr9_20873808_20879727
Angptl7,4,148495183,148500460,protein_coding,-1,5277,chr4_148495183_148500460
Ank,15,27466677,27594909,protein_coding,1,128232,chr15_27466677_27594909
Ank1,8,22974844,23150497,protein_coding,1,175653,chr8_22974844_23150497
Ank2,3,126921612,127499350,protein_coding,-1,577738,chr3_126921612_127499350
Ank3,10,69398773,70027438,protein_coding,1,628665,chr10_69398773_70027438
Ankar,1,72642980,72700579,protein_coding,-1,57599,chr1_72642980_72700579
Ankdd1b,13,96416134,96471267,protein_coding,-1,55133,chr13_96416134_96471267
Ankef1,2,136501910,136562091,protein_coding,1,60181,chr2_136501910_136562091
Ankfn1,11,89390223,89841266,protein_coding,-1,451043,chr11_89390223_89841266
Ankfy1,11,72690006,72772146,protein_coding,1,82140,chr11_72690006_72772146
Ankhd1,18,36559987,36658913,protein_coding,1,98926,chr18_36559987_36658913
Ankib1,5,3690000,3802925,protein_coding,-1,112925,chr5_3690000_3802925
Ankk1,9,49415194,49427021,protein_coding,-1,11827,chr9_49415194_49427021
Ankle1,8,71406010,71409904,protein_coding,1,3894,chr8_71406010_71409904
Ankle2,5,110231004,110256651,protein_coding,1,25647,chr5_110231004_110256651
Ankmy1,1,92859803,92902906,protein_coding,-1,43103,chr1_92859803_92902906
Ankmy2,12,36157114,36197291,protein_coding,1,40177,chr12_36157114_36197291
Ankra2,13,98263074,98274754,protein_coding,1,11680,chr13_98263074_98274754
Ankrd1,19,36111961,36120099,protein_coding,-1,8138,chr19_36111961_36120099
Ankrd10,8,11611583,11635757,protein_coding,-1,24174,chr8_11611583_11635757
Ankrd11,8,122883822,123042277,protein_coding,-1,158455,chr8_122883822_123042277
Ankrd12,17,65965698,66077089,protein_coding,-1,111391,chr17_65965698_66077089
Ankrd13a,5,114774677,114806200,protein_coding,1,31523,chr5_114774677_114806200
Ankrd13b,11,77470485,77489678,protein_coding,-1,19193,chr11_77470485_77489678
Ankrd13c,3,157947239,158008034,protein_coding,1,60795,chr3_157947239_158008034
Ankrd13d,19,4270180,4283137,protein_coding,-1,12957,chr19_4270180_4283137
Ankrd16,2,11777876,11790329,protein_coding,1,12453,chr2_11777876_11790329
Ankrd17,5,90227166,90366577,protein_coding,-1,139411,chr5_90227166_90366577
Ankrd2,19,42036000,42045110,protein_coding,1,9110,chr19_42036000_42045110
Ankrd23,1,36530188,36536883,protein_coding,-1,6695,chr1_36530188_36536883
Ankrd24,10,81628540,81647610,protein_coding,1,19070,chr10_81628540_81647610
Ankrd26,6,118501308,118562226,protein_coding,-1,60918,chr6_118501308_118562226
Ankrd27,7,35586244,35639226,protein_coding,1,52982,chr7_35586244_35639226
Ankrd28,14,31698768,31830651,protein_coding,-1,131883,chr14_31698768_31830651
Ankrd29,18,12252362,12305797,protein_coding,-1,53435,chr18_12252362_12305797
Ankrd31,13,96748272,96910039,protein_coding,1,161767,chr13_96748272_96910039
Ankrd33b,15,31291478,31367726,protein_coding,-1,76248,chr15_31291478_31367726
Ankrd34a,3,96596636,96599775,protein_coding,1,3139,chr3_96596636_96599775
Ankrd34b,13,92425896,92441658,protein_coding,1,15762,chr13_92425896_92441658
Ankrd34c,9,89725245,89738475,protein_coding,-1,13230,chr9_89725245_89738475
Ankrd35,3,96670131,96691032,protein_coding,1,20901,chr3_96670131_96691032
Ankrd36,11,5569684,5689337,protein_coding,1,119653,chr11_5569684_5689337
Ankrd37,8,45996902,46005707,protein_coding,-1,8805,chr8_45996902_46005707
Ankrd39,1,36537507,36547445,protein_coding,-1,9938,chr1_36537507_36547445
Ankrd40,11,94328001,94341841,protein_coding,1,13840,chr11_94328001_94341841
Ankrd42,7,92581723,92637142,protein_coding,-1,55419,chr7_92581723_92637142
Ankrd44,1,54645340,54926387,protein_coding,-1,281047,chr1_54645340_54926387
Ankrd45,1,161142691,161170498,protein_coding,1,27807,chr1_161142691_161170498
Ankrd46,15,36477668,36496820,protein_coding,-1,19152,chr15_36477668_36496820
Ankrd49,9,14779618,14784856,protein_coding,-1,5238,chr9_14779618_14784856
Ankrd50,3,38449259,38484844,protein_coding,-1,35585,chr3_38449259_38484844
Ankrd52,10,128377115,128408704,protein_coding,1,31589,chr10_128377115_128408704
Ankrd53,6,83762644,83768326,protein_coding,1,5682,chr6_83762644_83768326
Ankrd54,15,79053094,79062893,protein_coding,-1,9799,chr15_79053094_79062893
Ankrd55,13,112288451,112384002,protein_coding,1,95551,chr13_112288451_112384002
Ankrd6,4,32804035,32950841,protein_coding,-1,146806,chr4_32804035_32950841
Ankrd61,5,143890741,143897685,protein_coding,-1,6944,chr5_143890741_143897685
Ankrd63,2,118699103,118703963,protein_coding,-1,4860,chr2_118699103_118703963
Ankrd65,4,155790439,155799503,protein_coding,1,9064,chr4_155790439_155799503
Ankrd66,17,43534188,43543639,protein_coding,-1,9451,chr17_43534188_43543639
Ankrd7,6,18866318,18879586,protein_coding,1,13268,chr6_18866318_18879586
Ankrd9,12,110975353,110979040,protein_coding,-1,3687,chr12_110975353_110979040
Anks1,17,27909306,28062775,protein_coding,1,153469,chr17_27909306_28062775
Anks1b,10,89873509,90973300,protein_coding,1,1099791,chr10_89873509_90973300
Anks3,16,4941436,4964205,protein_coding,-1,22769,chr16_4941436_4964205
Anks4b,7,120173858,120185586,protein_coding,1,11728,chr7_120173858_120185586
Anks6,4,47015669,47057427,protein_coding,-1,41758,chr4_47015669_47057427
Ankub1,3,57657393,57692799,protein_coding,-1,35406,chr3_57657393_57692799
Ankzf1,1,75192151,75199387,protein_coding,1,7236,chr1_75192151_75199387
Anln,9,22332012,22389188,protein_coding,-1,57176,chr9_22332012_22389188
Ano1,7,144588549,144751974,protein_coding,-1,163425,chr7_144588549_144751974
Ano10,9,122175874,122294423,protein_coding,-1,118549,chr9_122175874_122294423
Ano2,6,125690419,126040126,protein_coding,1,349707,chr6_125690419_126040126
Ano3,2,110655201,110950923,protein_coding,-1,295722,chr2_110655201_110950923
Ano4,10,88948994,89344762,protein_coding,-1,395768,chr10_88948994_89344762
Ano5,7,51511029,51598709,protein_coding,1,87680,chr7_51511029_51598709
Ano6,15,95790843,95974751,protein_coding,1,183908,chr15_95790843_95974751
Ano7,1,93373930,93404303,protein_coding,1,30373,chr1_93373930_93404303
Ano8,8,71476019,71485963,protein_coding,-1,9944,chr8_71476019_71485963
Ano9,7,141101212,141117806,protein_coding,-1,16594,chr7_141101212_141117806
Anp32-ps,11,33394879,33395266,processed_pseudogene,-1,387,chr11_33394879_33395266
Anp32a,9,62341293,62378812,protein_coding,1,37519,chr9_62341293_62378812
Anp32b,4,46450902,46472657,protein_coding,1,21755,chr4_46450902_46472657
Anp32b-ps1,4,143389659,143390416,processed_pseudogene,1,757,chr4_143389659_143390416
Anp32e,3,95929246,95947390,protein_coding,1,18144,chr3_95929246_95947390
Antxr1,6,87133853,87335821,protein_coding,-1,201968,chr6_87133853_87335821
Antxr2,5,97882783,98031043,protein_coding,-1,148260,chr5_97882783_98031043
Anxa1,19,20373428,20390944,protein_coding,-1,17516,chr19_20373428_20390944
Anxa10,8,62057042,62123150,protein_coding,-1,66108,chr8_62057042_62123150
Anxa11,14,25842156,25886804,protein_coding,1,44648,chr14_25842156_25886804
Anxa13,CHR_MG74_PATCH,58341363,58397832,lncRNA;processed_transcript,-1,56469,chrCHR_MG74_PATCH_58341363_58397832
Anxa2,9,69453620,69491795,protein_coding,1,38175,chr9_69453620_69491795
Anxa3,5,96793339,96845966,protein_coding,1,52627,chr5_96793339_96845966
Anxa4,6,86736840,86793584,protein_coding,-1,56744,chr6_86736840_86793584
Anxa5,3,36448923,36475894,protein_coding,-1,26971,chr3_36448923_36475894
Anxa6,11,54979108,55033445,protein_coding,-1,54337,chr11_54979108_55033445
Anxa7,14,20455260,20480133,protein_coding,-1,24873,chr14_20455260_20480133
Anxa9,3,95296096,95307176,protein_coding,-1,11080,chr3_95296096_95307176
Aoah,13,20794113,21036617,protein_coding,1,242504,chr13_20794113_21036617
Aoc2,11,101325063,101329702,protein_coding,1,4639,chr11_101325063_101329702
Aoc3,11,101330605,101341938,protein_coding,1,11333,chr11_101330605_101341938
Aox1,1,58029931,58106413,protein_coding,1,76482,chr1_58029931_58106413
Aox2,1,58278326,58380259,protein_coding,1,101933,chr1_58278326_58380259
Aox3,1,58113130,58200698,protein_coding,1,87568,chr1_58113130_58200698
Aox4,1,58210397,58268597,protein_coding,1,58200,chr1_58210397_58268597
Ap1ar,3,127807007,127837523,protein_coding,-1,30516,chr3_127807007_127837523
Ap1b1,11,4986824,5042791,protein_coding,1,55967,chr11_4986824_5042791
Ap1g1,8,109778554,109864204,protein_coding,1,85650,chr8_109778554_109864204
Ap1g2,14,55098575,55106593,protein_coding,-1,8018,chr14_55098575_55106593
Ap1m1,8,72240018,72257385,protein_coding,1,17367,chr8_72240018_72257385
Ap1m2,9,21294275,21312337,protein_coding,-1,18062,chr9_21294275_21312337
Ap1s1,5,137034993,137046135,protein_coding,-1,11142,chr5_137034993_137046135
Ap1s2,X,163909017,163933666,protein_coding,1,24649,chrX_163909017_163933666
Ap1s3,1,79606876,79671972,protein_coding,-1,65096,chr1_79606876_79671972
Ap2a1,7,44900373,44929496,protein_coding,-1,29123,chr7_44900373_44929496
Ap2a2,7,141562173,141633011,protein_coding,1,70838,chr7_141562173_141633011
Ap2b1,11,83299024,83405035,protein_coding,1,106011,chr11_83299024_83405035
Ap2m1,16,20535478,20544909,protein_coding,1,9431,chr16_20535478_20544909
Ap2s1,7,16738410,16749294,protein_coding,1,10884,chr7_16738410_16749294
Ap3b1,13,94358960,94566317,protein_coding,1,207357,chr13_94358960_94566317
Ap3b2,7,81460399,81493925,protein_coding,-1,33526,chr7_81460399_81493925
Ap3d1,10,80706956,80742264,protein_coding,-1,35308,chr10_80706956_80742264
Ap3m1,14,21031442,21052508,protein_coding,-1,21066,chr14_21031442_21052508
Ap3m1-ps,10,82585426,82586683,processed_pseudogene,1,1257,chr10_82585426_82586683
Ap3m2,8,22787354,22805622,protein_coding,-1,18268,chr8_22787354_22805622
Ap3s1,18,46741876,46790826,protein_coding,1,48950,chr18_46741876_46790826
Ap3s1-ps1,X,38685592,38686170,processed_pseudogene,-1,578,chrX_38685592_38686170
Ap3s1-ps2,8,94405211,94405789,processed_pseudogene,1,578,chr8_94405211_94405789
Ap3s2,7,79875325,79920649,protein_coding,-1,45324,chr7_79875325_79920649
Ap4b1,3,103809520,103822025,protein_coding,1,12505,chr3_103809520_103822025
Ap4e1,2,127008717,127067909,protein_coding,1,59192,chr2_127008717_127067909
Ap4m1,5,138172002,138180429,protein_coding,1,8427,chr5_138172002_138180429
Ap4s1,12,51691033,51744786,protein_coding,1,53753,chr12_51691033_51744786
Ap5b1,19,5568025,5571261,protein_coding,1,3236,chr19_5568025_5571261
Ap5m1,14,49066097,49094234,protein_coding,1,28137,chr14_49066097_49094234
Ap5s1,2,131207078,131213514,protein_coding,1,6436,chr2_131207078_131213514
Ap5z1,5,142463944,142478710,protein_coding,1,14766,chr5_142463944_142478710
Apaf1,10,90989311,91082770,protein_coding,-1,93459,chr10_90989311_91082770
Apba1,19,23758887,23949596,protein_coding,1,190709,chr19_23758887_23949596
Apba2,7,64501706,64753878,protein_coding,1,252172,chr7_64501706_64753878
Apba3,10,81266960,81273246,protein_coding,1,6286,chr10_81266960_81273246
Apbb1,7,105558483,105581653,protein_coding,-1,23170,chr7_105558483_105581653
Apbb1ip,2,22774094,22875653,protein_coding,1,101559,chr2_22774094_22875653
Apbb2,5,66298703,66618784,protein_coding,-1,320081,chr5_66298703_66618784
Apbb3,18,36671154,36679366,protein_coding,-1,8212,chr18_36671154_36679366
Apc,18,34220924,34322552,protein_coding,1,101628,chr18_34220924_34322552
Apc-ps1,5,76196625,76197094,transcribed_processed_pseudogene,1,469,chr5_76196625_76197094
Apc2,10,80295977,80318263,protein_coding,1,22286,chr10_80295977_80318263
Apcdd1,18,62922231,62961179,protein_coding,1,38948,chr18_62922231_62961179
Apeh,9,108085413,108094606,protein_coding,-1,9193,chr9_108085413_108094606
Apex1,14,50924968,50927139,protein_coding,1,2171,chr14_50924968_50927139
Apex2,X,150519519,150589868,protein_coding,-1,70349,chrX_150519519_150589868
Aph1a,3,95893969,95898288,protein_coding,1,4319,chr3_95893969_95898288
Aph1b,9,66775202,66795490,protein_coding,-1,20288,chr9_66775202_66795490
Aph1c,9,66814994,66834726,protein_coding,-1,19732,chr9_66814994_66834726
Api5,2,94411682,94438136,protein_coding,-1,26454,chr2_94411682_94438136
Api5-ps,7,26918776,26919352,processed_pseudogene,-1,576,chr7_26918776_26919352
Apip,2,103073675,103092644,protein_coding,1,18969,chr2_103073675_103092644
Aplf,6,87628424,87672193,protein_coding,-1,43769,chr6_87628424_87672193
Apln,X,48025146,48034853,protein_coding,-1,9707,chrX_48025146_48034853
Aplnr,2,85136225,85139923,protein_coding,1,3698,chr2_85136225_85139923
Aplp1,7,30434982,30445535,protein_coding,-1,10553,chr7_30434982_30445535
Aplp2,9,31149557,31211815,protein_coding,-1,62258,chr9_31149557_31211815
Apmap,2,150583080,150608567,protein_coding,-1,25487,chr2_150583080_150608567
Apoa1,9,46228580,46230466,protein_coding,1,1886,chr9_46228580_46230466
Apoa2,1,171225054,171226379,protein_coding,1,1325,chr1_171225054_171226379
Apob,12,7977648,8016835,protein_coding,1,39187,chr12_7977648_8016835
Apobec1,6,122577792,122602444,protein_coding,-1,24652,chr6_122577792_122602444
Apobec2,17,48415334,48432930,protein_coding,-1,17596,chr17_48415334_48432930
Apobec3,15,79891659,79915906,protein_coding,1,24247,chr15_79891659_79915906
Apobec4,1,152750551,152757544,protein_coding,1,6993,chr1_152750551_152757544
Apobr,7,126584942,126589112,protein_coding,1,4170,chr7_126584942_126589112
Apod,16,31296192,31314808,protein_coding,-1,18616,chr16_31296192_31314808
Apoe,7,19696109,19699188,protein_coding,-1,3079,chr7_19696109_19699188
Apof,10,128267997,128270153,protein_coding,1,2156,chr10_128267997_128270153
Apoh,11,108343354,108414396,protein_coding,1,71042,chr11_108343354_108414396
Apol10b,15,77583819,77596125,protein_coding,-1,12306,chr15_77583819_77596125
Apol6,15,77044729,77057106,protein_coding,1,12377,chr15_77044729_77057106
Apol7a,15,77388219,77399110,protein_coding,-1,10891,chr15_77388219_77399110
Apol7b,15,77422209,77447492,protein_coding,-1,25283,chr15_77422209_77447492
Apol7d,1,71652837,71662843,antisense,1,10006,chr1_71652837_71662843
Apol8,15,77747798,77757003,protein_coding,-1,9205,chr15_77747798_77757003
Apol9a,15,77403789,77411135,protein_coding,-1,7346,chr15_77403789_77411135
Apol9b,15,77729039,77736382,protein_coding,1,7343,chr15_77729039_77736382
Apold1,6,134981718,134986836,protein_coding,1,5118,chr6_134981718_134986836
Apom,17,35128997,35132050,protein_coding,-1,3053,chr17_35128997_35132050
Apoo,X,94367117,94417093,protein_coding,1,49976,chrX_94367117_94417093
Apoo-ps,13,107414144,107414729,processed_pseudogene,-1,585,chr13_107414144_107414729
Apool,X,112311334,112372755,protein_coding,1,61421,chrX_112311334_112372755
Apopt1,12,111713261,111755053,protein_coding,1,41792,chr12_111713261_111755053
App,16,84949685,85173766,protein_coding,-1,224081,chr16_84949685_85173766
Appbp2,11,85187262,85235130,protein_coding,-1,47868,chr11_85187262_85235130
Appbp2os,11,85234775,85238304,antisense,1,3529,chr11_85234775_85238304
Appl1,14,26918988,26971232,protein_coding,-1,52244,chr14_26918988_26971232
Appl2,10,83600033,83648738,protein_coding,-1,48705,chr10_83600033_83648738
Aprt,8,122574635,122576909,protein_coding,-1,2274,chr8_122574635_122576909
Aprt-ps,8,71223949,71224453,processed_pseudogene,1,504,chr8_71223949_71224453
Aptx,4,40682382,40703194,protein_coding,-1,20812,chr4_40682382_40703194
Aqp1,6,55336432,55348555,protein_coding,1,12123,chr6_55336432_55348555
Aqp10-ps,3,89964709,89968658,unprocessed_pseudogene,-1,3949,chr3_89964709_89968658
Aqp11,7,97724006,97738289,protein_coding,-1,14283,chr7_97724006_97738289
Aqp3,4,41092722,41098183,protein_coding,-1,5461,chr4_41092722_41098183
Aqp4,18,15389496,15410982,protein_coding,-1,21486,chr18_15389496_15410982
Aqp5,15,99590782,99594829,protein_coding,1,4047,chr15_99590782_99594829
Aqp6,15,99601400,99605477,protein_coding,1,4077,chr15_99601400_99605477
Aqp7,4,41033074,41048139,protein_coding,-1,15065,chr4_41033074_41048139
Aqp9,9,71110659,71168682,protein_coding,-1,58023,chr9_71110659_71168682
Aqr,2,114101170,114187024,protein_coding,-1,85854,chr2_114101170_114187024
Ar,X,98148769,98323215,protein_coding,1,174446,chrX_98148769_98323215
Araf,X,20797814,20860519,protein_coding,1,62705,chrX_20797814_20860519
Arap1,7,101348067,101412586,protein_coding,1,64519,chr7_101348067_101412586
Arap2,5,62602445,62766159,protein_coding,-1,163714,chr5_62602445_62766159
Arap3,18,37972628,37998969,protein_coding,-1,26341,chr18_37972628_37998969
Arc,15,74669083,74672570,protein_coding,-1,3487,chr15_74669083_74672570
Arcn1,9,44741564,44767845,protein_coding,-1,26281,chr9_44741564_44767845
Areg,5,91139599,91148432,protein_coding,1,8833,chr5_91139599_91148432
Arel1,12,84918148,84970900,protein_coding,-1,52752,chr12_84918148_84970900
Arf1,11,59211412,59228270,protein_coding,-1,16858,chr11_59211412_59228270
Arf2,11,103966739,103985337,protein_coding,1,18598,chr11_103966739_103985337
Arf3,15,98736634,98763214,protein_coding,-1,26580,chr15_98736634_98763214
Arf4,14,26638074,26665084,protein_coding,1,27010,chr14_26638074_26665084
Arf5,6,28423560,28426602,protein_coding,1,3042,chr6_28423560_28426602
Arf6,12,69372150,69373783,protein_coding,1,1633,chr12_69372150_69373783
Arfgap1,2,180967225,180982526,protein_coding,1,15301,chr2_180967225_180982526
Arfgap2,2,91264974,91276931,protein_coding,1,11957,chr2_91264974_91276931
Arfgap3,15,83299739,83350247,protein_coding,-1,50508,chr15_83299739_83350247
Arfgef1,1,10137571,10232670,protein_coding,-1,95099,chr1_10137571_10232670
Arfgef2,2,166805588,166898052,protein_coding,1,92464,chr2_166805588_166898052
Arfip1,3,84496093,84582625,protein_coding,-1,86532,chr3_84496093_84582625
Arfip2,7,105634203,105640416,protein_coding,-1,6213,chr7_105634203_105640416
Arfrp1,2,181357690,181365404,protein_coding,-1,7714,chr2_181357690_181365404
Arg1,10,24915221,24927484,protein_coding,-1,12263,chr10_24915221_24927484
Arg2,12,79130777,79156301,protein_coding,1,25524,chr12_79130777_79156301
Arglu1,8,8665075,8690521,protein_coding,-1,25446,chr8_8665075_8690521
Arhgap1,2,91649860,91672326,protein_coding,1,22466,chr2_91649860_91672326
Arhgap10,8,77250366,77517953,protein_coding,-1,267587,chr8_77250366_77517953
Arhgap11a,2,113831492,113848661,protein_coding,-1,17169,chr2_113831492_113848661
Arhgap12,18,6024427,6136098,protein_coding,-1,111671,chr18_6024427_6136098
Arhgap15,2,43748824,44395953,protein_coding,1,647129,chr2_43748824_44395953
Arhgap15os,2,44059238,44065324,antisense,-1,6086,chr2_44059238_44065324
Arhgap17,7,123279218,123369915,protein_coding,-1,90697,chr7_123279218_123369915
Arhgap18,10,26753421,26918648,protein_coding,1,165227,chr10_26753421_26918648
Arhgap19,19,41766588,41802047,protein_coding,-1,35459,chr19_41766588_41802047
Arhgap20,9,51765337,51853856,protein_coding,1,88519,chr9_51765337_51853856
Arhgap20os,9,51832814,51875886,antisense,-1,43072,chr9_51832814_51875886
Arhgap21,2,20847919,20968881,protein_coding,-1,120962,chr2_20847919_20968881
Arhgap22,14,33214026,33369934,protein_coding,1,155908,chr14_33214026_33369934
Arhgap23,11,97415533,97502402,protein_coding,1,86869,chr11_97415533_97502402
Arhgap24,5,102481391,102897937,protein_coding,1,416546,chr5_102481391_102897937
Arhgap25,6,87458545,87533259,protein_coding,-1,74714,chr6_87458545_87533259
Arhgap26,18,38676718,39376284,protein_coding,1,699566,chr18_38676718_39376284
Arhgap27,11,103331497,103363692,protein_coding,-1,32195,chr11_103331497_103363692
Arhgap27os1,11,103363213,103364651,antisense,1,1438,chr11_103363213_103364651
Arhgap27os3,11,103344753,103350124,antisense,1,5371,chr11_103344753_103350124
Arhgap28,17,67842713,68004120,protein_coding,-1,161407,chr17_67842713_68004120
Arhgap29,3,121952541,122016753,protein_coding,1,64212,chr3_121952541_122016753
Arhgap30,1,171388954,171410298,protein_coding,1,21344,chr1_171388954_171410298
Arhgap31,16,38598340,38713274,protein_coding,-1,114934,chr16_38598340_38713274
Arhgap32,9,32116136,32268446,protein_coding,1,152310,chr9_32116136_32268446
Arhgap33,7,30522226,30535060,protein_coding,-1,12834,chr7_30522226_30535060
Arhgap33os,7,30515122,30522193,protein_coding,1,7071,chr7_30515122_30522193
Arhgap35,7,16493719,16614993,protein_coding,-1,121274,chr7_16493719_16614993
Arhgap36,X,49463945,49500244,protein_coding,1,36299,chrX_49463945_49500244
Arhgap39,15,76723985,76818170,protein_coding,-1,94185,chr15_76723985_76818170
Arhgap4,X,73891442,73921870,protein_coding,-1,30428,chrX_73891442_73921870
Arhgap40,2,158512796,158550762,protein_coding,1,37966,chr2_158512796_158550762
Arhgap42,9,8994329,9239101,protein_coding,-1,244772,chr9_8994329_9239101
Arhgap44,11,65002039,65162961,protein_coding,-1,160922,chr11_65002039_65162961
Arhgap5,12,52503972,52571975,protein_coding,1,68003,chr12_52503972_52571975
Arhgap6,X,168795099,169304435,protein_coding,1,509336,chrX_168795099_169304435
Arhgap8,15,84720052,84772207,protein_coding,1,52155,chr15_84720052_84772207
Arhgap9,10,127321964,127329943,protein_coding,1,7979,chr10_127321964_127329943
Arhgdia,11,120578104,120581624,protein_coding,-1,3520,chr11_120578104_120581624
Arhgdib,6,136923655,136941899,protein_coding,-1,18244,chr6_136923655_136941899
Arhgdig,17,26199183,26207786,protein_coding,-1,8603,chr17_26199183_26207786
Arhgef1,7,24902912,24926594,protein_coding,1,23682,chr7_24902912_24926594
Arhgef10,8,14911663,15001085,protein_coding,1,89422,chr8_14911663_15001085
Arhgef10l,4,140514485,140666012,protein_coding,-1,151527,chr4_140514485_140666012
Arhgef11,3,87617559,87738034,protein_coding,1,120475,chr3_87617559_87738034
Arhgef12,9,42963842,43107239,protein_coding,-1,143397,chr9_42963842_43107239
Arhgef15,11,68943155,68957480,protein_coding,-1,14325,chr11_68943155_68957480
Arhgef17,7,100869752,100932107,protein_coding,-1,62355,chr7_100869752_100932107
Arhgef18,8,3353415,3456601,protein_coding,1,103186,chr8_3353415_3456601
Arhgef19,4,141239499,141257564,protein_coding,1,18065,chr4_141239499_141257564
Arhgef2,3,88605966,88648052,protein_coding,1,42086,chr3_88605966_88648052
Arhgef25,10,127182525,127190083,protein_coding,-1,7558,chr10_127182525_127190083
Arhgef26,3,62338344,62462221,protein_coding,1,123877,chr3_62338344_62462221
Arhgef28,13,97899469,98206439,protein_coding,-1,306970,chr13_97899469_98206439
Arhgef3,14,27114899,27403911,protein_coding,1,289012,chr14_27114899_27403911
Arhgef33,17,80307407,80400081,protein_coding,1,92674,chr17_80307407_80400081
Arhgef37,18,61491657,61536594,protein_coding,-1,44937,chr18_61491657_61536594
Arhgef39,4,43496142,43499695,protein_coding,-1,3553,chr4_43496142_43499695
Arhgef4,1,34678188,34813309,protein_coding,1,135121,chr1_34678188_34813309
Arhgef40,14,51984719,52006251,protein_coding,1,21532,chr14_51984719_52006251
Arhgef5,6,43265582,43289320,protein_coding,1,23738,chr6_43265582_43289320
Arhgef6,X,57231485,57338729,protein_coding,-1,107244,chrX_57231485_57338729
Arhgef7,8,11727721,11835219,protein_coding,1,107498,chr8_11727721_11835219
Arhgef9,X,95048935,95196856,protein_coding,-1,147921,chrX_95048935_95196856
Arid1a,4,133679008,133756769,protein_coding,-1,77761,chr4_133679008_133756769
Arid1b,17,4994332,5347656,protein_coding,1,353324,chr17_4994332_5347656
Arid2,15,96287518,96404992,protein_coding,1,117474,chr15_96287518_96404992
Arid3a,10,79927043,79955018,protein_coding,1,27975,chr10_79927043_79955018
Arid3b,9,57790353,57836793,protein_coding,-1,46440,chr9_57790353_57836793
Arid3c,4,41723836,41731142,protein_coding,-1,7306,chr4_41723836_41731142
Arid4a,12,71015990,71098592,protein_coding,1,82602,chr12_71015990_71098592
Arid4b,13,14063232,14199603,protein_coding,1,136371,chr13_14063232_14199603
Arid5a,1,36307733,36324029,protein_coding,1,16296,chr1_36307733_36324029
Arid5b,10,68092520,68278740,protein_coding,-1,186220,chr10_68092520_68278740
Arih1,9,59388258,59486618,protein_coding,-1,98360,chr9_59388258_59486618
Arih2,9,108602942,108649386,protein_coding,-1,46444,chr9_108602942_108649386
Arl1,10,88730858,88744094,protein_coding,1,13236,chr10_88730858_88744094
Arl10,13,54575015,54581128,protein_coding,1,6113,chr13_54575015_54581128
Arl11,14,61309753,61311936,protein_coding,1,2183,chr14_61309753_61311936
Arl13a,X,134187501,134208028,protein_coding,1,20527,chrX_134187501_134208028
Arl13b,16,62793685,62847040,protein_coding,-1,53355,chr16_62793685_62847040
Arl14ep,2,106962527,106974424,protein_coding,-1,11897,chr2_106962527_106974424
Arl14epl,18,46921815,46934232,protein_coding,1,12417,chr18_46921815_46934232
Arl15,13,113794505,114157461,protein_coding,1,362956,chr13_113794505_114157461
Arl16,11,120464866,120467607,protein_coding,-1,2741,chr11_120464866_120467607
Arl2,19,6134374,6141548,protein_coding,-1,7174,chr19_6134374_6141548
Arl2bp,8,94666600,94674425,protein_coding,1,7825,chr8_94666600_94674425
Arl3,19,46531096,46573198,protein_coding,-1,42102,chr19_46531096_46573198
Arl4a,12,40005447,40038025,protein_coding,-1,32578,chr12_40005447_40038025
Arl4aos,12,40038099,40040027,antisense,1,1928,chr12_40038099_40040027
Arl4c,1,88673125,88702221,protein_coding,-1,29096,chr1_88673125_88702221
Arl4d,11,101665541,101667832,protein_coding,1,2291,chr11_101665541_101667832
Arl5a,2,52397951,52424901,protein_coding,-1,26950,chr2_52397951_52424901
Arl5b,2,15049395,15082456,protein_coding,1,33061,chr2_15049395_15082456
Arl5c,11,97989578,97996181,protein_coding,-1,6603,chr11_97989578_97996181
Arl6,16,59612949,59639391,protein_coding,-1,26442,chr16_59612949_59639391
Arl6ip1,7,118118891,118129662,protein_coding,-1,10771,chr7_118118891_118129662
Arl6ip4,5,124116089,124118196,protein_coding,1,2107,chr5_124116089_124118196
Arl6ip5,6,97210689,97233315,protein_coding,1,22626,chr6_97210689_97233315
Arl6ip6,2,53191726,53219220,protein_coding,1,27494,chr2_53191726_53219220
Arl8a,1,135146824,135156269,protein_coding,1,9445,chr1_135146824_135156269
Arl8b,6,108783099,108825278,protein_coding,1,42179,chr6_108783099_108825278
Arl9,5,77004055,77010606,protein_coding,1,6551,chr5_77004055_77010606
Armc1,3,19131402,19163065,protein_coding,-1,31663,chr3_19131402_19163065
Armc10,5,21645813,21662694,protein_coding,1,16881,chr5_21645813_21662694
Armc12,17,28530806,28539110,protein_coding,1,8304,chr17_28530806_28539110
Armc2,10,41914990,42018442,protein_coding,-1,103452,chr10_41914990_42018442
Armc3,2,19199302,19310241,protein_coding,1,110939,chr2_19199302_19310241
Armc4,18,7088209,7297936,protein_coding,-1,209727,chr18_7088209_7297936
Armc5,7,128237342,128245100,protein_coding,1,7758,chr7_128237342_128245100
Armc6,8,70220172,70234466,protein_coding,-1,14294,chr8_70220172_70234466
Armc7,11,115475667,115490467,protein_coding,1,14800,chr11_115475667_115490467
Armc8,9,99478372,99568899,protein_coding,-1,90527,chr9_99478372_99568899
Armc9,1,86154780,86278284,protein_coding,1,123504,chr1_86154780_86278284
Armcx1,X,134717963,134721917,protein_coding,1,3954,chrX_134717963_134721917
Armcx2,X,134804145,134809221,protein_coding,-1,5076,chrX_134804145_134809221
Armcx3,X,134756595,134761455,protein_coding,1,4860,chrX_134756595_134761455
Armcx4,X,134686519,134696757,protein_coding,1,10238,chrX_134686519_134696757
Armcx5,X,135742733,135747322,protein_coding,1,4589,chrX_135742733_135747322
Armcx6,X,134748461,134751417,protein_coding,-1,2956,chrX_134748461_134751417
Arnt,3,95434388,95497240,protein_coding,1,62852,chr3_95434388_95497240
Arnt2,7,84246278,84410176,protein_coding,-1,163898,chr7_84246278_84410176
Arntl,7,113207465,113314126,protein_coding,1,106661,chr7_113207465_113314126
Arntl2,6,146796055,146833529,protein_coding,1,37474,chr6_146796055_146833529
Arpc1a,5,145083830,145108761,protein_coding,1,24931,chr5_145083830_145108761
Arpc1b,5,145114215,145130705,protein_coding,1,16490,chr5_145114215_145130705
Arpc2,1,74236084,74268209,protein_coding,1,32125,chr1_74236084_74268209
Arpc3,5,122391878,122414184,protein_coding,1,22306,chr5_122391878_122414184
Arpc4,6,113378115,113390448,protein_coding,1,12333,chr6_113378115_113390448
Arpc5,1,152766542,152775597,protein_coding,1,9055,chr1_152766542_152775597
Arpc5l,2,39005348,39015877,protein_coding,1,10529,chr2_39005348_39015877
Arpp19,9,75037614,75060313,protein_coding,1,22699,chr9_75037614_75060313
Arpp21,9,112065091,112235938,protein_coding,-1,170847,chr9_112065091_112235938
Arr3,X,100605497,100618493,protein_coding,1,12996,chrX_100605497_100618493
Arrb1,7,99535466,99606771,protein_coding,1,71305,chr7_99535466_99606771
Arrb2,11,70432635,70440828,protein_coding,1,8193,chr11_70432635_70440828
Arrdc1,2,24925352,24935252,protein_coding,-1,9900,chr2_24925352_24935252
Arrdc2,8,70835124,70839720,protein_coding,-1,4596,chr8_70835124_70839720
Arrdc3,13,80883384,80896042,protein_coding,1,12658,chr13_80883384_80896042
Arrdc4,7,68736995,68749241,protein_coding,-1,12246,chr7_68736995_68749241
Arrdc5,17,56294111,56300286,protein_coding,-1,6175,chr17_56294111_56300286
Arsa,15,89472476,89477425,protein_coding,-1,4949,chr15_89472476_89477425
Arsb,13,93771630,93943016,protein_coding,1,171386,chr13_93771630_93943016
Arsg,11,109473374,109573330,protein_coding,1,99956,chr11_109473374_109573330
Arsi,18,60911780,60918561,protein_coding,1,6781,chr18_60911780_60918561
Arsj,3,126363684,126440375,protein_coding,1,76691,chr3_126363684_126440375
Arsk,13,76060422,76098660,protein_coding,-1,38238,chr13_76060422_76098660
Art1,7,102101743,102113933,protein_coding,1,12190,chr7_102101743_102113933
Art3,5,92331827,92414628,protein_coding,1,82801,chr5_92331827_92414628
Art4,6,136848451,136857733,protein_coding,-1,9282,chr6_136848451_136857733
Art5,7,102096879,102109489,protein_coding,-1,12610,chr7_102096879_102109489
Artn,4,117926162,117929763,protein_coding,-1,3601,chr4_117926162_117929763
Arv1,8,124722139,124734123,protein_coding,1,11984,chr8_124722139_124734123
Arvcf,16,18348182,18407958,protein_coding,1,59776,chr16_18348182_18407958
Arx,X,93286445,93298357,protein_coding,1,11912,chrX_93286445_93298357
Arxes1,X,136033367,136034946,protein_coding,1,1579,chrX_136033367_136034946
Arxes2,X,135993824,135995355,protein_coding,1,1531,chrX_135993824_135995355
As3mt,19,46707458,46741099,protein_coding,1,33641,chr19_46707458_46741099
Asah1,8,41340197,41374773,protein_coding,-1,34576,chr8_41340197_41374773
Asah2,19,31982597,32108211,protein_coding,-1,125614,chr19_31982597_32108211
Asap1,15,64086857,64382919,protein_coding,-1,296062,chr15_64086857_64382919
Asap2,12,20990459,21270171,protein_coding,1,279712,chr12_20990459_21270171
Asap3,4,136206365,136245216,protein_coding,1,38851,chr4_136206365_136245216
Asb1,1,91540544,91559589,protein_coding,1,19045,chr1_91540544_91559589
Asb11,X,164436994,164459170,protein_coding,1,22176,chrX_164436994_164459170
Asb12,X,95470201,95557987,protein_coding,-1,87786,chrX_95470201_95557987
Asb13,13,3634032,3653822,protein_coding,1,19790,chr13_3634032_3653822
Asb14,14,26894557,26916060,protein_coding,1,21503,chr14_26894557_26916060
Asb15,6,24528144,24573164,protein_coding,1,45020,chr6_24528144_24573164
Asb16,11,102268743,102279462,protein_coding,1,10719,chr11_102268743_102279462
Asb17,3,153844209,153855082,protein_coding,1,10873,chr3_153844209_153855082
Asb17os,3,153836902,153852424,antisense,-1,15522,chr3_153836902_153852424
Asb18,1,89950220,90014666,protein_coding,-1,64446,chr1_89950220_90014666
Asb2,12,103321142,103356001,protein_coding,-1,34859,chr12_103321142_103356001
Asb3,11,30885416,31102704,protein_coding,1,217288,chr11_30885416_31102704
Asb4,6,5383386,5433022,protein_coding,1,49636,chr6_5383386_5433022
Asb5,8,54529580,54587875,protein_coding,1,58295,chr8_54529580_54587875
Asb6,2,30823097,30830333,protein_coding,-1,7236,chr2_30823097_30830333
Asb7,7,66644565,66689596,protein_coding,-1,45031,chr7_66644565_66689596
Asb8,15,98134637,98165625,protein_coding,-1,30988,chr15_98134637_98165625
Asb9,X,164506327,164539752,protein_coding,1,33425,chrX_164506327_164539752
Ascc1,10,60002805,60099988,protein_coding,1,97183,chr10_60002805_60099988
Ascc2,11,4637747,4685699,protein_coding,1,47952,chr11_4637747_4685699
Ascc3,10,50592669,50851485,protein_coding,1,258816,chr10_50592669_50851485
Ascl1,10,87490819,87493660,protein_coding,-1,2841,chr10_87490819_87493660
Ascl2,7,142966829,142969264,protein_coding,-1,2435,chr7_142966829_142969264
Ascl3,7,109727465,109731726,protein_coding,-1,4261,chr7_109727465_109731726
Ascl4,10,85927681,85946206,protein_coding,1,18525,chr10_85927681_85946206
Ascl5,1,136050804,136051370,protein_coding,1,566,chr1_136050804_136051370
Asf1a,10,53596757,53609225,protein_coding,1,12468,chr10_53596757_53609225
Asf1b,8,83955507,83970197,protein_coding,1,14690,chr8_83955507_83970197
Asgr1,11,70054085,70057894,protein_coding,1,3809,chr11_70054085_70057894
Ash1l,3,88950622,89079375,protein_coding,1,128753,chr3_88950622_89079375
Ash2l,8,25815996,25847694,protein_coding,-1,31698,chr8_25815996_25847694
Asic1,15,99670368,99701130,protein_coding,1,30762,chr15_99670368_99701130
Asic2,11,80880169,81968457,protein_coding,-1,1088288,chr11_80880169_81968457
Asic3,5,24413392,24417835,protein_coding,1,4443,chr5_24413392_24417835
Asic4,1,75450436,75474343,protein_coding,1,23907,chr1_75450436_75474343
Asl,5,130011258,130029247,protein_coding,-1,17989,chr5_130011258_130029247
Asmt,X,170672644,170678054,protein_coding,1,5410,chrX_170672644_170678054
Asna1,8,85017931,85025281,protein_coding,-1,7350,chr8_85017931_85025281
Asns,6,7675169,7693254,protein_coding,-1,18085,chr6_7675169_7693254
Asnsd1,1,53344617,53352752,protein_coding,-1,8135,chr1_53344617_53352752
Aspa,11,73304992,73329596,protein_coding,-1,24604,chr11_73304992_73329596
Aspdh,7,44465391,44467758,protein_coding,1,2367,chr7_44465391_44467758
Aspg,12,112106679,112127559,protein_coding,1,20880,chr12_112106679_112127559
Asph,4,9448069,9669344,protein_coding,-1,221275,chr4_9448069_9669344
Asphd1,7,126945567,126949582,protein_coding,-1,4015,chr7_126945567_126949582
Asphd2,5,112384354,112394866,protein_coding,-1,10512,chr5_112384354_112394866
Aspm,1,139454772,139494091,protein_coding,1,39319,chr1_139454772_139494091
Aspn,13,49544443,49567565,protein_coding,1,23122,chr13_49544443_49567565
Asprv1,6,86628164,86629710,protein_coding,1,1546,chr6_86628164_86629710
Aspscr1,11,120672973,120709447,protein_coding,1,36474,chr11_120672973_120709447
Asrgl1,19,9109868,9135636,protein_coding,-1,25768,chr19_9109868_9135636
Ass1,2,31470207,31520672,protein_coding,1,50465,chr2_31470207_31520672
Aste1,9,105395392,105412229,protein_coding,1,16837,chr9_105395392_105412229
Astn1,1,158362273,158691781,protein_coding,1,329508,chr1_158362273_158691781
Astn2,4,65380803,66404611,protein_coding,-1,1023808,chr4_65380803_66404611
Asxl1,2,153345829,153404007,protein_coding,1,58178,chr2_153345829_153404007
Asxl2,12,3426857,3506852,protein_coding,1,79995,chr12_3426857_3506852
Asxl3,18,22344246,22530227,protein_coding,1,185981,chr18_22344246_22530227
Asz1,6,18050964,18109061,protein_coding,-1,58097,chr6_18050964_18109061
Atad1,19,32671638,32739786,protein_coding,-1,68148,chr19_32671638_32739786
Atad2,15,58094044,58135082,protein_coding,-1,41038,chr15_58094044_58135082
Atad2b,12,4917353,5047394,protein_coding,1,130041,chr12_4917353_5047394
Atad3a,4,155740641,155761093,protein_coding,-1,20452,chr4_155740641_155761093
Atad3aos,4,155761178,155769264,antisense,1,8086,chr4_155761178_155769264
Atad5,11,80089400,80135794,protein_coding,1,46394,chr11_80089400_80135794
Atat1,17,35897595,35910075,protein_coding,-1,12480,chr17_35897595_35910075
Atcay,10,81204508,81230833,protein_coding,-1,26325,chr10_81204508_81230833
Atcayos,10,81194609,81210877,antisense,1,16268,chr10_81194609_81210877
Ate1,7,130391493,130520369,protein_coding,-1,128876,chr7_130391493_130520369
Atf1,15,100227819,100261244,protein_coding,1,33425,chr15_100227819_100261244
Atf2,2,73816509,73892639,protein_coding,-1,76130,chr2_73816509_73892639
Atf3,1,191170296,191218039,protein_coding,-1,47743,chr1_191170296_191218039
Atf4,15,80255184,80257541,protein_coding,1,2357,chr15_80255184_80257541
Atf5,7,44812256,44816658,protein_coding,-1,4402,chr7_44812256_44816658
Atf6,1,170704674,170867771,protein_coding,-1,163097,chr1_170704674_170867771
Atf6b,17,34647146,34655074,protein_coding,1,7928,chr17_34647146_34655074
Atf7,15,102525946,102625464,protein_coding,-1,99518,chr15_102525946_102625464
Atf7ip,6,136506167,136610862,protein_coding,1,104695,chr6_136506167_136610862
Atf7ip2,16,10192712,10251478,protein_coding,1,58766,chr16_10192712_10251478
Atg10,13,90935356,91223968,protein_coding,-1,288612,chr13_90935356_91223968
Atg101,15,101284272,101290945,protein_coding,1,6673,chr15_101284272_101290945
Atg12,18,46730144,46741580,protein_coding,-1,11436,chr18_46730144_46741580
Atg13,2,91674618,91710576,protein_coding,-1,35958,chr2_91674618_91710576
Atg14,14,47540893,47570649,protein_coding,-1,29756,chr14_47540893_47570649
Atg16l1,1,87755870,87792428,protein_coding,1,36558,chr1_87755870_87792428
Atg16l2,7,101263034,101302251,protein_coding,-1,39217,chr7_101263034_101302251
Atg2a,19,6241668,6262335,protein_coding,1,20667,chr19_6241668_6262335
Atg2b,12,105616136,105685211,protein_coding,-1,69075,chr12_105616136_105685211
Atg3,16,45158785,45188538,protein_coding,1,29753,chr16_45158785_45188538
Atg4a,X,140956907,141164270,protein_coding,1,207363,chrX_140956907_141164270
Atg4a-ps,3,103643954,103646068,protein_coding,-1,2114,chr3_103643954_103646068
Atg4b,1,93751500,93790610,protein_coding,1,39110,chr1_93751500_93790610
Atg4c,4,99193934,99259787,protein_coding,1,65853,chr4_99193934_99259787
Atg4d,9,21265293,21277772,protein_coding,1,12479,chr9_21265293_21277772
Atg5,10,44268358,44364291,protein_coding,1,95933,chr10_44268358_44364291
Atg7,6,114643097,114860614,protein_coding,1,217517,chr6_114643097_114860614
Atg9a,1,75180860,75192196,protein_coding,-1,11336,chr1_75180860_75192196
Atg9b,5,24384181,24392143,protein_coding,-1,7962,chr5_24384181_24392143
Atic,1,71557150,71579631,protein_coding,1,22481,chr1_71557150_71579631
Atl1,12,69892614,69966417,protein_coding,1,73803,chr12_69892614_69966417
Atl2,17,79848390,79896123,protein_coding,-1,47733,chr17_79848390_79896123
Atl3,19,7494040,7539674,protein_coding,1,45634,chr19_7494040_7539674
Atm,9,53439149,53536740,protein_coding,-1,97591,chr9_53439149_53536740
Atmin,8,116943393,116960445,protein_coding,1,17052,chr8_116943393_116960445
Atn1,6,124742544,124756524,protein_coding,-1,13980,chr6_124742544_124756524
Atoh7,10,63099651,63101279,protein_coding,1,1628,chr10_63099651_63101279
Atoh8,6,72206177,72235577,protein_coding,-1,29400,chr6_72206177_72235577
Atox1,11,55446641,55461239,protein_coding,-1,14598,chr11_55446641_55461239
Atp10a,7,58656166,58829420,protein_coding,1,173254,chr7_58656166_58829420
Atp10b,11,43149877,43262285,protein_coding,1,112408,chr11_43149877_43262285
Atp10d,5,72203329,72298775,polymorphic_pseudogene,1,95446,chr5_72203329_72298775
Atp11a,8,12757014,12868728,protein_coding,1,111714,chr8_12757014_12868728
Atp11b,3,35754106,35856276,protein_coding,1,102170,chr3_35754106_35856276
Atp11c,X,60223290,60592698,protein_coding,-1,369408,chrX_60223290_60592698
Atp12a,14,56365068,56388550,protein_coding,1,23482,chr14_56365068_56388550
Atp13a1,8,69791163,69807749,protein_coding,1,16586,chr8_69791163_69807749
Atp13a2,4,140986873,141007330,protein_coding,1,20457,chr4_140986873_141007330
Atp13a3,16,30312423,30405975,protein_coding,-1,93552,chr16_30312423_30405975
Atp13a4,16,29395853,29544864,protein_coding,-1,149011,chr16_29395853_29544864
Atp13a5,16,29231851,29378732,protein_coding,-1,146881,chr16_29231851_29378732
Atp1a1,3,101576219,101604684,protein_coding,-1,28465,chr3_101576219_101604684
Atp1a2,1,172271709,172298064,protein_coding,-1,26355,chr1_172271709_172298064
Atp1a3,7,24978167,25005958,protein_coding,-1,27791,chr7_24978167_25005958
Atp1a4,1,172223513,172258414,protein_coding,-1,34901,chr1_172223513_172258414
Atp1b1,1,164437109,164458355,protein_coding,-1,21246,chr1_164437109_164458355
Atp1b2,11,69599736,69605942,protein_coding,-1,6206,chr11_69599736_69605942
Atp1b3,9,96332655,96364442,protein_coding,-1,31787,chr9_96332655_96364442
Atp1b4,X,38316184,38336769,protein_coding,1,20585,chrX_38316184_38336769
Atp2a1,7,126445858,126463108,protein_coding,-1,17250,chr7_126445858_126463108
Atp2a2,5,122453513,122502225,protein_coding,-1,48712,chr5_122453513_122502225
Atp2a3,11,72961169,72993044,protein_coding,1,31875,chr11_72961169_72993044
Atp2b1,10,98914406,99026143,protein_coding,1,111737,chr10_98914406_99026143
Atp2b2,6,113743831,114042613,protein_coding,-1,298782,chr6_113743831_114042613
Atp2b3,X,73503086,73571005,protein_coding,1,67919,chrX_73503086_73571005
Atp2b4,1,133699457,133801041,protein_coding,-1,101584,chr1_133699457_133801041
Atp2c1,9,105403539,105527319,protein_coding,-1,123780,chr9_105403539_105527319
Atp2c2,8,119700009,119757717,protein_coding,1,57708,chr8_119700009_119757717
Atp4a,7,30712209,30725534,protein_coding,1,13325,chr7_30712209_30725534
Atp5a1,18,77773729,77782869,protein_coding,1,9140,chr18_77773729_77782869
Atp5b,10,128083273,128090391,protein_coding,1,7118,chr10_128083273_128090391
Atp5c1,2,10056016,10080510,protein_coding,-1,24494,chr2_10056016_10080510
Atp5c1-ps,13,77669087,77670475,processed_pseudogene,-1,1388,chr13_77669087_77670475
Atp5d,10,80138632,80145818,protein_coding,1,7186,chr10_80138632_80145818
Atp5e,2,174461072,174464105,protein_coding,-1,3033,chr2_174461072_174464105
Atp5g1,11,96068852,96075670,protein_coding,-1,6818,chr11_96068852_96075670
Atp5g2,15,102662864,102672352,protein_coding,-1,9488,chr15_102662864_102672352
Atp5g3,2,73908447,73911326,protein_coding,-1,2879,chr2_73908447_73911326
Atp5h,11,115415689,115419962,protein_coding,-1,4273,chr11_115415689_115419962
Atp5j,16,84827866,84835625,protein_coding,-1,7759,chr16_84827866_84835625
Atp5j2,5,145183698,145192062,protein_coding,-1,8364,chr5_145183698_145192062
Atp5k,5,108433244,108434448,protein_coding,-1,1204,chr5_108433244_108434448
Atp5k-ps2,2,173984482,173984691,processed_pseudogene,-1,209,chr2_173984482_173984691
Atp5l,9,44912557,44920742,protein_coding,-1,8185,chr9_44912557_44920742
Atp5l-ps1,7,62476306,62476617,processed_pseudogene,1,311,chr7_62476306_62476617
Atp5l-ps2,11,86185329,86185642,processed_pseudogene,1,313,chr11_86185329_86185642
Atp5l2-ps,11,97768060,97768371,processed_pseudogene,1,311,chr11_97768060_97768371
Atp5o,16,91684398,91931687,protein_coding,-1,247289,chr16_91684398_91931687
Atp6ap1,X,74297097,74304721,protein_coding,1,7624,chrX_74297097_74304721
Atp6ap1l,13,90883433,90905355,protein_coding,-1,21922,chr13_90883433_90905355
Atp6ap2,X,12587801,12617049,protein_coding,1,29248,chrX_12587801_12617049
Atp6v0a1,11,101009452,101063719,protein_coding,1,54267,chr11_101009452_101063719
Atp6v0a2,5,124628576,124724455,protein_coding,1,95879,chr5_124628576_124724455
Atp6v0a4,6,38048483,38124586,protein_coding,-1,76103,chr6_38048483_38124586
Atp6v0b,4,117884326,117887333,protein_coding,-1,3007,chr4_117884326_117887333
Atp6v0c,17,24163866,24169702,protein_coding,-1,5836,chr17_24163866_24169702
Atp6v0c-ps1,7,4412438,4412900,processed_pseudogene,1,462,chr7_4412438_4412900
Atp6v0c-ps2,6,37806086,37806550,processed_pseudogene,1,464,chr6_37806086_37806550
Atp6v0d1,8,105524465,105566047,protein_coding,-1,41582,chr8_105524465_105566047
Atp6v0d2,4,19876841,19922605,protein_coding,-1,45764,chr4_19876841_19922605
Atp6v0e,17,26663231,26699647,protein_coding,1,36416,chr17_26663231_26699647
Atp6v0e2,6,48537615,48541801,protein_coding,1,4186,chr6_48537615_48541801
Atp6v1a,16,44085402,44139705,protein_coding,-1,54303,chr16_44085402_44139705
Atp6v1b1,6,83742990,83758855,protein_coding,1,15865,chr6_83742990_83758855
Atp6v1b2,8,69088646,69113711,protein_coding,1,25065,chr8_69088646_69113711
Atp6v1c1,15,38661933,38692446,protein_coding,1,30513,chr15_38661933_38692446
Atp6v1c2,12,17284721,17329359,protein_coding,-1,44638,chr12_17284721_17329359
Atp6v1d,12,78840725,78861638,protein_coding,-1,20913,chr12_78840725_78861638
Atp6v1e1,6,120794305,120822793,protein_coding,-1,28488,chr6_120794305_120822793
Atp6v1f,6,29467718,29470512,protein_coding,1,2794,chr6_29467718_29470512
Atp6v1g1,4,63544772,63550750,protein_coding,1,5978,chr4_63544772_63550750
Atp6v1g2,17,35233660,35238767,protein_coding,1,5107,chr17_35233660_35238767
Atp6v1h,1,5070018,5162529,protein_coding,1,92511,chr1_5070018_5162529
Atp7a,X,106027276,106124926,protein_coding,1,97650,chrX_106027276_106124926
Atp7b,8,21992785,22060305,protein_coding,-1,67520,chr8_21992785_22060305
Atp8a1,5,67618140,67847434,protein_coding,-1,229294,chr5_67618140_67847434
Atp8a2,14,59638540,60197179,protein_coding,-1,558639,chr14_59638540_60197179
Atp8b1,18,64528967,64661267,protein_coding,-1,132300,chr18_64528967_64661267
Atp8b2,3,89939481,89963508,protein_coding,-1,24027,chr3_89939481_89963508
Atp8b3,10,80519584,80539124,protein_coding,-1,19540,chr10_80519584_80539124
Atp8b4,2,126320973,126500674,protein_coding,-1,179701,chr2_126320973_126500674
Atp8b5,4,43267159,43373833,protein_coding,1,106674,chr4_43267159_43373833
Atp9a,2,168634438,168742409,protein_coding,-1,107971,chr2_168634438_168742409
Atp9b,18,80734141,80934060,protein_coding,-1,199919,chr18_80734141_80934060
Atpaf1,4,115784812,115822655,protein_coding,1,37843,chr4_115784812_115822655
Atpaf2,11,60400626,60418457,protein_coding,-1,17831,chr11_60400626_60418457
Atpif1,4,132530555,132533659,protein_coding,-1,3104,chr4_132530555_132533659
Atr,9,95857597,95951781,protein_coding,1,94184,chr9_95857597_95951781
Atraid,5,31048312,31054623,protein_coding,1,6311,chr5_31048312_31054623
Atrip,9,109057933,109074124,protein_coding,-1,16191,chr9_109057933_109074124
Atrn,2,130906495,131030333,protein_coding,1,123838,chr2_130906495_131030333
Atrnl1,19,57611034,58133343,protein_coding,1,522309,chr19_57611034_58133343
Atrx,X,105797615,105929403,protein_coding,-1,131788,chrX_105797615_105929403
Atxn1,13,45549755,45965008,protein_coding,-1,415253,chr13_45549755_45965008
Atxn10,15,85336245,85463212,protein_coding,1,126967,chr15_85336245_85463212
Atxn1l,8,109726451,109737739,protein_coding,-1,11288,chr8_109726451_109737739
Atxn2,5,121711337,121816493,protein_coding,1,105156,chr5_121711337_121816493
Atxn2l,7,126491708,126503437,protein_coding,-1,11729,chr7_126491708_126503437
Atxn3,12,101918901,101958246,protein_coding,-1,39345,chr12_101918901_101958246
Atxn7,14,13961440,14107302,protein_coding,1,145862,chr14_13961440_14107302
Atxn7l1,12,33147693,33373185,protein_coding,1,225492,chr12_33147693_33373185
Atxn7l1os2,12,33358243,33394760,antisense,-1,36517,chr12_33358243_33394760
Atxn7l2,3,108202222,108210934,protein_coding,-1,8712,chr3_108202222_108210934
Atxn7l3,11,102289300,102296631,protein_coding,-1,7331,chr11_102289300_102296631
Atxn7l3b,10,112925430,112929001,protein_coding,-1,3571,chr10_112925430_112929001
Auh,13,52835119,52929681,protein_coding,-1,94562,chr13_52835119_52929681
Aunip,4,134510999,134523927,protein_coding,1,12928,chr4_134510999_134523927
Aup1,6,83054521,83057808,protein_coding,1,3287,chr6_83054521_83057808
Aurka,2,172356190,172370535,protein_coding,-1,14345,chr2_172356190_172370535
Aurkaip1,4,155831272,155833130,protein_coding,1,1858,chr4_155831272_155833130
Aurkb,11,69045647,69051664,protein_coding,1,6017,chr11_69045647_69051664
Aurkc,7,6995300,7003091,protein_coding,1,7791,chr7_6995300_7003091
Auts2,5,131437333,132543344,protein_coding,-1,1106011,chr5_131437333_132543344
Aven,2,112492964,112634573,protein_coding,1,141609,chr2_112492964_112634573
Avil,10,127000709,127020994,protein_coding,1,20285,chr10_127000709_127020994
Avl9,6,56714899,56761912,protein_coding,1,47013,chr6_56714899_56761912
Avp,2,130580620,130582554,protein_coding,-1,1934,chr2_130580620_130582554
Avpi1,19,42123273,42129059,protein_coding,-1,5786,chr19_42123273_42129059
Avpr1a,10,122448499,122453452,protein_coding,1,4953,chr10_122448499_122453452
Avpr1b,1,131599239,131612000,protein_coding,1,12761,chr1_131599239_131612000
Avpr2,X,73892102,73895502,protein_coding,1,3400,chrX_73892102_73895502
Awat2,X,100402221,100442717,protein_coding,-1,40496,chrX_100402221_100442717
Axdnd1,1,156323509,156421159,protein_coding,-1,97650,chr1_156323509_156421159
Axin1,17,26138688,26195811,protein_coding,1,57123,chr17_26138688_26195811
Axin2,11,108920349,108950783,protein_coding,1,30434,chr11_108920349_108950783
Axl,7,25757273,25788705,protein_coding,-1,31432,chr7_25757273_25788705
Aym1,5,113357294,113357821,protein_coding,1,527,chr5_113357294_113357821
Azi2,9,118040499,118069794,protein_coding,1,29295,chr9_118040499_118069794
Azin1,15,38487427,38519266,protein_coding,-1,31839,chr15_38487427_38519266
Azin2,4,128930233,128962442,protein_coding,-1,32209,chr4_128930233_128962442
B020004J07Rik,4,101834969,101844023,protein_coding,-1,9054,chr4_101834969_101844023
B020011L13Rik,1,117781133,117803359,protein_coding,1,22226,chr1_117781133_117803359
B020018J22Rik,12,112428284,112435338,lincRNA,-1,7054,chr12_112428284_112435338
B130024G19Rik,7,70364910,70489972,processed_transcript,1,125062,chr7_70364910_70489972
B130034C11Rik,16,87495999,87504033,processed_transcript,1,8034,chr16_87495999_87504033
B130055M24Rik,7,127448636,127460360,processed_transcript,1,11724,chr7_127448636_127460360
B230110C06Rik,14,15437623,15452445,processed_transcript,1,14822,chr14_15437623_15452445
B230110G15Rik,6,138580624,138599314,antisense,1,18690,chr6_138580624_138599314
B230112J18Rik,5,116312360,116318281,lincRNA,1,5921,chr5_116312360_116318281
B230118H07Rik,2,101560781,101649532,protein_coding,-1,88751,chr2_101560781_101649532
B230119M05Rik,X,134684562,134686462,processed_transcript,-1,1900,chrX_134684562_134686462
B230206H07Rik,7,141359141,141365110,processed_transcript,-1,5969,chr7_141359141_141365110
B230206L02Rik,11,94133485,94155776,processed_transcript,1,22291,chr11_94133485_94155776
B230208H11Rik,10,12916648,12923090,lincRNA,-1,6442,chr10_12916648_12923090
B230209E15Rik,7,61529871,61615327,lincRNA,-1,85456,chr7_61529871_61615327
B230216N24Rik,1,98031116,98057680,processed_transcript,-1,26564,chr1_98031116_98057680
B230217C12Rik,11,97840780,97844099,protein_coding,1,3319,chr11_97840780_97844099
B230217O12Rik,19,57323193,57360775,processed_transcript,-1,37582,chr19_57323193_57360775
B230219D22Rik,13,55693124,55703500,protein_coding,1,10376,chr13_55693124_55703500
B230311B06Rik,7,118592328,118596838,lincRNA,1,4510,chr7_118592328_118596838
B230312C02Rik,2,180370491,180385885,lincRNA,-1,15394,chr2_180370491_180385885
B230317F23Rik,8,60983437,60985908,lincRNA,1,2471,chr8_60983437_60985908
B230319C09Rik,6,83441755,83448322,processed_transcript,1,6567,chr6_83441755_83448322
B230369F24Rik,CHR_MG4281_PATCH,178313327,178318549,antisense;lncRNA,-1,5222,chrCHR_MG4281_PATCH_178313327_178318549
B230398E01Rik,3,94959034,94962048,antisense,-1,3014,chr3_94959034_94962048
B2m,2,122147686,122153083,protein_coding,1,5397,chr2_122147686_122153083
B330016D10Rik,4,141546189,141547892,pseudogene,1,1703,chr4_141546189_141547892
B3galnt1,3,69574158,69598960,protein_coding,-1,24802,chr3_69574158_69598960
B3galnt2,13,13954469,13999103,protein_coding,1,44634,chr13_13954469_13999103
B3galt1,2,67565871,68122689,protein_coding,1,556818,chr2_67565871_68122689
B3galt2,1,143640664,143654614,protein_coding,1,13950,chr1_143640664_143654614
B3galt4,17,33949909,33951488,protein_coding,-1,1579,chr17_33949909_33951488
B3galt5,16,96235801,96319859,protein_coding,1,84058,chr16_96235801_96319859
B3galt6,4,155989466,155992649,protein_coding,-1,3183,chr4_155989466_155992649
B3gat1,9,26733728,26763101,protein_coding,1,29373,chr9_26733728_26763101
B3gat2,1,23761753,23849158,protein_coding,1,87405,chr1_23761753_23849158
B3gat3,19,8920374,8927236,protein_coding,1,6862,chr19_8920374_8927236
B3glct,5,149678230,149762599,protein_coding,1,84369,chr5_149678230_149762599
B3gnt2,11,22759738,22860961,protein_coding,-1,101223,chr11_22759738_22860961
B3gnt3,8,71690756,71701789,protein_coding,-1,11033,chr8_71690756_71701789
B3gnt4,5,123510460,123511882,protein_coding,1,1422,chr5_123510460_123511882
B3gnt5,16,19760208,19772753,protein_coding,1,12545,chr16_19760208_19772753
B3gnt6,7,98192417,98199481,protein_coding,-1,7064,chr7_98192417_98199481
B3gnt7,1,86302832,86307305,protein_coding,1,4473,chr1_86302832_86307305
B3gnt8,7,25626654,25635100,protein_coding,1,8446,chr7_25626654_25635100
B3gnt9,8,105252638,105255153,protein_coding,-1,2515,chr8_105252638_105255153
B3gntl1,11,121616197,121673153,protein_coding,-1,56956,chr11_121616197_121673153
B430010I23Rik,8,41017468,41024216,antisense,1,6748,chr8_41017468_41024216
B430212C06Rik,18,67321209,67344103,processed_transcript,-1,22894,chr18_67321209_67344103
B430306N03Rik,17,48312244,48327024,protein_coding,1,14780,chr17_48312244_48327024
B4galnt1,10,127165225,127172330,protein_coding,1,7105,chr10_127165225_127172330
B4galnt2,11,95865943,95914891,protein_coding,-1,48948,chr11_95865943_95914891
B4galnt3,6,120203073,120294559,protein_coding,-1,91486,chr6_120203073_120294559
B4galnt4,7,141061104,141072400,protein_coding,1,11296,chr7_141061104_141072400
B4galt1,4,40804602,40854005,protein_coding,-1,49403,chr4_40804602_40854005
B4galt2,4,117869260,117883487,protein_coding,-1,14227,chr4_117869260_117883487
B4galt3,1,171270328,171276896,protein_coding,1,6568,chr1_171270328_171276896
B4galt4,16,38742264,38769049,protein_coding,1,26785,chr16_38742264_38769049
B4galt5,2,167298444,167349183,protein_coding,-1,50739,chr2_167298444_167349183
B4galt6,18,20684599,20746404,protein_coding,-1,61805,chr18_20684599_20746404
B4galt7,13,55599896,55610443,protein_coding,1,10547,chr13_55599896_55610443
B4gat1,19,5038826,5041131,protein_coding,1,2305,chr19_5038826_5041131
B630019K06Rik,X,8892382,8894964,protein_coding,1,2582,chrX_8892382_8894964
B830017H08Rik,16,17833121,17835008,protein_coding,1,1887,chr16_17833121_17835008
B930018H19Rik,8,34589420,34640316,lincRNA,-1,50896,chr8_34589420_34640316
B930025P03Rik,8,10870422,10882454,lincRNA,-1,12032,chr8_10870422_10882454
B930059L03Rik,12,110590512,110592700,lincRNA,1,2188,chr12_110590512_110592700
B930095G15Rik,14,121248706,121253971,sense_intronic,1,5265,chr14_121248706_121253971
B9d1,11,61505144,61512931,protein_coding,1,7787,chr11_61505144_61512931
B9d1os,11,61504386,61505059,antisense,-1,673,chr11_61504386_61505059
B9d2,7,25680780,25686558,protein_coding,1,5778,chr7_25680780_25686558
BB019430,10,58696745,58704279,lincRNA,1,7534,chr10_58696745_58704279
BB031773,4,103004106,103011965,antisense,-1,7859,chr4_103004106_103011965
BB557941,2,57127479,57181754,processed_transcript,-1,54275,chr2_57127479_57181754
BC002059,17,16951539,16974157,lincRNA,1,22618,chr17_16951539_16974157
BC003965,17,25184554,25187662,protein_coding,1,3108,chr17_25184554_25187662
BC004004,17,29268788,29314065,protein_coding,1,45277,chr17_29268788_29314065
BC005537,13,24801657,24816197,protein_coding,1,14540,chr13_24801657_24816197
BC005624,2,30972177,30982201,protein_coding,-1,10024,chr2_30972177_30982201
BC006965,11,112663927,112781976,processed_transcript,-1,118049,chr11_112663927_112781976
BC016579,16,45626848,45654068,protein_coding,-1,27220,chr16_45626848_45654068
BC017158,7,128271379,128298170,protein_coding,-1,26791,chr7_128271379_128298170
BC018473,11,116752167,116759373,antisense,1,7206,chr11_116752167_116759373
BC021767,3,94661830,94670696,transcribed_unprocessed_pseudogene,-1,8866,chr3_94661830_94670696
BC024063,10,82083353,82111216,protein_coding,1,27863,chr10_82083353_82111216
BC024139,15,76119517,76126596,protein_coding,-1,7079,chr15_76119517_76126596
BC024386,7,140906014,140907983,processed_transcript,1,1969,chr7_140906014_140907983
BC024978,7,27195781,27210186,protein_coding,1,14405,chr7_27195781_27210186
BC025920,10,81606270,81620703,protein_coding,1,14433,chr10_81606270_81620703
BC028528,3,95883954,95892005,protein_coding,-1,8051,chr3_95883954_95892005
BC029722,2,155817730,155819426,protein_coding,-1,1696,chr2_155817730_155819426
BC030500,8,58911755,58914298,protein_coding,1,2543,chr8_58911755_58914298
BC031181,18,75005868,75010152,protein_coding,1,4284,chr18_75005868_75010152
BC034090,1,155212471,155244444,protein_coding,-1,31973,chr1_155212471_155244444
BC035044,6,128849090,128891126,protein_coding,-1,42036,chr6_128849090_128891126
BC037032,15,4020114,4027405,processed_transcript,-1,7291,chr15_4020114_4027405
BC037704,19,43675178,43677176,processed_transcript,1,1998,chr19_43675178_43677176
BC039966,4,153947633,153950503,antisense,-1,2870,chr4_153947633_153950503
BC046251,7,65582070,65618884,lincRNA,1,36814,chr7_65582070_65618884
BC048403,10,121739937,121752878,protein_coding,1,12941,chr10_121739937_121752878
BC048507,13,67863326,67863925,protein_coding,1,599,chr13_67863326_67863925
BC048559,10,41746721,41783437,antisense,1,36716,chr10_41746721_41783437
BC048562,9,108436482,108446086,protein_coding,1,9604,chr9_108436482_108446086
BC048679,7,81494275,81498281,protein_coding,-1,4006,chr7_81494275_81498281
BC049352,9,45182007,45250020,protein_coding,1,68013,chr9_45182007_45250020
BC049715,6,136827626,136840662,protein_coding,1,13036,chr6_136827626_136840662
BC049762,11,51253651,51263046,protein_coding,-1,9395,chr11_51253651_51263046
BC051019,7,109712181,109723850,protein_coding,-1,11669,chr7_109712181_109723850
BC051142,17,34398820,34460734,protein_coding,1,61914,chr17_34398820_34460734
BC051226,17,33908044,33909317,bidirectional_promoter_lncRNA,-1,1273,chr17_33908044_33909317
BC051408,18,28711861,28726847,lincRNA,1,14986,chr18_28711861_28726847
BC052040,2,115581716,115778768,protein_coding,1,197052,chr2_115581716_115778768
BC053393,11,46571536,46589232,protein_coding,1,17696,chr11_46571536_46589232
BC055324,1,163945993,163994796,protein_coding,-1,48803,chr1_163945993_163994796
BC055402,1,57200645,57214993,lincRNA,-1,14348,chr1_57200645_57214993
BC064078,6,128992952,129008040,transcribed_unprocessed_pseudogene,1,15088,chr6_128992952_129008040
BC065397,X,136741824,136803364,processed_transcript,1,61540,chrX_136741824_136803364
BC067074,13,113293159,113379711,protein_coding,1,86552,chr13_113293159_113379711
BC085271,1,183205071,183206557,transcribed_processed_pseudogene,-1,1486,chr1_183205071_183206557
BC106175,12,8478874,8482157,transcribed_processed_pseudogene,-1,3283,chr12_8478874_8482157
BC106179,16,23220656,23225484,processed_transcript,-1,4828,chr16_23220656_23225484
BC107364,3,96433788,96452306,protein_coding,-1,18518,chr3_96433788_96452306
BE692007,19,11470166,11484578,processed_transcript,-1,14412,chr19_11470166_11484578
Baalc,15,38796295,38952912,protein_coding,1,156617,chr15_38796295_38952912
Baat,4,49489422,49506557,protein_coding,-1,17135,chr4_49489422_49506557
Babam1,8,71396861,71404619,protein_coding,1,7758,chr8_71396861_71404619
Bace1,9,45838580,45864399,protein_coding,1,25819,chr9_45838580_45864399
Bace2,16,97356742,97442936,protein_coding,1,86194,chr16_97356742_97442936
Bach1,16,87698945,87733346,protein_coding,1,34401,chr16_87698945_87733346
Bach2,4,32238804,32586108,protein_coding,1,347304,chr4_32238804_32586108
Bach2os,4,32559680,32571708,antisense,-1,12028,chr4_32559680_32571708
Bad,19,6941861,6951899,protein_coding,1,10038,chr19_6941861_6951899
Bag1,4,40936398,40948294,protein_coding,-1,11896,chr4_40936398_40948294
Bag2,1,33745484,33757795,protein_coding,-1,12311,chr1_33745484_33757795
Bag3,7,128523616,128546981,protein_coding,1,23365,chr7_128523616_128546981
Bag4,8,25764538,25785287,protein_coding,-1,20749,chr8_25764538_25785287
Bag5,12,111709488,111713257,protein_coding,-1,3769,chr12_111709488_111713257
Bag6,17,35135178,35147322,protein_coding,1,12144,chr17_35135178_35147322
Bahcc1,11,120232947,120292296,protein_coding,1,59349,chr11_120232947_120292296
Bahd1,2,118900377,118924528,protein_coding,1,24151,chr2_118900377_118924528
Baiap2,11,119942763,120006782,protein_coding,1,64019,chr11_119942763_120006782
Baiap2l1,5,144264526,144358112,protein_coding,-1,93586,chr5_144264526_144358112
Baiap2l2,15,79258195,79285537,protein_coding,-1,27342,chr15_79258195_79285537
Baiap3,17,25242659,25256364,protein_coding,-1,13705,chr17_25242659_25256364
Bak1,17,27019810,27029009,protein_coding,-1,9199,chr17_27019810_27029009
Bambi,18,3507923,3516404,protein_coding,1,8481,chr18_3507923_3516404
Bambi-ps1,2,122466935,122467526,processed_pseudogene,-1,591,chr2_122466935_122467526
Banf1,19,5364638,5367168,protein_coding,-1,2530,chr19_5364638_5367168
Banf2os,2,144059138,144068806,antisense,-1,9668,chr2_144059138_144068806
Bank1,3,136053363,136326066,protein_coding,-1,272703,chr3_136053363_136326066
Banp,8,121949750,122029258,protein_coding,1,79508,chr8_121949750_122029258
Bap1,14,31251450,31259944,protein_coding,1,8494,chr14_31251450_31259944
Bard1,1,71027498,71103146,protein_coding,-1,75648,chr1_71027498_71103146
Barhl1,2,28907679,28916668,protein_coding,-1,8989,chr2_28907679_28916668
Barx2,9,31846044,31913462,protein_coding,-1,67418,chr9_31846044_31913462
Basp1,15,25363277,25413764,protein_coding,-1,50487,chr15_25363277_25413764
Batf3,1,191097847,191108945,protein_coding,1,11098,chr1_191097847_191108945
Bax,7,45461697,45466898,protein_coding,-1,5201,chr7_45461697_45466898
Baz1a,12,54892989,55014348,protein_coding,-1,121359,chr12_54892989_55014348
Baz1b,5,135187264,135246129,protein_coding,1,58865,chr5_135187264_135246129
Baz2a,10,128091577,128129303,protein_coding,1,37726,chr10_128091577_128129303
Baz2b,2,59899363,60209839,protein_coding,-1,310476,chr2_59899363_60209839
Bbc3,7,16308393,16318205,protein_coding,1,9812,chr7_16308393_16318205
Bbip1,19,53929861,53944627,protein_coding,-1,14766,chr19_53929861_53944627
Bbox1,2,110262697,110314560,protein_coding,-1,51863,chr2_110262697_110314560
Bbs1,19,4886878,4906628,protein_coding,-1,19750,chr19_4886878_4906628
Bbs10,10,111298679,111301727,protein_coding,1,3048,chr10_111298679_111301727
Bbs12,3,37312554,37321453,protein_coding,1,8899,chr3_37312554_37321453
Bbs2,8,94067954,94098928,protein_coding,-1,30974,chr8_94067954_94098928
Bbs4,9,59321990,59353508,protein_coding,-1,31518,chr9_59321990_59353508
Bbs5,2,69647171,69667571,protein_coding,1,20400,chr2_69647171_69667571
Bbs7,3,36573142,36613477,protein_coding,-1,40335,chr3_36573142_36613477
Bbs9,9,22475715,22888280,protein_coding,1,412565,chr9_22475715_22888280
Bbx,16,50191844,50432390,protein_coding,-1,240546,chr16_50191844_50432390
Bc1,7,144914470,144914637,lincRNA,1,167,chr7_144914470_144914637
Bcam,7,19756131,19771016,protein_coding,-1,14885,chr7_19756131_19771016
Bcan,3,87987531,88000230,protein_coding,-1,12699,chr3_87987531_88000230
Bcap29,12,31590967,31634658,protein_coding,-1,43691,chr12_31590967_31634658
Bcap31,X,73686178,73716175,protein_coding,-1,29997,chrX_73686178_73716175
Bcar1,8,111710474,111743809,protein_coding,-1,33335,chr8_111710474_111743809
Bcar3,3,122294136,122530191,protein_coding,1,236055,chr3_122294136_122530191
Bcas1,2,170346991,170427845,protein_coding,-1,80854,chr2_170346991_170427845
Bcas1os2,2,170356361,170380435,antisense,1,24074,chr2_170356361_170380435
Bcas2,3,103171655,103179166,protein_coding,1,7511,chr3_103171655_103179166
Bcas3,11,85353167,85826058,protein_coding,1,472891,chr11_85353167_85826058
Bcas3os1,11,85702200,85719744,antisense,-1,17544,chr11_85702200_85719744
Bcas3os2,11,85766831,85775680,antisense,-1,8849,chr11_85766831_85775680
Bcat1,6,144993835,145076184,protein_coding,-1,82349,chr6_144993835_145076184
Bcat2,7,45570153,45589711,protein_coding,1,19558,chr7_45570153_45589711
Bccip,7,133709333,133721145,protein_coding,1,11812,chr7_133709333_133721145
Bcdin3d,15,99470079,99474730,protein_coding,-1,4651,chr15_99470079_99474730
Bche,3,73635808,73708415,protein_coding,-1,72607,chr3_73635808_73708415
Bckdha,7,25629946,25658981,protein_coding,-1,29035,chr7_25629946_25658981
Bckdhb,9,83925145,84124240,protein_coding,1,199095,chr9_83925145_84124240
Bckdk,7,127904082,127910221,protein_coding,1,6139,chr7_127904082_127910221
Bcl10,3,145922804,145934356,protein_coding,1,11552,chr3_145922804_145934356
Bcl11a,11,24078056,24174123,protein_coding,1,96067,chr11_24078056_24174123
Bcl11b,12,107910403,108003602,protein_coding,-1,93199,chr12_107910403_108003602
Bcl2,1,106538178,106714274,protein_coding,-1,176096,chr1_106538178_106714274
Bcl2a1a,9,88956900,88962419,protein_coding,1,5519,chr9_88956900_88962419
Bcl2a1b,9,89199209,89207827,protein_coding,1,8618,chr9_89199209_89207827
Bcl2a1c,9,114330135,114330578,protein_coding,1,443,chr9_114330135_114330578
Bcl2a1d,9,88723285,88731914,protein_coding,-1,8629,chr9_88723285_88731914
Bcl2l1,2,152780668,152831728,protein_coding,-1,51060,chr2_152780668_152831728
Bcl2l10,9,75347758,75351649,protein_coding,1,3891,chr9_75347758_75351649
Bcl2l11,2,128126038,128162547,protein_coding,1,36509,chr2_128126038_128162547
Bcl2l12,7,44991222,44998712,protein_coding,-1,7490,chr7_44991222_44998712
Bcl2l13,6,120836212,120892842,protein_coding,1,56630,chr6_120836212_120892842
Bcl2l15,3,103832601,103854618,protein_coding,1,22017,chr3_103832601_103854618
Bcl2l2,14,54883377,54888234,protein_coding,1,4857,chr14_54883377_54888234
Bcl3,7,19808462,19822770,protein_coding,-1,14308,chr7_19808462_19822770
Bcl6,16,23965052,23988852,protein_coding,-1,23800,chr16_23965052_23988852
Bcl6b,11,70224128,70229798,protein_coding,-1,5670,chr11_70224128_70229798
Bcl7a,5,123343834,123374992,protein_coding,1,31158,chr5_123343834_123374992
Bcl7b,5,135168283,135181855,protein_coding,1,13572,chr5_135168283_135181855
Bcl7c,7,127661456,127708933,protein_coding,-1,47477,chr7_127661456_127708933
Bcl9,3,97203662,97297917,protein_coding,-1,94255,chr3_97203662_97297917
Bcl9l,9,44482825,44511896,protein_coding,1,29071,chr9_44482825_44511896
Bclaf1,10,20312469,20344613,protein_coding,1,32144,chr10_20312469_20344613
Bco1,8,117095854,117133720,protein_coding,1,37866,chr8_117095854_117133720
Bco2,9,50533087,50555181,protein_coding,-1,22094,chr9_50533087_50555181
Bcor,X,12036740,12160355,protein_coding,-1,123615,chrX_12036740_12160355
Bcorl1,X,48341358,48408049,protein_coding,1,66691,chrX_48341358_48408049
Bcr,10,75060592,75184921,protein_coding,1,124329,chr10_75060592_75184921
Bcs1l,1,74588289,74592443,protein_coding,1,4154,chr1_74588289_74592443
Bdh1,16,31422280,31458901,protein_coding,1,36621,chr16_31422280_31458901
Bdh2,3,135281221,135304426,protein_coding,1,23205,chr3_135281221_135304426
Bdkrb1,12,105603085,105605428,protein_coding,1,2343,chr12_105603085_105605428
Bdkrb2,12,105563226,105595237,protein_coding,1,32011,chr12_105563226_105595237
Bdnf,2,109674700,109727007,protein_coding,1,52307,chr2_109674700_109727007
Bdp1,13,100017994,100104070,protein_coding,-1,86076,chr13_100017994_100104070
Bean1,8,104170442,104219122,protein_coding,1,48680,chr8_104170442_104219122
Becn1,11,101285952,101302286,protein_coding,-1,16334,chr11_101285952_101302286
Begain,12,109032187,109068217,protein_coding,-1,36030,chr12_109032187_109068217
Bend3,10,43478831,43515396,protein_coding,1,36565,chr10_43478831_43515396
Bend4,5,67392147,67428310,protein_coding,-1,36163,chr5_67392147_67428310
Bend5,4,111415006,111460298,protein_coding,1,45292,chr4_111415006_111460298
Bend6,1,33852052,33907816,protein_coding,-1,55764,chr1_33852052_33907816
Bend7,2,4717831,4802142,protein_coding,1,84311,chr2_4717831_4802142
Best1,19,9985174,10001633,protein_coding,-1,16459,chr19_9985174_10001633
Best2,8,85007202,85014531,protein_coding,-1,7329,chr8_85007202_85014531
Best3,10,116986314,117025040,protein_coding,1,38726,chr10_116986314_117025040
Best4-ps,4,117145257,117148637,unitary_pseudogene,1,3380,chr4_117145257_117148637
Bet1,6,4076899,4086972,protein_coding,-1,10073,chr6_4076899_4086972
Bet1l,7,140853394,140857577,protein_coding,-1,4183,chr7_140853394_140857577
Bex1,X,136213972,136215513,protein_coding,-1,1541,chrX_136213972_136215513
Bex2,X,136066564,136068236,protein_coding,-1,1672,chrX_136066564_136068236
Bex4,X,136138996,136140443,protein_coding,1,1447,chrX_136138996_136140443
Bfar,16,13671858,13703612,protein_coding,1,31754,chr16_13671858_13703612
Bfsp1,2,143826528,143863173,protein_coding,-1,36645,chr2_143826528_143863173
Bfsp2,9,103424924,103480420,protein_coding,-1,55496,chr9_103424924_103480420
Bglap,3,88383501,88384464,protein_coding,-1,963,chr3_88383501_88384464
Bglap2,3,88377736,88378699,protein_coding,-1,963,chr3_88377736_88378699
Bglap3,3,88368616,88372743,protein_coding,-1,4127,chr3_88368616_88372743
Bgn,X,73483602,73495933,protein_coding,1,12331,chrX_73483602_73495933
Bhlha15,5,144190286,144194441,protein_coding,1,4155,chr5_144190286_144194441
Bhlha9,11,76672470,76673676,protein_coding,1,1206,chr11_76672470_76673676
Bhlhb9,X,135797594,135891081,protein_coding,1,93487,chrX_135797594_135891081
Bhlhe22,3,18054174,18057517,protein_coding,1,3343,chr3_18054174_18057517
Bhlhe40,6,108660629,108666925,protein_coding,1,6296,chr6_108660629_108666925
Bhlhe41,6,145858243,145865558,protein_coding,-1,7315,chr6_145858243_145865558
Bhmt,13,93616675,93637961,protein_coding,-1,21286,chr13_93616675_93637961
Bhmt2,13,93655720,93674302,protein_coding,-1,18582,chr13_93655720_93674302
Bicc1,10,70922832,71159700,protein_coding,-1,236868,chr10_70922832_71159700
Bicd1,6,149408886,149563329,protein_coding,1,154443,chr6_149408886_149563329
Bicd2,13,49341585,49387026,protein_coding,1,45441,chr13_49341585_49387026
Bid,6,120891930,120916853,protein_coding,-1,24923,chr6_120891930_120916853
Bik,15,83526862,83544634,protein_coding,1,17772,chr15_83526862_83544634
Bin1,18,32377230,32435737,protein_coding,1,58507,chr18_32377230_32435737
Bin2,15,100641077,100669553,protein_coding,-1,28476,chr15_100641077_100669553
Bin3,14,70100105,70138206,protein_coding,1,38101,chr14_70100105_70138206
Birc2,9,7818227,7837064,protein_coding,-1,18837,chr9_7818227_7837064
Birc3,9,7848699,7873186,protein_coding,-1,24487,chr9_7848699_7873186
Birc5,11,117849251,117855743,protein_coding,1,6492,chr11_117849251_117855743
Birc6,17,74528295,74703356,protein_coding,1,175061,chr17_74528295_74703356
Birc7,2,180929023,180934010,protein_coding,1,4987,chr2_180929023_180934010
Bivm,1,44118957,44144770,protein_coding,1,25813,chr1_44118957_44144770
Blcap,2,157556362,157571274,protein_coding,-1,14912,chr2_157556362_157571274
Blm,7,80454733,80535119,protein_coding,-1,80386,chr7_80454733_80535119
Blmh,11,76924809,76987379,protein_coding,1,62570,chr11_76924809_76987379
Blnk,19,40928927,40994535,protein_coding,-1,65608,chr19_40928927_40994535
Bloc1s1,10,128917882,128924035,protein_coding,-1,6153,chr10_128917882_128924035
Bloc1s2,19,44139246,44146446,protein_coding,-1,7200,chr19_44139246_44146446
Bloc1s2-ps,2,52619754,52620185,processed_pseudogene,1,431,chr2_52619754_52620185
Bloc1s3,7,19504486,19508367,protein_coding,-1,3881,chr7_19504486_19508367
Bloc1s4,5,36747378,36748650,protein_coding,-1,1272,chr5_36747378_36748650
Bloc1s5,13,38592842,38635109,protein_coding,-1,42267,chr13_38592842_38635109
Bloc1s6,2,122738503,122749475,protein_coding,1,10972,chr2_122738503_122749475
Bloc1s6os,2,122733290,122738362,antisense,-1,5072,chr2_122733290_122738362
Blvra,2,127070665,127097084,protein_coding,1,26419,chr2_127070665_127097084
Blvrb,7,27447978,27466144,protein_coding,1,18166,chr7_27447978_27466144
Blzf1,1,164289800,164307489,protein_coding,-1,17689,chr1_164289800_164307489
Bmf,2,118528757,118549687,protein_coding,-1,20930,chr2_118528757_118549687
Bmi1,2,18677018,18686629,protein_coding,1,9611,chr2_18677018_18686629
Bmp1,14,70474558,70520234,protein_coding,-1,45676,chr14_70474558_70520234
Bmp15,X,6314107,6320721,protein_coding,-1,6614,chrX_6314107_6320721
Bmp2,2,133552159,133562885,protein_coding,1,10726,chr2_133552159_133562885
Bmp2k,5,96997689,97091867,protein_coding,1,94178,chr5_96997689_97091867
Bmp3,5,98854415,98884396,protein_coding,1,29981,chr5_98854415_98884396
Bmp4,14,46383520,46390669,protein_coding,-1,7149,chr14_46383520_46390669
Bmp5,9,75775364,75900310,protein_coding,1,124946,chr9_75775364_75900310
Bmp6,13,38345107,38500302,protein_coding,1,155195,chr13_38345107_38500302
Bmp7,2,172868012,172940321,protein_coding,-1,72309,chr2_172868012_172940321
Bmp8a,4,123312645,123343252,protein_coding,-1,30607,chr4_123312645_123343252
Bmp8b,4,123105165,123132099,protein_coding,1,26934,chr4_123105165_123132099
Bmper,9,23223076,23485200,protein_coding,1,262124,chr9_23223076_23485200
Bmpr1a,14,34410734,34503341,protein_coding,-1,92607,chr14_34410734_34503341
Bmpr1b,3,141837136,142169425,protein_coding,-1,332289,chr3_141837136_142169425
Bmpr2,1,59763400,59879014,protein_coding,1,115614,chr1_59763400_59879014
Bms1,6,118383381,118419474,protein_coding,-1,36093,chr6_118383381_118419474
Bmx,X,164192842,164258193,protein_coding,-1,65351,chrX_164192842_164258193
Bmyc,2,25706739,25707721,protein_coding,1,982,chr2_25706739_25707721
Bnc1,7,81966653,81992307,protein_coding,-1,25654,chr7_81966653_81992307
Bnc2,4,84275095,84675275,protein_coding,-1,400180,chr4_84275095_84675275
Bnip1,17,26781066,26792565,protein_coding,1,11499,chr17_26781066_26792565
Bnip2,9,69989466,70008317,protein_coding,1,18851,chr9_69989466_70008317
Bnip3,7,138890836,138909519,protein_coding,-1,18683,chr7_138890836_138909519
Bnip3l,14,66985239,67008877,protein_coding,-1,23638,chr14_66985239_67008877
Bnipl,3,95241271,95251193,protein_coding,-1,9922,chr3_95241271_95251193
Boc,16,44485049,44558897,protein_coding,-1,73848,chr16_44485049_44558897
Bod1,11,31665181,31671885,protein_coding,-1,6704,chr11_31665181_31671885
Bod1l,5,41787538,41844315,protein_coding,-1,56777,chr5_41787538_41844315
Bok,1,93685660,93695764,protein_coding,1,10104,chr1_93685660_93695764
Bola1,3,96196588,96219709,protein_coding,-1,23121,chr3_96196588_96219709
Bola2,7,126695401,126699798,protein_coding,1,4397,chr7_126695401_126699798
Bola3,6,83349147,83360136,protein_coding,1,10989,chr6_83349147_83360136
Boll,1,55248658,55363469,protein_coding,-1,114811,chr1_55248658_55363469
Bop1,15,76452989,76477277,protein_coding,-1,24288,chr15_76452989_76477277
Bora,14,99046222,99074540,protein_coding,1,28318,chr14_99046222_99074540
Bpgm,6,34476207,34505613,protein_coding,1,29406,chr6_34476207_34505613
Bphl,13,34037597,34074074,protein_coding,1,36477,chr13_34037597_34074074
Bpifa3,2,154130336,154138356,protein_coding,1,8020,chr2_154130336_154138356
Bpifb1,2,154190818,154220369,protein_coding,1,29551,chr2_154190818_154220369
Bpifb4,2,153938221,153964101,protein_coding,1,25880,chr2_153938221_153964101
Bpifb5,2,154223742,154240902,protein_coding,1,17160,chr2_154223742_154240902
Bpifb9a,2,154257854,154271245,protein_coding,1,13391,chr2_154257854_154271245
Bpifb9b,2,154307227,154320646,protein_coding,1,13419,chr2_154307227_154320646
Bpifc,10,85959340,86011895,protein_coding,-1,52555,chr10_85959340_86011895
Bpnt1,1,185332149,185357777,protein_coding,1,25628,chr1_185332149_185357777
Bptf,11,107033081,107132127,protein_coding,-1,99046,chr11_107033081_107132127
Braf,6,39603237,39725463,protein_coding,-1,122226,chr6_39603237_39725463
Brap,5,121660563,121687256,protein_coding,1,26693,chr5_121660563_121687256
Brat1,5,140705011,140719379,protein_coding,1,14368,chr5_140705011_140719379
Brca1,11,101488764,101551955,protein_coding,-1,63191,chr11_101488764_101551955
Brca2,5,150522630,150570329,protein_coding,1,47699,chr5_150522630_150570329
Brcc3,X,75416628,75454001,protein_coding,1,37373,chrX_75416628_75454001
Brd1,15,88687034,88734233,protein_coding,-1,47199,chr15_88687034_88734233
Brd2,17,34112023,34122634,protein_coding,-1,10611,chr17_34112023_34122634
Brd3,2,27445579,27507662,protein_coding,-1,62083,chr2_27445579_27507662
Brd4,17,32196274,32284722,protein_coding,-1,88448,chr17_32196274_32284722
Brd7,8,88331039,88362194,protein_coding,-1,31155,chr8_88331039_88362194
Brd8,18,34598615,34624601,protein_coding,-1,25986,chr18_34598615_34624601
Brd9,13,73937811,73960895,protein_coding,1,23084,chr13_73937811_73960895
Brdt,5,107331159,107387058,protein_coding,1,55899,chr5_107331159_107387058
Brf1,12,112960085,113000704,protein_coding,-1,40619,chr12_112960085_113000704
Brf2,8,27123364,27128680,protein_coding,-1,5316,chr8_27123364_27128680
Bri3,5,144244437,144446757,protein_coding,1,202320,chr5_144244437_144446757
Bri3bp,5,125441568,125460370,protein_coding,1,18802,chr5_125441568_125460370
Brinp1,4,68761514,68954397,protein_coding,-1,192883,chr4_68761514_68954397
Brinp2,1,158245269,158356326,protein_coding,-1,111057,chr1_158245269_158356326
Brinp3,1,146494760,146902472,protein_coding,1,407712,chr1_146494760_146902472
Brip1,11,86058138,86201193,protein_coding,-1,143055,chr11_86058138_86201193
Brix1,15,10474779,10485947,protein_coding,-1,11168,chr15_10474779_10485947
Brk1,6,113604772,113616951,protein_coding,1,12179,chr6_113604772_113616951
Brms1,19,5041354,5049917,protein_coding,1,8563,chr19_5041354_5049917
Brms1l,12,55836324,55869736,protein_coding,1,33412,chr12_55836324_55869736
Brox,1,183276352,183297269,protein_coding,-1,20917,chr1_183276352_183297269
Brpf1,6,113307137,113324860,protein_coding,1,17723,chr6_113307137_113324860
Brpf3,17,28801090,28839949,protein_coding,1,38859,chr17_28801090_28839949
Brsk1,7,4690604,4715997,protein_coding,1,25393,chr7_4690604_4715997
Brsk2,7,141949751,142004247,protein_coding,1,54496,chr7_141949751_142004247
Brwd1,16,95992092,96082526,protein_coding,-1,90434,chr16_95992092_96082526
Brwd3,X,108737016,108834372,protein_coding,-1,97356,chrX_108737016_108834372
Bscl2,19,8837467,8848683,protein_coding,1,11216,chr19_8837467_8848683
Bsdc1,4,129461581,129488498,protein_coding,1,26917,chr4_129461581_129488498
Bsg,10,79704491,79711969,protein_coding,1,7478,chr10_79704491_79711969
Bsn,9,108096022,108190384,protein_coding,-1,94362,chr9_108096022_108190384
Bsph1,7,13450841,13473449,protein_coding,1,22608,chr7_13450841_13473449
Bspry,4,62480053,62497298,protein_coding,1,17245,chr4_62480053_62497298
Bst1,5,43818885,43843986,protein_coding,1,25101,chr5_43818885_43843986
Bst2,8,71534255,71537456,protein_coding,-1,3201,chr8_71534255_71537456
Bsx,9,40874127,40880057,protein_coding,1,5930,chr9_40874127_40880057
Btaf1,19,36926079,37012752,protein_coding,1,86673,chr19_36926079_37012752
Btbd1,7,81792074,81829431,protein_coding,-1,37357,chr7_81792074_81829431
Btbd10,7,113315626,113369392,protein_coding,-1,53766,chr7_113315626_113369392
Btbd11,10,85386814,85660292,protein_coding,1,273478,chr10_85386814_85660292
Btbd16,7,130774069,130825899,protein_coding,1,51830,chr7_130774069_130825899
Btbd17,11,114791217,114795945,protein_coding,-1,4728,chr11_114791217_114795945
Btbd18,2,84659079,84668780,protein_coding,1,9701,chr2_84659079_84668780
Btbd19,4,117119219,117125725,protein_coding,-1,6506,chr4_117119219_117125725
Btbd2,10,80642617,80657071,protein_coding,-1,14454,chr10_80642617_80657071
Btbd3,2,138256565,138589292,protein_coding,1,332727,chr2_138256565_138589292
Btbd6,12,112976482,112978945,protein_coding,1,2463,chr12_112976482_112978945
Btbd7,12,102780797,102878471,protein_coding,-1,97674,chr12_102780797_102878471
Btbd8,5,107437997,107511207,protein_coding,1,73210,chr5_107437997_107511207
Btbd9,17,30215524,30576488,protein_coding,-1,360964,chr17_30215524_30576488
Btc,5,91357261,91402994,protein_coding,-1,45733,chr5_91357261_91402994
Btd,14,31641028,31668579,protein_coding,1,27551,chr14_31641028_31668579
Btf3,13,98309896,98317006,protein_coding,-1,7110,chr13_98309896_98317006
Btf3l4,4,108814295,108833614,protein_coding,-1,19319,chr4_108814295_108833614
Btg1,10,96617006,96622809,protein_coding,1,5803,chr10_96617006_96622809
Btg2,1,134075170,134079120,protein_coding,-1,3950,chr1_134075170_134079120
Btg3,16,78332637,78377192,protein_coding,-1,44555,chr16_78332637_78377192
Btg4,9,51060901,51119875,protein_coding,1,58974,chr9_51060901_51119875
Btk,X,134542336,134583570,protein_coding,-1,41234,chrX_134542336_134583570
Btla,16,45224315,45257670,protein_coding,1,33355,chr16_45224315_45257670
Btn1a1,13,23456992,23465901,protein_coding,-1,8909,chr13_23456992_23465901
Btn2a2,13,23477676,23488857,protein_coding,-1,11181,chr13_23477676_23488857
Btnl10,11,58917908,58927158,protein_coding,1,9250,chr11_58917908_58927158
Btnl7-ps,17,34532877,34547651,unprocessed_pseudogene,-1,14774,chr17_34532877_34547651
Btnl9,11,49165585,49187159,protein_coding,-1,21574,chr11_49165585_49187159
Btrc,19,45363734,45530013,protein_coding,1,166279,chr19_45363734_45530013
Bub1,2,127801122,127831865,protein_coding,-1,30743,chr2_127801122_127831865
Bub1b,2,118598211,118641591,protein_coding,1,43380,chr2_118598211_118641591
Bub3,7,131560222,131571895,protein_coding,1,11673,chr7_131560222_131571895
Bud13,9,46283008,46299110,protein_coding,1,16102,chr9_46283008_46299110
Bud31,5,145140362,145148078,protein_coding,1,7716,chr5_145140362_145148078
Bves,10,45335772,45372479,protein_coding,1,36707,chr10_45335772_45372479
Bysl,17,47599331,47611492,protein_coding,-1,12161,chr17_47599331_47611492
Bzw1,1,58392898,58407353,protein_coding,1,14455,chr1_58392898_58407353
Bzw2,12,36091835,36158080,protein_coding,-1,66245,chr12_36091835_36158080
C030004G16Rik,18,42615635,42622459,lincRNA,-1,6824,chr18_42615635_42622459
C030006K11Rik,15,76721465,76723845,protein_coding,-1,2380,chr15_76721465_76723845
C030013C21Rik,11,80507410,80509106,sense_intronic,-1,1696,chr11_80507410_80509106
C030013G03Rik,17,12466844,12479578,antisense,1,12734,chr17_12466844_12479578
C030018K13Rik,5,64477008,64483967,lincRNA,1,6959,chr5_64477008_64483967
C030029H02Rik,7,136268324,136318513,lincRNA,1,50189,chr7_136268324_136318513
C030034I22Rik,17,69417402,69421632,lincRNA,1,4230,chr17_69417402_69421632
C030034L19Rik,3,9403064,9437233,lincRNA,1,34169,chr3_9403064_9437233
C030037D09Rik,11,88718645,88728893,lincRNA,1,10248,chr11_88718645_88728893
C030047K22Rik,15,18697684,18818774,lincRNA,-1,121090,chr15_18697684_18818774
C130026I21Rik,1,84992690,85270566,protein_coding,-1,277876,chr1_84992690_85270566
C130026L21Rik,5,111581422,111604932,lincRNA,1,23510,chr5_111581422_111604932
C130036L24Rik,1,86359574,86373791,processed_transcript,1,14217,chr1_86359574_86373791
C130046K22Rik,11,103697724,103722832,processed_transcript,1,25108,chr11_103697724_103722832
C130050O18Rik,5,139405280,139415623,protein_coding,1,10343,chr5_139405280_139415623
C130060C02Rik,19,15985078,16010696,bidirectional_promoter_lncRNA,1,25618,chr19_15985078_16010696
C130071C03Rik,13,83721381,83884194,lincRNA,1,162813,chr13_83721381_83884194
C130074G19Rik,1,184871926,184883218,protein_coding,-1,11292,chr1_184871926_184883218
C130080G10Rik,2,114054335,114064868,antisense,1,10533,chr2_114054335_114064868
C130083M11Rik,5,52199984,52216434,lincRNA,-1,16450,chr5_52199984_52216434
C1d,11,17257579,17269176,protein_coding,1,11597,chr11_17257579_17269176
C1galt1,6,7844842,7875687,protein_coding,1,30845,chr6_7844842_7875687
C1galt1c1,X,38630785,38635087,protein_coding,-1,4302,chrX_38630785_38635087
C1qa,4,136895917,136898803,protein_coding,-1,2886,chr4_136895917_136898803
C1qb,4,136880129,136886187,protein_coding,-1,6058,chr4_136880129_136886187
C1qbp,11,70977836,70983026,protein_coding,-1,5190,chr11_70977836_70983026
C1qc,4,136889804,136893065,protein_coding,-1,3261,chr4_136889804_136893065
C1ql1,11,102939264,102946688,protein_coding,-1,7424,chr11_102939264_102946688
C1ql2,1,120340582,120343174,protein_coding,1,2592,chr1_120340582_120343174
C1ql3,2,13003457,13011806,protein_coding,-1,8349,chr2_13003457_13011806
C1qtnf1,11,118428203,118449963,protein_coding,1,21760,chr11_118428203_118449963
C1qtnf2,11,43474276,43491525,protein_coding,1,17249,chr11_43474276_43491525
C1qtnf3,15,10952332,10980150,protein_coding,1,27818,chr15_10952332_10980150
C1qtnf4,2,90885860,90890525,protein_coding,1,4665,chr2_90885860_90890525
C1qtnf6,15,78523346,78531416,protein_coding,-1,8070,chr15_78523346_78531416
C1qtnf7,5,43515538,43618803,protein_coding,1,103265,chr5_43515538_43618803
C1ra,6,124512405,124523443,protein_coding,1,11038,chr6_124512405_124523443
C1rb,6,124570294,124581171,protein_coding,1,10877,chr6_124570294_124581171
C1rl,6,124493113,124510643,protein_coding,1,17530,chr6_124493113_124510643
C1s1,6,124530345,124542359,protein_coding,-1,12014,chr6_124530345_124542359
C1s2,6,124624625,124636085,protein_coding,-1,11460,chr6_124624625_124636085
C2,17,34862604,34898265,protein_coding,-1,35661,chr17_34862604_34898265
C230012O17Rik,4,24960790,24967449,processed_transcript,-1,6659,chr4_24960790_24967449
C230014O12Rik,2,34018289,34107735,lincRNA,-1,89446,chr2_34018289_34107735
C230024C17Rik,1,153721240,153737829,lincRNA,-1,16589,chr1_153721240_153737829
C230029F24Rik,1,49244616,49340443,lincRNA,1,95827,chr1_49244616_49340443
C230035I16Rik,13,23427975,23431022,lincRNA,-1,3047,chr13_23427975_23431022
C230037L18Rik,15,89476236,89484847,antisense,1,8611,chr15_89476236_89484847
C230057M02Rik,8,122724948,122752325,lincRNA,-1,27377,chr8_122724948_122752325
C230062I16Rik,7,29953621,29970352,transcribed_unprocessed_pseudogene,1,16731,chr7_29953621_29970352
C230072F16Rik,17,80896793,80933045,lincRNA,1,36252,chr17_80896793_80933045
C2cd2,16,97855209,97962598,protein_coding,-1,107389,chr16_97855209_97962598
C2cd2l,9,44309237,44320285,protein_coding,-1,11048,chr9_44309237_44320285
C2cd3,7,100372233,100470152,protein_coding,1,97919,chr7_100372233_100470152
C2cd4a,9,67830489,67832330,protein_coding,-1,1841,chr9_67830489_67832330
C2cd4b,9,67759437,67760930,protein_coding,1,1493,chr9_67759437_67760930
C2cd4c,10,79606854,79614025,protein_coding,-1,7171,chr10_79606854_79614025
C2cd4d,3,94362438,94364566,protein_coding,1,2128,chr3_94362438_94364566
C2cd5,6,143010920,143100141,protein_coding,-1,89221,chr6_143010920_143100141
C3,17,57203970,57228136,protein_coding,-1,24166,chr17_57203970_57228136
C330002G04Rik,19,22978230,23075924,lincRNA,-1,97694,chr19_22978230_23075924
C330007P06Rik,X,36823737,36874111,protein_coding,-1,50374,chrX_36823737_36874111
C330011M18Rik,8,84065236,84067287,antisense,-1,2051,chr8_84065236_84067287
C330013E15Rik,15,100614137,100615110,bidirectional_promoter_lncRNA,-1,973,chr15_100614137_100615110
C330018A13Rik,5,116123614,116129110,antisense,1,5496,chr5_116123614_116129110
C330018D20Rik,18,56955833,56975368,protein_coding,-1,19535,chr18_56955833_56975368
C330022C24Rik,7,140837221,140845689,antisense,-1,8468,chr7_140837221_140845689
C330024C12Rik,17,87192216,87194942,lincRNA,-1,2726,chr17_87192216_87194942
C330024D21Rik,5,67463897,67477632,processed_transcript,1,13735,chr5_67463897_67477632
C3ar1,6,122847138,122856161,protein_coding,-1,9023,chr6_122847138_122856161
C430042M11Rik,17,83851675,83854418,lincRNA,-1,2743,chr17_83851675_83854418
C430049B03Rik,X,53055046,53057190,processed_transcript,-1,2144,chrX_53055046_53057190
C4a,17,34809092,34823464,processed_transcript,-1,14372,chr17_34809092_34823464
C4b,17,34728380,34743882,protein_coding,-1,15502,chr17_34728380_34743882
C4bp,1,130634773,130661632,protein_coding,-1,26859,chr1_130634773_130661632
C4bp-ps1,1,130670261,130684071,unprocessed_pseudogene,-1,13810,chr1_130670261_130684071
C530005A16Rik,4,116589733,116597630,processed_transcript,-1,7897,chr4_116589733_116597630
C530008M17Rik,5,76656512,76873554,protein_coding,1,217042,chr5_76656512_76873554
C530044C16Rik,6,50776115,50815033,lincRNA,1,38918,chr6_50776115_50815033
C5ar1,7,16246743,16259540,protein_coding,-1,12797,chr7_16246743_16259540
C5ar2,7,16234585,16244154,protein_coding,-1,9569,chr7_16234585_16244154
C6,15,4727175,4814967,protein_coding,1,87792,chr15_4727175_4814967
C630028M04Rik,4,51968094,52051110,lincRNA,-1,83016,chr4_51968094_52051110
C630031E19Rik,12,29675628,29686445,antisense,-1,10817,chr12_29675628_29686445
C630043F03Rik,4,72201348,72215352,processed_transcript,1,14004,chr4_72201348_72215352
C7,15,4988762,5063740,protein_coding,-1,74978,chr15_4988762_5063740
C730002L08Rik,19,20410544,20552330,processed_transcript,-1,141786,chr19_20410544_20552330
C730036E19Rik,1,151138034,151142345,lincRNA,1,4311,chr1_151138034_151142345
C77080,4,129219578,129261404,protein_coding,-1,41826,chr4_129219578_129261404
C86187,7,46967711,46975911,lincRNA,-1,8200,chr7_46967711_46975911
C87198,12,56591059,56594996,lincRNA,1,3937,chr12_56591059_56594996
C87436,6,86438374,86473500,protein_coding,1,35126,chr6_86438374_86473500
C8a,4,104815679,104876398,protein_coding,-1,60719,chr4_104815679_104876398
C8b,4,104766317,104804548,protein_coding,1,38231,chr4_104766317_104804548
C8g,2,25498651,25501719,protein_coding,-1,3068,chr2_25498651_25501719
C9,15,6445327,6498751,protein_coding,1,53424,chr15_6445327_6498751
C920006O11Rik,9,78175914,78178879,transcribed_unprocessed_pseudogene,1,2965,chr9_78175914_78178879
C920009B18Rik,10,22306702,22321765,transcribed_unprocessed_pseudogene,1,15063,chr10_22306702_22321765
C920021L13Rik,3,95871522,95889093,antisense,1,17571,chr3_95871522_95889093
CJ186046Rik,17,85693629,85713028,lincRNA,1,19399,chr17_85693629_85713028
CK137956,4,127927592,127970951,protein_coding,-1,43359,chr4_127927592_127970951
CN725425,15,91199494,91260894,protein_coding,1,61400,chr15_91199494_91260894
Caap1,4,94500081,94556796,protein_coding,-1,56715,chr4_94500081_94556796
Cab39,1,85793441,85851576,protein_coding,1,58135,chr1_85793441_85851576
Cab39l,14,59440972,59585764,protein_coding,1,144792,chr14_59440972_59585764
Cabin1,10,75646112,75764341,protein_coding,-1,118229,chr10_75646112_75764341
Cables1,18,11839220,11945630,protein_coding,1,106410,chr18_11839220_11945630
Cables2,2,180258540,180273496,protein_coding,-1,14956,chr2_180258540_180273496
Cabp1,5,115168689,115194381,protein_coding,-1,25692,chr5_115168689_115194381
Cabp4,19,4135422,4144033,protein_coding,-1,8611,chr19_4135422_4144033
Cabp5,7,13398132,13408887,protein_coding,1,10755,chr7_13398132_13408887
Cabp7,11,4736892,4746778,protein_coding,-1,9886,chr11_4736892_4746778
Cabyr,18,12740322,12755260,protein_coding,1,14938,chr18_12740322_12755260
Cacfd1,2,27009926,27021089,protein_coding,1,11163,chr2_27009926_27021089
Cachd1,4,100776675,101029220,protein_coding,1,252545,chr4_100776675_101029220
Cacna1a,8,84338639,84640246,protein_coding,1,301607,chr8_84338639_84640246
Cacna1b,2,24603887,24763152,protein_coding,-1,159265,chr2_24603887_24763152
Cacna1c,6,118587240,119196890,protein_coding,-1,609650,chr6_118587240_119196890
Cacna1d,14,30039939,30491455,protein_coding,-1,451516,chr14_30039939_30491455
Cacna1e,1,154390731,154884501,protein_coding,-1,493770,chr1_154390731_154884501
Cacna1f,X,7607083,7635196,protein_coding,1,28113,chrX_7607083_7635196
Cacna1g,11,94408391,94474198,protein_coding,-1,65807,chr11_94408391_94474198
Cacna1h,17,25374285,25433783,protein_coding,-1,59498,chr17_25374285_25433783
Cacna1i,15,80287238,80398279,protein_coding,1,111041,chr15_80287238_80398279
Cacna1s,1,136052750,136119822,protein_coding,1,67072,chr1_136052750_136119822
Cacna2d1,5,15934691,16374511,protein_coding,1,439820,chr5_15934691_16374511
Cacna2d2,9,107399612,107529343,protein_coding,1,129731,chr9_107399612_107529343
Cacna2d3,14,28904943,29721864,protein_coding,-1,816921,chr14_28904943_29721864
Cacna2d4,6,119236526,119352407,protein_coding,1,115881,chr6_119236526_119352407
Cacnb1,11,98001508,98023034,protein_coding,-1,21526,chr11_98001508_98023034
Cacnb2,2,14603088,14987908,protein_coding,1,384820,chr2_14603088_14987908
Cacnb3,15,98630840,98644529,protein_coding,1,13689,chr15_98630840_98644529
Cacnb4,2,52428320,52676831,protein_coding,-1,248511,chr2_52428320_52676831
Cacng1,11,107703218,107716522,protein_coding,-1,13304,chr11_107703218_107716522
Cacng2,15,77991748,78120028,protein_coding,-1,128280,chr15_77991748_78120028
Cacng3,7,122670492,122769393,protein_coding,1,98901,chr7_122670492_122769393
Cacng4,11,107732357,107794557,protein_coding,-1,62200,chr11_107732357_107794557
Cacng5,11,107874605,107915055,protein_coding,-1,40450,chr11_107874605_107915055
Cacng6,7,3422711,3435667,protein_coding,1,12956,chr7_3422711_3435667
Cacng7,7,3331471,3368221,protein_coding,1,36750,chr7_3331471_3368221
Cacng8,7,3389199,3415648,protein_coding,1,26449,chr7_3389199_3415648
Cactin,10,81321103,81326242,protein_coding,1,5139,chr10_81321103_81326242
Cacul1,19,60524696,60581025,protein_coding,-1,56329,chr19_60524696_60581025
Cacybp,1,160202367,160212875,protein_coding,-1,10508,chr1_160202367_160212875
Cad,5,31054780,31078479,protein_coding,1,23699,chr5_31054780_31078479
Cadm1,9,47530173,47858115,protein_coding,1,327942,chr9_47530173_47858115
Cadm2,16,66655421,67620908,protein_coding,-1,965487,chr16_66655421_67620908
Cadm3,1,173333258,173367695,protein_coding,-1,34437,chr1_173333258_173367695
Cadm4,7,24482023,24504539,protein_coding,1,22516,chr7_24482023_24504539
Cadps,14,12372563,12823079,protein_coding,-1,450516,chr14_12372563_12823079
Cadps2,6,23262773,23839421,protein_coding,-1,576648,chr6_23262773_23839421
Cage1,13,38006052,38037069,protein_coding,-1,31017,chr13_38006052_38037069
Calb1,4,15881264,15908064,protein_coding,1,26800,chr4_15881264_15908064
Calb2,8,110137502,110168210,protein_coding,-1,30708,chr8_110137502_110168210
Calca,7,114631478,114636357,protein_coding,-1,4879,chr7_114631478_114636357
Calcb,7,114718643,114723365,protein_coding,1,4722,chr7_114718643_114723365
Calcoco1,15,102706777,102722178,protein_coding,-1,15401,chr15_102706777_102722178
Calcoco2,11,96099326,96111964,protein_coding,-1,12638,chr11_96099326_96111964
Calcr,6,3685680,3764714,protein_coding,-1,79034,chr6_3685680_3764714
Calcrl,2,84330626,84425411,protein_coding,-1,94785,chr2_84330626_84425411
Cald1,6,34598500,34775473,protein_coding,1,176973,chr6_34598500_34775473
Calhm1,19,47140909,47144254,protein_coding,-1,3345,chr19_47140909_47144254
Calhm2,19,47105353,47138294,protein_coding,-1,32941,chr19_47105353_47138294
Calhm3,19,47151609,47157764,protein_coding,-1,6155,chr19_47151609_47157764
Calm1,12,100199435,100209814,protein_coding,1,10379,chr12_100199435_100209814
Calm2,17,87433412,87446935,protein_coding,-1,13523,chr17_87433412_87446935
Calm3,7,16915379,16924114,protein_coding,-1,8735,chr7_16915379_16924114
Calml3,13,3802896,3804316,protein_coding,-1,1420,chr13_3802896_3804316
Calml4,9,62858080,62875921,protein_coding,1,17841,chr9_62858080_62875921
Caln1,5,130369455,130847412,protein_coding,1,477957,chr5_130369455_130847412
Calr,8,84841850,84846934,protein_coding,-1,5084,chr8_84841850_84846934
Calr3,8,72424176,72443870,protein_coding,-1,19694,chr8_72424176_72443870
Calr4,4,109234485,109254571,protein_coding,1,20086,chr4_109234485_109254571
Calu,6,29348069,29377110,protein_coding,1,29041,chr6_29348069_29377110
Caly,7,140069880,140082548,protein_coding,-1,12668,chr7_140069880_140082548
Camk1,6,113334124,113343984,protein_coding,-1,9860,chr6_113334124_113343984
Camk1d,2,5293457,5714515,protein_coding,-1,421058,chr2_5293457_5714515
Camk1g,1,193346346,193370298,protein_coding,-1,23952,chr1_193346346_193370298
Camk2a,18,60925618,60988152,protein_coding,1,62534,chr18_60925618_60988152
Camk2b,11,5969644,6066362,protein_coding,-1,96718,chr11_5969644_6066362
Camk2d,3,126596302,126846326,protein_coding,1,250024,chr3_126596302_126846326
Camk2g,14,20734875,20794088,protein_coding,-1,59213,chr14_20734875_20794088
Camk2n1,4,138454314,138460123,protein_coding,1,5809,chr4_138454314_138460123
Camk2n2,16,20619215,20621287,protein_coding,-1,2072,chr16_20619215_20621287
Camk4,18,32934931,33191228,protein_coding,1,256297,chr18_32934931_33191228
Camkk1,11,73019008,73042073,protein_coding,1,23065,chr11_73019008_73042073
Camkk2,5,122731170,122779409,protein_coding,-1,48239,chr5_122731170_122779409
Camkmt,17,85090552,85458588,protein_coding,1,368036,chr17_85090552_85458588
Camkv,9,107935674,107949691,protein_coding,1,14017,chr9_107935674_107949691
Caml,13,55623005,55632411,protein_coding,1,9406,chr13_55623005_55632411
Camp,9,109847379,109849617,protein_coding,-1,2238,chr9_109847379_109849617
Camsap1,2,25926838,25983282,protein_coding,-1,56444,chr2_25926838_25983282
Camsap2,1,136268123,136346104,protein_coding,-1,77981,chr1_136268123_136346104
Camsap3,8,3587293,3609075,protein_coding,1,21782,chr8_3587293_3609075
Camta1,4,150917322,151861876,protein_coding,-1,944554,chr4_150917322_151861876
Camta2,11,70669463,70688105,protein_coding,-1,18642,chr11_70669463_70688105
Cand1,10,119199255,119240055,protein_coding,-1,40800,chr10_119199255_119240055
Cand2,6,115774538,115805557,protein_coding,1,31019,chr6_115774538_115805557
Cant1,11,118406289,118419086,protein_coding,-1,12797,chr11_118406289_118419086
Canx,11,50293961,50325673,protein_coding,-1,31712,chr11_50293961_50325673
Cap1,4,122859047,122886056,protein_coding,-1,27009,chr4_122859047_122886056
Cap2,13,46501848,46650281,protein_coding,1,148433,chr13_46501848_46650281
Capg,6,72544391,72562983,protein_coding,1,18592,chr6_72544391_72562983
Capn1,19,5988545,6015897,protein_coding,-1,27352,chr19_5988545_6015897
Capn10,1,92934376,92947941,protein_coding,1,13565,chr1_92934376_92947941
Capn11,17,45630204,45659325,protein_coding,-1,29121,chr17_45630204_45659325
Capn12,7,28881422,28893563,protein_coding,1,12141,chr7_28881422_28893563
Capn13,17,73306464,73400866,protein_coding,-1,94402,chr17_73306464_73400866
Capn15,17,25958364,25985796,protein_coding,-1,27432,chr17_25958364_25985796
Capn2,1,182467260,182517608,protein_coding,-1,50348,chr1_182467260_182517608
Capn3,2,120463572,120504918,protein_coding,1,41346,chr2_120463572_120504918
Capn5,7,98121559,98178274,protein_coding,-1,56715,chr7_98121559_98178274
Capn6,X,143802231,143827414,protein_coding,-1,25183,chrX_143802231_143827414
Capn7,14,31336638,31371986,protein_coding,1,35348,chr14_31336638_31371986
Capn9,8,124576111,124618731,protein_coding,1,42620,chr8_124576111_124618731
Capns1,7,30186936,30198811,protein_coding,-1,11875,chr7_30186936_30198811
Capns2,8,92901407,92902411,protein_coding,1,1004,chr8_92901407_92902411
Caprin1,2,103762941,103797649,protein_coding,-1,34708,chr2_103762941_103797649
Caprin2,6,148842492,148896237,protein_coding,-1,53745,chr6_148842492_148896237
Caps2,10,112163621,112216555,protein_coding,1,52934,chr10_112163621_112216555
Capsl,15,9436028,9466038,protein_coding,1,30010,chr15_9436028_9466038
Capza1,3,104822779,104864505,protein_coding,-1,41726,chr3_104822779_104864505
Capza2,6,17636234,17666972,protein_coding,1,30738,chr6_17636234_17666972
Capza3,6,140041252,140042778,protein_coding,1,1526,chr6_140041252_140042778
Capzb,4,139192899,139291818,protein_coding,1,98919,chr4_139192899_139291818
Car1,3,14766216,14808368,protein_coding,-1,42152,chr3_14766216_14808368
Car10,11,93098028,93601749,protein_coding,1,503721,chr11_93098028_93601749
Car11,7,45699843,45704682,protein_coding,1,4839,chr7_45699843_45704682
Car12,9,66713686,66766845,protein_coding,1,53159,chr9_66713686_66766845
Car13,3,14641727,14663002,protein_coding,1,21275,chr3_14641727_14663002
Car14,3,95897768,95904691,protein_coding,-1,6923,chr3_95897768_95904691
Car15,16,17835276,17838364,protein_coding,-1,3088,chr16_17835276_17838364
Car2,3,14886273,14900770,protein_coding,1,14497,chr3_14886273_14900770
Car3,3,14863512,14872523,protein_coding,1,9011,chr3_14863512_14872523
Car4,11,84957786,84966044,protein_coding,1,8258,chr11_84957786_84966044
Car5a,8,121916126,121944904,protein_coding,-1,28778,chr8_121916126_121944904
Car5b,X,163976822,164027997,protein_coding,-1,51175,chrX_163976822_164027997
Car6,4,150187015,150201332,protein_coding,-1,14317,chr4_150187015_150201332
Car7,8,104534689,104550343,protein_coding,1,15654,chr8_104534689_104550343
Car8,4,8143362,8239041,protein_coding,-1,95679,chr4_8143362_8239041
Car9,4,43506966,43513729,protein_coding,1,6763,chr4_43506966_43513729
Card10,15,78775138,78803042,protein_coding,-1,27904,chr15_78775138_78803042
Card11,5,140872990,141000582,protein_coding,-1,127592,chr5_140872990_141000582
Card14,11,119307768,119345375,protein_coding,1,37607,chr11_119307768_119345375
Card6,15,5095981,5108539,protein_coding,-1,12558,chr15_5095981_5108539
Card9,2,26352176,26360918,protein_coding,-1,8742,chr2_26352176_26360918
Carf,1,60098247,60153953,protein_coding,1,55706,chr1_60098247_60153953
Carhsp1,16,8658580,8672155,protein_coding,-1,13575,chr16_8658580_8672155
Carm1,9,21546894,21592623,protein_coding,1,45729,chr9_21546894_21592623
Carns1,19,4164323,4175479,protein_coding,-1,11156,chr19_4164323_4175479
Cars,7,143557230,143600090,protein_coding,-1,42860,chr7_143557230_143600090
Cars2,8,11513977,11550783,protein_coding,-1,36806,chr8_11513977_11550783
Cartpt,13,99898489,99901091,protein_coding,-1,2602,chr13_99898489_99901091
Casc1,6,145174834,145211005,protein_coding,-1,36171,chr6_145174834_145211005
Casc3,11,98804905,98833814,protein_coding,1,28909,chr11_98804905_98833814
Casc4,2,121866970,121936220,protein_coding,1,69250,chr2_121866970_121936220
Casd1,6,4600839,4643355,protein_coding,1,42516,chr6_4600839_4643355
Cask,X,13517080,13851367,protein_coding,-1,334287,chrX_13517080_13851367
Caskin1,17,24488601,24508671,protein_coding,1,20070,chr17_24488601_24508671
Caskin2,11,115799183,115813639,protein_coding,-1,14456,chr11_115799183_115813639
Casp1,9,5298508,5307290,protein_coding,1,8782,chr9_5298508_5307290
Casp12,9,5345430,5373032,protein_coding,1,27602,chr9_5345430_5373032
Casp16,17,23550965,23555704,polymorphic_pseudogene,-1,4739,chr17_23550965_23555704
Casp2,6,42264985,42282508,protein_coding,1,17523,chr6_42264985_42282508
Casp3,8,46617291,46639689,protein_coding,1,22398,chr8_46617291_46639689
Casp4,9,5308828,5336783,protein_coding,1,27955,chr9_5308828_5336783
Casp6,3,129901425,129914103,protein_coding,1,12678,chr3_129901425_129914103
Casp7,19,56397129,56442344,protein_coding,1,45215,chr19_56397129_56442344
Casp8,1,58795374,58847503,protein_coding,1,52129,chr1_58795374_58847503
Casp8ap2,4,32615451,32653265,protein_coding,1,37814,chr4_32615451_32653265
Casp9,4,141793612,141815976,protein_coding,1,22364,chr4_141793612_141815976
Casq1,1,172209894,172219868,protein_coding,-1,9974,chr1_172209894_172219868
Casq2,3,102086415,102146514,protein_coding,1,60099,chr3_102086415_102146514
Casr,16,36493696,36562141,protein_coding,-1,68445,chr16_36493696_36562141
Cass4,2,172393794,172433757,protein_coding,1,39963,chr2_172393794_172433757
Cast,13,74692368,74808810,protein_coding,-1,116442,chr13_74692368_74808810
Casz1,4,148804429,148954889,protein_coding,1,150460,chr4_148804429_148954889
Cat,2,103453849,103485160,protein_coding,-1,31311,chr2_103453849_103485160
Catip,1,74362108,74369321,protein_coding,1,7213,chr1_74362108_74369321
Catsper1,19,5335741,5344280,protein_coding,1,8539,chr19_5335741_5344280
Catsper2,2,121392631,121413792,protein_coding,-1,21161,chr2_121392631_121413792
Catsper3,13,55784568,55808998,protein_coding,1,24430,chr13_55784568_55808998
Catsper4,4,134211970,134227383,protein_coding,-1,15413,chr4_134211970_134227383
Catsperb,12,101404653,101626009,protein_coding,1,221356,chr12_101404653_101626009
Catsperd,17,56628143,56664456,protein_coding,1,36313,chr17_56628143_56664456
Catsperg1,7,29181321,29214035,protein_coding,-1,32714,chr7_29181321_29214035
Catsperg2,7,29697219,29727032,protein_coding,-1,29813,chr7_29697219_29727032
Cav1,6,17306335,17341452,protein_coding,1,35117,chr6_17306335_17341452
Cav2,6,17281185,17289115,protein_coding,1,7930,chr6_17281185_17289115
Cav3,6,112459505,112472872,protein_coding,1,13367,chr6_112459505_112472872
Cbfa2t2,2,154436481,154539356,protein_coding,1,102875,chr2_154436481_154539356
Cbfa2t2-ps1,5,60231483,60232212,processed_pseudogene,1,729,chr5_60231483_60232212
Cbfa2t3,8,122625141,122699109,protein_coding,-1,73968,chr8_122625141_122699109
Cbfb,8,105170674,105217989,protein_coding,1,47315,chr8_105170674_105217989
Cbl,9,44142976,44234049,protein_coding,-1,91073,chr9_44142976_44234049
Cblb,16,52031225,52208048,protein_coding,1,176823,chr16_52031225_52208048
Cblc,7,19778881,19796809,protein_coding,-1,17928,chr7_19778881_19796809
Cbll1,12,31484829,31499616,protein_coding,-1,14787,chr12_31484829_31499616
Cbln1,8,87468405,87472609,protein_coding,-1,4204,chr8_87468405_87472609
Cbln2,18,86711110,86718283,protein_coding,1,7173,chr18_86711110_86718283
Cbln3,14,55878913,55884392,protein_coding,-1,5479,chr14_55878913_55884392
Cbln4,2,172036233,172043466,protein_coding,-1,7233,chr2_172036233_172043466
Cbr1,16,93605853,93610505,protein_coding,1,4652,chr16_93605853_93610505
Cbr3,16,93683215,93690990,protein_coding,1,7775,chr16_93683215_93690990
Cbr4,8,61487734,61506694,protein_coding,1,18960,chr8_61487734_61506694
Cbs,17,31608894,31637238,protein_coding,-1,28344,chr17_31608894_31637238
Cbwd1,19,24919916,24961610,protein_coding,-1,41694,chr19_24919916_24961610
Cbx1,11,96789127,96808640,protein_coding,1,19513,chr11_96789127_96808640
Cbx2,11,119022962,119031270,protein_coding,1,8308,chr11_119022962_119031270
Cbx3,6,51470360,51483704,protein_coding,1,13344,chr6_51470360_51483704
Cbx3-ps3,4,83701084,83702036,processed_pseudogene,1,952,chr4_83701084_83702036
Cbx4,11,119077573,119086221,protein_coding,-1,8648,chr11_119077573_119086221
Cbx5,15,103191544,103239816,protein_coding,-1,48272,chr15_103191544_103239816
Cbx6,15,79823896,79834688,protein_coding,-1,10792,chr15_79823896_79834688
Cbx7,15,79915807,79971119,protein_coding,-1,55312,chr15_79915807_79971119
Cbx8,11,119036305,119040969,protein_coding,-1,4664,chr11_119036305_119040969
Cby1,15,79659199,79667660,protein_coding,1,8461,chr15_79659199_79667660
Cby3,11,50354462,50359699,protein_coding,1,5237,chr11_50354462_50359699
Cc2d1a,8,84132828,84147936,protein_coding,-1,15108,chr8_84132828_84147936
Cc2d1b,4,108619940,108634123,protein_coding,1,14183,chr4_108619940_108634123
Cc2d2a,5,43662346,43740972,protein_coding,1,78626,chr5_43662346_43740972
Cc2d2b,19,40748753,40827743,protein_coding,1,78990,chr19_40748753_40827743
Ccar1,10,62743928,62792286,protein_coding,-1,48358,chr10_62743928_62792286
Ccar2,14,70138164,70153811,protein_coding,-1,15647,chr14_70138164_70153811
Ccbe1,18,66045302,66302741,protein_coding,-1,257439,chr18_66045302_66302741
Ccdc102a,8,94902869,94918098,protein_coding,-1,15229,chr8_94902869_94918098
Ccdc103,11,102881204,102885216,protein_coding,1,4012,chr11_102881204_102885216
Ccdc105,10,78746926,78753065,protein_coding,-1,6139,chr10_78746926_78753065
Ccdc106,7,5020553,5060785,protein_coding,1,40232,chr7_5020553_5060785
Ccdc107,4,43492900,43495921,protein_coding,1,3021,chr4_43492900_43495921
Ccdc110,8,45934619,45944145,protein_coding,1,9526,chr8_45934619_45944145
Ccdc112,18,46282151,46311928,protein_coding,-1,29777,chr18_46282151_46311928
Ccdc113,8,95534085,95558890,protein_coding,1,24805,chr8_95534085_95558890
Ccdc114,7,45924072,45948963,protein_coding,1,24891,chr7_45924072_45948963
Ccdc115,1,34436670,34439672,protein_coding,-1,3002,chr1_34436670_34439672
Ccdc116,16,17139064,17147229,protein_coding,-1,8165,chr16_17139064_17147229
Ccdc117,11,5528887,5542187,protein_coding,-1,13300,chr11_5528887_5542187
Ccdc12,9,110656503,110711606,protein_coding,1,55103,chr9_110656503_110711606
Ccdc120,X,7731714,7750905,protein_coding,-1,19191,chrX_7731714_7750905
Ccdc121,1,181509633,181511451,protein_coding,-1,1818,chr1_181509633_181511451
Ccdc122,14,77036772,77112257,protein_coding,1,75485,chr14_77036772_77112257
Ccdc124,8,70868227,70873935,protein_coding,-1,5708,chr8_70868227_70873935
Ccdc125,13,100669717,100697240,protein_coding,1,27523,chr13_100669717_100697240
Ccdc126,6,49319274,49341582,protein_coding,1,22308,chr6_49319274_49341582
Ccdc127,13,74350309,74365783,protein_coding,1,15474,chr13_74350309_74365783
Ccdc13,9,121797627,121839461,protein_coding,-1,41834,chr9_121797627_121839461
Ccdc130,8,84257795,84270380,protein_coding,-1,12585,chr8_84257795_84270380
Ccdc134,15,82127922,82142203,protein_coding,1,14281,chr15_82127922_82142203
Ccdc136,6,29396309,29426994,protein_coding,1,30685,chr6_29396309_29426994
Ccdc137,11,120458115,120464358,protein_coding,1,6243,chr11_120458115_120464358
Ccdc138,10,58497948,58576244,protein_coding,1,78296,chr10_58497948_58576244
Ccdc14,16,34690616,34725202,protein_coding,1,34586,chr16_34690616_34725202
Ccdc141,2,77009902,77170636,protein_coding,-1,160734,chr2_77009902_77170636
Ccdc142,6,83101601,83108394,protein_coding,1,6793,chr6_83101601_83108394
Ccdc142os,6,83106608,83109054,antisense,-1,2446,chr6_83106608_83109054
Ccdc144b,3,36007244,36053547,protein_coding,-1,46303,chr3_36007244_36053547
Ccdc146,5,21292961,21424677,protein_coding,-1,131716,chr5_21292961_21424677
Ccdc148,2,58821070,59160683,protein_coding,-1,339613,chr2_58821070_59160683
Ccdc149,5,52374651,52471521,protein_coding,-1,96870,chr5_52374651_52471521
Ccdc15,9,37275835,37348432,protein_coding,-1,72597,chr9_37275835_37348432
Ccdc150,1,54250683,54368727,protein_coding,1,118044,chr1_54250683_54368727
Ccdc151,9,21989871,22002634,protein_coding,-1,12763,chr9_21989871_22002634
Ccdc152,15,3280070,3303526,protein_coding,-1,23456,chr15_3280070_3303526
Ccdc153,9,44240676,44247306,protein_coding,1,6630,chr9_44240676_44247306
Ccdc154,17,25162461,25171913,protein_coding,1,9452,chr17_25162461_25171913
Ccdc155,7,45183624,45204892,protein_coding,-1,21268,chr7_45183624_45204892
Ccdc157,11,4141123,4160293,protein_coding,-1,19170,chr11_4141123_4160293
Ccdc158,5,92607954,92675271,protein_coding,-1,67317,chr5_92607954_92675271
Ccdc159,9,21927471,21935872,protein_coding,1,8401,chr9_21927471_21935872
Ccdc160,X,52791200,52799468,protein_coding,1,8268,chrX_52791200_52799468
Ccdc162,10,41538846,41716634,protein_coding,-1,177788,chr10_41538846_41716634
Ccdc163,4,116708509,116751206,protein_coding,1,42697,chr4_116708509_116751206
Ccdc166,15,75979872,75982455,protein_coding,-1,2583,chr15_75979872_75982455
Ccdc167,17,29687357,29717044,protein_coding,-1,29687,chr17_29687357_29717044
Ccdc169,3,55137339,55172935,protein_coding,1,35596,chr3_55137339_55172935
Ccdc17,4,116596654,116600266,protein_coding,1,3612,chr4_116596654_116600266
Ccdc170,10,4482502,4562231,protein_coding,1,79729,chr10_4482502_4562231
Ccdc171,4,83525545,83864670,protein_coding,1,339125,chr4_83525545_83864670
Ccdc172,19,58511993,58553085,protein_coding,1,41092,chr19_58511993_58553085
Ccdc173,2,69758033,69789575,protein_coding,-1,31542,chr2_69758033_69789575
Ccdc174,6,91878053,91899843,protein_coding,1,21790,chr6_91878053_91899843
Ccdc175,12,72101300,72185029,protein_coding,-1,83729,chr12_72101300_72185029
Ccdc177,12,80754043,80760687,protein_coding,-1,6644,chr12_80754043_80760687
Ccdc178,18,21810893,22171442,protein_coding,-1,360549,chr18_21810893_22171442
Ccdc18,5,108132875,108233628,protein_coding,1,100753,chr5_108132875_108233628
Ccdc181,1,164275585,164287847,protein_coding,1,12262,chr1_164275585_164287847
Ccdc183,2,25608635,25617678,protein_coding,-1,9043,chr2_25608635_25617678
Ccdc184,15,98167158,98170134,protein_coding,1,2976,chr15_98167158_98170134
Ccdc186,19,56787481,56822190,protein_coding,-1,34709,chr19_56787481_56822190
Ccdc22,X,7593809,7605517,protein_coding,-1,11708,chrX_7593809_7605517
Ccdc24,4,117866524,117872557,protein_coding,-1,6033,chr4_117866524_117872557
Ccdc25,14,65837302,65866607,protein_coding,1,29305,chr14_65837302_65866607
Ccdc27,4,154026639,154042677,protein_coding,-1,16038,chr4_154026639_154042677
Ccdc28a,10,18213676,18234998,protein_coding,-1,21322,chr10_18213676_18234998
Ccdc28b,4,129619274,129623947,protein_coding,-1,4673,chr4_129619274_129623947
Ccdc3,2,5137776,5230878,protein_coding,1,93102,chr2_5137776_5230878
Ccdc30,4,119322466,119415521,protein_coding,-1,93055,chr4_119322466_119415521
Ccdc32,2,119017779,119029393,protein_coding,-1,11614,chr2_119017779_119029393
Ccdc33,9,58028677,58118823,protein_coding,-1,90146,chr9_58028677_58118823
Ccdc34,2,110017817,110173360,protein_coding,1,155543,chr2_110017817_110173360
Ccdc34os,2,110031250,110050479,antisense,-1,19229,chr2_110031250_110050479
Ccdc36,9,108403611,108428484,protein_coding,-1,24873,chr9_108403611_108428484
Ccdc38,10,93540632,93584327,protein_coding,1,43695,chr10_93540632_93584327
Ccdc39,3,33812362,33844310,protein_coding,-1,31948,chr3_33812362_33844310
Ccdc40,11,119228572,119265238,protein_coding,1,36666,chr11_119228572_119265238
Ccdc42,11,68587021,68597966,protein_coding,1,10945,chr11_68587021_68597966
Ccdc43,11,102684686,102697782,protein_coding,-1,13096,chr11_102684686_102697782
Ccdc47,11,106197408,106216344,protein_coding,-1,18936,chr11_106197408_106216344
Ccdc50,16,27388869,27452218,protein_coding,1,63349,chr16_27388869_27452218
Ccdc50-ps,4,100567108,100568048,processed_pseudogene,-1,940,chr4_100567108_100568048
Ccdc51,9,109082493,109092489,protein_coding,1,9996,chr9_109082493_109092489
Ccdc57,11,120826529,120932872,protein_coding,-1,106343,chr11_120826529_120932872
Ccdc58,16,36071685,36092120,protein_coding,1,20435,chr16_36071685_36092120
Ccdc59,10,105841067,105847833,protein_coding,1,6766,chr10_105841067_105847833
Ccdc6,10,70097121,70193200,protein_coding,1,96079,chr10_70097121_70193200
Ccdc60,5,116124641,116288985,protein_coding,-1,164344,chr5_116124641_116288985
Ccdc61,7,18890883,18910415,protein_coding,-1,19532,chr7_18890883_18910415
Ccdc62,5,123930679,123969895,protein_coding,1,39216,chr5_123930679_123969895
Ccdc63,5,122108040,122140823,protein_coding,-1,32783,chr5_122108040_122140823
Ccdc65,15,98708207,98723336,protein_coding,1,15129,chr15_98708207_98723336
Ccdc66,14,27481090,27508460,protein_coding,-1,27370,chr14_27481090_27508460
Ccdc68,18,69925426,69969484,protein_coding,1,44058,chr18_69925426_69969484
Ccdc69,11,55049731,55078131,protein_coding,-1,28400,chr11_55049731_55078131
Ccdc71,9,108460527,108465938,protein_coding,1,5411,chr9_108460527_108465938
Ccdc71l,12,32378704,32382943,protein_coding,1,4239,chr12_32378704_32382943
Ccdc73,2,104867805,105017904,protein_coding,1,150099,chr2_104867805_105017904
Ccdc74a,16,17646470,17650738,protein_coding,1,4268,chr16_17646470_17650738
Ccdc77,6,120324323,120364374,protein_coding,-1,40051,chr6_120324323_120364374
Ccdc78,17,25786580,25790513,protein_coding,1,3933,chr17_25786580_25790513
Ccdc8,7,16992708,16997516,protein_coding,1,4808,chr7_16992708_16997516
Ccdc80,16,45093402,45128077,protein_coding,1,34675,chr16_45093402_45128077
Ccdc81,7,89866148,89903629,protein_coding,-1,37481,chr7_89866148_89903629
Ccdc82,9,13246955,13292520,protein_coding,1,45565,chr9_13246955_13292520
Ccdc83,7,90223873,90265777,protein_coding,-1,41904,chr7_90223873_90265777
Ccdc84,9,44410159,44418569,protein_coding,-1,8410,chr9_44410159_44418569
Ccdc85a,11,28385685,28584324,protein_coding,-1,198639,chr11_28385685_28584324
Ccdc85b,19,5453180,5457894,protein_coding,-1,4714,chr19_5453180_5457894
Ccdc85c,12,108203602,108275425,protein_coding,-1,71823,chr12_108203602_108275425
Ccdc86,19,10941481,10949266,protein_coding,-1,7785,chr19_10941481_10949266
Ccdc87,19,4839366,4842528,protein_coding,1,3162,chr19_4839366_4842528
Ccdc88a,11,29373658,29510808,protein_coding,1,137150,chr11_29373658_29510808
Ccdc88b,19,6844623,6858211,protein_coding,-1,13588,chr19_6844623_6858211
Ccdc88c,12,100911523,101029056,protein_coding,-1,117533,chr12_100911523_101029056
Ccdc89,7,90426577,90428669,protein_coding,1,2092,chr7_90426577_90428669
Ccdc9,7,16274042,16286795,protein_coding,-1,12753,chr7_16274042_16286795
Ccdc90b,7,92561149,92582294,protein_coding,1,21145,chr7_92561149_92582294
Ccdc91,6,147475828,147632612,protein_coding,1,156784,chr6_147475828_147632612
Ccdc92,5,124834418,124862424,protein_coding,-1,28006,chr5_124834418_124862424
Ccdc93,1,121431049,121506460,protein_coding,1,75411,chr1_121431049_121506460
Ccdc96,5,36484588,36488172,protein_coding,1,3584,chr5_36484588_36488172
Ccdc97,7,25711106,25719088,protein_coding,-1,7982,chr7_25711106_25719088
Ccer1,10,97693059,97694923,protein_coding,1,1864,chr10_97693059_97694923
Cchcr1,17,35517100,35531015,protein_coding,1,13915,chr17_35517100_35531015
Cck,9,121489824,121495694,protein_coding,-1,5870,chr9_121489824_121495694
Cckbr,7,105425731,105470898,protein_coding,1,45167,chr7_105425731_105470898
Ccl12,11,82101845,82103400,protein_coding,1,1555,chr11_82101845_82103400
Ccl17,8,94810453,94812036,protein_coding,1,1583,chr8_94810453_94812036
Ccl2,11,82035571,82037453,protein_coding,1,1882,chr11_82035571_82037453
Ccl22,8,94745590,94751699,protein_coding,1,6109,chr8_94745590_94751699
Ccl24,5,135569937,135573049,protein_coding,-1,3112,chr5_135569937_135573049
Ccl25,8,4325210,4360020,protein_coding,1,34810,chr8_4325210_4360020
Ccl27b,4,42655251,42655998,protein_coding,1,747,chr4_42655251_42655998
Ccl28,13,119623819,119654359,protein_coding,1,30540,chr13_119623819_119654359
Ccl3,11,83647844,83649355,protein_coding,-1,1511,chr11_83647844_83649355
Ccl4,11,83662584,83664683,protein_coding,1,2099,chr11_83662584_83664683
Ccl5,11,83525778,83530518,protein_coding,-1,4740,chr11_83525778_83530518
Ccl6,11,83587882,83593087,protein_coding,-1,5205,chr11_83587882_83593087
Ccl9,11,83572919,83578636,protein_coding,-1,5717,chr11_83572919_83578636
Ccm2,11,6546887,6596744,protein_coding,1,49857,chr11_6546887_6596744
Ccm2l,2,153065955,153081735,protein_coding,1,15780,chr2_153065955_153081735
Ccna1,3,55045469,55055501,protein_coding,-1,10032,chr3_55045469_55055501
Ccna2,3,36564865,36572150,protein_coding,-1,7285,chr3_36564865_36572150
Ccnb1,13,100778650,100786570,protein_coding,-1,7920,chr13_100778650_100786570
Ccnb1ip1,14,50789248,50807732,protein_coding,-1,18484,chr14_50789248_50807732
Ccnb2,9,70407692,70421547,protein_coding,-1,13855,chr9_70407692_70421547
Ccnc,4,21727701,21759922,protein_coding,1,32221,chr4_21727701_21759922
Ccnd1,7,144929931,144939925,protein_coding,-1,9994,chr7_144929931_144939925
Ccnd2,6,127125162,127152193,protein_coding,-1,27031,chr6_127125162_127152193
Ccnd3,17,47505051,47599691,protein_coding,1,94640,chr17_47505051_47599691
Ccnd3-ps,4,139345300,139346180,processed_pseudogene,-1,880,chr4_139345300_139346180
Ccndbp1,2,121008403,121016904,protein_coding,1,8501,chr2_121008403_121016904
Ccne1,7,38097984,38107534,protein_coding,-1,9550,chr7_38097984_38107534
Ccne2,4,11191351,11204779,protein_coding,1,13428,chr4_11191351_11204779
Ccnf,17,24222198,24251484,protein_coding,-1,29286,chr17_24222198_24251484
Ccng1,11,40748552,40755311,protein_coding,-1,6759,chr11_40748552_40755311
Ccng2,5,93267257,93276231,protein_coding,1,8974,chr5_93267257_93276231
Ccnh,13,85189408,85223469,protein_coding,1,34061,chr13_85189408_85223469
Ccni,5,93181933,93206495,protein_coding,-1,24562,chr5_93181933_93206495
Ccnj,19,40831279,40848572,protein_coding,1,17293,chr19_40831279_40848572
Ccnjl,11,43528784,43586997,protein_coding,1,58213,chr11_43528784_43586997
Ccnk,12,108179579,108203359,protein_coding,1,23780,chr12_108179579_108203359
Ccnl1,3,65946151,65958249,protein_coding,-1,12098,chr3_65946151_65958249
Ccnl2,4,155812489,155824543,protein_coding,1,12054,chr4_155812489_155824543
Ccno,13,112987802,112990777,protein_coding,1,2975,chr13_112987802_112990777
Ccnt1,15,98538689,98570923,protein_coding,-1,32234,chr15_98538689_98570923
Ccnt2,1,127774164,127808061,protein_coding,1,33897,chr1_127774164_127808061
Ccny,18,9312304,9450154,protein_coding,-1,137850,chr18_9312304_9450154
Ccnyl1,1,64690455,64725644,protein_coding,1,35189,chr1_64690455_64725644
Ccp110,7,118712552,118737024,protein_coding,1,24472,chr7_118712552_118737024
Ccpg1,9,72985429,73016340,protein_coding,1,30911,chr9_72985429_73016340
Ccpg1os,9,72979722,72985382,protein_coding,-1,5660,chr9_72979722_72985382
Ccr1,9,123962124,123968692,protein_coding,-1,6568,chr9_123962124_123968692
Ccr10,11,101172997,101175443,protein_coding,-1,2446,chr11_101172997_101175443
Ccr2,9,124101950,124113557,protein_coding,1,11607,chr9_124101950_124113557
Ccr3,9,124021972,124031689,protein_coding,1,9717,chr9_124021972_124031689
Ccr4,9,114490316,114504916,protein_coding,-1,14600,chr9_114490316_114504916
Ccr5,9,124121543,124147699,protein_coding,1,26156,chr9_124121543_124147699
Ccr6,17,8236043,8257141,protein_coding,1,21098,chr17_8236043_8257141
Ccr7,11,99144196,99155077,protein_coding,-1,10881,chr11_99144196_99155077
Ccr9,9,123678439,123784330,protein_coding,1,105891,chr9_123678439_123784330
Ccrl2,9,111054486,111057519,protein_coding,-1,3033,chr9_111054486_111057519
Ccs,19,4825366,4839332,protein_coding,-1,13966,chr19_4825366_4839332
Ccsap,8,123840831,123860209,protein_coding,-1,19378,chr8_123840831_123860209
Ccser1,6,61180324,62382865,protein_coding,1,1202541,chr6_61180324_62382865
Ccser2,14,36874936,36968777,protein_coding,-1,93841,chr14_36874936_36968777
Cct2,10,117051001,117063814,protein_coding,-1,12813,chr10_117051001_117063814
Cct3,3,88297116,88321767,protein_coding,1,24651,chr3_88297116_88321767
Cct3-ps1,4,52900599,52902683,processed_pseudogene,1,2084,chr4_52900599_52902683
Cct4,11,22990519,23003780,protein_coding,1,13261,chr11_22990519_23003780
Cct5,15,31590800,31601804,protein_coding,-1,11004,chr15_31590800_31601804
Cct6a,5,129786998,129846371,protein_coding,1,59373,chr5_129786998_129846371
Cct6b,11,82719250,82764321,protein_coding,-1,45071,chr11_82719250_82764321
Cct7,6,85451514,85468475,protein_coding,1,16961,chr6_85451514_85468475
Cct8,16,87483326,87495873,protein_coding,-1,12547,chr16_87483326_87495873
Cct8l1,5,25516067,25518027,protein_coding,1,1960,chr5_25516067_25518027
Ccz1,5,143987909,144014877,protein_coding,-1,26968,chr5_143987909_144014877
Cd101,3,100993529,101029556,protein_coding,-1,36027,chr3_100993529_101029556
Cd109,9,78615546,78716253,protein_coding,1,100707,chr9_78615546_78716253
Cd14,18,36725067,36726798,protein_coding,-1,1731,chr18_36725067_36726798
Cd151,7,141467392,141471473,protein_coding,1,4081,chr7_141467392_141471473
Cd160,3,96798763,96829351,protein_coding,-1,30588,chr3_96798763_96829351
Cd163,6,124304656,124330527,protein_coding,1,25871,chr6_124304656_124330527
Cd163l1,7,140218267,140231145,protein_coding,1,12878,chr7_140218267_140231145
Cd164,10,41519414,41531048,protein_coding,1,11634,chr10_41519414_41531048
Cd164l2,4,133212131,133224555,protein_coding,1,12424,chr4_133212131_133224555
Cd180,13,102693558,102739629,protein_coding,1,46071,chr13_102693558_102739629
Cd1d1,3,86995834,86999441,protein_coding,-1,3607,chr3_86995834_86999441
Cd200,16,45382135,45409053,protein_coding,-1,26918,chr16_45382135_45409053
Cd200r1,16,44765736,44794978,protein_coding,1,29242,chr16_44765736_44794978
Cd200r4,16,44811733,44839150,protein_coding,1,27417,chr16_44811733_44839150
Cd207,6,83671215,83677857,protein_coding,-1,6642,chr6_83671215_83677857
Cd209a,8,3743397,3748984,protein_coding,-1,5587,chr8_3743397_3748984
Cd209c,8,3940222,3954746,protein_coding,-1,14524,chr8_3940222_3954746
Cd22,7,30865402,30880342,protein_coding,-1,14940,chr7_30865402_30880342
Cd226,18,89176967,89272229,protein_coding,1,95262,chr18_89176967_89272229
Cd247,1,165788681,165877277,protein_coding,1,88596,chr1_165788681_165877277
Cd248,19,5068078,5070682,protein_coding,1,2604,chr19_5068078_5070682
Cd24a,10,43578284,43584265,protein_coding,1,5981,chr10_43578284_43584265
Cd27,6,125232622,125237010,protein_coding,-1,4388,chr6_125232622_125237010
Cd274,19,29367455,29388095,protein_coding,1,20640,chr19_29367455_29388095
Cd276,9,58524298,58555437,protein_coding,-1,31139,chr9_58524298_58555437
Cd28,1,60716800,60773359,protein_coding,1,56559,chr1_60716800_60773359
Cd2ap,17,42792951,42876665,protein_coding,-1,83714,chr17_42792951_42876665
Cd2bp2,7,127191660,127196050,protein_coding,-1,4390,chr7_127191660_127196050
Cd300a,11,114890041,114904654,protein_coding,1,14613,chr11_114890041_114904654
Cd300lb,11,114922781,114934386,protein_coding,-1,11605,chr11_114922781_114934386
Cd300ld,11,114982274,114989922,protein_coding,-1,7648,chr11_114982274_114989922
Cd300lf,11,115116214,115133992,protein_coding,-1,17778,chr11_115116214_115133992
Cd300lg,11,102041509,102055620,protein_coding,1,14111,chr11_102041509_102055620
Cd302,2,60251993,60284488,protein_coding,-1,32495,chr2_60251993_60284488
Cd320,17,33843091,33849774,protein_coding,1,6683,chr17_33843091_33849774
Cd33,7,43524216,43544428,protein_coding,-1,20212,chr7_43524216_43544428
Cd34,1,194938819,194961279,protein_coding,1,22460,chr1_194938819_194961279
Cd36,5,17781690,17888801,protein_coding,-1,107111,chr5_17781690_17888801
Cd37,7,45233632,45239115,protein_coding,-1,5483,chr7_45233632_45239115
Cd38,5,43868553,43912375,protein_coding,1,43822,chr5_43868553_43912375
Cd3d,9,44981786,44987339,protein_coding,1,5553,chr9_44981786_44987339
Cd3e,9,44998740,45009627,protein_coding,-1,10887,chr9_44998740_45009627
Cd3eap,7,19356014,19359483,protein_coding,-1,3469,chr7_19356014_19359483
Cd4,6,124864692,124888221,protein_coding,-1,23529,chr6_124864692_124888221
Cd40,2,165055627,165072948,protein_coding,1,17321,chr2_165055627_165072948
Cd44,2,102811141,102901665,protein_coding,-1,90524,chr2_102811141_102901665
Cd46,1,195036826,195092249,protein_coding,-1,55423,chr1_195036826_195092249
Cd47,16,49800533,49915010,protein_coding,1,114477,chr16_49800533_49915010
Cd48,1,171682009,171705258,protein_coding,1,23249,chr1_171682009_171705258
Cd5,19,10717116,10739002,protein_coding,-1,21886,chr19_10717116_10739002
Cd52,4,134082448,134095082,protein_coding,-1,12634,chr4_134082448_134095082
Cd53,3,106759921,106790149,protein_coding,-1,30228,chr3_106759921_106790149
Cd55,1,130439027,130462744,protein_coding,-1,23717,chr1_130439027_130462744
Cd59a,2,104095801,104115354,protein_coding,1,19553,chr2_104095801_104115354
Cd59b,2,104069849,104091187,protein_coding,1,21338,chr2_104069849_104091187
Cd6,19,10789341,10830058,protein_coding,-1,40717,chr19_10789341_10830058
Cd63,10,128900989,128912822,protein_coding,1,11833,chr10_128900989_128912822
Cd63-ps,18,50134726,50135600,transcribed_processed_pseudogene,1,874,chr18_50134726_50135600
Cd68,11,69664213,69666153,protein_coding,-1,1940,chr11_69664213_69666153
Cd7,11,121036747,121039418,protein_coding,-1,2671,chr11_121036747_121039418
Cd70,17,57145997,57149777,protein_coding,-1,3780,chr17_57145997_57149777
Cd72,4,43446462,43454628,protein_coding,-1,8166,chr4_43446462_43454628
Cd74,18,60803848,60812652,protein_coding,1,8804,chr18_60803848_60812652
Cd79a,7,24897381,24902197,protein_coding,1,4816,chr7_24897381_24902197
Cd79b,11,106311341,106314762,protein_coding,-1,3421,chr11_106311341_106314762
Cd80,16,38455561,38496335,protein_coding,1,40774,chr16_38455561_38496335
Cd81,7,143052739,143067934,protein_coding,1,15195,chr7_143052739_143067934
Cd82,2,93419111,93463140,protein_coding,-1,44029,chr2_93419111_93463140
Cd83,13,43784775,43803132,protein_coding,1,18357,chr13_43784775_43803132
Cd84,1,171839697,171890718,protein_coding,1,51021,chr1_171839697_171890718
Cd86,16,36603869,36666081,protein_coding,-1,62212,chr16_36603869_36666081
Cd8a,6,71373427,71379173,protein_coding,1,5746,chr6_71373427_71379173
Cd8b1,6,71322788,71337494,protein_coding,1,14706,chr6_71322788_71337494
Cd9,6,125460266,125494791,protein_coding,-1,34525,chr6_125460266_125494791
Cd9-ps,7,41682658,41683307,processed_pseudogene,-1,649,chr7_41682658_41683307
Cd93,2,148436640,148443563,protein_coding,-1,6923,chr2_148436640_148443563
Cd99l2,X,71420060,71492849,protein_coding,-1,72789,chrX_71420060_71492849
Cda,4,138338424,138367992,protein_coding,-1,29568,chr4_138338424_138367992
Cdadc1,14,59559388,59597959,protein_coding,-1,38571,chr14_59559388_59597959
Cdan1,2,120716154,120850128,protein_coding,-1,133974,chr2_120716154_120850128
Cdc123,2,5794294,5845164,protein_coding,-1,50870,chr2_5794294_5845164
Cdc14a,3,116272553,116428745,protein_coding,-1,156192,chr3_116272553_116428745
Cdc14b,13,64189268,64275290,protein_coding,-1,86022,chr13_64189268_64275290
Cdc16,8,13757676,13781938,protein_coding,1,24262,chr8_13757676_13781938
Cdc20,4,118432901,118437352,protein_coding,-1,4451,chr4_118432901_118437352
Cdc20b,13,113035111,113091195,protein_coding,1,56084,chr13_113035111_113091195
Cdc23,18,34630951,34651735,protein_coding,-1,20784,chr18_34630951_34651735
Cdc25a,9,109875579,109893895,protein_coding,1,18316,chr9_109875579_109893895
Cdc25b,2,131186949,131198497,protein_coding,1,11548,chr2_131186949_131198497
Cdc25c,18,34732993,34751533,protein_coding,-1,18540,chr18_34732993_34751533
Cdc26,4,62383654,62408642,protein_coding,-1,24988,chr4_62383654_62408642
Cdc27,11,104502745,104550620,protein_coding,-1,47875,chr11_104502745_104550620
Cdc34,10,79682195,79688398,protein_coding,1,6203,chr10_79682195_79688398
Cdc37,9,21133222,21149982,protein_coding,-1,16760,chr9_21133222_21149982
Cdc37l1,19,28990352,29026681,protein_coding,1,36329,chr19_28990352_29026681
Cdc40,10,40831621,40883311,protein_coding,-1,51690,chr10_40831621_40883311
Cdc42,4,137319696,137357720,protein_coding,-1,38024,chr4_137319696_137357720
Cdc42bpa,1,179960472,180165603,protein_coding,1,205131,chr1_179960472_180165603
Cdc42bpb,12,111292976,111377718,protein_coding,-1,84742,chr12_111292976_111377718
Cdc42bpg,19,6306456,6325652,protein_coding,1,19196,chr19_6306456_6325652
Cdc42ep1,15,78842624,78850897,protein_coding,1,8273,chr15_78842624_78850897
Cdc42ep2,19,5915636,5924816,protein_coding,-1,9180,chr19_5915636_5924816
Cdc42ep3,17,79333727,79355091,protein_coding,-1,21364,chr17_79333727_79355091
Cdc42ep4,11,113726850,113751881,protein_coding,-1,25031,chr11_113726850_113751881
Cdc42ep5,7,4151260,4164860,protein_coding,-1,13600,chr7_4151260_4164860
Cdc42se1,3,95228732,95236409,protein_coding,1,7677,chr3_95228732_95236409
Cdc42se2,11,54717456,54787675,protein_coding,-1,70219,chr11_54717456_54787675
Cdc45,16,18780447,18811987,protein_coding,-1,31540,chr16_18780447_18811987
Cdc5l,17,45391884,45433737,protein_coding,-1,41853,chr17_45391884_45433737
Cdc6,11,98907801,98923940,protein_coding,1,16139,chr11_98907801_98923940
Cdc7,5,106964322,106984432,protein_coding,1,20110,chr5_106964322_106984432
Cdc73,1,143598800,143702893,protein_coding,-1,104093,chr1_143598800_143702893
Cdca2,14,67676331,67715841,protein_coding,-1,39510,chr14_67676331_67715841
Cdca3,6,124829547,124833701,protein_coding,1,4154,chr6_124829547_124833701
Cdca4,12,112820229,112829423,protein_coding,-1,9194,chr12_112820229_112829423
Cdca5,19,6084983,6091777,protein_coding,1,6794,chr19_6084983_6091777
Cdca7,2,72476159,72486893,protein_coding,1,10734,chr2_72476159_72486893
Cdca7l,12,117804289,117878706,protein_coding,1,74417,chr12_117804289_117878706
Cdca8,4,124918465,124939311,protein_coding,-1,20846,chr4_124918465_124939311
Cdcp1,9,123170824,123216038,protein_coding,-1,45214,chr9_123170824_123216038
Cdcp2,4,107096891,107113125,protein_coding,1,16234,chr4_107096891_107113125
Cdh1,8,106603351,106670246,protein_coding,1,66895,chr8_106603351_106670246
Cdh10,15,18818947,19014236,protein_coding,1,195289,chr15_18818947_19014236
Cdh11,8,102632095,102785642,protein_coding,-1,153547,chr8_102632095_102785642
Cdh12,15,20449265,21589533,protein_coding,1,1140268,chr15_20449265_21589533
Cdh13,8,118283733,119324921,protein_coding,1,1041188,chr8_118283733_119324921
Cdh15,8,122847966,122867397,protein_coding,1,19431,chr8_122847966_122867397
Cdh16,8,104601911,104624396,protein_coding,-1,22485,chr8_104601911_104624396
Cdh17,4,11758147,11817895,protein_coding,1,59748,chr4_11758147_11817895
Cdh18,15,22549022,23474418,protein_coding,1,925396,chr15_22549022_23474418
Cdh19,1,110888326,110977584,protein_coding,-1,89258,chr1_110888326_110977584
Cdh2,18,16588877,16809246,protein_coding,-1,220369,chr18_16588877_16809246
Cdh20,1,104768529,104995481,protein_coding,1,226952,chr1_104768529_104995481
Cdh22,2,165111507,165234853,protein_coding,-1,123346,chr2_165111507_165234853
Cdh23,10,60302748,60696490,protein_coding,-1,393742,chr10_60302748_60696490
Cdh24,14,54631231,54641364,protein_coding,-1,10133,chr14_54631231_54641364
Cdh3,8,106510891,106557297,protein_coding,1,46406,chr8_106510891_106557297
Cdh4,2,179442431,179899373,protein_coding,1,456942,chr2_179442431_179899373
Cdh5,8,104101625,104144511,protein_coding,1,42886,chr8_104101625_104144511
Cdh6,15,13028701,13173675,protein_coding,-1,144974,chr15_13028701_13173675
Cdh7,1,109982431,110140157,protein_coding,1,157726,chr1_109982431_110140157
Cdh8,8,99024471,99416471,protein_coding,-1,392000,chr8_99024471_99416471
Cdh9,15,16728756,16857094,protein_coding,1,128338,chr15_16728756_16857094
Cdhr1,14,37077857,37098347,protein_coding,-1,20490,chr14_37077857_37098347
Cdhr2,13,54701461,54736662,protein_coding,1,35201,chr13_54701461_54736662
Cdhr3,12,33033796,33092875,protein_coding,-1,59079,chr12_33033796_33092875
Cdhr4,9,107992497,107999684,protein_coding,1,7187,chr9_107992497_107999684
Cdhr5,7,141269083,141276786,protein_coding,-1,7703,chr7_141269083_141276786
Cdip1,16,4750348,4790292,protein_coding,-1,39944,chr16_4750348_4790292
Cdipt,7,126975914,126980501,protein_coding,1,4587,chr7_126975914_126980501
Cdk1,10,69335146,69352938,protein_coding,-1,17792,chr10_69335146_69352938
Cdk10,8,123224842,123232250,protein_coding,1,7408,chr8_123224842_123232250
Cdk11b,4,155624854,155649938,protein_coding,1,25084,chr4_155624854_155649938
Cdk12,11,98203059,98278504,protein_coding,1,75445,chr11_98203059_98278504
Cdk13,13,17710315,17805097,protein_coding,-1,94782,chr13_17710315_17805097
Cdk14,5,4803391,5420312,protein_coding,-1,616921,chr5_4803391_5420312
Cdk15,1,59256906,59352993,protein_coding,1,96087,chr1_59256906_59352993
Cdk16,X,20687954,20699880,protein_coding,1,11926,chrX_20687954_20699880
Cdk17,10,93160875,93267071,protein_coding,1,106196,chr10_93160875_93267071
Cdk18,1,132112237,132139684,protein_coding,-1,27447,chr1_132112237_132139684
Cdk19,10,40339564,40483818,protein_coding,1,144254,chr10_40339564_40483818
Cdk2,10,128697939,128705031,protein_coding,-1,7092,chr10_128697939_128705031
Cdk20,13,64432314,64441773,protein_coding,1,9459,chr13_64432314_64441773
Cdk2ap1,5,124345417,124363082,protein_coding,-1,17665,chr5_124345417_124363082
Cdk2ap2,19,4097182,4099019,protein_coding,1,1837,chr19_4097182_4099019
Cdk4,10,127063534,127067920,protein_coding,1,4386,chr10_127063534_127067920
Cdk5,5,24418241,24423530,protein_coding,-1,5289,chr5_24418241_24423530
Cdk5r1,11,80477023,80481184,protein_coding,1,4161,chr11_80477023_80481184
Cdk5r2,1,74854934,74857732,protein_coding,1,2798,chr1_74854934_74857732
Cdk5rap1,2,154335380,154373010,protein_coding,-1,37630,chr2_154335380_154373010
Cdk5rap2,4,70216856,70410443,protein_coding,-1,193587,chr4_70216856_70410443
Cdk5rap3,11,96907426,96916496,protein_coding,-1,9070,chr11_96907426_96916496
Cdk6,5,3341485,3531008,protein_coding,1,189523,chr5_3341485_3531008
Cdk7,13,100702631,100730939,protein_coding,-1,28308,chr13_100702631_100730939
Cdk8,5,146231230,146302874,protein_coding,1,71644,chr5_146231230_146302874
Cdk9,2,32705784,32713076,protein_coding,-1,7292,chr2_32705784_32713076
Cdkal1,13,29191746,29855674,protein_coding,-1,663928,chr13_29191746_29855674
Cdkl1,12,69746848,69791267,protein_coding,-1,44419,chr12_69746848_69791267
Cdkl2,5,92006074,92043883,protein_coding,-1,37809,chr5_92006074_92043883
Cdkl3,11,52004221,52089784,protein_coding,1,85563,chr11_52004221_52089784
Cdkl4,17,80523550,80577813,protein_coding,-1,54263,chr17_80523550_80577813
Cdkl5,X,160771923,160994704,protein_coding,-1,222781,chrX_160771923_160994704
Cdkn1a,17,29090976,29100727,protein_coding,1,9751,chr17_29090976_29100727
Cdkn1b,6,134920401,134925513,protein_coding,1,5112,chr6_134920401_134925513
Cdkn1c,7,143458339,143461050,protein_coding,-1,2711,chr7_143458339_143461050
Cdkn2a,4,89274471,89294653,protein_coding,-1,20182,chr4_89274471_89294653
Cdkn2aip,8,47709344,47713932,protein_coding,-1,4588,chr8_47709344_47713932
Cdkn2aipnl,11,51967661,51977334,protein_coding,1,9673,chr11_51967661_51977334
Cdkn2b,4,89306299,89311039,protein_coding,-1,4740,chr4_89306299_89311039
Cdkn2c,4,109660876,109667189,protein_coding,-1,6313,chr4_109660876_109667189
Cdkn2d,9,21288410,21291407,protein_coding,-1,2997,chr9_21288410_21291407
Cdkn3,14,46760541,46771669,protein_coding,1,11128,chr14_46760541_46771669
Cdnf,2,3513030,3526376,protein_coding,1,13346,chr2_3513030_3526376
Cdo1,18,46713193,46728395,protein_coding,-1,15202,chr18_46713193_46728395
Cdon,9,35421128,35507652,protein_coding,1,86524,chr9_35421128_35507652
Cdpf1,15,85806972,85811697,protein_coding,-1,4725,chr15_85806972_85811697
Cdr1,X,61184005,61185558,protein_coding,-1,1553,chrX_61184005_61185558
Cdr2,7,120957036,120982312,protein_coding,-1,25276,chr7_120957036_120982312
Cdr2l,11,115381916,115396132,protein_coding,1,14216,chr11_115381916_115396132
Cdrt4,11,62951193,62993095,protein_coding,1,41902,chr11_62951193_62993095
Cds1,5,101765130,101823858,protein_coding,1,58728,chr5_101765130_101823858
Cds2,2,132263148,132312050,protein_coding,1,48902,chr2_132263148_132312050
Cdsn,17,35552128,35557180,protein_coding,1,5052,chr17_35552128_35557180
Cdt1,8,122568015,122573554,protein_coding,1,5539,chr8_122568015_122573554
Cdv3,9,103353094,103365840,protein_coding,-1,12746,chr9_103353094_103365840
Cdx4,X,103321398,103330592,protein_coding,1,9194,chrX_103321398_103330592
Cdyl,13,35659833,35874063,protein_coding,1,214230,chr13_35659833_35874063
Cdyl2,8,116574400,116732991,protein_coding,-1,158591,chr8_116574400_116732991
Ceacam1,7,25461707,25477603,protein_coding,-1,15896,chr7_25461707_25477603
Ceacam12,7,18065929,18077986,protein_coding,1,12057,chr7_18065929_18077986
Ceacam16,7,19852097,19861299,protein_coding,-1,9202,chr7_19852097_19861299
Ceacam19,7,19875742,19887965,protein_coding,-1,12223,chr7_19875742_19887965
Ceacam2,7,25516042,25539857,protein_coding,-1,23815,chr7_25516042_25539857
Ceacam9,7,16721929,16726132,protein_coding,1,4203,chr7_16721929_16726132
Cebpa,7,35119293,35121928,protein_coding,1,2635,chr7_35119293_35121928
Cebpb,2,167688915,167690418,protein_coding,1,1503,chr2_167688915_167690418
Cebpd,16,15887286,15891031,protein_coding,1,3745,chr16_15887286_15891031
Cebpg,7,35046422,35056573,protein_coding,-1,10151,chr7_35046422_35056573
Cebpz,17,78919006,78937066,protein_coding,-1,18060,chr17_78919006_78937066
Cebpzos,17,78916500,78920306,protein_coding,1,3806,chr17_78916500_78920306
Cecr2,6,120666369,120771190,protein_coding,1,104821,chr6_120666369_120771190
Cel,2,28555795,28563403,protein_coding,-1,7608,chr2_28555795_28563403
Cela1,15,100674421,100687921,protein_coding,-1,13500,chr15_100674421_100687921
Cela2a,4,141814962,141826160,protein_coding,-1,11198,chr4_141814962_141826160
Celf1,2,90940382,91019498,protein_coding,1,79116,chr2_90940382_91019498
Celf2,2,6539694,7509563,protein_coding,-1,969869,chr2_6539694_7509563
Celf3,3,94478295,94492198,protein_coding,1,13903,chr3_94478295_94492198
Celf4,18,25477632,25754157,protein_coding,-1,276525,chr18_25477632_25754157
Celf5,10,81459227,81482709,protein_coding,-1,23482,chr10_81459227_81482709
Celf6,9,59577917,59607292,protein_coding,1,29375,chr9_59577917_59607292
Celrr,1,121087405,121178441,lincRNA,1,91036,chr1_121087405_121178441
Celsr1,15,85898929,86034203,protein_coding,-1,135274,chr15_85898929_86034203
Celsr2,3,108390851,108415552,protein_coding,-1,24701,chr3_108390851_108415552
Celsr3,9,108826320,108852969,protein_coding,1,26649,chr9_108826320_108852969
Cemip,7,83932857,84086502,protein_coding,-1,153645,chr7_83932857_84086502
Cend1,7,141426446,141429491,protein_coding,-1,3045,chr7_141426446_141429491
Cenpa,5,30666777,30674830,protein_coding,1,8053,chr5_30666777_30674830
Cenpb,2,131175182,131180067,protein_coding,-1,4885,chr2_131175182_131180067
Cenpc1,5,86012024,86065583,protein_coding,-1,53559,chr5_86012024_86065583
Cenpe,3,135212537,135273611,protein_coding,1,61074,chr3_135212537_135273611
Cenpf,1,189640606,189688086,protein_coding,-1,47480,chr1_189640606_189688086
Cenph,13,100759674,100775899,protein_coding,-1,16225,chr13_100759674_100775899
Cenpi,X,134308084,134362639,protein_coding,1,54555,chrX_134308084_134362639
Cenpj,14,56526761,56575425,protein_coding,-1,48664,chr14_56526761_56575425
Cenpk,13,104228611,104252392,protein_coding,1,23781,chr13_104228611_104252392
Cenpl,1,161070713,161086724,protein_coding,1,16011,chr1_161070713_161086724
Cenpm,15,82233779,82244748,protein_coding,-1,10969,chr15_82233779_82244748
Cenpn,8,116921730,116941507,protein_coding,1,19777,chr8_116921730_116941507
Cenpo,12,4196004,4234294,protein_coding,-1,38290,chr12_4196004_4234294
Cenpp,13,49464023,49652785,protein_coding,-1,188762,chr13_49464023_49652785
Cenpq,17,40923051,40935047,protein_coding,-1,11996,chr17_40923051_40935047
Cenpt,8,105844673,105853278,protein_coding,-1,8605,chr8_105844673_105853278
Cenpu,8,46552028,46580007,protein_coding,1,27979,chr8_46552028_46580007
Cenpv,11,62524946,62539261,protein_coding,-1,14315,chr11_62524946_62539261
Cenpw,10,30194569,30200560,protein_coding,-1,5991,chr10_30194569_30200560
Cep104,4,153975194,154008732,protein_coding,1,33538,chr4_153975194_154008732
Cep112,11,108425192,108860615,protein_coding,1,435423,chr11_108425192_108860615
Cep120,18,53681723,53744608,protein_coding,-1,62885,chr18_53681723_53744608
Cep128,12,90998492,91384409,protein_coding,-1,385917,chr12_90998492_91384409
Cep131,11,120064430,120086827,protein_coding,-1,22397,chr11_120064430_120086827
Cep135,5,76588698,76646466,protein_coding,1,57768,chr5_76588698_76646466
Cep152,2,125563088,125625113,protein_coding,-1,62025,chr2_125563088_125625113
Cep162,9,87189577,87255536,protein_coding,-1,65959,chr9_87189577_87255536
Cep164,9,45766946,45828691,protein_coding,-1,61745,chr9_45766946_45828691
Cep170,1,176733653,176814067,protein_coding,-1,80414,chr1_176733653_176814067
Cep170b,12,112720455,112746592,protein_coding,1,26137,chr12_112720455_112746592
Cep19,16,32099800,32108069,protein_coding,1,8269,chr16_32099800_32108069
Cep192,18,67800107,67885170,protein_coding,1,85063,chr18_67800107_67885170
Cep250,2,155956458,155998900,protein_coding,1,42442,chr2_155956458_155998900
Cep290,10,100487558,100574840,protein_coding,1,87282,chr10_100487558_100574840
Cep295,9,15316915,15357788,protein_coding,-1,40873,chr9_15316915_15357788
Cep350,1,155844964,155973255,protein_coding,-1,128291,chr1_155844964_155973255
Cep41,6,30653457,30693749,protein_coding,-1,40292,chr6_30653457_30693749
Cep44,8,56531522,56551047,protein_coding,-1,19525,chr8_56531522_56551047
Cep55,19,38055011,38074423,protein_coding,1,19412,chr19_38055011_38074423
Cep57,9,13807792,13827107,protein_coding,-1,19315,chr9_13807792_13827107
Cep57l1,10,41718840,41809871,protein_coding,-1,91031,chr10_41718840_41809871
Cep63,9,102584588,102626534,protein_coding,-1,41946,chr9_102584588_102626534
Cep68,11,20227037,20249429,protein_coding,-1,22392,chr11_20227037_20249429
Cep70,9,99243367,99300404,protein_coding,1,57037,chr9_99243367_99300404
Cep72,13,74036500,74062299,protein_coding,-1,25799,chr13_74036500_74062299
Cep76,18,67617800,67641336,protein_coding,-1,23536,chr18_67617800_67641336
Cep78,19,15955773,15984989,protein_coding,-1,29216,chr19_15955773_15984989
Cep83,10,94688654,94790853,protein_coding,1,102199,chr10_94688654_94790853
Cep83os,10,94671025,94688576,bidirectional_promoter_lncRNA,-1,17551,chr10_94671025_94688576
Cep85,4,134129858,134187112,protein_coding,-1,57254,chr4_134129858_134187112
Cep85l,10,53273443,53379947,protein_coding,-1,106504,chr10_53273443_53379947
Cep89,7,35397035,35438689,protein_coding,1,41654,chr7_35397035_35438689
Cep95,11,106789252,106819930,protein_coding,1,30678,chr11_106789252_106819930
Cep97,16,55899888,55934855,protein_coding,-1,34967,chr16_55899888_55934855
Cept1,3,106502260,106547802,protein_coding,-1,45542,chr3_106502260_106547802
Cer1,4,82881751,82885148,protein_coding,-1,3397,chr4_82881751_82885148
Cercam,2,29869164,29882840,protein_coding,1,13676,chr2_29869164_29882840
Cerk,15,86139128,86186141,protein_coding,-1,47013,chr15_86139128_86186141
Cerkl,2,79330543,79456785,protein_coding,-1,126242,chr2_79330543_79456785
Cers2,3,95314791,95323599,protein_coding,1,8808,chr3_95314791_95323599
Cers3,7,66743504,66823691,protein_coding,1,80187,chr7_66743504_66823691
Cers4,8,4493026,4531680,protein_coding,1,38654,chr8_4493026_4531680
Cers5,15,99734881,99772885,protein_coding,-1,38004,chr15_99734881_99772885
Cers6,2,68861441,69114282,protein_coding,1,252841,chr2_68861441_69114282
Ces1a,8,93020214,93048192,protein_coding,-1,27978,chr8_93020214_93048192
Ces1d,8,93166068,93197838,protein_coding,-1,31770,chr8_93166068_93197838
Ces2b,8,104831572,104840093,protein_coding,1,8521,chr8_104831572_104840093
Ces2g,8,104961718,104969537,protein_coding,1,7819,chr8_104961718_104969537
Ces3b,8,105083753,105093929,protein_coding,1,10176,chr8_105083753_105093929
Ces4a,8,105131800,105150109,protein_coding,1,18309,chr8_105131800_105150109
Ces5a,8,93499064,93535830,protein_coding,-1,36766,chr8_93499064_93535830
Cetn2,X,72913532,72918411,protein_coding,-1,4879,chrX_72913532_72918411
Cetn3,13,81783077,81797155,protein_coding,1,14078,chr13_81783077_81797155
Cetn4,3,37307749,37312708,protein_coding,-1,4959,chr3_37307749_37312708
Cfap126,1,171113918,171126967,protein_coding,1,13049,chr1_171113918_171126967
Cfap20,8,95420249,95434869,protein_coding,-1,14620,chr8_95420249_95434869
Cfap221,1,119923341,119997234,protein_coding,-1,73893,chr1_119923341_119997234
Cfap36,11,29221532,29247409,protein_coding,-1,25877,chr11_29221532_29247409
Cfap43,19,47736857,47919287,protein_coding,-1,182430,chr19_47736857_47919287
Cfap44,16,44394796,44482428,protein_coding,1,87632,chr16_44394796_44482428
Cfap45,1,172520801,172545870,protein_coding,1,25069,chr1_172520801_172545870
Cfap46,7,139600951,139683817,protein_coding,-1,82866,chr7_139600951_139683817
Cfap52,11,67924806,67965651,protein_coding,-1,40845,chr11_67924806_67965651
Cfap53,18,74283090,74359986,protein_coding,1,76896,chr18_74283090_74359986
Cfap54,10,92775619,93081618,protein_coding,-1,305999,chr10_92775619_93081618
Cfap57,4,118554551,118620777,protein_coding,-1,66226,chr4_118554551_118620777
Cfap58,19,47937675,48035387,protein_coding,1,97712,chr19_47937675_48035387
Cfap61,2,145934784,146215039,protein_coding,1,280255,chr2_145934784_146215039
Cfap69,5,5579278,5664239,protein_coding,-1,84961,chr5_5579278_5664239
Cfap70,14,20394193,20452226,protein_coding,-1,58033,chr14_20394193_20452226
Cfap74,4,155409190,155466823,protein_coding,1,57633,chr4_155409190_155466823
Cfap97,8,46151771,46195590,protein_coding,1,43819,chr8_46151771_46195590
Cfap99,5,34288600,34327327,protein_coding,1,38727,chr5_34288600_34327327
Cfb,17,34856374,34862518,protein_coding,-1,6144,chr17_34856374_34862518
Cfd,10,79890853,79892655,protein_coding,1,1802,chr10_79890853_79892655
Cfdp1,8,111768491,111854291,protein_coding,-1,85800,chr8_111768491_111854291
Cfh,1,140084708,140183764,protein_coding,-1,99056,chr1_140084708_140183764
Cfhr1,1,139547053,139560272,protein_coding,-1,13219,chr1_139547053_139560272
Cfi,3,129835884,129875332,protein_coding,1,39448,chr3_129835884_129875332
Cfl1,19,5490455,5495201,protein_coding,1,4746,chr19_5490455_5495201
Cfl2,12,54858809,54862877,protein_coding,-1,4068,chr12_54858809_54862877
Cflar,1,58711508,58758884,protein_coding,1,47376,chr1_58711508_58758884
Cfp,X,20925454,20931555,protein_coding,-1,6101,chrX_20925454_20931555
Cftr,6,18170687,18322768,protein_coding,1,152081,chr6_18170687_18322768
Cggbp1,16,64851996,64859507,protein_coding,1,7511,chr16_64851996_64859507
Cgn,3,94760069,94786515,protein_coding,-1,26446,chr3_94760069_94786515
Cgnl1,9,71626509,71771602,protein_coding,-1,145093,chr9_71626509_71771602
Cgref1,5,30933143,30945591,protein_coding,-1,12448,chr5_30933143_30945591
Cgrrf1,14,46832125,46854193,protein_coding,1,22068,chr14_46832125_46854193
Ch25h,19,34473778,34475164,protein_coding,-1,1386,chr19_34473778_34475164
Chac1,2,119351229,119354381,protein_coding,1,3152,chr2_119351229_119354381
Chac2,11,30976707,30986350,protein_coding,-1,9643,chr11_30976707_30986350
Chadl,15,81678296,81697287,protein_coding,-1,18991,chr15_81678296_81697287
Chaf1a,17,56040439,56072289,protein_coding,1,31850,chr17_56040439_56072289
Chaf1b,16,93883901,93906115,protein_coding,1,22214,chr16_93883901_93906115
Champ1,8,13869641,13881639,protein_coding,1,11998,chr8_13869641_13881639
Chat,14,32408203,32465989,protein_coding,-1,57786,chr14_32408203_32465989
Chchd1,14,20703006,20704425,protein_coding,1,1419,chr14_20703006_20704425
Chchd10,10,75933130,75937747,protein_coding,1,4617,chr10_75933130_75937747
Chchd2,5,129881156,129887470,protein_coding,-1,6314,chr5_129881156_129887470
Chchd3,6,32790976,33060260,protein_coding,-1,269284,chr6_32790976_33060260
Chchd4,6,91462172,91473546,protein_coding,-1,11374,chr6_91462172_91473546
Chchd5,2,129129700,129134134,protein_coding,1,4434,chr2_129129700_129134134
Chchd6,6,89383146,89595652,protein_coding,-1,212506,chr6_89383146_89595652
Chchd7,4,3938888,3951046,protein_coding,1,12158,chr4_3938888_3951046
Chd1,17,15704967,15772610,protein_coding,1,67643,chr17_15704967_15772610
Chd1l,3,97560742,97610203,protein_coding,-1,49461,chr3_97560742_97610203
Chd2,7,73426638,73541830,protein_coding,-1,115192,chr7_73426638_73541830
Chd3,11,69343273,69369406,protein_coding,-1,26133,chr11_69343273_69369406
Chd4,6,125095981,125130591,protein_coding,1,34610,chr6_125095981_125130591
Chd5,4,152338651,152390194,protein_coding,1,51543,chr4_152338651_152390194
Chd6,2,160946978,161109075,protein_coding,-1,162097,chr2_160946978_161109075
Chd7,4,8690406,8867659,protein_coding,1,177253,chr4_8690406_8867659
Chd8,14,52198151,52257780,protein_coding,-1,59629,chr14_52198151_52257780
Chd9,8,90828352,91054516,protein_coding,1,226164,chr8_90828352_91054516
Chdh,14,30009023,30040527,protein_coding,1,31504,chr14_30009023_30040527
Chek1,9,36708482,36727065,protein_coding,-1,18583,chr9_36708482_36727065
Chek2,5,110839979,110874145,protein_coding,1,34166,chr5_110839979_110874145
Cherp,8,72460489,72475226,protein_coding,-1,14737,chr8_72460489_72475226
Chfr,5,110135842,110171972,protein_coding,1,36130,chr5_110135842_110171972
Chga,12,102554969,102565028,protein_coding,1,10059,chr12_102554969_102565028
Chgb,2,132781278,132795079,protein_coding,1,13801,chr2_132781278_132795079
Chia1,3,106113229,106132120,protein_coding,1,18891,chr3_106113229_106132120
Chic1,X,103356476,103396092,protein_coding,1,39616,chrX_103356476_103396092
Chic2,5,74997988,75044774,protein_coding,-1,46786,chr5_74997988_75044774
Chid1,7,141493136,141539857,protein_coding,-1,46721,chr7_141493136_141539857
Chil1,1,134182176,134190181,protein_coding,1,8005,chr1_134182176_134190181
Chil5,3,106016919,106032814,protein_coding,-1,15895,chr3_106016919_106032814
Chit1,1,134111242,134151540,protein_coding,1,40298,chr1_134111242_134151540
Chka,19,3851773,3894369,protein_coding,1,42596,chr19_3851773_3894369
Chkb,15,89426360,89429908,protein_coding,-1,3548,chr15_89426360_89429908
Chl1,6,103510586,103750211,protein_coding,1,239625,chr6_103510586_103750211
Chm,X,113040593,113185517,protein_coding,-1,144924,chrX_113040593_113185517
Chml,1,175682237,175692901,protein_coding,-1,10664,chr1_175682237_175692901
Chmp1a,8,123204264,123212763,protein_coding,-1,8499,chr8_123204264_123212763
Chmp1b,18,67205366,67207889,protein_coding,1,2523,chr18_67205366_67207889
Chmp2a,7,13032010,13034807,protein_coding,-1,2797,chr7_13032010_13034807
Chmp2b,16,65539128,65562726,protein_coding,-1,23598,chr16_65539128_65562726
Chmp3,6,71543797,71582609,protein_coding,1,38812,chr6_71543797_71582609
Chmp4b,2,154651705,154694785,protein_coding,1,43080,chr2_154651705_154694785
Chmp4c,3,10366907,10428856,protein_coding,1,61949,chr3_10366907_10428856
Chmp5,4,40948407,40965303,protein_coding,1,16896,chr4_40948407_40965303
Chmp6,11,119913441,119919548,protein_coding,1,6107,chr11_119913441_119919548
Chmp7,14,69717000,69732541,protein_coding,-1,15541,chr14_69717000_69732541
Chn1,2,73610660,73775346,protein_coding,-1,164686,chr2_73610660_73775346
Chn1os3,2,73596526,73616012,antisense,1,19486,chr2_73596526_73616012
Chn2,6,54039554,54301810,protein_coding,1,262256,chr6_54039554_54301810
Chodl,16,78930948,78951733,protein_coding,1,20785,chr16_78930948_78951733
Chordc1,9,18292125,18317442,protein_coding,1,25317,chr9_18292125_18317442
Chp1,2,119547697,119587027,protein_coding,1,39330,chr2_119547697_119587027
Chp2,7,122219496,122222824,protein_coding,1,3328,chr7_122219496_122222824
Chpf,1,75474569,75479307,protein_coding,-1,4738,chr1_75474569_75479307
Chpf2,5,24586741,24594556,protein_coding,1,7815,chr5_24586741_24594556
Chpt1,10,88452745,88504073,protein_coding,-1,51328,chr10_88452745_88504073
Chrac1,15,73090392,73097554,protein_coding,1,7162,chr15_73090392_73097554
Chrd,16,20733127,20742384,protein_coding,1,9257,chr16_20733127_20742384
Chrdl1,X,143285674,143394262,protein_coding,-1,108588,chrX_143285674_143394262
Chrdl2,7,100006172,100034728,protein_coding,1,28556,chr7_100006172_100034728
Chrm1,19,8663789,8683587,protein_coding,1,19798,chr19_8663789_8683587
Chrm2,6,36388084,36528414,protein_coding,1,140330,chr6_36388084_36528414
Chrm3,13,9875486,10360847,protein_coding,-1,485361,chr13_9875486_10360847
Chrm4,2,91927249,91928688,protein_coding,1,1439,chr2_91927249_91928688
Chrm5,2,112479171,112480769,protein_coding,-1,1598,chr2_112479171_112480769
Chrna1,2,73563215,73580338,protein_coding,-1,17123,chr2_73563215_73580338
Chrna10,7,102111266,102116828,protein_coding,-1,5562,chr7_102111266_102116828
Chrna2,14,66135039,66152948,protein_coding,1,17909,chr14_66135039_66152948
Chrna3,9,55010111,55026562,protein_coding,-1,16451,chr9_55010111_55026562
Chrna4,2,181018380,181043546,protein_coding,-1,25166,chr2_181018380_181043546
Chrna5,9,54980880,55007779,protein_coding,1,26899,chr9_54980880_55007779
Chrna6,8,27403212,27413944,protein_coding,-1,10732,chr8_27403212_27413944
Chrna7,7,63098692,63212569,protein_coding,-1,113877,chr7_63098692_63212569
Chrna9,5,65934921,65977326,protein_coding,1,42405,chr5_65934921_65977326
Chrnb1,11,69784036,69795943,protein_coding,-1,11907,chr11_69784036_69795943
Chrnb2,3,89746195,89764632,protein_coding,-1,18437,chr3_89746195_89764632
Chrnb3,8,27368711,27399730,protein_coding,1,31019,chr8_27368711_27399730
Chrnb4,9,55028154,55048779,protein_coding,-1,20625,chr9_55028154_55048779
Chrne,11,70614883,70619216,protein_coding,-1,4333,chr11_70614883_70619216
Chst1,2,92599707,92615250,protein_coding,1,15543,chr2_92599707_92615250
Chst10,1,38863867,38898161,protein_coding,-1,34294,chr1_38863867_38898161
Chst11,10,82985498,83195900,protein_coding,1,210402,chr10_82985498_83195900
Chst12,5,140505550,140525724,protein_coding,1,20174,chr5_140505550_140525724
Chst13,6,90308349,90325185,protein_coding,-1,16836,chr6_90308349_90325185
Chst14,2,118926496,118928585,protein_coding,1,2089,chr2_118926496_118928585
Chst15,7,132235780,132317228,protein_coding,-1,81448,chr7_132235780_132317228
Chst2,9,95399292,95406722,protein_coding,-1,7430,chr9_95399292_95406722
Chst3,10,60181532,60219260,protein_coding,-1,37728,chr10_60181532_60219260
Chst4,8,110029153,110039740,protein_coding,-1,10587,chr8_110029153_110039740
Chst5,8,111889136,111910447,protein_coding,-1,21311,chr8_111889136_111910447
Chst7,X,20059560,20097521,protein_coding,1,37961,chrX_20059560_20097521
Chst8,7,34674468,34812711,protein_coding,-1,138243,chr7_34674468_34812711
Chst9,18,15451924,15760157,protein_coding,-1,308233,chr18_15451924_15760157
Chsy1,7,66109515,66173798,protein_coding,1,64283,chr7_66109515_66173798
Chsy3,18,59175401,59535999,protein_coding,1,360598,chr18_59175401_59535999
Chtf18,17,25718926,25727419,protein_coding,-1,8493,chr17_25718926_25727419
Chtf8,8,106883863,106893601,protein_coding,-1,9738,chr8_106883863_106893601
Chtop,3,90498956,90509498,protein_coding,-1,10542,chr3_90498956_90509498
Chuk,19,44073335,44107480,protein_coding,-1,34145,chr19_44073335_44107480
Churc1,12,76765538,76783180,protein_coding,1,17642,chr12_76765538_76783180
Ciao1,2,127240938,127247816,protein_coding,-1,6878,chr2_127240938_127247816
Ciapin1,8,94819804,94838358,protein_coding,-1,18554,chr8_94819804_94838358
Ciart,3,95878503,95882251,protein_coding,-1,3748,chr3_95878503_95882251
Cib1,7,80227147,80232813,protein_coding,-1,5666,chr7_80227147_80232813
Cib2,9,54544794,54560218,protein_coding,-1,15424,chr9_54544794_54560218
Cib3,8,72204335,72212996,protein_coding,-1,8661,chr8_72204335_72212996
Cic,7,25267704,25294159,protein_coding,1,26455,chr7_25267704_25294159
Cidea,18,67343604,67367785,protein_coding,1,24181,chr18_67343604_67367785
Cideb,14,55754050,55758458,protein_coding,-1,4408,chr14_55754050_55758458
Cidec,6,113424634,113435760,protein_coding,-1,11126,chr6_113424634_113435760
Ciita,16,10480059,10528418,protein_coding,1,48359,chr16_10480059_10528418
Cilp,9,65265180,65280605,protein_coding,1,15425,chr9_65265180_65280605
Cilp2,8,69880369,69887687,protein_coding,-1,7318,chr8_69880369_69887687
Cinp,12,110872610,110889145,protein_coding,-1,16535,chr12_110872610_110889145
Cipc,12,86947043,86965362,protein_coding,1,18319,chr12_86947043_86965362
Cir1,2,73283105,73312701,protein_coding,-1,29596,chr2_73283105_73312701
Cirbp,10,80165985,80172786,protein_coding,1,6801,chr10_80165985_80172786
Cisd1,10,71330480,71344954,protein_coding,-1,14474,chr10_71330480_71344954
Cisd2,3,135406412,135423925,protein_coding,-1,17513,chr3_135406412_135423925
Cisd3,11,97685826,97688621,protein_coding,1,2795,chr11_97685826_97688621
Cish,9,107296026,107302784,protein_coding,1,6758,chr9_107296026_107302784
Cit,5,115845278,116008947,protein_coding,1,163669,chr5_115845278_116008947
Cited1,X,102247381,102252181,protein_coding,-1,4800,chrX_102247381_102252181
Cited2,10,17723218,17725674,protein_coding,1,2456,chr10_17723218_17725674
Cited4,4,120666572,120667820,protein_coding,1,1248,chr4_120666572_120667820
Ciz1,2,32352327,32380970,protein_coding,1,28643,chr2_32352327_32380970
Ckap2,8,22168160,22185819,protein_coding,-1,17659,chr8_22168160_22185819
Ckap2l,2,129268210,129297212,protein_coding,-1,29002,chr2_129268210_129297212
Ckap4,10,84526305,84534062,protein_coding,-1,7757,chr10_84526305_84534062
Ckap5,2,91526762,91620664,protein_coding,1,93902,chr2_91526762_91620664
Ckb,12,111669361,111672338,protein_coding,-1,2977,chr12_111669361_111672338
Cklf,8,104250861,104264938,protein_coding,1,14077,chr8_104250861_104264938
Ckm,7,19404776,19422841,protein_coding,1,18065,chr7_19404776_19422841
Ckmt1,2,121357714,121363737,protein_coding,1,6023,chr2_121357714_121363737
Ckmt2,13,91853387,91876885,protein_coding,-1,23498,chr13_91853387_91876885
Cks1b,3,89415472,89418383,protein_coding,-1,2911,chr3_89415472_89418383
Cks1brt,8,85151924,85173622,protein_coding,1,21698,chr8_85151924_85173622
Cks2,13,51645232,51650660,protein_coding,1,5428,chr13_51645232_51650660
Clasp1,1,118389058,118612678,protein_coding,1,223620,chr1_118389058_118612678
Clasp2,9,113741473,113919682,protein_coding,1,178209,chr9_113741473_113919682
Clasrp,7,19581035,19604486,protein_coding,-1,23451,chr7_19581035_19604486
Clca2,3,145070263,145099443,protein_coding,-1,29180,chr3_145070263_145099443
Clca3a1,3,144729677,144760977,protein_coding,-1,31300,chr3_144729677_144760977
Clca3a2,3,144796559,144819494,protein_coding,-1,22935,chr3_144796559_144819494
Clca3b,3,144822623,144849357,protein_coding,-1,26734,chr3_144822623_144849357
Clca4a,3,144952480,144975045,protein_coding,-1,22565,chr3_144952480_144975045
Clca4b,3,144910921,144932529,protein_coding,-1,21608,chr3_144910921_144932529
Clca4c-ps,3,144861826,144896011,transcribed_unprocessed_pseudogene,-1,34185,chr3_144861826_144896011
Clcc1,3,108653913,108678840,protein_coding,1,24927,chr3_108653913_108678840
Clcf1,19,4214237,4223490,protein_coding,1,9253,chr19_4214237_4223490
Clcn1,6,42286685,42315756,protein_coding,1,29071,chr6_42286685_42315756
Clcn2,16,20702964,20717746,protein_coding,-1,14782,chr16_20702964_20717746
Clcn3,8,60910389,60983300,protein_coding,-1,72911,chr8_60910389_60983300
Clcn5,X,7153810,7319358,protein_coding,-1,165548,chrX_7153810_7319358
Clcn6,4,148004259,148038821,protein_coding,-1,34562,chr4_148004259_148038821
Clcn7,17,25133391,25162104,protein_coding,1,28713,chr17_25133391_25162104
Clcnka,4,141384610,141398724,protein_coding,-1,14114,chr4_141384610_141398724
Clcnkb,4,141404353,141416014,protein_coding,-1,11661,chr4_141404353_141416014
Cldn1,16,26356642,26371841,protein_coding,-1,15199,chr16_26356642_26371841
Cldn10,14,118787908,118875489,protein_coding,1,87581,chr14_118787908_118875489
Cldn11,3,31149920,31164324,protein_coding,1,14404,chr3_31149920_31164324
Cldn12,5,5489537,5514958,protein_coding,-1,25421,chr5_5489537_5514958
Cldn14,16,93919031,94008837,protein_coding,-1,89806,chr16_93919031_94008837
Cldn15,5,136966616,136975858,protein_coding,1,9242,chr5_136966616_136975858
Cldn19,4,119255414,119262438,protein_coding,1,7024,chr4_119255414_119262438
Cldn20,17,3532554,3533213,protein_coding,1,659,chr17_3532554_3533213
Cldn22,8,47824482,47825476,protein_coding,1,994,chr8_47824482_47825476
Cldn23,8,35824712,35826559,protein_coding,-1,1847,chr8_35824712_35826559
Cldn3,5,134986214,134987472,protein_coding,1,1258,chr5_134986214_134987472
Cldn4,5,134945119,134946934,protein_coding,-1,1815,chr5_134945119_134946934
Cldn5,16,18776847,18778262,protein_coding,1,1415,chr16_18776847_18778262
Cldn7,11,69964779,69967885,protein_coding,1,3106,chr11_69964779_69967885
Cldn9,17,23682584,23684026,protein_coding,-1,1442,chr17_23682584_23684026
Cldnd1,16,58727910,58734251,protein_coding,1,6341,chr16_58727910_58734251
Cldnd2,7,43440782,43443334,protein_coding,1,2552,chr7_43440782_43443334
Clec10a,11,70156197,70170834,protein_coding,1,14637,chr11_70156197_70170834
Clec11a,7,44302687,44306902,protein_coding,-1,4215,chr7_44302687_44306902
Clec14a,12,58264720,58269290,protein_coding,-1,4570,chr12_58264720_58269290
Clec16a,16,10545339,10744878,protein_coding,1,199539,chr16_10545339_10744878
Clec18a,8,111058920,111092426,protein_coding,-1,33506,chr8_111058920_111092426
Clec1a,6,129424772,129452000,protein_coding,-1,27228,chr6_129424772_129452000
Clec2d,6,129180615,129186534,protein_coding,1,5919,chr6_129180615_129186534
Clec2e,6,129091998,129100913,protein_coding,-1,8915,chr6_129091998_129100913
Clec2f,6,129014112,129020527,protein_coding,1,6415,chr6_129014112_129020527
Clec2g,6,128934381,128984707,protein_coding,1,50326,chr6_128934381_128984707
Clec2h,6,128662385,128677374,protein_coding,1,14989,chr6_128662385_128677374
Clec2l,6,38663067,38680865,protein_coding,1,17798,chr6_38663067_38680865
Clec3b,9,123150946,123157432,protein_coding,1,6486,chr9_123150946_123157432
Clec4a2,6,123106428,123143999,protein_coding,1,37571,chr6_123106428_123143999
Clec4a3,6,122952515,122969875,protein_coding,1,17360,chr6_122952515_122969875
Clec4g,8,3707064,3720651,protein_coding,-1,13587,chr8_3707064_3720651
Clec5a,6,40574894,40585821,protein_coding,-1,10927,chr6_40574894_40585821
Clec9a,6,129408862,129424763,protein_coding,1,15901,chr6_129408862_129424763
Clgn,8,83389867,83428552,protein_coding,1,38685,chr8_83389867_83428552
Clhc1,11,29547950,29578367,protein_coding,1,30417,chr11_29547950_29578367
Clic1,17,35049966,35058749,protein_coding,1,8783,chr17_35049966_35058749
Clic3,2,25456838,25458776,protein_coding,1,1938,chr2_25456838_25458776
Clic4,4,135213969,135272814,protein_coding,-1,58845,chr4_135213969_135272814
Clic5,17,44134768,44280172,protein_coding,1,145404,chr17_44134768_44280172
Clic6,16,92485736,92541243,protein_coding,1,55507,chr16_92485736_92541243
Clint1,11,45851964,45910625,protein_coding,1,58661,chr11_45851964_45910625
Clip1,5,123577795,123684618,protein_coding,-1,106823,chr5_123577795_123684618
Clip2,5,134489383,134552434,protein_coding,-1,63051,chr5_134489383_134552434
Clip3,7,30291728,30308367,protein_coding,1,16639,chr7_30291728_30308367
Clip4,17,71768473,71864273,protein_coding,1,95800,chr17_71768473_71864273
Clk1,1,58410189,58424066,protein_coding,-1,13877,chr1_58410189_58424066
Clk2,3,89164795,89176921,protein_coding,1,12126,chr3_89164795_89176921
Clk3,9,57750624,57765860,protein_coding,-1,15236,chr9_57750624_57765860
Clk4,11,51261730,51281766,protein_coding,1,20036,chr11_51261730_51281766
Clmn,12,104763117,104865076,protein_coding,-1,101959,chr12_104763117_104865076
Clmp,9,40685962,40785319,protein_coding,1,99357,chr9_40685962_40785319
Cln3,7,126571207,126585817,protein_coding,-1,14610,chr7_126571207_126585817
Cln5,14,103070216,103077628,protein_coding,1,7412,chr14_103070216_103077628
Cln6,9,62838785,62852006,protein_coding,1,13221,chr9_62838785_62852006
Cln8,8,14881335,14901720,protein_coding,1,20385,chr8_14881335_14901720
Clnk,5,38706462,38876812,protein_coding,-1,170350,chr5_38706462_38876812
Clnkos,5,38735983,38747897,antisense,1,11914,chr5_38735983_38747897
Clns1a,7,97696634,97720796,protein_coding,1,24162,chr7_97696634_97720796
Clock,5,76209868,76304792,protein_coding,-1,94924,chr5_76209868_76304792
Clp1,2,84722104,84727350,protein_coding,-1,5246,chr2_84722104_84727350
Clpb,7,101663633,101795506,protein_coding,1,131873,chr7_101663633_101795506
Clpp,17,56990305,56996188,protein_coding,1,5883,chr17_56990305_56996188
Clps,17,28558149,28560766,protein_coding,-1,2617,chr17_28558149_28560766
Clptm1,7,19631571,19665033,protein_coding,-1,33462,chr7_19631571_19665033
Clptm1l,13,73604006,73620605,protein_coding,1,16599,chr13_73604006_73620605
Clpx,9,65294260,65330658,protein_coding,1,36398,chr9_65294260_65330658
Clrn1,3,58844028,58885340,protein_coding,-1,41312,chr3_58844028_58885340
Clrn2,5,45453751,45464149,protein_coding,1,10398,chr5_45453751_45464149
Clspn,4,126556935,126593903,protein_coding,1,36968,chr4_126556935_126593903
Clstn1,4,149586468,149648899,protein_coding,1,62431,chr4_149586468_149648899
Clstn2,9,97444395,98033181,protein_coding,-1,588786,chr9_97444395_98033181
Clstn3,6,124430581,124464794,protein_coding,-1,34213,chr6_124430581_124464794
Clta,4,44004452,44032846,protein_coding,1,28394,chr4_44004452_44032846
Cltb,13,54592401,54611344,protein_coding,-1,18943,chr13_54592401_54611344
Cltc,11,86694351,86757565,protein_coding,-1,63214,chr11_86694351_86757565
Clu,14,65968483,65981547,protein_coding,1,13064,chr14_65968483_65981547
Cluap1,16,3908801,3941147,protein_coding,1,32346,chr16_3908801_3941147
Cluh,11,74649495,74670847,protein_coding,1,21352,chr11_74649495_74670847
Clvs1,4,9269293,9451691,protein_coding,1,182398,chr4_9269293_9451691
Clvs2,10,33512286,33624769,protein_coding,-1,112483,chr10_33512286_33624769
Clybl,14,122181704,122402234,protein_coding,1,220530,chr14_122181704_122402234
Cmah,13,24327404,24477377,protein_coding,1,149973,chr13_24327404_24477377
Cmas,6,142756686,142775714,protein_coding,1,19028,chr6_142756686_142775714
Cmbl,15,31565389,31590119,protein_coding,1,24730,chr15_31565389_31590119
Cmc1,9,118064522,118150177,protein_coding,-1,85655,chr9_118064522_118150177
Cmc2,8,116888685,116921455,protein_coding,-1,32770,chr8_116888685_116921455
Cmip,8,117257064,117459430,protein_coding,1,202366,chr8_117257064_117459430
Cmklr1,5,113612354,113650426,protein_coding,-1,38072,chr5_113612354_113650426
Cmpk1,4,114959336,114987241,protein_coding,-1,27905,chr4_114959336_114987241
Cmpk2,12,26469204,26479837,protein_coding,1,10633,chr12_26469204_26479837
Cmss1,16,57302000,57606864,protein_coding,-1,304864,chr16_57302000_57606864
Cmtm1,8,104292622,104310145,protein_coding,-1,17523,chr8_104292622_104310145
Cmtm2a,8,104281042,104293181,protein_coding,-1,12139,chr8_104281042_104293181
Cmtm3,8,104339410,104347672,protein_coding,1,8262,chr8_104339410_104347672
Cmtm4,8,104348191,104395807,protein_coding,-1,47616,chr8_104348191_104395807
Cmtm5,14,54936261,54939274,protein_coding,1,3013,chr14_54936261_54939274
Cmtm6,9,114731116,114749344,protein_coding,1,18228,chr9_114731116_114749344
Cmtm7,9,114756836,114781856,protein_coding,-1,25020,chr9_114756836_114781856
Cmtm8,9,114789345,114844156,protein_coding,-1,54811,chr9_114789345_114844156
Cmtr1,17,29660595,29705979,protein_coding,1,45384,chr17_29660595_29705979
Cmtr2,8,110215665,110224486,protein_coding,1,8821,chr8_110215665_110224486
Cmya5,13,93040713,93144724,protein_coding,-1,104011,chr13_93040713_93144724
Cnbd2,2,156312299,156375638,protein_coding,1,63339,chr2_156312299_156375638
Cnbp,6,87842615,87851106,protein_coding,-1,8491,chr6_87842615_87851106
Cndp1,18,84610509,84650095,protein_coding,-1,39586,chr18_84610509_84650095
Cndp2,18,84667465,84685702,protein_coding,-1,18237,chr18_84667465_84685702
Cnep1r1,8,88118769,88135110,protein_coding,1,16341,chr8_88118769_88135110
Cnfn,7,25367620,25369724,protein_coding,-1,2104,chr7_25367620_25369724
Cnga2,X,71991849,72010218,protein_coding,1,18369,chrX_71991849_72010218
Cnga3,1,37214434,37263384,protein_coding,1,48950,chr1_37214434_37263384
Cnga4,7,105404568,105408742,protein_coding,1,4174,chr7_105404568_105408742
Cngb1,8,95239045,95306585,protein_coding,-1,67540,chr8_95239045_95306585
Cngb3,4,19280850,19510623,protein_coding,1,229773,chr4_19280850_19510623
Cnih1,14,46775567,46788411,protein_coding,-1,12844,chr14_46775567_46788411
Cnih2,19,5092868,5098521,protein_coding,-1,5653,chr19_5092868_5098521
Cnih3,1,181352628,181460641,protein_coding,1,108013,chr1_181352628_181460641
Cnih4,1,181144693,181168994,protein_coding,1,24301,chr1_181144693_181168994
Cnksr1,4,134228041,134238399,protein_coding,-1,10358,chr4_134228041_134238399
Cnksr2,X,157821436,158043294,protein_coding,-1,221858,chrX_157821436_158043294
Cnksr3,10,7119063,7212237,protein_coding,-1,93174,chr10_7119063_7212237
Cnn1,9,22099216,22109630,protein_coding,1,10414,chr9_22099216_22109630
Cnn2,10,79988584,79996062,protein_coding,1,7478,chr10_79988584_79996062
Cnn3,3,121426497,121458207,protein_coding,1,31710,chr3_121426497_121458207
Cnnm1,19,43440436,43497210,protein_coding,1,56774,chr19_43440436_43497210
Cnnm2,19,46761596,46880192,protein_coding,1,118596,chr19_46761596_46880192
Cnnm3,1,36511867,36528237,protein_coding,1,16370,chr1_36511867_36528237
Cnnm4,1,36471620,36508764,protein_coding,1,37144,chr1_36471620_36508764
Cnot1,8,95719451,95807464,protein_coding,-1,88013,chr8_95719451_95807464
Cnot10,9,114585878,114640184,protein_coding,-1,54306,chr9_114585878_114640184
Cnot11,1,39534992,39546889,protein_coding,1,11897,chr1_39534992_39546889
Cnot2,10,116485161,116581511,protein_coding,-1,96350,chr10_116485161_116581511
Cnot3,7,3645268,3661109,protein_coding,1,15841,chr7_3645268_3661109
Cnot4,6,35022065,35133724,protein_coding,-1,111659,chr6_35022065_35133724
Cnot6,11,49671503,49712723,protein_coding,-1,41220,chr11_49671503_49712723
Cnot6l,5,96070333,96164171,protein_coding,-1,93838,chr5_96070333_96164171
Cnot7,8,40492540,40515847,protein_coding,-1,23307,chr8_40492540_40515847
Cnot8,11,58104153,58118594,protein_coding,1,14441,chr11_58104153_58118594
Cnp,11,100574904,100591729,protein_coding,1,16825,chr11_100574904_100591729
Cnppd1,1,75134554,75142711,protein_coding,-1,8157,chr1_75134554_75142711
Cnpy1,5,28200819,28245806,protein_coding,-1,44987,chr5_28200819_28245806
Cnpy2,10,128322459,128327553,protein_coding,1,5094,chr10_128322459_128327553
Cnpy3,17,46735705,46752214,protein_coding,-1,16509,chr17_46735705_46752214
Cnpy4,5,138187485,138193918,protein_coding,1,6433,chr5_138187485_138193918
Cnr1,4,33924593,33948831,protein_coding,1,24238,chr4_33924593_33948831
Cnr2,4,135895394,135920207,protein_coding,1,24813,chr4_135895394_135920207
Cnrip1,11,17051586,17079371,protein_coding,1,27785,chr11_17051586_17079371
Cnst,1,179546370,179627478,protein_coding,1,81108,chr1_179546370_179627478
Cntd1,11,101279012,101296317,protein_coding,1,17305,chr11_101279012_101296317
Cntf,19,12763660,12765632,protein_coding,-1,1972,chr19_12763660_12765632
Cntfr,4,41657498,41697089,protein_coding,-1,39591,chr4_41657498_41697089
Cntln,4,84884309,85131921,protein_coding,1,247612,chr4_84884309_85131921
Cntn1,15,92051165,92341967,protein_coding,1,290802,chr15_92051165_92341967
Cntn2,1,132509427,132543256,protein_coding,-1,33829,chr1_132509427_132543256
Cntn3,6,102162655,102573101,protein_coding,-1,410446,chr6_102162655_102573101
Cntn4,6,105677660,106699310,protein_coding,1,1021650,chr6_105677660_106699310
Cntn5,9,9660891,10904775,protein_coding,-1,1243884,chr9_9660891_10904775
Cntn6,6,104492790,104863406,protein_coding,1,370616,chr6_104492790_104863406
Cntnap1,11,101170523,101190724,protein_coding,1,20201,chr11_101170523_101190724
Cntnap2,6,45059357,47304213,protein_coding,1,2244856,chr6_45059357_47304213
Cntnap3,13,64736182,64903955,protein_coding,-1,167773,chr13_64736182_64903955
Cntnap4,8,112570043,112882717,protein_coding,1,312674,chr8_112570043_112882717
Cntnap5a,1,115684756,116587323,protein_coding,1,902567,chr1_115684756_116587323
Cntnap5b,1,99772765,100485942,protein_coding,1,713177,chr1_99772765_100485942
Cntnap5c,17,57769570,58410355,protein_coding,1,640785,chr17_57769570_58410355
Cntrl,2,35109492,35178822,protein_coding,1,69330,chr2_35109492_35178822
Cntrob,11,69299487,69323775,protein_coding,-1,24288,chr11_69299487_69323775
Coa3,11,101277968,101279114,protein_coding,-1,1146,chr11_101277968_101279114
Coa4,7,100537071,100540369,protein_coding,1,3298,chr7_100537071_100540369
Coa5,1,37417084,37430103,protein_coding,-1,13019,chr1_37417084_37430103
Coa6,8,126422515,126425433,protein_coding,1,2918,chr8_126422515_126425433
Coa7,4,108328140,108341544,protein_coding,1,13404,chr4_108328140_108341544
Coasy,11,101082565,101086619,protein_coding,1,4054,chr11_101082565_101086619
Cobl,11,12236608,12464960,protein_coding,-1,228352,chr11_12236608_12464960
Cobll1,2,65088339,65239403,protein_coding,-1,151064,chr2_65088339_65239403
Coch,12,51593341,51605771,protein_coding,1,12430,chr12_51593341_51605771
Cog1,11,113649169,113667054,protein_coding,1,17885,chr11_113649169_113667054
Cog2,8,124520767,124552008,protein_coding,1,31241,chr8_124520767_124552008
Cog3,14,75702350,75754558,protein_coding,-1,52208,chr14_75702350_75754558
Cog4,8,110846600,110882227,protein_coding,1,35627,chr8_110846600_110882227
Cog5,12,31654869,31937630,protein_coding,1,282761,chr12_31654869_31937630
Cog6,3,52981875,53017237,protein_coding,-1,35362,chr3_52981875_53017237
Cog7,7,121879363,121981711,protein_coding,-1,102348,chr7_121879363_121981711
Cog8,8,107046289,107056689,protein_coding,-1,10400,chr8_107046289_107056689
Coil,11,88970252,88991613,protein_coding,1,21361,chr11_88970252_88991613
Col11a1,3,114030540,114220718,protein_coding,1,190178,chr3_114030540_114220718
Col11a2,17,34039437,34066685,protein_coding,1,27248,chr17_34039437_34066685
Col12a1,9,79598991,79718831,protein_coding,-1,119840,chr9_79598991_79718831
Col13a1,10,61838236,61979108,protein_coding,-1,140872,chr10_61838236_61979108
Col14a1,15,55307750,55520803,protein_coding,1,213053,chr15_55307750_55520803
Col15a1,4,47208161,47313167,protein_coding,1,105006,chr4_47208161_47313167
Col16a1,4,130047840,130099283,protein_coding,1,51443,chr4_130047840_130099283
Col17a1,19,47646344,47692094,protein_coding,-1,45750,chr19_47646344_47692094
Col18a1,10,77052178,77166548,protein_coding,-1,114370,chr10_77052178_77166548
Col19a1,1,24261890,24587472,protein_coding,-1,325582,chr1_24261890_24587472
Col1a1,11,94936224,94953042,protein_coding,1,16818,chr11_94936224_94953042
Col1a2,6,4504814,4541544,protein_coding,1,36730,chr6_4504814_4541544
Col20a1,2,180986535,181018363,protein_coding,1,31828,chr2_180986535_181018363
Col22a1,15,71795795,72034227,protein_coding,-1,238432,chr15_71795795_72034227
Col23a1,11,51289920,51583918,protein_coding,1,293998,chr11_51289920_51583918
Col24a1,3,145292472,145552011,protein_coding,1,259539,chr3_145292472_145552011
Col25a1,3,130131501,130599877,protein_coding,1,468376,chr3_130131501_130599877
Col26a1,5,136741759,136883209,protein_coding,-1,141450,chr5_136741759_136883209
Col27a1,4,63214004,63334991,protein_coding,1,120987,chr4_63214004_63334991
Col28a1,6,7997808,8192617,protein_coding,-1,194809,chr6_7997808_8192617
Col2a1,15,97975602,98004695,protein_coding,-1,29093,chr15_97975602_98004695
Col3a1,1,45311538,45349706,protein_coding,1,38168,chr1_45311538_45349706
Col4a1,8,11198423,11312826,protein_coding,-1,114403,chr8_11198423_11312826
Col4a2,8,11312805,11449287,protein_coding,1,136482,chr8_11312805_11449287
Col4a3,1,82586921,82722059,protein_coding,1,135138,chr1_82586921_82722059
Col4a3bp,13,96542618,96640167,protein_coding,1,97549,chr13_96542618_96640167
Col4a4,1,82448423,82586849,protein_coding,-1,138426,chr1_82448423_82586849
Col4a5,X,141475385,141689234,protein_coding,1,213849,chrX_141475385_141689234
Col4a6,X,141047650,141474076,protein_coding,-1,426426,chrX_141047650_141474076
Col5a1,2,27886425,28039514,protein_coding,1,153089,chr2_27886425_28039514
Col5a2,1,45374321,45503282,protein_coding,-1,128961,chr1_45374321_45503282
Col5a3,9,20770050,20815067,protein_coding,-1,45017,chr9_20770050_20815067
Col6a1,10,76708792,76726168,protein_coding,-1,17376,chr10_76708792_76726168
Col6a2,10,76595762,76623630,protein_coding,-1,27868,chr10_76595762_76623630
Col6a3,1,90765923,90843971,protein_coding,-1,78048,chr1_90765923_90843971
Col6a4,9,105989454,106096783,protein_coding,-1,107329,chr9_105989454_106096783
Col6a5,9,105856078,105960643,protein_coding,-1,104565,chr9_105856078_105960643
Col6a6,9,105687809,105828160,protein_coding,-1,140351,chr9_105687809_105828160
Col7a1,9,108953586,108984875,protein_coding,1,31289,chr9_108953586_108984875
Col8a1,16,57624258,57754737,protein_coding,-1,130479,chr16_57624258_57754737
Col8a2,4,126286793,126314330,protein_coding,1,27537,chr4_126286793_126314330
Col9a1,1,24177610,24252684,protein_coding,1,75074,chr1_24177610_24252684
Col9a2,4,121039385,121055322,protein_coding,1,15937,chr4_121039385_121055322
Col9a3,2,180597790,180622189,protein_coding,1,24399,chr2_180597790_180622189
Colec11,12,28594173,28623377,protein_coding,-1,29204,chr12_28594173_28623377
Colec12,18,9707595,9882644,protein_coding,1,175049,chr18_9707595_9882644
Colgalt1,8,71610998,71624911,protein_coding,1,13913,chr8_71610998_71624911
Colgalt2,1,152399830,152510695,protein_coding,1,110865,chr1_152399830_152510695
Colq,14,31523082,31591343,protein_coding,-1,68261,chr14_31523082_31591343
Commd1,11,22896136,22982382,protein_coding,-1,86246,chr11_22896136_22982382
Commd10,18,46958816,47234284,protein_coding,1,275468,chr18_46958816_47234284
Commd2,3,57644349,57651715,protein_coding,-1,7366,chr3_57644349_57651715
Commd3,2,18672384,18676231,protein_coding,1,3847,chr2_18672384_18676231
Commd4,9,57155035,57158331,protein_coding,-1,3296,chr9_57155035_57158331
Commd5,15,76899910,76901305,protein_coding,1,1395,chr15_76899910_76901305
Commd6,14,101632981,101640686,protein_coding,-1,7705,chr14_101632981_101640686
Commd7,2,153616933,153632781,protein_coding,-1,15848,chr2_153616933_153632781
Commd8,5,72156575,72168189,protein_coding,-1,11614,chr5_72156575_72168189
Commd9,2,101886247,101901646,protein_coding,1,15399,chr2_101886247_101901646
Comp,8,70373558,70382066,protein_coding,1,8508,chr8_70373558_70382066
Comt,16,18406886,18427738,protein_coding,-1,20852,chr16_18406886_18427738
Comtd1,14,21845855,21848977,protein_coding,-1,3122,chr14_21845855_21848977
Copa,1,172082529,172122330,protein_coding,1,39801,chr1_172082529_172122330
Copb1,7,114215559,114254711,protein_coding,-1,39152,chr7_114215559_114254711
Copb2,9,98563721,98588382,protein_coding,1,24661,chr9_98563721_98588382
Cope,8,70302518,70312993,protein_coding,1,10475,chr8_70302518_70312993
Copg1,6,87887814,87913595,protein_coding,1,25781,chr6_87887814_87913595
Copg2,6,30747554,30896794,protein_coding,-1,149240,chr6_30747554_30896794
Coprs,8,13884794,13890281,protein_coding,-1,5487,chr8_13884794_13890281
Cops2,2,125830304,125859139,protein_coding,-1,28835,chr2_125830304_125859139
Cops3,11,59817795,59839838,protein_coding,-1,22043,chr11_59817795_59839838
Cops4,5,100518309,100547803,protein_coding,1,29494,chr5_100518309_100547803
Cops5,1,10024601,10038168,protein_coding,-1,13567,chr1_10024601_10038168
Cops6,5,138161071,138164646,protein_coding,1,3575,chr5_138161071_138164646
Cops7a,6,124958413,124965538,protein_coding,-1,7125,chr6_124958413_124965538
Cops7b,1,86582904,86609375,protein_coding,1,26471,chr1_86582904_86609375
Cops8,1,90602981,90613341,protein_coding,1,10360,chr1_90602981_90613341
Copz1,15,103272714,103299868,protein_coding,1,27154,chr15_103272714_103299868
Copz2,11,96849870,96861203,protein_coding,1,11333,chr11_96849870_96861203
Coq10a,10,128363100,128368997,protein_coding,-1,5897,chr10_128363100_128368997
Coq10b,1,55052770,55072702,protein_coding,1,19932,chr1_55052770_55072702
Coq2,5,100654723,100675140,protein_coding,-1,20417,chr5_100654723_100675140
Coq3,4,21879673,21912162,protein_coding,1,32489,chr4_21879673_21912162
Coq4,2,29787493,29797935,protein_coding,1,10442,chr2_29787493_29797935
Coq5,5,115279666,115296972,protein_coding,1,17306,chr5_115279666_115296972
Coq6,12,84361657,84373796,protein_coding,1,12139,chr12_84361657_84373796
Coq7,7,118509659,118533356,protein_coding,-1,23697,chr7_118509659_118533356
Coq9,8,94838321,94854895,protein_coding,1,16574,chr8_94838321_94854895
Corin,5,72300025,72504473,protein_coding,-1,204448,chr5_72300025_72504473
Coro1a,7,126699773,126707787,protein_coding,-1,8014,chr7_126699773_126707787
Coro1b,19,4148618,4154035,protein_coding,1,5417,chr19_4148618_4154035
Coro1c,5,113842436,113908758,protein_coding,-1,66322,chr5_113842436_113908758
Coro2a,4,46536937,46602202,protein_coding,-1,65265,chr4_46536937_46602202
Coro2b,9,62419492,62537044,protein_coding,-1,117552,chr9_62419492_62537044
Coro6,11,77462411,77470484,protein_coding,1,8073,chr11_77462411_77470484
Coro7,16,4626133,4679777,protein_coding,-1,53644,chr16_4626133_4679777
Cort,4,149125034,149126763,protein_coding,-1,1729,chr4_149125034_149126763
Cotl1,8,119809222,119840544,protein_coding,-1,31322,chr8_119809222_119840544
Cox10,11,63962627,64079468,protein_coding,-1,116841,chr11_63962627_64079468
Cox11,11,90638173,90644931,protein_coding,1,6758,chr11_90638173_90644931
Cox14,15,99725647,99729532,protein_coding,1,3885,chr15_99725647_99729532
Cox15,19,43733254,43753000,protein_coding,-1,19746,chr19_43733254_43753000
Cox16,12,81359026,81485127,protein_coding,-1,126101,chr12_81359026_81485127
Cox17,16,38346991,38352763,protein_coding,1,5772,chr16_38346991_38352763
Cox18,5,90214724,90224001,protein_coding,-1,9277,chr5_90214724_90224001
Cox19,5,139336189,139351418,protein_coding,-1,15229,chr5_139336189_139351418
Cox20,1,178319129,178322693,protein_coding,1,3564,chr1_178319129_178322693
Cox4i1,8,120668222,120674207,protein_coding,1,5985,chr8_120668222_120674207
Cox4i2,2,152754173,152765037,protein_coding,1,10864,chr2_152754173_152765037
Cox5a,9,57521274,57532426,protein_coding,1,11152,chr9_57521274_57532426
Cox5b,1,36691449,36693681,protein_coding,1,2232,chr1_36691449_36693681
Cox6a1,5,115345642,115348981,protein_coding,-1,3339,chr5_115345642_115348981
Cox6a2,7,128205435,128206387,protein_coding,-1,952,chr7_128205435_128206387
Cox6b1,7,30616861,30626151,protein_coding,-1,9290,chr7_30616861_30626151
Cox6b2,7,4751792,4753094,protein_coding,-1,1302,chr7_4751792_4753094
Cox6c,15,35925886,35938246,protein_coding,-1,12360,chr15_35925886_35938246
Cox7a1,7,30184144,30186078,protein_coding,1,1934,chr7_30184144_30186078
Cox7a2,9,79755361,79759878,protein_coding,-1,4517,chr9_79755361_79759878
Cox7a2l,17,83501918,83517330,protein_coding,-1,15412,chr17_83501918_83517330
Cox7b,X,106015700,106022450,protein_coding,1,6750,chrX_106015700_106022450
Cox7b2,5,71442824,71548205,protein_coding,-1,105381,chr5_71442824_71548205
Cox7c,13,86044816,86046904,protein_coding,-1,2088,chr13_86044816_86046904
Cox8a,19,7215153,7217616,protein_coding,-1,2463,chr19_7215153_7217616
Cox8b,7,140898945,140900446,protein_coding,-1,1501,chr7_140898945_140900446
Cp,3,19957054,20009145,protein_coding,1,52091,chr3_19957054_20009145
Cpa2,6,30541582,30564476,protein_coding,1,22894,chr6_30541582_30564476
Cpa3,3,20215620,20242181,protein_coding,-1,26561,chr3_20215620_20242181
Cpa4,6,30568369,30592418,protein_coding,1,24049,chr6_30568369_30592418
Cpa6,1,10324720,10719945,protein_coding,-1,395225,chr1_10324720_10719945
Cpb1,3,20248264,20275733,protein_coding,-1,27469,chr3_20248264_20275733
Cpb2,14,75242287,75283555,protein_coding,1,41268,chr14_75242287_75283555
Cpd,11,76778424,76847018,protein_coding,-1,68594,chr11_76778424_76847018
Cpe,8,64592542,64693054,protein_coding,-1,100512,chr8_64592542_64693054
Cpeb1,7,81347026,81455465,protein_coding,-1,108439,chr7_81347026_81455465
Cpeb2,5,43233170,43289724,protein_coding,1,56554,chr5_43233170_43289724
Cpeb3,19,37021291,37208601,protein_coding,-1,187310,chr19_37021291_37208601
Cpeb4,11,31872211,31935634,protein_coding,1,63423,chr11_31872211_31935634
Cped1,6,21985916,22256404,protein_coding,1,270488,chr6_21985916_22256404
Cplx1,5,108518554,108550024,protein_coding,-1,31470,chr5_108518554_108550024
Cplx2,13,54371349,54383917,protein_coding,1,12568,chr13_54371349_54383917
Cplx3,9,57599992,57606281,protein_coding,-1,6289,chr9_57599992_57606281
Cpm,10,117629500,117687352,protein_coding,1,57852,chr10_117629500_117687352
Cpn1,19,43956307,43986556,protein_coding,-1,30249,chr19_43956307_43986556
Cpne1,2,156071842,156111965,protein_coding,-1,40123,chr2_156071842_156111965
Cpne2,8,94532990,94570531,protein_coding,1,37541,chr8_94532990_94570531
Cpne3,4,19519254,19570108,protein_coding,-1,50854,chr4_19519254_19570108
Cpne4,9,104547286,105034544,protein_coding,1,487258,chr9_104547286_105034544
Cpne5,17,29155556,29238167,protein_coding,-1,82611,chr17_29155556_29238167
Cpne6,14,55510445,55517431,protein_coding,1,6986,chr14_55510445_55517431
Cpne7,8,123117374,123135182,protein_coding,1,17808,chr8_123117374_123135182
Cpne8,15,90487482,90679432,protein_coding,-1,191950,chr15_90487482_90679432
Cpne9,6,113282307,113305627,protein_coding,1,23320,chr6_113282307_113305627
Cpox,16,58670292,58717636,protein_coding,1,47344,chr16_58670292_58717636
Cpped1,16,11803721,11909445,protein_coding,-1,105724,chr16_11803721_11909445
Cpq,15,33083129,33594552,protein_coding,1,511423,chr15_33083129_33594552
Cps1,1,67123026,67231259,protein_coding,1,108233,chr1_67123026_67231259
Cpsf1,15,76595803,76607591,protein_coding,-1,11788,chr15_76595803_76607591
Cpsf2,12,101975988,102006424,protein_coding,1,30436,chr12_101975988_102006424
Cpsf3,12,21285391,21315056,protein_coding,1,29665,chr12_21285391_21315056
Cpsf4,5,145167213,145182041,protein_coding,1,14828,chr5_145167213_145182041
Cpsf4l,11,113698172,113710017,protein_coding,-1,11845,chr11_113698172_113710017
Cpsf6,10,117344673,117380015,protein_coding,-1,35342,chr10_117344673_117380015
Cpsf7,19,10525266,10547653,protein_coding,1,22387,chr19_10525266_10547653
Cpt1a,19,3322334,3385733,protein_coding,1,63399,chr19_3322334_3385733
Cpt1b,15,89416405,89425863,protein_coding,-1,9458,chr15_89416405_89425863
Cpt1c,7,44959372,44974851,protein_coding,-1,15479,chr7_44959372_44974851
Cpt2,4,107903981,107923610,protein_coding,-1,19629,chr4_107903981_107923610
Cptp,4,155864723,155869440,protein_coding,-1,4717,chr4_155864723_155869440
Cpxm1,2,130390775,130397574,protein_coding,-1,6799,chr2_130390775_130397574
Cpxm2,7,132032687,132154739,protein_coding,-1,122052,chr7_132032687_132154739
Cr1l,1,195097382,195131586,protein_coding,-1,34204,chr1_195097382_195131586
Cr2,1,195136811,195176716,protein_coding,-1,39905,chr1_195136811_195176716
Crabp1,9,54764748,54773110,protein_coding,1,8362,chr9_54764748_54773110
Crabp2,3,87948666,87953376,protein_coding,1,4710,chr3_87948666_87953376
Cracr2a,6,127561338,127674248,protein_coding,1,112910,chr6_127561338_127674248
Cracr2b,7,141461094,141466613,protein_coding,1,5519,chr7_141461094_141466613
Cradd,10,95174746,95324133,protein_coding,-1,149387,chr10_95174746_95324133
Cramp1l,17,24961226,25015788,protein_coding,-1,54562,chr17_24961226_25015788
Crat,2,30400471,30415813,protein_coding,-1,15342,chr2_30400471_30415813
Crb1,1,139197056,139377100,protein_coding,-1,180044,chr1_139197056_139377100
Crb2,2,37776249,37799103,protein_coding,1,22854,chr2_37776249_37799103
Crb3,17,57059105,57065918,protein_coding,1,6813,chr17_57059105_57065918
Crbn,6,106780201,106800077,protein_coding,-1,19876,chr6_106780201_106800077
Crcp,5,130029290,130060789,protein_coding,1,31499,chr5_130029290_130060789
Crct1,3,93014205,93015687,protein_coding,-1,1482,chr3_93014205_93015687
Creb1,1,64532645,64604548,protein_coding,1,71903,chr1_64532645_64604548
Creb3,4,43562332,43567060,protein_coding,1,4728,chr4_43562332_43567060
Creb3l1,2,91982328,92024502,protein_coding,-1,42174,chr2_91982328_92024502
Creb3l2,6,37327255,37442146,protein_coding,-1,114891,chr6_37327255_37442146
Creb3l3,10,81084324,81098874,protein_coding,-1,14550,chr10_81084324_81098874
Creb3l4,3,90237500,90243512,protein_coding,-1,6012,chr3_90237500_90243512
Creb5,6,53287270,53700376,protein_coding,1,413106,chr6_53287270_53700376
Crebbp,16,4081328,4213997,protein_coding,-1,132669,chr16_4081328_4213997
Crebl2,6,134830154,134858931,protein_coding,1,28777,chr6_134830154_134858931
Crebrf,17,26715650,26776635,protein_coding,1,60985,chr17_26715650_26776635
Crebzf,7,90442729,90447994,protein_coding,1,5265,chr7_90442729_90447994
Creg1,1,165763746,165775308,protein_coding,1,11562,chr1_165763746_165775308
Creg2,1,39618406,39651474,protein_coding,-1,33068,chr1_39618406_39651474
Creld1,6,113483297,113493343,protein_coding,1,10046,chr6_113483297_113493343
Creld2,15,88819646,88826683,protein_coding,1,7037,chr15_88819646_88826683
Crem,18,3266048,3337748,protein_coding,-1,71700,chr18_3266048_3337748
Crh,3,19693401,19695396,protein_coding,-1,1995,chr3_19693401_19695396
Crhbp,13,95431371,95444924,protein_coding,-1,13553,chr13_95431371_95444924
Crhr1,11,104132855,104175523,protein_coding,1,42668,chr11_104132855_104175523
Crhr2,6,55090049,55133016,protein_coding,-1,42967,chr6_55090049_55133016
Crim1,17,78200248,78376592,protein_coding,1,176344,chr17_78200248_78376592
Crip1,12,113146316,113153879,protein_coding,1,7563,chr12_113146316_113153879
Crip2,12,113140236,113145506,protein_coding,1,5270,chr12_113140236_113145506
Crip3,17,46428926,46431776,protein_coding,1,2850,chr17_46428926_46431776
Cript,17,87025550,87035810,protein_coding,1,10260,chr17_87025550_87035810
Crispld1,1,17727045,17766344,protein_coding,1,39299,chr1_17727045_17766344
Crispld2,8,119992438,120052793,protein_coding,1,60355,chr8_119992438_120052793
Crk,11,75679259,75706908,protein_coding,1,27649,chr11_75679259_75706908
Crkl,16,17451987,17487434,protein_coding,1,35447,chr16_17451987_17487434
Crlf1,8,70493158,70504081,protein_coding,1,10923,chr8_70493158_70504081
Crlf2,5,109554709,109558993,protein_coding,-1,4284,chr5_109554709_109558993
Crlf3,11,80046493,80080991,protein_coding,-1,34498,chr11_80046493_80080991
Crls1,2,132846666,132866785,protein_coding,1,20119,chr2_132846666_132866785
Crmp1,5,37241940,37292133,protein_coding,1,50193,chr5_37241940_37292133
Crnde,8,92326033,92356120,processed_transcript,-1,30087,chr8_92326033_92356120
Crnkl1,2,145917479,145935014,protein_coding,-1,17535,chr2_145917479_145935014
Crocc,4,141016637,141060550,protein_coding,-1,43913,chr4_141016637_141060550
Crot,5,8966033,8997324,protein_coding,-1,31291,chr5_8966033_8997324
Crry-ps,8,73749475,73750783,processed_pseudogene,-1,1308,chr8_73749475_73750783
Crtac1,19,42268287,42431785,protein_coding,-1,163498,chr19_42268287_42431785
Crtam,9,40969691,41004628,protein_coding,-1,34937,chr9_40969691_41004628
Crtap,9,114375134,114390675,protein_coding,-1,15541,chr9_114375134_114390675
Crtc1,8,70382355,70439579,protein_coding,-1,57224,chr8_70382355_70439579
Crtc2,3,90254163,90264125,protein_coding,1,9962,chr3_90254163_90264125
Crtc3,7,80586627,80688877,protein_coding,-1,102250,chr7_80586627_80688877
Crx,7,15865947,15879968,protein_coding,-1,14021,chr7_15865947_15879968
Crxos,7,15882617,15904020,protein_coding,1,21403,chr7_15882617_15904020
Cry1,10,85131700,85185064,protein_coding,-1,53364,chr10_85131700_85185064
Cry2,2,92403646,92434043,protein_coding,-1,30397,chr2_92403646_92434043
Cryaa,17,31677807,31681733,protein_coding,1,3926,chr17_31677807_31681733
Cryab,9,50751325,50756636,protein_coding,1,5311,chr9_50751325_50756636
Cryba1,11,77718615,77725283,protein_coding,-1,6668,chr11_77718615_77725283
Cryba2,1,74889934,74893143,protein_coding,-1,3209,chr1_74889934_74893143
Cryba4,5,112246493,112252518,protein_coding,-1,6025,chr5_112246493_112252518
Crybb1,5,112255815,112269585,protein_coding,1,13770,chr5_112255815_112269585
Crybb3,5,113075839,113081584,protein_coding,-1,5745,chr5_113075839_113081584
Crybg3,16,59490775,59600979,protein_coding,-1,110204,chr16_59490775_59600979
Cryga,1,65100389,65103373,protein_coding,-1,2984,chr1_65100389_65103373
Cryge,1,65048554,65051149,protein_coding,-1,2595,chr1_65048554_65051149
Crygn,5,24751003,24758008,protein_coding,-1,7005,chr5_24751003_24758008
Crygs,16,22805203,22811577,protein_coding,-1,6374,chr16_22805203_22811577
Cryl1,14,57274993,57398529,protein_coding,-1,123536,chr14_57274993_57398529
Crym,7,120186380,120202111,protein_coding,-1,15731,chr7_120186380_120202111
Cryz,3,154596711,154623182,protein_coding,1,26471,chr3_154596711_154623182
Cryzl1,16,91689322,91728975,protein_coding,-1,39653,chr16_91689322_91728975
Cs,10,128337734,128362479,protein_coding,1,24745,chr10_128337734_128362479
Csad,15,102176999,102204724,protein_coding,-1,27725,chr15_102176999_102204724
Csdc2,15,81936759,81950941,protein_coding,1,14182,chr15_81936759_81950941
Csde1,3,103020426,103058186,protein_coding,1,37760,chr3_103020426_103058186
Cse1l,2,166906040,166946389,protein_coding,1,40349,chr2_166906040_166946389
Csf1,3,107741048,107760469,protein_coding,-1,19421,chr3_107741048_107760469
Csf1r,18,61100598,61132149,protein_coding,1,31551,chr18_61100598_61132149
Csf1r-ps,19,60079432,60087657,processed_pseudogene,1,8225,chr19_60079432_60087657
Csf2,11,54247271,54249667,protein_coding,-1,2396,chr11_54247271_54249667
Csf2ra,19,61223957,61228429,protein_coding,-1,4472,chr19_61223957_61228429
Csf2rb,15,78325752,78353847,protein_coding,1,28095,chr15_78325752_78353847
Csf3,11,98701263,98703629,protein_coding,1,2366,chr11_98701263_98703629
Csf3r,4,126024550,126044440,protein_coding,1,19890,chr4_126024550_126044440
Csgalnact1,8,68356781,68735146,protein_coding,-1,378365,chr8_68356781_68735146
Csgalnact2,6,118107452,118139140,protein_coding,-1,31688,chr6_118107452_118139140
Csk,9,57626646,57653631,protein_coding,-1,26985,chr9_57626646_57653631
Csl,10,99757706,99759658,protein_coding,-1,1952,chr10_99757706_99759658
Csmd1,8,15892537,17535586,protein_coding,-1,1643049,chr8_15892537_17535586
Csmd2,4,127987857,128567656,protein_coding,1,579799,chr4_127987857_128567656
Csmd2os,4,128133523,128166967,antisense,-1,33444,chr4_128133523_128166967
Csmd3,15,47580637,48792063,protein_coding,-1,1211426,chr15_47580637_48792063
Csnk1a1,18,61555274,61590061,protein_coding,1,34787,chr18_61555274_61590061
Csnk1d,11,120958990,120991330,protein_coding,-1,32340,chr11_120958990_120991330
Csnk1e,15,79417856,79455566,protein_coding,-1,37710,chr15_79417856_79455566
Csnk1g1,9,65908924,66045015,protein_coding,1,136091,chr9_65908924_66045015
Csnk1g2,10,80622838,80640749,protein_coding,1,17911,chr10_80622838_80640749
Csnk1g3,18,53862122,53955548,protein_coding,1,93426,chr18_53862122_53955548
Csnk2a1,2,152226839,152281852,protein_coding,1,55013,chr2_152226839_152281852
Csnk2a1-ps,X,16610252,16611426,processed_pseudogene,1,1174,chrX_16610252_16611426
Csnk2a1-ps1,14,14197306,14198464,processed_pseudogene,1,1158,chr14_14197306_14198464
Csnk2a2,8,95446096,95490039,protein_coding,-1,43943,chr8_95446096_95490039
Csnk2b,17,35116196,35122053,protein_coding,-1,5857,chr17_35116196_35122053
Csnka2ip,16,64477810,64602408,protein_coding,-1,124598,chr16_64477810_64602408
Cspg4,9,56865033,56899870,protein_coding,1,34837,chr9_56865033_56899870
Cspg5,9,110243783,110262576,protein_coding,1,18793,chr9_110243783_110262576
Cspp1,1,10037987,10136768,protein_coding,1,98781,chr1_10037987_10136768
Csrnp1,9,119971163,119984658,protein_coding,-1,13495,chr9_119971163_119984658
Csrnp2,15,100479570,100495488,protein_coding,-1,15918,chr15_100479570_100495488
Csrnp3,2,65845767,66031546,protein_coding,1,185779,chr2_65845767_66031546
Csrp1,1,135720061,135752232,protein_coding,1,32171,chr1_135720061_135752232
Csrp2,10,110919789,110939622,protein_coding,1,19833,chr10_110919789_110939622
Cst3,2,148871722,148875692,protein_coding,-1,3970,chr2_148871722_148875692
Cst6,19,5344705,5349574,protein_coding,-1,4869,chr19_5344705_5349574
Cst7,2,150570415,150578944,protein_coding,1,8529,chr2_150570415_150578944
Csta1,16,36119946,36131241,protein_coding,-1,11295,chr16_36119946_36131241
Cstad,2,30595040,30608943,protein_coding,1,13903,chr2_30595040_30608943
Cstb,10,78425669,78427622,protein_coding,1,1953,chr10_78425669_78427622
Cstf1,2,172370681,172382448,protein_coding,1,11767,chr2_172370681_172382448
Cstf2,X,134059187,134086819,protein_coding,1,27632,chrX_134059187_134086819
Cstf2t,19,31082837,31087069,protein_coding,1,4232,chr19_31082837_31087069
Cstf3,2,104590523,104665429,protein_coding,1,74906,chr2_104590523_104665429
Cstl1,2,148750358,148755433,protein_coding,1,5075,chr2_148750358_148755433
Ctbp1,5,33247723,33274994,protein_coding,-1,27271,chr5_33247723_33274994
Ctbp2,7,132987563,133124354,protein_coding,-1,136791,chr7_132987563_133124354
Ctbs,3,146449795,146465849,protein_coding,1,16054,chr3_146449795_146465849
Ctc1,11,69015911,69036473,protein_coding,1,20562,chr11_69015911_69036473
Ctcf,8,105636568,105682922,protein_coding,1,46354,chr8_105636568_105682922
Ctcfl,2,173093609,173119525,protein_coding,-1,25916,chr2_173093609_173119525
Ctcflos,2,173110818,173133204,antisense,1,22386,chr2_173110818_173133204
Ctdnep1,11,69981156,69990601,protein_coding,1,9445,chr11_69981156_69990601
Ctdp1,18,80407959,80469695,protein_coding,-1,61736,chr18_80407959_80469695
Ctdsp1,1,74391509,74397285,protein_coding,1,5776,chr1_74391509_74397285
Ctdsp2,10,126978717,126999975,protein_coding,1,21258,chr10_126978717_126999975
Ctdspl,9,118926453,119043998,protein_coding,1,117545,chr9_118926453_119043998
Ctdspl2,2,121956001,122013642,protein_coding,1,57641,chr2_121956001_122013642
Ctf1,7,127712736,127718192,protein_coding,1,5456,chr7_127712736_127718192
Ctf2,7,127718106,127732166,protein_coding,-1,14060,chr7_127718106_127732166
Cth,3,157894248,157925077,protein_coding,-1,30829,chr3_157894248_157925077
Cthrc1,15,38940083,39087121,protein_coding,1,147038,chr15_38940083_39087121
Ctif,18,75431224,75697554,protein_coding,-1,266330,chr18_75431224_75697554
Ctla2a,13,60934155,60936625,protein_coding,-1,2470,chr13_60934155_60936625
Ctla2b,13,60895350,60897447,protein_coding,-1,2097,chr13_60895350_60897447
Ctla4,1,60887000,60942198,protein_coding,1,55198,chr1_60887000_60942198
Ctnna1,18,35118859,35254779,protein_coding,1,135920,chr18_35118859_35254779
Ctnna2,6,76881637,77979699,protein_coding,-1,1098062,chr6_76881637_77979699
Ctnna3,10,63430098,65003667,protein_coding,1,1573569,chr10_63430098_65003667
Ctnnal1,4,56810935,56865188,protein_coding,-1,54253,chr4_56810935_56865188
Ctnnb1,9,120929216,120960507,protein_coding,1,31291,chr9_120929216_120960507
Ctnnbip1,4,149518236,149566437,protein_coding,1,48201,chr4_149518236_149566437
Ctnnbl1,2,157737401,157891614,protein_coding,1,154213,chr2_157737401_157891614
Ctnnd1,2,84600071,84650765,protein_coding,-1,50694,chr2_84600071_84650765
Ctnnd2,15,30172593,31029341,protein_coding,1,856748,chr15_30172593_31029341
Ctns,11,73183596,73199042,protein_coding,-1,15446,chr11_73183596_73199042
Ctps,4,120539868,120570276,protein_coding,-1,30408,chr4_120539868_120570276
Ctps2,X,162901238,163032508,protein_coding,1,131270,chrX_162901238_163032508
Ctr9,7,111028951,111056377,protein_coding,1,27426,chr7_111028951_111056377
Ctrb1,8,111686519,111691010,protein_coding,-1,4491,chr8_111686519_111691010
Ctrcos,4,141844321,141846990,antisense,1,2669,chr4_141844321_141846990
Ctrl,8,105932003,105933862,protein_coding,-1,1859,chr8_105932003_105933862
Cts8,13,61246745,61255358,protein_coding,-1,8613,chr13_61246745_61255358
Cts8-ps,13,61281380,61288850,transcribed_unprocessed_pseudogene,-1,7470,chr13_61281380_61288850
Ctsa,2,164832873,164841032,protein_coding,1,8159,chr2_164832873_164841032
Ctsb,14,63122462,63145923,protein_coding,1,23461,chr14_63122462_63145923
Ctsc,7,88278085,88310888,protein_coding,1,32803,chr7_88278085_88310888
Ctsd,7,142375911,142388038,protein_coding,-1,12127,chr7_142375911_142388038
Ctsf,19,4855130,4860918,protein_coding,1,5788,chr19_4855130_4860918
Ctsh,9,90054152,90076089,protein_coding,1,21937,chr9_90054152_90076089
Ctsk,3,95499256,95509362,protein_coding,1,10106,chr3_95499256_95509362
Ctsl,13,64359337,64370890,protein_coding,-1,11553,chr13_64359337_64370890
Ctsm,13,61535743,61541839,protein_coding,-1,6096,chr13_61535743_61541839
Ctsm-ps2,13,61482408,61490329,unprocessed_pseudogene,-1,7921,chr13_61482408_61490329
Ctso,3,81932601,81956725,protein_coding,1,24124,chr3_81932601_81956725
Ctss,3,95526786,95556403,protein_coding,1,29617,chr3_95526786_95556403
Ctsw,19,5465043,5468507,protein_coding,-1,3464,chr19_5465043_5468507
Ctsz,2,174427493,174439039,protein_coding,-1,11546,chr2_174427493_174439039
Cttn,7,144435733,144471009,protein_coding,-1,35276,chr7_144435733_144471009
Cttnbp2,6,18366478,18514843,protein_coding,-1,148365,chr6_18366478_18514843
Cttnbp2nl,3,105001915,105053146,protein_coding,-1,51231,chr3_105001915_105053146
Ctu1,7,43672016,43678298,protein_coding,1,6282,chr7_43672016_43678298
Ctu2,8,122476143,122484138,protein_coding,1,7995,chr8_122476143_122484138
Ctxn1,8,4257660,4259274,protein_coding,-1,1614,chr8_4257660_4259274
Ctxn2,2,125136633,125147841,protein_coding,1,11208,chr2_125136633_125147841
Ctxn3,18,57468516,57478133,protein_coding,1,9617,chr18_57468516_57478133
Cubn,2,13276338,13491813,protein_coding,-1,215475,chr2_13276338_13491813
Cuedc1,11,88098058,88194140,protein_coding,1,96082,chr11_88098058_88194140
Cuedc2,19,46329812,46338702,protein_coding,-1,8890,chr19_46329812_46338702
Cul1,6,47453398,47526139,protein_coding,1,72741,chr6_47453398_47526139
Cul2,18,3382988,3436377,protein_coding,1,53389,chr18_3382988_3436377
Cul3,1,80264923,80340480,protein_coding,-1,75557,chr1_80264923_80340480
Cul4a,8,13105621,13147940,protein_coding,1,42319,chr8_13105621_13147940
Cul4b,X,38533274,38576196,protein_coding,-1,42922,chrX_38533274_38576196
Cul5,9,53614582,53670014,protein_coding,-1,55432,chr9_53614582_53670014
Cul7,17,46650337,46664364,protein_coding,1,14027,chr17_46650337_46664364
Cul9,17,46500572,46546388,protein_coding,-1,45816,chr17_46500572_46546388
Cuta,17,26933819,26939569,protein_coding,-1,5750,chr17_26933819_26939569
Cutal,2,34874396,34892132,protein_coding,1,17736,chr2_34874396_34892132
Cutc,19,43752996,43768638,protein_coding,1,15642,chr19_43752996_43768638
Cux1,5,136248135,136567490,protein_coding,-1,319355,chr5_136248135_136567490
Cux2,5,121856366,122050102,protein_coding,-1,193736,chr5_121856366_122050102
Cuzd1,7,131308554,131322292,protein_coding,-1,13738,chr7_131308554_131322292
Cwc15,9,14500617,14510577,protein_coding,1,9960,chr9_14500617_14510577
Cwc22,2,77881159,77946375,protein_coding,-1,65216,chr2_77881159_77946375
Cwc25,11,97745481,97766556,protein_coding,-1,21075,chr11_97745481_97766556
Cwc27,13,104631140,104817142,protein_coding,-1,186002,chr13_104631140_104817142
Cwf19l1,19,44108637,44135876,protein_coding,-1,27239,chr19_44108637_44135876
Cwf19l2,9,3403592,3479236,protein_coding,1,75644,chr9_3403592_3479236
Cwh43,5,73406075,73453435,protein_coding,1,47360,chr5_73406075_73453435
Cx3cl1,8,94772009,94782427,protein_coding,1,10418,chr8_94772009_94782427
Cx3cr1,9,119901616,120069879,protein_coding,-1,168263,chr9_119901616_120069879
Cxadr,16,78301489,78359774,protein_coding,1,58285,chr16_78301489_78359774
Cxcl11,5,92359544,92365485,polymorphic_pseudogene,-1,5941,chr5_92359544_92365485
Cxcl12,6,117168535,117181367,protein_coding,1,12832,chr6_117168535_117181367
Cxcl13,5,95956951,95961068,protein_coding,1,4117,chr5_95956951_95961068
Cxcl14,13,56288643,56296551,protein_coding,-1,7908,chr13_56288643_56296551
Cxcl16,11,70453983,70459984,protein_coding,-1,6001,chr11_70453983_70459984
Cxcl17,7,25400053,25412886,protein_coding,-1,12833,chr7_25400053_25412886
Cxcl5,5,90759360,90761624,protein_coding,1,2264,chr5_90759360_90761624
Cxcr1,1,74191785,74194631,protein_coding,-1,2846,chr1_74191785_74194631
Cxcr2,1,74153989,74161246,protein_coding,1,7257,chr1_74153989_74161246
Cxcr4,1,128588199,128592293,protein_coding,-1,4094,chr1_128588199_128592293
Cxcr5,9,44511787,44561877,protein_coding,-1,50090,chr9_44511787_44561877
Cxcr6,9,123806475,123811760,protein_coding,1,5285,chr9_123806475_123811760
Cxxc1,18,74216124,74221496,protein_coding,1,5372,chr18_74216124_74221496
Cxxc4,3,134236484,134262161,protein_coding,1,25677,chr3_134236484_134262161
Cxxc5,18,35829397,35861688,protein_coding,1,32291,chr18_35829397_35861688
Cyb561,11,105933702,105953336,protein_coding,-1,19634,chr11_105933702_105953336
Cyb561a3,19,10577172,10595961,protein_coding,1,18789,chr19_10577172_10595961
Cyb561d1,3,108195687,108201212,protein_coding,-1,5525,chr3_108195687_108201212
Cyb561d2,9,107539007,107542193,protein_coding,-1,3186,chr9_107539007_107542193
Cyb5a,18,84838704,84879871,protein_coding,1,41167,chr18_84838704_84879871
Cyb5b,8,107150640,107187471,protein_coding,1,36831,chr8_107150640_107187471
Cyb5d1,11,69391925,69395631,protein_coding,-1,3706,chr11_69391925_69395631
Cyb5d2,11,72777232,72796142,protein_coding,-1,18910,chr11_72777232_72796142
Cyb5r1,1,134405559,134411740,protein_coding,1,6181,chr1_134405559_134411740
Cyb5r2,7,107748455,107758032,protein_coding,-1,9577,chr7_107748455_107758032
Cyb5r3,15,83153494,83172592,protein_coding,-1,19098,chr15_83153494_83172592
Cyb5r4,9,87022014,87077774,protein_coding,1,55760,chr9_87022014_87077774
Cyb5rl,4,107066988,107088268,protein_coding,1,21280,chr4_107066988_107088268
Cyba,8,122424776,122432930,protein_coding,-1,8154,chr8_122424776_122432930
Cybb,X,9435252,9487771,protein_coding,-1,52519,chrX_9435252_9487771
Cybrd1,2,71117923,71142926,protein_coding,1,25003,chr2_71117923_71142926
Cyc1,15,76343523,76346260,protein_coding,1,2737,chr15_76343523_76346260
Cycs,6,50562563,50566538,protein_coding,-1,3975,chr6_50562563_50566538
Cycs-ps2,5,101305578,101305869,processed_pseudogene,1,291,chr5_101305578_101305869
Cycs-ps3,13,94053843,94054388,processed_pseudogene,1,545,chr13_94053843_94054388
Cyct,2,76353942,76360450,protein_coding,-1,6508,chr2_76353942_76360450
Cyfip1,7,55841745,55932602,protein_coding,1,90857,chr7_55841745_55932602
Cyfip2,11,46193850,46312859,protein_coding,-1,119009,chr11_46193850_46312859
Cygb,11,116645595,116654313,protein_coding,-1,8718,chr11_116645595_116654313
Cyhr1,15,76643395,76660117,protein_coding,-1,16722,chr15_76643395_76660117
Cyld,8,88697028,88751945,protein_coding,1,54917,chr8_88697028_88751945
Cym,3,107211293,107221732,protein_coding,-1,10439,chr3_107211293_107221732
Cyp11a1,9,58006411,58027023,protein_coding,1,20612,chr9_58006411_58027023
Cyp1a1,9,57687928,57703824,protein_coding,1,15896,chr9_57687928_57703824
Cyp1b1,17,79701537,79715061,protein_coding,-1,13524,chr17_79701537_79715061
Cyp20a1,1,60343323,60388060,protein_coding,1,44737,chr1_60343323_60388060
Cyp24a1,2,170482708,170497145,protein_coding,-1,14437,chr2_170482708_170497145
Cyp26a1,19,37697798,37701536,protein_coding,1,3738,chr19_37697798_37701536
Cyp26b1,6,84571414,84593908,protein_coding,-1,22494,chr6_84571414_84593908
Cyp26c1,19,37685581,37693398,protein_coding,1,7817,chr19_37685581_37693398
Cyp27a1,1,74713574,74737892,protein_coding,1,24318,chr1_74713574_74737892
Cyp27b1,10,127048250,127053006,protein_coding,1,4756,chr10_127048250_127053006
Cyp2a5,7,26835305,26843548,protein_coding,1,8243,chr7_26835305_26843548
Cyp2b10,7,25897620,25926624,protein_coding,1,29004,chr7_25897620_25926624
Cyp2b19,7,26757142,26772630,protein_coding,1,15488,chr7_26757142_26772630
Cyp2b27-ps,7,26004605,26028906,unprocessed_pseudogene,-1,24301,chr7_26004605_26028906
Cyp2c52-ps,19,38976647,39003289,unprocessed_pseudogene,1,26642,chr19_38976647_39003289
Cyp2c55,19,39007019,39042693,protein_coding,1,35674,chr19_39007019_39042693
Cyp2c65,19,39061015,39093944,protein_coding,1,32929,chr19_39061015_39093944
Cyp2c71-ps,19,39946400,39952855,processed_pseudogene,1,6455,chr19_39946400_39952855
Cyp2c72-ps,19,39347367,39360403,processed_pseudogene,1,13036,chr19_39347367_39360403
Cyp2d22,15,82370527,82380260,protein_coding,-1,9733,chr15_82370527_82380260
Cyp2d26,15,82790101,82794294,protein_coding,-1,4193,chr15_82790101_82794294
Cyp2d33-ps,15,82562197,82565518,unprocessed_pseudogene,1,3321,chr15_82562197_82565518
Cyp2d34-ps,15,82608921,82612915,unprocessed_pseudogene,-1,3994,chr15_82608921_82612915
Cyp2d35-ps,15,82649917,82654711,unprocessed_pseudogene,-1,4794,chr15_82649917_82654711
Cyp2d36-ps,15,82671288,82683257,unprocessed_pseudogene,-1,11969,chr15_82671288_82683257
Cyp2d41-ps,15,82777931,82782110,unprocessed_pseudogene,-1,4179,chr15_82777931_82782110
Cyp2e1,7,140763739,140774987,protein_coding,1,11248,chr7_140763739_140774987
Cyp2f2,7,27119909,27133660,protein_coding,1,13751,chr7_27119909_27133660
Cyp2j12,4,96099318,96141152,protein_coding,-1,41834,chr4_96099318_96141152
Cyp2j13,4,96027534,96077546,protein_coding,-1,50012,chr4_96027534_96077546
Cyp2j14-ps,4,96356311,96380211,unprocessed_pseudogene,-1,23900,chr4_96356311_96380211
Cyp2j15-ps,4,96245560,96274270,unprocessed_pseudogene,-1,28710,chr4_96245560_96274270
Cyp2j6,4,96516138,96553661,protein_coding,-1,37523,chr4_96516138_96553661
Cyp2j8,4,96444596,96507386,protein_coding,-1,62790,chr4_96444596_96507386
Cyp2j9,4,96568429,96591578,protein_coding,-1,23149,chr4_96568429_96591578
Cyp2r1,7,114549682,114562972,protein_coding,-1,13290,chr7_114549682_114562972
Cyp2s1,7,25802475,25816913,protein_coding,-1,14438,chr7_25802475_25816913
Cyp2t4,7,27153714,27158668,protein_coding,1,4954,chr7_27153714_27158668
Cyp2u1,3,131288441,131303227,protein_coding,-1,14786,chr3_131288441_131303227
Cyp2w1,5,139352617,139357033,protein_coding,1,4416,chr5_139352617_139357033
Cyp39a1,17,43667425,43751431,protein_coding,1,84006,chr17_43667425_43751431
Cyp3a13,5,137892932,137921619,protein_coding,-1,28687,chr5_137892932_137921619
Cyp3a57,5,145345279,145390926,protein_coding,1,45647,chr5_145345279_145390926
Cyp3a61-ps1,5,138383812,138391594,unprocessed_pseudogene,-1,7782,chr5_138383812_138391594
Cyp3a63-ps,5,145624092,145633993,unprocessed_pseudogene,-1,9901,chr5_145624092_145633993
Cyp46a1,12,108334381,108362234,protein_coding,1,27853,chr12_108334381_108362234
Cyp4a28-ps,4,115138568,115156506,unprocessed_pseudogene,-1,17938,chr4_115138568_115156506
Cyp4a30-ps,4,115343788,115363115,unprocessed_pseudogene,1,19327,chr4_115343788_115363115
Cyp4b1,4,115624725,115647723,protein_coding,-1,22998,chr4_115624725_115647723
Cyp4f13,17,32924688,32947402,protein_coding,-1,22714,chr17_32924688_32947402
Cyp4f14,17,32905070,32917342,protein_coding,-1,12272,chr17_32905070_32917342
Cyp4f15,17,32685627,32703352,protein_coding,1,17725,chr17_32685627_32703352
Cyp4f16,17,32536558,32551798,protein_coding,1,15240,chr17_32536558_32551798
Cyp4f17,17,32506050,32530143,protein_coding,1,24093,chr17_32506050_32530143
Cyp4f18,8,71988482,72009626,protein_coding,-1,21144,chr8_71988482_72009626
Cyp4f37,17,32621309,32636184,protein_coding,1,14875,chr17_32621309_32636184
Cyp4f38-ps,17,32642725,32653196,unprocessed_pseudogene,1,10471,chr17_32642725_32653196
Cyp4f39,17,32452723,32493320,protein_coding,1,40597,chr17_32452723_32493320
Cyp4f40,17,32658900,32676914,protein_coding,1,18014,chr17_32658900_32676914
Cyp4f41-ps,17,32950961,32965718,transcribed_unprocessed_pseudogene,-1,14757,chr17_32950961_32965718
Cyp4v3,8,45304944,45333216,protein_coding,-1,28272,chr8_45304944_45333216
Cyp4x1,4,115106323,115134281,protein_coding,-1,27958,chr4_115106323_115134281
Cyp51,5,4081145,4104746,protein_coding,-1,23601,chr5_4081145_4104746
Cyp7b1,3,18071950,18243338,protein_coding,-1,171388,chr3_18071950_18243338
Cyp8b1,9,121914356,121916305,protein_coding,-1,1949,chr9_121914356_121916305
Cys1,12,24665833,24681813,protein_coding,-1,15980,chr12_24665833_24681813
Cysltr1,X,106574346,106603679,protein_coding,-1,29333,chrX_106574346_106603679
Cysrt1,2,25238818,25242452,protein_coding,-1,3634,chr2_25238818_25242452
Cystm1,18,36342520,36403097,protein_coding,1,60577,chr18_36342520_36403097
Cyth1,11,118132019,118248592,protein_coding,-1,116573,chr11_118132019_118248592
Cyth2,7,45806637,45814581,protein_coding,-1,7944,chr7_45806637_45814581
Cyth3,5,143622447,143710250,protein_coding,1,87803,chr5_143622447_143710250
Cyth4,15,78597047,78622019,protein_coding,1,24972,chr15_78597047_78622019
Cytip,2,58129137,58195532,protein_coding,-1,66395,chr2_58129137_58195532
Cyyr1,16,85421533,85553397,protein_coding,-1,131864,chr16_85421533_85553397
D030025E07Rik,3,128117015,128231606,processed_transcript,-1,114591,chr3_128117015_128231606
D030025P21Rik,12,84875769,84879755,antisense,1,3986,chr12_84875769_84879755
D030028A08Rik,11,96916270,96965060,processed_transcript,1,48790,chr11_96916270_96965060
D030040B21Rik,1,16657552,16662278,lincRNA,1,4726,chr1_16657552_16662278
D030045P18Rik,10,45807562,45852283,lincRNA,1,44721,chr10_45807562_45852283
D030047H15Rik,7,4126340,4136926,antisense,-1,10586,chr7_4126340_4136926
D030055H07Rik,9,106148687,106160201,antisense,1,11514,chr9_106148687_106160201
D030056L22Rik,19,18713193,18718428,protein_coding,1,5235,chr19_18713193_18718428
D030068K23Rik,8,109075222,109273811,lincRNA,1,198589,chr8_109075222_109273811
D10Wsu102e,10,83360221,83488505,protein_coding,1,128284,chr10_83360221_83488505
D11Bhm181e,11,78561319,78561600,processed_pseudogene,-1,281,chr11_78561319_78561600
D11Wsu47e,11,113684412,113694647,protein_coding,1,10235,chr11_113684412_113694647
D130007C19Rik,4,123902129,123903634,pseudogene,-1,1505,chr4_123902129_123903634
D130009I18Rik,14,104612791,104966783,lincRNA,1,353992,chr14_104612791_104966783
D130017N08Rik,5,143758354,143768575,lincRNA,1,10221,chr5_143758354_143768575
D130020L05Rik,12,101082451,101088927,antisense,1,6476,chr12_101082451_101088927
D130040H23Rik,8,69271080,69314207,protein_coding,1,43127,chr8_69271080_69314207
D130043K22Rik,13,24845135,24901270,protein_coding,1,56135,chr13_24845135_24901270
D130079A08Rik,14,104288431,104459336,lincRNA,-1,170905,chr14_104288431_104459336
D14Ertd670e,14,19838925,19844677,lincRNA,1,5752,chr14_19838925_19844677
D16Ertd472e,16,78540338,78576708,protein_coding,-1,36370,chr16_78540338_78576708
D17H6S53E,17,35126373,35128855,protein_coding,1,2482,chr17_35126373_35128855
D1Ertd622e,1,97606318,97662074,protein_coding,-1,55756,chr1_97606318_97662074
D1Pas1,1,186967416,186970627,protein_coding,1,3211,chr1_186967416_186970627
D230025D16Rik,8,105225145,105253053,protein_coding,1,27908,chr8_105225145_105253053
D2hgdh,1,93824909,93852348,protein_coding,1,27439,chr1_93824909_93852348
D330023K18Rik,2,31146457,31152291,processed_transcript,-1,5834,chr2_31146457_31152291
D330037F02Rik,9,115665914,115674353,processed_transcript,1,8439,chr9_115665914_115674353
D330041H03Rik,17,24404649,24414542,processed_transcript,-1,9893,chr17_24404649_24414542
D330050G23Rik,2,116900152,116912791,lincRNA,1,12639,chr2_116900152_116912791
D330050I16Rik,19,5388336,5389601,antisense,1,1265,chr19_5388336_5389601
D3Ertd751e,3,41742611,41803320,protein_coding,1,60709,chr3_41742611_41803320
D430001F17Rik,16,91931237,91962915,antisense,1,31678,chr16_91931237_91962915
D430018E03Rik,5,142874077,142878373,sense_intronic,-1,4296,chr5_142874077_142878373
D430019H16Rik,12,105453856,105493095,protein_coding,1,39239,chr12_105453856_105493095
D430020J02Rik,12,116401947,116405210,bidirectional_promoter_lncRNA,-1,3263,chr12_116401947_116405210
D430036J16Rik,9,81631551,81645156,antisense,1,13605,chr9_81631551_81645156
D430041D05Rik,2,104143073,104411013,protein_coding,-1,267940,chr2_104143073_104411013
D430042O09Rik,7,125707888,125874793,protein_coding,1,166905,chr7_125707888_125874793
D530049I02Rik,1,73398968,73430790,lincRNA,1,31822,chr1_73398968_73430790
D5Ertd579e,5,36600485,36696024,protein_coding,-1,95539,chr5_36600485_36696024
D5Ertd605e,5,147418601,147423044,lincRNA,1,4443,chr5_147418601_147423044
D5Ertd615e,5,45009171,45424402,lincRNA,-1,415231,chr5_45009171_45424402
D630003M21Rik,2,158182533,158229222,protein_coding,-1,46689,chr2_158182533_158229222
D630023F18Rik,1,65105285,65123214,protein_coding,-1,17929,chr1_65105285_65123214
D630024D03Rik,11,31790113,31824524,lincRNA,-1,34411,chr11_31790113_31824524
D630029K05Rik,10,116964707,116969105,lincRNA,1,4398,chr10_116964707_116969105
D630033O11Rik,9,43243599,43280076,lincRNA,1,36477,chr9_43243599_43280076
D630039A03Rik,4,57908483,57916297,protein_coding,-1,7814,chr4_57908483_57916297
D630045J12Rik,6,38123174,38254009,protein_coding,-1,130835,chr6_38123174_38254009
D6Ertd474e,6,143245888,143297272,lincRNA,1,51384,chr6_143245888_143297272
D6Ertd527e,6,87104746,87112997,protein_coding,1,8251,chr6_87104746_87112997
D6Wsu163e,6,126939962,126975967,protein_coding,1,36005,chr6_126939962_126975967
D730003I15Rik,1,191224454,191226140,lincRNA,1,1686,chr1_191224454_191226140
D730045A05Rik,18,74017907,74020088,lincRNA,1,2181,chr18_74017907_74020088
D7Ertd128e,7,30885031,30886446,lincRNA,1,1415,chr7_30885031_30886446
D7Ertd443e,7,134265779,134501160,protein_coding,-1,235381,chr7_134265779_134501160
D830005E20Rik,10,33222345,33256418,antisense,-1,34073,chr10_33222345_33256418
D830013O20Rik,12,73364075,73409557,lincRNA,-1,45482,chr12_73364075_73409557
D830026I12Rik,6,17197751,17210152,lincRNA,1,12401,chr6_17197751_17210152
D830030K20Rik,14,3208488,3234351,protein_coding,1,25863,chr14_3208488_3234351
D830035M03Rik,9,120490532,120492547,antisense,-1,2015,chr9_120490532_120492547
D8Ertd738e,8,84246238,84249719,protein_coding,-1,3481,chr8_84246238_84249719
D930007P13Rik,15,103123070,103146828,lincRNA,-1,23758,chr15_103123070_103146828
D930015M05Rik,2,92408892,92432308,processed_transcript,1,23416,chr2_92408892_92432308
D930019O06Rik,1,39650176,39657390,antisense,1,7214,chr1_39650176_39657390
D930020B18Rik,10,121641588,121693915,protein_coding,1,52327,chr10_121641588_121693915
D930028M14Rik,7,25152457,25156627,lincRNA,1,4170,chr7_25152457_25156627
D930032P07Rik,19,28678224,28720027,lincRNA,1,41803,chr19_28678224_28720027
D930048N14Rik,11,51650954,51657681,protein_coding,1,6727,chr11_51650954_51657681
D9Wsu149,9,57482976,57483569,processed_pseudogene,1,593,chr9_57482976_57483569
DQ267100,12,109649617,109650196,snoRNA,1,579,chr12_109649617_109650196
DQ267101,12,109651424,109652004,snoRNA,1,580,chr12_109651424_109652004
DQ267102,12,109656345,109656924,snoRNA,1,579,chr12_109656345_109656924
DXBay18,X,73137232,73149450,protein_coding,-1,12218,chrX_73137232_73149450
Daam1,12,71831078,71992333,protein_coding,1,161255,chr12_71831078_71992333
Daam2,17,49456022,49564343,protein_coding,-1,108321,chr17_49456022_49564343
Dab1,4,103619359,104744844,protein_coding,1,1125485,chr4_103619359_104744844
Dab2,15,6299788,6440712,protein_coding,1,140924,chr15_6299788_6440712
Dab2ip,2,35558266,35730994,protein_coding,1,172728,chr2_35558266_35730994
Dach1,14,97786853,98169765,protein_coding,-1,382912,chr14_97786853_98169765
Dach2,X,113297510,113836386,protein_coding,1,538876,chrX_113297510_113836386
Dact1,12,71309884,71320107,protein_coding,1,10223,chr12_71309884_71320107
Dact2,17,14195052,14204304,protein_coding,-1,9252,chr17_14195052_14204304
Dact3,7,16875317,16887462,protein_coding,1,12145,chr7_16875317_16887462
Dad1,14,54235479,54254104,protein_coding,-1,18625,chr14_54235479_54254104
Dag1,9,108204634,108263958,protein_coding,-1,59324,chr9_108204634_108263958
Dagla,19,10245265,10304877,protein_coding,-1,59612,chr19_10245265_10304877
Daglb,5,143464584,143505942,protein_coding,1,41358,chr5_143464584_143505942
Dalrd3,9,108569886,108572774,protein_coding,1,2888,chr9_108569886_108572774
Dancr,5,74093060,74095406,processed_transcript,1,2346,chr5_74093060_74095406
Dand5,8,84815404,84832409,protein_coding,-1,17005,chr8_84815404_84832409
Dao,5,114003703,114025682,protein_coding,1,21979,chr5_114003703_114025682
Dap,15,31224314,31274341,protein_coding,1,50027,chr15_31224314_31274341
Dap3,3,88920803,88951181,protein_coding,-1,30378,chr3_88920803_88951181
Dapk1,13,60601947,60763191,protein_coding,1,161244,chr13_60601947_60763191
Dapk2,9,66158223,66272242,protein_coding,1,114019,chr9_66158223_66272242
Dapk3,10,81183005,81193197,protein_coding,1,10192,chr10_81183005_81193197
Dapl1,2,59484653,59505020,protein_coding,1,20367,chr2_59484653_59505020
Dapp1,3,137931007,137981545,protein_coding,-1,50538,chr3_137931007_137981545
Dars,1,128363707,128417368,protein_coding,-1,53661,chr1_128363707_128417368
Dars2,1,161040601,161070658,protein_coding,-1,30057,chr1_161040601_161070658
Daw1,1,83159752,83210574,protein_coding,1,50822,chr1_83159752_83210574
Daxx,17,33909414,33915590,protein_coding,1,6176,chr17_33909414_33915590
Dazap1,10,80261486,80288408,protein_coding,1,26922,chr10_80261486_80288408
Dazap2,15,100615349,100620761,protein_coding,1,5412,chr15_100615349_100620761
Dazl,17,50279395,50293636,protein_coding,-1,14241,chr17_50279395_50293636
Dbf4,5,8396973,8422716,protein_coding,-1,25743,chr5_8396973_8422716
Dbh,2,27165233,27183200,protein_coding,1,17967,chr2_27165233_27183200
Dbhos,2,27144898,27162703,antisense,-1,17805,chr2_27144898_27162703
Dbi,1,120113280,120121078,protein_coding,-1,7798,chr1_120113280_120121078
Dbil5,11,76217608,76218666,protein_coding,1,1058,chr11_76217608_76218666
Dbn1,13,55473429,55488111,protein_coding,-1,14682,chr13_55473429_55488111
Dbndd1,8,123504718,123515463,protein_coding,-1,10745,chr8_123504718_123515463
Dbndd2,2,164486106,164493319,protein_coding,1,7213,chr2_164486106_164493319
Dbnl,11,5788488,5800962,protein_coding,1,12474,chr11_5788488_5800962
Dbp,7,45705088,45710203,protein_coding,1,5115,chr7_45705088_45710203
Dbpht2,12,74296668,74302008,lincRNA,1,5340,chr12_74296668_74302008
Dbr1,9,99575799,99584501,protein_coding,1,8702,chr9_99575799_99584501
Dbt,3,116513070,116549981,protein_coding,1,36911,chr3_116513070_116549981
Dbx2,15,95623563,95655960,protein_coding,-1,32397,chr15_95623563_95655960
Dcaf10,4,45342101,45379759,protein_coding,1,37658,chr4_45342101_45379759
Dcaf11,14,55560006,55570065,protein_coding,1,10059,chr14_55560006_55570065
Dcaf12,4,41291300,41314889,protein_coding,-1,23589,chr4_41291300_41314889
Dcaf12l1,X,44786570,44790197,protein_coding,-1,3627,chrX_44786570_44790197
Dcaf12l2,X,44365458,44368342,protein_coding,-1,2884,chrX_44365458_44368342
Dcaf13,15,38976016,39146856,protein_coding,1,170840,chr15_38976016_39146856
Dcaf15,8,84097072,84104768,protein_coding,-1,7696,chr8_84097072_84104768
Dcaf17,2,71055328,71099142,protein_coding,1,43814,chr2_71055328_71099142
Dcaf4,12,83520466,83541920,protein_coding,1,21454,chr12_83520466_83541920
Dcaf5,12,80335848,80436601,protein_coding,-1,100753,chr12_80335848_80436601
Dcaf6,1,165328698,165460475,protein_coding,-1,131777,chr1_165328698_165460475
Dcaf7,11,106036872,106059324,protein_coding,1,22452,chr11_106036872_106059324
Dcaf8,1,172148084,172197005,protein_coding,1,48921,chr1_172148084_172197005
Dcakd,11,102994047,103028333,protein_coding,-1,34286,chr11_102994047_103028333
Dcbld1,10,52233619,52321378,protein_coding,1,87759,chr10_52233619_52321378
Dcbld2,16,58408443,58469727,protein_coding,1,61284,chr16_58408443_58469727
Dcc,18,71253634,72351069,protein_coding,-1,1097435,chr18_71253634_72351069
Dcdc2a,13,25056004,25210706,protein_coding,1,154702,chr13_25056004_25210706
Dcdc2b,4,129608331,129614257,protein_coding,-1,5926,chr4_129608331_129614257
Dcdc2c,12,28437795,28552399,protein_coding,-1,114604,chr12_28437795_28552399
Dcdc5,2,106003336,106406151,transcribed_unitary_pseudogene,1,402815,chr2_106003336_106406151
Dchs1,7,105752990,105787654,protein_coding,-1,34664,chr7_105752990_105787654
Dck,5,88764996,88783281,protein_coding,1,18285,chr5_88764996_88783281
Dclk1,3,55242364,55539068,protein_coding,1,296704,chr3_55242364_55539068
Dclk2,3,86786151,86920852,protein_coding,-1,134701,chr3_86786151_86920852
Dclk3,9,111439081,111489118,protein_coding,1,50037,chr9_111439081_111489118
Dclre1a,19,56529167,56548222,protein_coding,-1,19055,chr19_56529167_56548222
Dclre1b,3,103800605,103809444,protein_coding,-1,8839,chr3_103800605_103809444
Dclre1c,2,3424131,3464130,protein_coding,1,39999,chr2_3424131_3464130
Dcn,10,97479609,97518143,protein_coding,1,38534,chr10_97479609_97518143
Dcp1a,14,30479535,30527063,protein_coding,1,47528,chr14_30479535_30527063
Dcp1b,6,119175253,119221616,protein_coding,1,46363,chr6_119175253_119221616
Dcp2,18,44380502,44424969,protein_coding,1,44467,chr18_44380502_44424969
Dcpp3,17,23917458,23919441,protein_coding,1,1983,chr17_23917458_23919441
Dcps,9,35124408,35176061,protein_coding,-1,51653,chr9_35124408_35176061
Dcst1,3,89350219,89365253,protein_coding,-1,15034,chr3_89350219_89365253
Dcst2,3,89361975,89377549,protein_coding,1,15574,chr3_89361975_89377549
Dcstamp,15,39745930,39760938,protein_coding,1,15008,chr15_39745930_39760938
Dct,14,118012790,118052244,protein_coding,-1,39454,chr14_118012790_118052244
Dctd,8,48099092,48153233,protein_coding,1,54141,chr8_48099092_48153233
Dctn1,6,83165920,83200117,protein_coding,1,34197,chr6_83165920_83200117
Dctn2,10,127266368,127281950,protein_coding,1,15582,chr10_127266368_127281950
Dctn3,4,41714798,41723170,protein_coding,-1,8372,chr4_41714798_41723170
Dctn4,18,60526185,60558766,protein_coding,1,32581,chr18_60526185_60558766
Dctn5,7,122133041,122149044,protein_coding,1,16003,chr7_122133041_122149044
Dctn6,8,34090420,34108796,protein_coding,-1,18376,chr8_34090420_34108796
Dctpp1,7,127256959,127260709,protein_coding,-1,3750,chr7_127256959_127260709
Dcun1d1,3,35892105,35937445,protein_coding,-1,45340,chr3_35892105_35937445
Dcun1d2,8,13255963,13288131,protein_coding,-1,32168,chr8_13255963_13288131
Dcun1d3,7,119852796,119896298,protein_coding,-1,43502,chr7_119852796_119896298
Dcun1d4,5,73481000,73560794,protein_coding,1,79794,chr5_73481000_73560794
Dcun1d5,9,7184520,7208205,protein_coding,1,23685,chr9_7184520_7208205
Dcx,X,143855842,143933311,protein_coding,-1,77469,chrX_143855842_143933311
Dcxr,11,120725399,120727281,protein_coding,-1,1882,chr11_120725399_120727281
Dda1,8,71469199,71476098,protein_coding,1,6899,chr8_71469199_71476098
Ddah1,3,145758675,145894277,protein_coding,1,135602,chr3_145758675_145894277
Ddah2,17,35059035,35062095,protein_coding,1,3060,chr17_35059035_35062095
Ddb1,19,10605327,10629819,protein_coding,1,24492,chr19_10605327_10629819
Ddb2,2,91211572,91236982,protein_coding,-1,25410,chr2_91211572_91236982
Ddc,11,11814101,11898144,protein_coding,-1,84043,chr11_11814101_11898144
Ddhd1,14,45588467,45658143,protein_coding,-1,69676,chr14_45588467_45658143
Ddhd2,8,25725346,25754596,protein_coding,-1,29250,chr8_25725346_25754596
Ddi2,4,141677549,141723419,protein_coding,-1,45870,chr4_141677549_141723419
Ddias,7,92857525,92874247,protein_coding,-1,16722,chr7_92857525_92874247
Ddit3,10,127290774,127296288,protein_coding,1,5514,chr10_127290774_127296288
Ddit4,10,59949669,59951834,protein_coding,-1,2165,chr10_59949669_59951834
Ddit4l,3,137621612,137628333,protein_coding,1,6721,chr3_137621612_137628333
Ddn,15,98803777,98809490,protein_coding,-1,5713,chr15_98803777_98809490
Ddo,10,40630011,40681847,protein_coding,1,51836,chr10_40630011_40681847
Ddost,4,138304730,138312628,protein_coding,1,7898,chr4_138304730_138312628
Ddr1,17,35681567,35704621,protein_coding,-1,23054,chr17_35681567_35704621
Ddr2,1,169972307,170110762,protein_coding,-1,138455,chr1_169972307_170110762
Ddrgk1,2,130653960,130664659,protein_coding,-1,10699,chr2_130653960_130664659
Ddt,10,75771230,75773414,protein_coding,-1,2184,chr10_75771230_75773414
Ddx1,12,13216973,13249213,protein_coding,-1,32240,chr12_13216973_13249213
Ddx10,9,53098635,53248053,protein_coding,-1,149418,chr9_53098635_53248053
Ddx11,17,66123520,66152174,protein_coding,1,28654,chr17_66123520_66152174
Ddx17,15,79527736,79546741,protein_coding,-1,19005,chr15_79527736_79546741
Ddx18,1,121553835,121567989,protein_coding,-1,14154,chr1_121553835_121567989
Ddx19a,8,110974996,110997800,protein_coding,-1,22804,chr8_110974996_110997800
Ddx19b,8,111003188,111031751,protein_coding,-1,28563,chr8_111003188_111031751
Ddx20,3,105678270,105687574,protein_coding,-1,9304,chr3_105678270_105687574
Ddx21,10,62580251,62602281,protein_coding,-1,22030,chr10_62580251_62602281
Ddx23,15,98645134,98662894,protein_coding,-1,17760,chr15_98645134_98662894
Ddx24,12,103407982,103425830,protein_coding,-1,17848,chr12_103407982_103425830
Ddx25,9,35536647,35558528,protein_coding,-1,21881,chr9_35536647_35558528
Ddx27,2,167015193,167034947,protein_coding,1,19754,chr2_167015193_167034947
Ddx28,8,106009621,106011882,protein_coding,-1,2261,chr8_106009621_106011882
Ddx31,2,28840406,28905571,protein_coding,1,65165,chr2_28840406_28905571
Ddx39,8,83715177,83726892,protein_coding,1,11715,chr8_83715177_83726892
Ddx39b,17,35241746,35253707,protein_coding,1,11961,chr17_35241746_35253707
Ddx3x,X,13280970,13294052,protein_coding,1,13082,chrX_13280970_13294052
Ddx3y,Y,1260771,1286629,protein_coding,-1,25858,chrY_1260771_1286629
Ddx4,13,112598333,112652475,protein_coding,-1,54142,chr13_112598333_112652475
Ddx41,13,55530410,55536658,protein_coding,-1,6248,chr13_55530410_55536658
Ddx42,11,106216926,106249139,protein_coding,1,32213,chr11_106216926_106249139
Ddx43,9,78395777,78423587,protein_coding,1,27810,chr9_78395777_78423587
Ddx46,13,55635027,55681256,protein_coding,1,46229,chr13_55635027_55681256
Ddx47,6,135011612,135023776,protein_coding,1,12164,chr6_135011612_135023776
Ddx49,8,70292866,70302489,protein_coding,-1,9623,chr8_70292866_70302489
Ddx5,11,106780355,106789185,protein_coding,-1,8830,chr11_106780355_106789185
Ddx50,10,62615895,62651218,protein_coding,-1,35323,chr10_62615895_62651218
Ddx51,5,110653451,110660496,protein_coding,1,7045,chr5_110653451_110660496
Ddx52,11,83942062,83963088,protein_coding,1,21026,chr11_83942062_83963088
Ddx54,5,120612739,120628592,protein_coding,1,15853,chr5_120612739_120628592
Ddx55,5,124552864,124569660,protein_coding,1,16796,chr5_124552864_124569660
Ddx56,11,6258919,6267772,protein_coding,-1,8853,chr11_6258919_6267772
Ddx58,4,40203773,40239828,protein_coding,-1,36055,chr4_40203773_40239828
Ddx59,1,136415271,136440158,protein_coding,1,24887,chr1_136415271_136440158
Ddx6,9,44604892,44640731,protein_coding,1,35839,chr9_44604892_44640731
Ddx60,8,61928087,62038244,protein_coding,1,110157,chr8_61928087_62038244
Deaf1,7,141297180,141327690,protein_coding,-1,30510,chr7_141297180_141327690
Decr1,4,15917240,15945507,protein_coding,-1,28267,chr4_15917240_15945507
Decr2,17,26081208,26090337,protein_coding,-1,9129,chr17_26081208_26090337
Dedd,1,171329145,171342331,protein_coding,1,13186,chr1_171329145_171342331
Dedd2,7,25199915,25220615,protein_coding,-1,20700,chr7_25199915_25220615
Def6,17,28207778,28228608,protein_coding,1,20830,chr17_28207778_28228608
Def8,8,123423527,123463270,protein_coding,1,39743,chr8_123423527_123463270
Defb1,8,21776599,21795185,protein_coding,1,18586,chr8_21776599_21795185
Defb20,2,152477063,152479934,protein_coding,1,2871,chr2_152477063_152479934
Defb35,8,21938352,21940878,protein_coding,1,2526,chr8_21938352_21940878
Defb36,2,152604327,152612729,protein_coding,1,8402,chr2_152604327_152612729
Degs1,1,182275772,182282804,protein_coding,-1,7032,chr1_182275772_182282804
Degs2,12,108678711,108702315,protein_coding,-1,23604,chr12_108678711_108702315
Dek,13,47084775,47106201,protein_coding,-1,21426,chr13_47084775_47106201
Dennd1a,2,37798991,38287390,protein_coding,-1,488399,chr2_37798991_38287390
Dennd1b,1,138963435,139178960,protein_coding,1,215525,chr1_138963435_139178960
Dennd1c,17,57065905,57078514,protein_coding,-1,12609,chr17_57065905_57078514
Dennd2a,6,39462378,39557867,protein_coding,-1,95489,chr6_39462378_39557867
Dennd2c,3,103102604,103169769,protein_coding,1,67165,chr3_103102604_103169769
Dennd2d,3,106482405,106503030,protein_coding,1,20625,chr3_106482405_106503030
Dennd3,15,73512560,73572242,protein_coding,1,59682,chr15_73512560_73572242
Dennd4a,9,64811340,64919667,protein_coding,1,108327,chr9_64811340_64919667
Dennd4b,3,90265185,90280669,protein_coding,1,15484,chr3_90265185_90280669
Dennd4c,4,86748555,86850603,protein_coding,1,102048,chr4_86748555_86850603
Dennd5a,7,109893780,109960470,protein_coding,-1,66690,chr7_109893780_109960470
Dennd5b,6,148988071,149101680,protein_coding,-1,113609,chr6_148988071_149101680
Dennd6a,14,26573856,26634322,protein_coding,1,60466,chr14_26573856_26634322
Dennd6b,15,89182213,89196496,protein_coding,-1,14283,chr15_89182213_89196496
Denr,5,123907175,123928835,protein_coding,1,21660,chr5_123907175_123928835
Depdc1a,3,159495433,159529955,protein_coding,1,34522,chr3_159495433_159529955
Depdc1b,13,108316332,108407782,protein_coding,1,91450,chr13_108316332_108407782
Depdc5,5,32863701,32994236,protein_coding,1,130535,chr5_32863701_32994236
Depdc7,2,104721784,104742878,protein_coding,-1,21094,chr2_104721784_104742878
Deptor,15,55112317,55259271,protein_coding,1,146954,chr15_55112317_55259271
Dera,6,137754546,137857340,protein_coding,1,102794,chr6_137754546_137857340
Derl1,15,57869502,57892448,protein_coding,-1,22946,chr15_57869502_57892448
Derl2,11,71007164,71019841,protein_coding,-1,12677,chr11_71007164_71019841
Derl3,10,75893413,75895941,protein_coding,1,2528,chr10_75893413_75895941
Des,1,75360329,75368579,protein_coding,1,8250,chr1_75360329_75368579
Desi1,15,81992523,82033862,protein_coding,-1,41339,chr15_81992523_82033862
Desi2,1,178187417,178257301,protein_coding,1,69884,chr1_178187417_178257301
Det1,7,78821547,78847263,protein_coding,-1,25716,chr7_78821547_78847263
Dexi,16,10502531,10543054,protein_coding,-1,40523,chr16_10502531_10543054
Dffa,4,149104146,149120647,protein_coding,1,16501,chr4_149104146_149120647
Dffb,4,153964449,153975126,protein_coding,-1,10677,chr4_153964449_153975126
Dgat1,15,76502015,76511953,protein_coding,-1,9938,chr15_76502015_76511953
Dgat2,7,99153658,99182719,protein_coding,-1,29061,chr7_99153658_99182719
Dgat2l6,X,100524838,100546144,protein_coding,1,21306,chrX_100524838_100546144
Dgcr2,16,17839482,17898562,protein_coding,-1,59080,chr16_17839482_17898562
Dgcr6,16,18052860,18071632,protein_coding,1,18772,chr16_18052860_18071632
Dgcr8,16,18253948,18289246,protein_coding,-1,35298,chr16_18253948_18289246
Dgka,10,128720134,128744855,protein_coding,-1,24721,chr10_128720134_128744855
Dgkb,12,37817726,38634239,protein_coding,1,816513,chr12_37817726_38634239
Dgkd,1,87853287,87945180,protein_coding,1,91893,chr1_87853287_87945180
Dgke,11,89035179,89066850,protein_coding,-1,31671,chr11_89035179_89066850
Dgkeos,11,89064729,89069098,antisense,1,4369,chr11_89064729_89069098
Dgkg,16,22468461,22657221,protein_coding,-1,188760,chr16_22468461_22657221
Dgkh,14,78558750,78732776,protein_coding,-1,174026,chr14_78558750_78732776
Dgki,6,36846022,37300184,protein_coding,-1,454162,chr6_36846022_37300184
Dgkq,5,108646693,108669672,protein_coding,-1,22979,chr5_108646693_108669672
Dgkz,2,91932824,91975864,protein_coding,-1,43040,chr2_91932824_91975864
Dguok,6,83480217,83506969,protein_coding,-1,26752,chr6_83480217_83506969
Dhcr24,4,106561038,106589113,protein_coding,1,28075,chr4_106561038_106589113
Dhcr7,7,143823145,143848410,protein_coding,1,25265,chr7_143823145_143848410
Dhdds,4,133969028,134000918,protein_coding,-1,31890,chr4_133969028_134000918
Dhdh,7,45470987,45488805,protein_coding,-1,17818,chr7_45470987_45488805
Dhfr,13,92354726,92389053,protein_coding,1,34327,chr13_92354726_92389053
Dhh,15,98891152,98898540,protein_coding,-1,7388,chr15_98891152_98898540
Dhodh,8,109591343,109608673,protein_coding,-1,17330,chr8_109591343_109608673
Dhps,8,85071757,85075162,protein_coding,1,3405,chr8_85071757_85075162
Dhrs1,14,55739020,55745690,protein_coding,-1,6670,chr14_55739020_55745690
Dhrs11,11,84820856,84828994,protein_coding,-1,8138,chr11_84820856_84828994
Dhrs13,11,78032280,78037866,protein_coding,1,5586,chr11_78032280_78037866
Dhrs13os,11,78030012,78032665,antisense,-1,2653,chr11_78030012_78032665
Dhrs2,14,55222007,55241435,protein_coding,1,19428,chr14_55222007_55241435
Dhrs3,4,144892827,144928209,protein_coding,1,35382,chr4_144892827_144928209
Dhrs4,14,55478758,55490340,protein_coding,1,11582,chr14_55478758_55490340
Dhrs7,12,72650353,72664909,protein_coding,-1,14556,chr12_72650353_72664909
Dhrs7b,11,60830631,60860195,protein_coding,1,29564,chr11_60830631_60860195
Dhrs7c,11,67798187,67816002,protein_coding,1,17815,chr11_67798187_67816002
Dhtkd1,2,5896115,5942792,protein_coding,-1,46677,chr2_5896115_5942792
Dhx15,5,52150203,52190514,protein_coding,-1,40311,chr5_52150203_52190514
Dhx16,17,35879819,35892670,protein_coding,1,12851,chr17_35879819_35892670
Dhx29,13,112927454,112969432,protein_coding,1,41978,chr13_112927454_112969432
Dhx30,9,110084320,110117830,protein_coding,-1,33510,chr9_110084320_110117830
Dhx32,7,133720942,133782726,protein_coding,-1,61784,chr7_133720942_133782726
Dhx33,11,70984091,71004437,protein_coding,-1,20346,chr11_70984091_71004437
Dhx34,7,16197147,16222037,protein_coding,-1,24890,chr7_16197147_16222037
Dhx35,2,158794807,158858214,protein_coding,1,63407,chr2_158794807_158858214
Dhx36,3,62468013,62507004,protein_coding,-1,38991,chr3_62468013_62507004
Dhx37,5,125413858,125434121,protein_coding,-1,20263,chr5_125413858_125434121
Dhx38,8,109548011,109565861,protein_coding,-1,17850,chr8_109548011_109565861
Dhx40,11,86768846,86807746,protein_coding,-1,38900,chr11_86768846_86807746
Dhx57,17,80238309,80290476,protein_coding,-1,52167,chr17_80238309_80290476
Dhx58,11,100694884,100704271,protein_coding,-1,9387,chr11_100694884_100704271
Dhx8,11,101732919,101767358,protein_coding,1,34439,chr11_101732919_101767358
Dhx9,1,153455758,153487660,protein_coding,-1,31902,chr1_153455758_153487660
Diablo,5,123509765,123524176,protein_coding,-1,14411,chr5_123509765_123524176
Dicer1,12,104687742,104751952,protein_coding,-1,64210,chr12_104687742_104751952
Dido1,2,180657964,180709999,protein_coding,-1,52035,chr2_180657964_180709999
Dimt1,13,106947127,106960224,protein_coding,1,13097,chr13_106947127_106960224
Dio2,12,90724552,90738438,protein_coding,-1,13886,chr12_90724552_90738438
Dio3,12,110279068,110281097,protein_coding,1,2029,chr12_110279068_110281097
Dip2a,10,76259429,76345291,protein_coding,-1,85862,chr10_76259429_76345291
Dip2b,15,100038664,100219473,protein_coding,1,180809,chr15_100038664_100219473
Dip2c,13,9276528,9668928,protein_coding,1,392400,chr13_9276528_9668928
Diras1,10,81019589,81025662,protein_coding,-1,6073,chr10_81019589_81025662
Diras2,13,52504380,52531279,protein_coding,-1,26899,chr13_52504380_52531279
Dis3,14,99075206,99099770,protein_coding,-1,24564,chr14_99075206_99099770
Dis3l,9,64306756,64341288,protein_coding,-1,34532,chr9_64306756_64341288
Dis3l2,1,86703808,87050095,protein_coding,1,346287,chr1_86703808_87050095
Disc1,8,125054195,125261858,protein_coding,1,207663,chr8_125054195_125261858
Disp1,1,183086266,183221522,protein_coding,-1,135256,chr1_183086266_183221522
Disp2,2,118779719,118811293,protein_coding,1,31574,chr2_118779719_118811293
Dixdc1,9,50662752,50739517,protein_coding,-1,76765,chr9_50662752_50739517
Dkc1,X,75095854,75109777,protein_coding,1,13923,chrX_75095854_75109777
Dkk2,3,132085292,132180304,protein_coding,1,95012,chr3_132085292_132180304
Dkk3,7,112116017,112159057,protein_coding,-1,43040,chr7_112116017_112159057
Dkk4,8,22624043,22627547,protein_coding,1,3504,chr8_22624043_22627547
Dkkl1,7,45207519,45212147,protein_coding,-1,4628,chr7_45207519_45212147
Dlat,9,50634633,50659780,protein_coding,-1,25147,chr9_50634633_50659780
Dlc1,8,36567751,36953143,protein_coding,-1,385392,chr8_36567751_36953143
Dld,12,31331277,31351453,protein_coding,-1,20176,chr12_31331277_31351453
Dlec1,9,119102478,119148246,protein_coding,1,45768,chr9_119102478_119148246
Dleu2,14,61602839,61682373,processed_transcript,-1,79534,chr14_61602839_61682373
Dleu7,14,62276231,62293047,protein_coding,-1,16816,chr14_62276231_62293047
Dlg1,16,31663443,31875129,protein_coding,1,211686,chr16_31663443_31875129
Dlg2,7,90476672,92449247,protein_coding,1,1972575,chr7_90476672_92449247
Dlg3,X,100767722,100818410,protein_coding,1,50688,chrX_100767722_100818410
Dlg4,11,70016942,70047522,protein_coding,1,30580,chr11_70016942_70047522
Dlg5,14,24133953,24245920,protein_coding,-1,111967,chr14_24133953_24245920
Dlgap1,17,69969073,70821413,protein_coding,1,852340,chr17_69969073_70821413
Dlgap2,8,14095865,14847680,protein_coding,1,751815,chr8_14095865_14847680
Dlgap3,4,127169204,127237022,protein_coding,1,67818,chr4_127169204_127237022
Dlgap4,2,156613705,156764363,protein_coding,1,150658,chr2_156613705_156764363
Dlgap5,14,47387779,47418407,protein_coding,-1,30628,chr14_47387779_47418407
Dlk1,12,109452823,109463336,protein_coding,1,10513,chr12_109452823_109463336
Dlk2,17,46297421,46303271,protein_coding,1,5850,chr17_46297421_46303271
Dll1,17,15367354,15376872,protein_coding,-1,9518,chr17_15367354_15376872
Dll3,7,28293553,28302238,protein_coding,-1,8685,chr7_28293553_28302238
Dll4,2,119325784,119335962,protein_coding,1,10178,chr2_119325784_119335962
Dlst,12,85110833,85134845,protein_coding,1,24012,chr12_85110833_85134845
Dlx1,2,71528113,71533981,protein_coding,1,5868,chr2_71528113_71533981
Dlx1as,2,71516454,71537891,antisense,-1,21437,chr2_71516454_71537891
Dlx2,2,71543408,71546754,protein_coding,-1,3346,chr2_71543408_71546754
Dlx3,11,95120119,95125296,protein_coding,1,5177,chr11_95120119_95125296
Dlx4,11,95140447,95146263,protein_coding,-1,5816,chr11_95140447_95146263
Dlx5,6,6877805,6882085,protein_coding,-1,4280,chr6_6877805_6882085
Dlx6,6,6863334,6868568,protein_coding,1,5234,chr6_6863334_6868568
Dlx6os1,6,6820189,6871633,antisense;misc_RNA,-1,51444,chr6_6820189_6871633
Dmap1,4,117674681,117682273,protein_coding,-1,7592,chr4_117674681_117682273
Dmbt1,7,131032046,131121628,protein_coding,1,89582,chr7_131032046_131121628
Dmbx1,4,115915119,115939926,protein_coding,-1,24807,chr4_115915119_115939926
Dmc1,15,79561497,79605109,protein_coding,-1,43612,chr15_79561497_79605109
Dmd,X,82948870,85206141,protein_coding,1,2257271,chrX_82948870_85206141
Dmgdh,13,93674433,93752833,protein_coding,1,78400,chr13_93674433_93752833
Dmkn,7,30763756,30781063,protein_coding,1,17307,chr7_30763756_30781063
Dmp1,5,104202613,104214102,protein_coding,1,11489,chr5_104202613_104214102
Dmpk,7,19083849,19093821,protein_coding,1,9972,chr7_19083849_19093821
Dmrt2,19,25672411,25678991,protein_coding,1,6580,chr19_25672411_25678991
Dmrta1,4,89679436,89694772,protein_coding,1,15336,chr4_89679436_89694772
Dmrta2,4,109978053,109983687,protein_coding,1,5634,chr4_109978053_109983687
Dmrta2os,4,109976738,109977813,antisense,-1,1075,chr4_109976738_109977813
Dmrtb1,4,107676290,107684230,protein_coding,-1,7940,chr4_107676290_107684230
Dmrtc1a,X,102903216,102908687,protein_coding,-1,5471,chrX_102903216_102908687
Dmrtc2,7,24870057,24877651,protein_coding,1,7594,chr7_24870057_24877651
Dmtf1,5,9118801,9161776,protein_coding,-1,42975,chr5_9118801_9161776
Dmtn,14,70601263,70636048,protein_coding,-1,34785,chr14_70601263_70636048
Dmwd,7,19076227,19082776,protein_coding,1,6549,chr7_19076227_19082776
Dmxl1,18,49832670,49965473,protein_coding,1,132803,chr18_49832670_49965473
Dmxl2,9,54365158,54501626,protein_coding,-1,136468,chr9_54365158_54501626
Dna2,10,62947026,62974185,protein_coding,1,27159,chr10_62947026_62974185
Dnaaf1,8,119575235,119598454,protein_coding,1,23219,chr8_119575235_119598454
Dnaaf2,12,69189087,69198429,protein_coding,-1,9342,chr12_69189087_69198429
Dnaaf3,7,4522933,4532453,protein_coding,-1,9520,chr7_4522933_4532453
Dnaaf5,5,139150223,139186510,protein_coding,1,36287,chr5_139150223_139186510
Dnah1,14,31260375,31323896,protein_coding,-1,63521,chr14_31260375_31323896
Dnah10,5,124725085,124834308,protein_coding,1,109223,chr5_124725085_124834308
Dnah11,12,117877982,118199043,protein_coding,-1,321061,chr12_117877982_118199043
Dnah12,14,26693274,26892505,protein_coding,1,199231,chr14_26693274_26892505
Dnah14,1,181576559,181815774,protein_coding,1,239215,chr1_181576559_181815774
Dnah17,11,118021723,118130634,protein_coding,-1,108911,chr11_118021723_118130634
Dnah2,11,69420809,69549110,protein_coding,-1,128301,chr11_69420809_69549110
Dnah3,7,119922671,120095280,protein_coding,-1,172609,chr7_119922671_120095280
Dnah5,15,28203752,28472052,protein_coding,1,268300,chr15_28203752_28472052
Dnah6,6,73017606,73221651,protein_coding,-1,204045,chr6_73017606_73221651
Dnah7a,1,53397006,53706784,protein_coding,-1,309778,chr1_53397006_53706784
Dnah7b,1,46066315,46373550,protein_coding,1,307235,chr1_46066315_46373550
Dnah7c,1,46425592,46807476,protein_coding,1,381884,chr1_46425592_46807476
Dnah8,17,30624354,30877365,protein_coding,1,253011,chr17_30624354_30877365
Dnah9,11,65831282,66168551,protein_coding,-1,337269,chr11_65831282_66168551
Dnaic1,4,41569775,41638158,protein_coding,1,68383,chr4_41569775_41638158
Dnaic2,11,114727408,114757889,protein_coding,1,30481,chr11_114727408_114757889
Dnaja1,4,40722150,40737149,protein_coding,1,14999,chr4_40722150_40737149
Dnaja1-ps,5,21951858,21952499,processed_pseudogene,-1,641,chr5_21951858_21952499
Dnaja2,8,85537633,85555344,protein_coding,-1,17711,chr8_85537633_85555344
Dnaja3,16,4639989,4707695,protein_coding,1,67706,chr16_4639989_4707695
Dnaja4,9,54698873,54716315,protein_coding,1,17442,chr9_54698873_54716315
Dnajb1,8,83608193,83612653,protein_coding,1,4460,chr8_83608193_83612653
Dnajb11,16,22857845,22879634,protein_coding,1,21789,chr16_22857845_22879634
Dnajb12,10,59879556,59899302,protein_coding,1,19746,chr10_59879556_59899302
Dnajb13,7,100501716,100514960,protein_coding,-1,13244,chr7_100501716_100514960
Dnajb14,3,137867675,137916557,protein_coding,1,48882,chr3_137867675_137916557
Dnajb2,1,75236406,75245692,protein_coding,1,9286,chr1_75236406_75245692
Dnajb3,1,88204732,88205782,protein_coding,-1,1050,chr1_88204732_88205782
Dnajb4,3,152178511,152210302,protein_coding,-1,31791,chr3_152178511_152210302
Dnajb5,4,42949814,42959425,protein_coding,1,9611,chr4_42949814_42959425
Dnajb6,5,29735688,29818134,protein_coding,1,82446,chr5_29735688_29818134
Dnajb7,15,81406926,81408299,protein_coding,-1,1373,chr15_81406926_81408299
Dnajb9,12,44205559,44210326,protein_coding,-1,4767,chr12_44205559_44210326
Dnajc1,2,18195654,18392830,protein_coding,-1,197176,chr2_18195654_18392830
Dnajc10,2,80315466,80354043,protein_coding,1,38577,chr2_80315466_80354043
Dnajc11,4,151933691,151982137,protein_coding,1,48446,chr4_151933691_151982137
Dnajc12,10,63382443,63410576,protein_coding,1,28133,chr10_63382443_63410576
Dnajc13,9,104151282,104262930,protein_coding,-1,111648,chr9_104151282_104262930
Dnajc14,10,128804062,128819446,protein_coding,1,15384,chr10_128804062_128819446
Dnajc15,14,77820681,77875125,protein_coding,-1,54444,chr14_77820681_77875125
Dnajc16,4,141760189,141790931,protein_coding,-1,30742,chr4_141760189_141790931
Dnajc17,2,119172500,119208795,protein_coding,-1,36295,chr2_119172500_119208795
Dnajc18,18,35671103,35708414,protein_coding,-1,37311,chr18_35671103_35708414
Dnajc19,3,34056020,34081321,protein_coding,-1,25301,chr3_34056020_34081321
Dnajc19-ps,7,103882654,103883004,processed_pseudogene,-1,350,chr7_103882654_103883004
Dnajc2,5,21757267,21785251,protein_coding,-1,27984,chr5_21757267_21785251
Dnajc21,15,10446756,10470516,protein_coding,-1,23760,chr15_10446756_10470516
Dnajc24,2,105966709,106003549,protein_coding,-1,36840,chr2_105966709_106003549
Dnajc25,4,58995062,59025573,protein_coding,1,30511,chr4_58995062_59025573
Dnajc27,12,4082583,4110606,protein_coding,1,28023,chr12_4082583_4110606
Dnajc28,16,91614254,91619026,protein_coding,-1,4772,chr16_91614254_91619026
Dnajc3,14,118937976,118981697,protein_coding,1,43721,chr14_118937976_118981697
Dnajc30,5,135064202,135065862,protein_coding,1,1660,chr5_135064202_135065862
Dnajc4,19,6987911,6992572,protein_coding,-1,4661,chr19_6987911_6992572
Dnajc5,2,181520485,181555133,protein_coding,1,34648,chr2_181520485_181555133
Dnajc5b,3,19508595,19610862,protein_coding,1,102267,chr3_19508595_19610862
Dnajc5g,5,31106285,31112526,protein_coding,1,6241,chr5_31106285_31112526
Dnajc6,4,101496631,101642799,protein_coding,1,146168,chr4_101496631_101642799
Dnajc7,11,100582818,100620188,protein_coding,-1,37370,chr11_100582818_100620188
Dnajc8,4,132535550,132553742,protein_coding,1,18192,chr4_132535550_132553742
Dnajc9,14,20384638,20388910,protein_coding,-1,4272,chr14_20384638_20388910
Dnal1,12,84114366,84147498,protein_coding,1,33132,chr12_84114366_84147498
Dnal4,15,79761453,79777849,protein_coding,-1,16396,chr15_79761453_79777849
Dnali1,4,125055338,125065703,protein_coding,-1,10365,chr4_125055338_125065703
Dnase1,16,4036942,4040024,protein_coding,1,3082,chr16_4036942_4040024
Dnase1l1,X,74273217,74282337,protein_coding,-1,9120,chrX_74273217_74282337
Dnase1l2,17,24440081,24443105,protein_coding,-1,3024,chr17_24440081_24443105
Dnase1l3,14,7964533,7994573,protein_coding,-1,30040,chr14_7964533_7994573
Dnase2a,8,84908560,84922915,protein_coding,1,14355,chr8_84908560_84922915
Dnase2b,3,146580985,146615596,protein_coding,-1,34611,chr3_146580985_146615596
Dnd1,18,36763671,36766214,protein_coding,-1,2543,chr18_36763671_36766214
Dner,1,84369839,84696221,protein_coding,-1,326382,chr1_84369839_84696221
Dnhd1,7,105650827,105721799,protein_coding,1,70972,chr7_105650827_105721799
Dnlz,2,26348121,26352110,protein_coding,-1,3989,chr2_26348121_26352110
Dnm1,2,32308471,32353338,protein_coding,-1,44867,chr2_32308471_32353338
Dnm1l,16,16312230,16358959,protein_coding,-1,46729,chr16_16312230_16358959
Dnm2,9,21424908,21507759,protein_coding,1,82851,chr9_21424908_21507759
Dnm3,1,161982453,162478034,protein_coding,-1,495581,chr1_161982453_162478034
Dnm3os,1,162217623,162225550,antisense,1,7927,chr1_162217623_162225550
Dnmbp,19,43846821,43940191,protein_coding,-1,93370,chr19_43846821_43940191
Dnmt1,9,20907209,20959888,protein_coding,-1,52679,chr9_20907209_20959888
Dnmt3a,12,3806007,3914443,protein_coding,1,108436,chr12_3806007_3914443
Dnmt3a-ps1,3,77562600,77563870,processed_pseudogene,-1,1270,chr3_77562600_77563870
Dnmt3aos,12,3859293,3862244,antisense,-1,2951,chr12_3859293_3862244
Dnmt3b,2,153649450,153687730,protein_coding,1,38280,chr2_153649450_153687730
Dnmt3l,10,78041947,78063622,protein_coding,1,21675,chr10_78041947_78063622
Dnmt3l-ps1,2,83744484,83745736,processed_pseudogene,-1,1252,chr2_83744484_83745736
Dnpep,1,75307896,75317990,protein_coding,-1,10094,chr1_75307896_75317990
Dnph1,17,46496711,46499624,protein_coding,1,2913,chr17_46496711_46499624
Dnttip1,2,164745983,164768607,protein_coding,1,22624,chr2_164745983_164768607
Dnttip2,3,122274388,122285271,protein_coding,1,10883,chr3_122274388_122285271
Doc2a,7,126847416,126852705,protein_coding,1,5289,chr7_126847416_126852705
Doc2b,11,75768966,75796049,protein_coding,-1,27083,chr11_75768966_75796049
Doc2g,19,4003313,4007005,protein_coding,1,3692,chr19_4003313_4007005
Dock1,7,134670654,135173639,protein_coding,1,502985,chr7_134670654_135173639
Dock10,1,80501073,80758527,protein_coding,-1,257454,chr1_80501073_80758527
Dock11,X,35888832,36076562,protein_coding,1,187730,chrX_35888832_36076562
Dock2,11,34226815,34783892,protein_coding,-1,557077,chr11_34226815_34783892
Dock3,9,106892825,107231909,protein_coding,-1,339084,chr9_106892825_107231909
Dock4,12,40445952,40846874,protein_coding,1,400922,chr12_40445952_40846874
Dock5,14,67752135,67933442,protein_coding,-1,181307,chr14_67752135_67933442
Dock6,9,21799860,21852635,protein_coding,-1,52775,chr9_21799860_21852635
Dock7,4,98936671,99120915,protein_coding,-1,184244,chr4_98936671_99120915
Dock8,19,24999534,25202432,protein_coding,1,202898,chr19_24999534_25202432
Dock9,14,121542046,121797837,protein_coding,-1,255791,chr14_121542046_121797837
Dohh,10,81384428,81388352,protein_coding,1,3924,chr10_81384428_81388352
Dok1,6,83030934,83033471,protein_coding,-1,2537,chr6_83030934_83033471
Dok2,14,70766036,70778495,protein_coding,1,12459,chr14_70766036_70778495
Dok3,13,55523231,55529296,protein_coding,-1,6065,chr13_55523231_55529296
Dok4,8,94863828,94876330,protein_coding,-1,12502,chr8_94863828_94876330
Dok5,2,170731807,170879769,protein_coding,1,147962,chr2_170731807_170879769
Dok6,18,89292424,89769528,protein_coding,-1,477104,chr18_89292424_89769528
Dok7,5,35056766,35087839,protein_coding,1,31073,chr5_35056766_35087839
Dolk,2,30284231,30286334,protein_coding,-1,2103,chr2_30284231_30286334
Dolpp1,2,30392254,30400529,protein_coding,1,8275,chr2_30392254_30400529
Donson,16,91676808,91688770,protein_coding,-1,11962,chr16_91676808_91688770
Dot1l,10,80755206,80795461,protein_coding,1,40255,chr10_80755206_80795461
Dpagt1,9,44326019,44333900,protein_coding,1,7881,chr9_44326019_44333900
Dpep2,8,105984944,105996423,protein_coding,-1,11479,chr8_105984944_105996423
Dpf1,7,29303951,29318243,protein_coding,1,14292,chr7_29303951_29318243
Dpf2,19,5896516,5913010,protein_coding,-1,16494,chr19_5896516_5913010
Dpf3,12,83213745,83487716,protein_coding,-1,273971,chr12_83213745_83487716
Dph1,11,75177643,75191241,protein_coding,-1,13598,chr11_75177643_75191241
Dph2,4,117888643,117892032,protein_coding,-1,3389,chr4_117888643_117892032
Dph3,14,32080566,32085729,protein_coding,-1,5163,chr14_32080566_32085729
Dph3b-ps,13,106546815,106547060,processed_pseudogene,-1,245,chr13_106546815_106547060
Dph5,3,115887837,115934361,protein_coding,1,46524,chr3_115887837_115934361
Dph6,2,114516416,114654964,protein_coding,-1,138548,chr2_114516416_114654964
Dph7,2,24962400,24972163,protein_coding,1,9763,chr2_24962400_24972163
Dpm1,2,168209048,168230591,protein_coding,-1,21543,chr2_168209048_168230591
Dpm2,2,32570858,32573579,protein_coding,1,2721,chr2_32570858_32573579
Dpm3,3,89259358,89267079,protein_coding,1,7721,chr3_89259358_89267079
Dpp10,1,123321471,124846039,protein_coding,-1,1524568,chr1_123321471_124846039
Dpp3,19,4907229,4928287,protein_coding,-1,21058,chr19_4907229_4928287
Dpp4,2,62330073,62412231,protein_coding,-1,82158,chr2_62330073_62412231
Dpp6,5,26817203,27727505,protein_coding,1,910302,chr5_26817203_27727505
Dpp7,2,25352276,25356359,protein_coding,-1,4083,chr2_25352276_25356359
Dpp8,9,65032414,65082651,protein_coding,1,50237,chr9_65032414_65082651
Dpp9,17,56186807,56218905,protein_coding,-1,32098,chr17_56186807_56218905
Dppa1,11,46607772,46629261,protein_coding,-1,21489,chr11_46607772_46629261
Dppa2,16,48303908,48319723,protein_coding,1,15815,chr16_48303908_48319723
Dppa5a,9,78367052,78368177,protein_coding,-1,1125,chr9_78367052_78368177
Dpt,1,164796644,164824266,protein_coding,1,27622,chr1_164796644_164824266
Dpy19l1,9,24411776,24503140,protein_coding,-1,91364,chr9_24411776_24503140
Dpy19l2,9,24557047,24696293,protein_coding,-1,139246,chr9_24557047_24696293
Dpy19l3,7,35685165,35754454,protein_coding,-1,69289,chr7_35685165_35754454
Dpy19l4,4,11261315,11322137,protein_coding,-1,60822,chr4_11261315_11322137
Dpy30,17,74299474,74323944,protein_coding,-1,24470,chr17_74299474_74323944
Dpyd,3,118562129,119432924,protein_coding,1,870795,chr3_118562129_119432924
Dpys,15,39768487,39857470,protein_coding,-1,88983,chr15_39768487_39857470
Dpysl2,14,66802864,66868688,protein_coding,-1,65824,chr14_66802864_66868688
Dpysl3,18,43320984,43438286,protein_coding,-1,117302,chr18_43320984_43438286
Dpysl4,7,139064188,139102704,protein_coding,1,38516,chr7_139064188_139102704
Dpysl5,5,30711564,30799375,protein_coding,1,87811,chr5_30711564_30799375
Dqx1,6,83057844,83067318,protein_coding,1,9474,chr6_83057844_83067318
Dr1,5,108268897,108280526,protein_coding,1,11629,chr5_108268897_108280526
Dram1,10,88322804,88379080,protein_coding,-1,56276,chr10_88322804_88379080
Dram2,3,106547798,106575890,protein_coding,1,28092,chr3_106547798_106575890
Drap1,19,5422805,5424979,protein_coding,-1,2174,chr19_5422805_5424979
Draxin,4,148098437,148130698,protein_coding,-1,32261,chr4_148098437_148130698
Drc1,5,30281388,30366695,protein_coding,1,85307,chr5_30281388_30366695
Drc7,8,95055103,95078141,protein_coding,1,23038,chr8_95055103_95078141
Drd1,13,54051183,54055705,protein_coding,-1,4522,chr13_54051183_54055705
Drd2,9,49340627,49408177,protein_coding,1,67550,chr9_49340627_49408177
Drd4,7,141292006,141296464,protein_coding,1,4458,chr7_141292006_141296464
Drd5,5,38319367,38322518,protein_coding,1,3151,chr5_38319367_38322518
Drg1,11,3187360,3266415,protein_coding,-1,79055,chr11_3187360_3266415
Drg2,11,60454591,60468754,protein_coding,1,14163,chr11_60454591_60468754
Drosha,15,12824815,12935291,protein_coding,1,110476,chr15_12824815_12935291
Drp2,X,134404551,134456573,protein_coding,1,52022,chrX_134404551_134456573
Dsc2,18,20030633,20059554,protein_coding,-1,28921,chr18_20030633_20059554
Dsc3,18,19960930,20002351,protein_coding,-1,41421,chr18_19960930_20002351
Dscam,16,96590840,97170752,protein_coding,-1,579912,chr16_96590840_97170752
Dscaml1,9,45426628,45753712,protein_coding,1,327084,chr9_45426628_45753712
Dscc1,15,55076099,55090491,protein_coding,-1,14392,chr15_55076099_55090491
Dse,10,34151393,34207715,protein_coding,-1,56322,chr10_34151393_34207715
Dsel,1,111858702,111864918,protein_coding,-1,6216,chr1_111858702_111864918
Dsg1a,18,20310811,20343350,protein_coding,1,32539,chr18_20310811_20343350
Dsg2,18,20558074,20604521,protein_coding,1,46447,chr18_20558074_20604521
Dsg4,18,20436175,20471821,protein_coding,1,35646,chr18_20436175_20471821
Dsn1,2,156995265,157007154,protein_coding,-1,11889,chr2_156995265_157007154
Dsp,13,38151294,38198577,protein_coding,1,47283,chr13_38151294_38198577
Dspp,5,104170712,104180127,protein_coding,1,9415,chr5_104170712_104180127
Dst,1,33908225,34308661,protein_coding,1,400436,chr1_33908225_34308661
Dstn,2,143915320,143943324,protein_coding,1,28004,chr2_143915320_143943324
Dstyk,1,132417555,132466958,protein_coding,1,49403,chr1_132417555_132466958
Dtd1,2,144599897,144768758,protein_coding,1,168861,chr2_144599897_144768758
Dtd2,12,51988312,52006501,protein_coding,-1,18189,chr12_51988312_52006501
Dthd1,5,62811674,62888308,protein_coding,1,76634,chr5_62811674_62888308
Dtl,1,191537356,191575544,protein_coding,-1,38188,chr1_191537356_191575544
Dtna,18,23415135,23659715,protein_coding,1,244580,chr18_23415135_23659715
Dtnb,12,3572381,3781796,protein_coding,1,209415,chr12_3572381_3781796
Dtnbp1,13,44922075,45002147,protein_coding,-1,80072,chr13_44922075_45002147
Dtwd1,2,126152141,126165279,protein_coding,1,13138,chr2_126152141_126165279
Dtwd2,18,49696145,49755601,protein_coding,-1,59456,chr18_49696145_49755601
Dtx1,5,120680202,120711927,protein_coding,-1,31725,chr5_120680202_120711927
Dtx2,5,135994800,136032872,protein_coding,1,38072,chr5_135994800_136032872
Dtx3,10,127190378,127195728,protein_coding,-1,5350,chr10_127190378_127195728
Dtx3l,16,35926511,35939151,protein_coding,-1,12640,chr16_35926511_35939151
Dtx4,19,12466338,12501454,protein_coding,-1,35116,chr19_12466338_12501454
Dtymk,1,93792576,93801934,protein_coding,-1,9358,chr1_93792576_93801934
Duox1,2,122315672,122347972,protein_coding,1,32300,chr2_122315672_122347972
Duox2,2,122279247,122298449,protein_coding,-1,19202,chr2_122279247_122298449
Duoxa2,2,122298900,122302885,protein_coding,1,3985,chr2_122298900_122302885
Dupd1,14,21676537,21714576,protein_coding,-1,38039,chr14_21676537_21714576
Dus1l,11,120789201,120796403,protein_coding,-1,7202,chr11_120789201_120796403
Dus2,8,105991337,106053840,protein_coding,1,62503,chr8_105991337_106053840
Dus3l,17,56764757,56770093,protein_coding,1,5336,chr17_56764757_56770093
Dus4l,12,31640050,31654826,protein_coding,-1,14776,chr12_31640050_31654826
Dusp1,17,26505590,26562128,protein_coding,-1,56538,chr17_26505590_26562128
Dusp10,1,184013302,184075636,protein_coding,1,62334,chr1_184013302_184075636
Dusp11,6,85942268,85961667,protein_coding,-1,19399,chr6_85942268_85961667
Dusp12,1,170873498,170885540,protein_coding,-1,12042,chr1_170873498_170885540
Dusp13,14,21733394,21751181,protein_coding,-1,17787,chr14_21733394_21751181
Dusp14,11,84048041,84069261,protein_coding,-1,21220,chr11_84048041_84069261
Dusp15,2,152940997,152951698,protein_coding,-1,10701,chr2_152940997_152951698
Dusp16,6,134715468,134792625,protein_coding,-1,77157,chr6_134715468_134792625
Dusp18,11,3895240,3901296,protein_coding,1,6056,chr11_3895240_3901296
Dusp19,2,80617045,80632361,protein_coding,1,15316,chr2_80617045_80632361
Dusp2,2,127336159,127338376,protein_coding,1,2217,chr2_127336159_127338376
Dusp22,13,30659999,30711231,protein_coding,1,51232,chr13_30659999_30711231
Dusp23,1,172630764,172632962,protein_coding,-1,2198,chr1_172630764_172632962
Dusp26,8,31089471,31097047,protein_coding,1,7576,chr8_31089471_31097047
Dusp27,1,166098148,166127922,protein_coding,-1,29774,chr1_166098148_166127922
Dusp28,1,92906981,92908435,protein_coding,1,1454,chr1_92906981_92908435
Dusp3,11,101971143,101987013,protein_coding,-1,15870,chr11_101971143_101987013
Dusp4,8,34807297,34819894,protein_coding,1,12597,chr8_34807297_34819894
Dusp5,19,53529109,53542431,protein_coding,1,13322,chr19_53529109_53542431
Dusp6,10,99263231,99267489,protein_coding,1,4258,chr10_99263231_99267489
Dusp7,9,106368632,106375724,protein_coding,1,7092,chr9_106368632_106375724
Dusp8,7,142079490,142095843,protein_coding,-1,16353,chr7_142079490_142095843
Dusp9,X,73639419,73643514,protein_coding,1,4095,chrX_73639419_73643514
Dut,2,125247190,125258608,protein_coding,1,11418,chr2_125247190_125258608
Duxbl1,14,25978577,25990088,protein_coding,1,11511,chr14_25978577_25990088
Duxbl3,14,26257962,26269436,protein_coding,1,11474,chr14_26257962_26269436
Dvl1,4,155847402,155859303,protein_coding,1,11901,chr4_155847402_155859303
Dvl2,11,70000595,70012301,protein_coding,1,11706,chr11_70000595_70012301
Dvl3,16,20516982,20534010,protein_coding,1,17028,chr16_20516982_20534010
Dxo,17,34837019,34839233,protein_coding,1,2214,chr17_34837019_34839233
Dydc1,14,41072911,41092197,protein_coding,1,19286,chr14_41072911_41092197
Dydc2,14,41049117,41069208,protein_coding,-1,20091,chr14_41049117_41069208
Dym,18,75018781,75286964,protein_coding,1,268183,chr18_75018781_75286964
Dync1h1,12,110601452,110666945,protein_coding,1,65493,chr12_110601452_110666945
Dync1i1,6,5725639,6028039,protein_coding,1,302400,chr6_5725639_6028039
Dync1i2,2,71211706,71263303,protein_coding,1,51597,chr2_71211706_71263303
Dync1li1,9,114688790,114724302,protein_coding,1,35512,chr9_114688790_114724302
Dync1li2,8,104417680,104443047,protein_coding,-1,25367,chr8_104417680_104443047
Dync2h1,9,6928503,7184446,protein_coding,-1,255943,chr9_6928503_7184446
Dync2li1,17,84626496,84655588,protein_coding,1,29092,chr17_84626496_84655588
Dynll1,5,115297110,115300999,protein_coding,-1,3889,chr5_115297110_115300999
Dynll2,11,87979525,87987533,protein_coding,-1,8008,chr11_87979525_87987533
Dynlrb1,2,155236533,155250277,protein_coding,1,13744,chr2_155236533_155250277
Dynlrb2,8,116504974,116515915,protein_coding,1,10941,chr8_116504974_116515915
Dynlt1-ps1,6,135349408,135349749,processed_pseudogene,-1,341,chr6_135349408_135349749
Dynlt1a,17,6306340,6317500,protein_coding,-1,11160,chr17_6306340_6317500
Dynlt1b,17,6430112,6436296,protein_coding,1,6184,chr17_6430112_6436296
Dynlt1c,17,6601671,6609774,protein_coding,1,8103,chr17_6601671_6609774
Dynlt1f,17,6646602,6655900,protein_coding,-1,9298,chr17_6646602_6655900
Dynlt3,X,9654267,9663003,protein_coding,-1,8736,chrX_9654267_9663003
Dyrk1a,16,94570010,94695517,protein_coding,1,125507,chr16_94570010_94695517
Dyrk1b,7,28179469,28187294,protein_coding,1,7825,chr7_28179469_28187294
Dyrk2,10,118855603,118870209,protein_coding,-1,14606,chr10_118855603_118870209
Dyrk3,1,131127455,131138340,protein_coding,-1,10885,chr1_131127455_131138340
Dysf,6,84008590,84211060,protein_coding,1,202470,chr6_84008590_84211060
Dzank1,2,144470557,144527414,protein_coding,-1,56857,chr2_144470557_144527414
Dzip1,14,118875520,118925460,protein_coding,-1,49940,chr14_118875520_118925460
Dzip1l,9,99629496,99669256,protein_coding,1,39760,chr9_99629496_99669256
Dzip3,16,48924232,48994165,protein_coding,-1,69933,chr16_48924232_48994165
E030013I19Rik,2,12300946,12312315,antisense,1,11369,chr2_12300946_12312315
E030018B13Rik,7,63916857,63920539,protein_coding,1,3682,chr7_63916857_63920539
E030024N20Rik,19,16164312,16164805,processed_pseudogene,-1,493,chr19_16164312_16164805
E030030I06Rik,10,22113050,22149270,protein_coding,-1,36220,chr10_22113050_22149270
E030044B06Rik,19,40868304,40882639,lincRNA,1,14335,chr19_40868304_40882639
E130006D01Rik,5,111734284,111761725,lincRNA,-1,27441,chr5_111734284_111761725
E130008D07Rik,17,43146041,43158291,lincRNA,-1,12250,chr17_43146041_43158291
E130102H24Rik,4,101346531,101356735,lincRNA,-1,10204,chr4_101346531_101356735
E130111B04Rik,11,102030268,102035084,antisense,-1,4816,chr11_102030268_102035084
E130114P18Rik,4,97568133,97778078,protein_coding,-1,209945,chr4_97568133_97778078
E130119H09Rik,13,53912263,53915748,processed_transcript,-1,3485,chr13_53912263_53915748
E130201H02Rik,7,120597625,120598475,processed_pseudogene,1,850,chr7_120597625_120598475
E130215H24Rik,2,150667494,150668935,processed_transcript,1,1441,chr2_150667494_150668935
E130218I03Rik,4,134243662,134245873,protein_coding,1,2211,chr4_134243662_134245873
E130304I02Rik,7,35802592,35838074,antisense,1,35482,chr7_35802592_35838074
E130307A14Rik,10,39621412,39732007,antisense,-1,110595,chr10_39621412_39732007
E130308A19Rik,4,59626211,59761439,protein_coding,1,135228,chr4_59626211_59761439
E130309D02Rik,5,143301195,143315360,protein_coding,-1,14165,chr5_143301195_143315360
E130311K13Rik,3,63914684,63929472,protein_coding,-1,14788,chr3_63914684_63929472
E130317F20Rik,10,79851381,79854971,bidirectional_promoter_lncRNA,-1,3590,chr10_79851381_79854971
E230015B07Rik,6,87671983,87681024,transcribed_unprocessed_pseudogene,1,9041,chr6_87671983_87681024
E230016K23Rik,11,83582056,83623693,processed_transcript,1,41637,chr11_83582056_83623693
E230016M11Rik,6,67036599,67080654,processed_transcript,1,44055,chr6_67036599_67080654
E230025N22Rik,18,36684923,36695925,protein_coding,-1,11002,chr18_36684923_36695925
E230029C05Rik,7,89980723,90049069,processed_transcript,1,68346,chr7_89980723_90049069
E2f1,2,154559407,154569892,protein_coding,-1,10485,chr2_154559407_154569892
E2f2,4,136172394,136196057,protein_coding,1,23663,chr4_136172394_136196057
E2f3,13,29906575,29986063,protein_coding,-1,79488,chr13_29906575_29986063
E2f4,8,105297663,105305370,protein_coding,1,7707,chr8_105297663_105305370
E2f5,3,14578641,14606309,protein_coding,1,27668,chr3_14578641_14606309
E2f6,12,16810963,16839742,protein_coding,1,28779,chr12_16810963_16839742
E2f7,10,110745439,110787384,protein_coding,1,41945,chr10_110745439_110787384
E2f8,7,48866429,48881596,protein_coding,-1,15167,chr7_48866429_48881596
E330011O21Rik,16,78250861,78302487,processed_transcript,-1,51626,chr16_78250861_78302487
E330013P04Rik,19,60144675,60162591,lincRNA,1,17916,chr19_60144675_60162591
E330014E10Rik,5,95775990,95804708,protein_coding,1,28718,chr5_95775990_95804708
E330017L17Rik,4,129906216,129919787,lincRNA,1,13571,chr4_129906216_129919787
E330020D12Rik,1,153404827,153414233,processed_transcript,-1,9406,chr1_153404827_153414233
E330021D16Rik,6,136400317,136415569,protein_coding,-1,15252,chr6_136400317_136415569
E330032C10Rik,17,73250986,73260656,lincRNA,1,9670,chr17_73250986_73260656
E330034G19Rik,14,24293214,24309966,protein_coding,1,16752,chr14_24293214_24309966
E330035G20Rik,12,112391526,112405812,lincRNA,-1,14286,chr12_112391526_112405812
E430018J23Rik,7,127389673,127393629,protein_coding,-1,3956,chr7_127389673_127393629
E430024I08Rik,13,74434781,74463429,lincRNA,-1,28648,chr13_74434781_74463429
E4f1,17,24443778,24470313,protein_coding,-1,26535,chr17_24443778_24470313
E530001F21Rik,X,105164632,105165361,processed_pseudogene,-1,729,chrX_105164632_105165361
E530011L22Rik,9,121754662,121759943,antisense,-1,5281,chr9_121754662_121759943
EU599041,7,43214039,43226842,lincRNA,1,12803,chr7_43214039_43226842
Eaf1,14,31494399,31509858,protein_coding,1,15459,chr14_31494399_31509858
Eaf2,16,36792884,36875003,protein_coding,-1,82119,chr16_36792884_36875003
Eapp,12,54670340,54695897,protein_coding,-1,25557,chr12_54670340_54695897
Ears2,7,122037213,122067263,protein_coding,-1,30050,chr7_122037213_122067263
Ebag9,15,44619175,44641515,protein_coding,1,22340,chr15_44619175_44641515
Ebf1,11,44617317,45008091,protein_coding,1,390774,chr11_44617317_45008091
Ebf2,14,67233292,67430918,protein_coding,1,197626,chr14_67233292_67430918
Ebf3,7,137193673,137314445,protein_coding,-1,120772,chr7_137193673_137314445
Ebf4,2,130295169,130370481,protein_coding,1,75312,chr2_130295169_130370481
Ebi3,17,55952640,55957022,protein_coding,1,4382,chr17_55952640_55957022
Ebna1bp2,4,118620799,118627776,protein_coding,1,6977,chr4_118620799_118627776
Ebp,X,8185329,8193512,protein_coding,-1,8183,chrX_8185329_8193512
Ebpl,14,61331742,61360439,protein_coding,-1,28697,chr14_61331742_61360439
Ecd,14,20319852,20348121,protein_coding,-1,28269,chr14_20319852_20348121
Ece1,4,137862237,137965229,protein_coding,1,102992,chr4_137862237_137965229
Ece2,16,20629828,20646485,protein_coding,1,16657,chr16_20629828_20646485
Ecel1,1,87147655,87156521,protein_coding,-1,8866,chr1_87147655_87156521
Ech1,7,28825217,28832247,protein_coding,1,7030,chr7_28825217_28832247
Echdc1,10,29313166,29347469,protein_coding,1,34303,chr10_29313166_29347469
Echdc2,4,108165437,108179308,protein_coding,1,13871,chr4_108165437_108179308
Echdc3,2,6188465,6213033,protein_coding,-1,24568,chr2_6188465_6213033
Echs1,7,140105710,140116476,protein_coding,-1,10766,chr7_140105710_140116476
Eci1,17,24426641,24439348,protein_coding,1,12707,chr17_24426641_24439348
Eci2,13,34977748,35027096,protein_coding,-1,49348,chr13_34977748_35027096
Eci3,13,34946614,34963810,protein_coding,-1,17196,chr13_34946614_34963810
Ecm1,3,95734147,95739569,protein_coding,-1,5422,chr3_95734147_95739569
Ecm2,13,49504810,49532789,protein_coding,1,27979,chr13_49504810_49532789
Ecscr,18,35713086,35722356,protein_coding,-1,9270,chr18_35713086_35722356
Ecsit,9,22072246,22085438,protein_coding,-1,13192,chr9_22072246_22085438
Ect2,3,27097222,27153878,protein_coding,-1,56656,chr3_27097222_27153878
Ect2l,10,18128903,18210890,protein_coding,-1,81987,chr10_18128903_18210890
Eda,X,99975606,100400762,protein_coding,1,425156,chrX_99975606_100400762
Eda2r,X,97333840,97377216,protein_coding,-1,43376,chrX_97333840_97377216
Edar,10,58600789,58675654,protein_coding,-1,74865,chr10_58600789_58675654
Edaradd,13,12472632,12520438,protein_coding,-1,47806,chr13_12472632_12520438
Edc3,9,57708540,57752499,protein_coding,1,43959,chr9_57708540_57752499
Edc4,8,105880881,105894908,protein_coding,1,14027,chr8_105880881_105894908
Edem1,6,108828641,108859356,protein_coding,1,30715,chr6_108828641_108859356
Edem2,2,155701677,155729475,protein_coding,-1,27798,chr2_155701677_155729475
Edem3,1,151755371,151822051,protein_coding,1,66680,chr1_151755371_151822051
Edf1,2,25557847,25562082,protein_coding,1,4235,chr2_25557847_25562082
Edil3,13,88821472,89323223,protein_coding,1,501751,chr13_88821472_89323223
Edn1,13,42301476,42307990,protein_coding,1,6514,chr13_42301476_42307990
Edn2,4,120161206,120167360,protein_coding,1,6154,chr4_120161206_120167360
Edn3,2,174760619,174784042,protein_coding,1,23423,chr2_174760619_174784042
Ednra,8,77663031,77724464,protein_coding,-1,61433,chr8_77663031_77724464
Ednrb,14,103814625,103844402,protein_coding,-1,29777,chr14_103814625_103844402
Edrf1,7,133637543,133672971,protein_coding,1,35428,chr7_133637543_133672971
Eea1,10,95940650,96045518,protein_coding,1,104868,chr10_95940650_96045518
Eed,7,89954654,89980983,protein_coding,-1,26329,chr7_89954654_89980983
Eef1a1,9,78478449,78489151,protein_coding,-1,10702,chr9_78478449_78489151
Eef1a1-ps1,19,17926623,17928009,processed_pseudogene,1,1386,chr19_17926623_17928009
Eef1a2,2,181147653,181157014,protein_coding,-1,9361,chr2_181147653_181157014
Eef1b2,1,63176825,63180486,protein_coding,1,3661,chr1_63176825_63180486
Eef1d,15,75894205,75909556,protein_coding,-1,15351,chr15_75894205_75909556
Eef1e1,13,38644207,38659058,protein_coding,-1,14851,chr13_38644207_38659058
Eef1g,19,8967041,8978479,protein_coding,1,11438,chr19_8967041_8978479
Eef2,10,81176631,81182498,protein_coding,1,5867,chr10_81176631_81182498
Eef2k,7,120842831,120907450,protein_coding,1,64619,chr7_120842831_120907450
Eef2kmt,16,5244152,5255983,protein_coding,-1,11831,chr16_5244152_5255983
Eefsec,6,88257334,88446539,protein_coding,-1,189205,chr6_88257334_88446539
Eepd1,9,25481547,25604110,protein_coding,1,122563,chr9_25481547_25604110
Efcab1,16,14906606,14981371,protein_coding,1,74765,chr16_14906606_14981371
Efcab10,12,33394854,33401267,protein_coding,1,6413,chr12_33394854_33401267
Efcab11,12,99693045,99884439,protein_coding,-1,191394,chr12_99693045_99884439
Efcab12,6,115810729,115838412,protein_coding,-1,27683,chr6_115810729_115838412
Efcab14,4,115737744,115777327,protein_coding,1,39583,chr4_115737744_115777327
Efcab2,1,178406085,178484513,protein_coding,1,78428,chr1_178406085_178484513
Efcab3,11,105063592,105117537,protein_coding,1,53945,chr11_105063592_105117537
Efcab5,11,77089915,77188968,protein_coding,-1,99053,chr11_77089915_77188968
Efcab6,15,83866712,84065379,protein_coding,-1,198667,chr15_83866712_84065379
Efcab7,4,99829198,99912788,protein_coding,1,83590,chr4_99829198_99912788
Efcab9,11,32522751,32532081,protein_coding,-1,9330,chr11_32522751_32532081
Efcc1,6,87730869,87755908,protein_coding,1,25039,chr6_87730869_87755908
Efemp1,11,28853204,28926743,protein_coding,1,73539,chr11_28853204_28926743
Efemp2,19,5473954,5482517,protein_coding,1,8563,chr19_5473954_5482517
Efhb,17,53398889,53463321,protein_coding,-1,64432,chr17_53398889_53463321
Efhc1,1,20951626,20990841,protein_coding,1,39215,chr1_20951626_20990841
Efhc2,X,17132049,17319368,protein_coding,-1,187319,chrX_17132049_17319368
Efhd1,1,87264363,87310839,protein_coding,1,46476,chr1_87264363_87310839
Efhd2,4,141858142,141874920,protein_coding,-1,16778,chr4_141858142_141874920
Efna1,3,89271733,89281142,protein_coding,-1,9409,chr3_89271733_89281142
Efna2,10,80179482,80190010,protein_coding,1,10528,chr10_80179482_80190010
Efna3,3,89313899,89322965,protein_coding,-1,9066,chr3_89313899_89322965
Efna4,3,89333390,89338028,protein_coding,-1,4638,chr3_89333390_89338028
Efna5,17,62604184,62881317,protein_coding,-1,277133,chr17_62604184_62881317
Efnb1,X,99136130,99148991,protein_coding,1,12861,chrX_99136130_99148991
Efnb2,8,8617434,8661242,protein_coding,-1,43808,chr8_8617434_8661242
Efnb3,11,69554092,69560205,protein_coding,-1,6113,chr11_69554092_69560205
Efr3a,15,65787034,65873816,protein_coding,1,86782,chr15_65787034_65873816
Efr3b,12,3962554,4038915,protein_coding,-1,76361,chr12_3962554_4038915
Efs,14,54916535,54926126,protein_coding,-1,9591,chr14_54916535_54926126
Eftud2,11,102838473,102880985,protein_coding,-1,42512,chr11_102838473_102880985
Egf,3,129677565,129755316,protein_coding,-1,77751,chr3_129677565_129755316
Egfem1,3,29082023,29691209,protein_coding,1,609186,chr3_29082023_29691209
Egfl6,X,166523007,166585720,protein_coding,-1,62713,chrX_166523007_166585720
Egfl7,2,26580014,26593120,protein_coding,1,13106,chr2_26580014_26593120
Egfl8,17,34613349,34615971,protein_coding,-1,2622,chr17_34613349_34615971
Egflam,15,7206120,7398395,protein_coding,-1,192275,chr15_7206120_7398395
Egfr,11,16752203,16918158,protein_coding,1,165955,chr11_16752203_16918158
Egln1,8,124908587,124949324,protein_coding,-1,40737,chr8_124908587_124949324
Egln2,7,27158658,27166802,protein_coding,-1,8144,chr7_27158658_27166802
Egln3,12,54178981,54203860,protein_coding,-1,24879,chr12_54178981_54203860
Egr1,18,34859823,34864984,protein_coding,1,5161,chr18_34859823_34864984
Egr2,10,67535475,67542217,protein_coding,1,6742,chr10_67535475_67542217
Egr3,14,70077203,70082614,protein_coding,1,5411,chr14_70077203_70082614
Egr4,6,85511121,85513589,protein_coding,-1,2468,chr6_85511121_85513589
Ehbp1,11,22005828,22342292,protein_coding,-1,336464,chr11_22005828_22342292
Ehbp1l1,19,5707376,5726317,protein_coding,-1,18941,chr19_5707376_5726317
Ehd1,19,6276725,6300096,protein_coding,1,23371,chr19_6276725_6300096
Ehd2,7,15946958,15967567,protein_coding,-1,20609,chr7_15946958_15967567
Ehd3,17,73804134,73832094,protein_coding,1,27960,chr17_73804134_73832094
Ehd4,2,120089175,120154606,protein_coding,-1,65431,chr2_120089175_120154606
Ehf,2,103263433,103303278,protein_coding,-1,39845,chr2_103263433_103303278
Ehhadh,16,21761287,21787807,protein_coding,-1,26520,chr16_21761287_21787807
Ehmt1,2,24789928,24919614,protein_coding,-1,129686,chr2_24789928_24919614
Ehmt2,17,34898469,34914052,protein_coding,1,15583,chr17_34898469_34914052
Ei24,9,36779159,36797393,protein_coding,-1,18234,chr9_36779159_36797393
Eid1,2,125673095,125674785,protein_coding,1,1690,chr2_125673095_125674785
Eid2,7,28267881,28269272,protein_coding,1,1391,chr7_28267881_28269272
Eid2b,7,28277739,28279489,protein_coding,1,1750,chr7_28277739_28279489
Eid3,10,82866626,82867930,protein_coding,1,1304,chr10_82866626_82867930
Eif1,11,100319885,100322096,protein_coding,1,2211,chr11_100319885_100322096
Eif1-ps1,14,40006220,40006549,processed_pseudogene,1,329,chr14_40006220_40006549
Eif1-ps2,13,64913972,64914310,processed_pseudogene,1,338,chr13_64913972_64914310
Eif1-ps3,2,72570481,72570822,processed_pseudogene,-1,341,chr2_72570481_72570822
Eif1a,18,46597701,46616456,protein_coding,1,18755,chr18_46597701_46616456
Eif1ad,19,5366741,5371526,protein_coding,1,4785,chr19_5366741_5371526
Eif1ax,X,159372178,159389928,protein_coding,1,17750,chrX_159372178_159389928
Eif1b,9,120492232,120495330,protein_coding,1,3098,chr9_120492232_120495330
Eif2a,3,58525821,58557501,protein_coding,1,31680,chr3_58525821_58557501
Eif2ak1,5,143817788,143904251,protein_coding,1,86463,chr5_143817788_143904251
Eif2ak2,17,78852564,78882573,protein_coding,-1,30009,chr17_78852564_78882573
Eif2ak3,6,70844515,70905245,protein_coding,1,60730,chr6_70844515_70905245
Eif2ak4,2,118388618,118475234,protein_coding,1,86616,chr2_118388618_118475234
Eif2b1,5,124570213,124579131,protein_coding,-1,8918,chr5_124570213_124579131
Eif2b2,12,85219481,85226628,protein_coding,1,7147,chr12_85219481_85226628
Eif2b3,4,117019402,117087306,protein_coding,1,67904,chr4_117019402_117087306
Eif2b4,5,31187558,31193430,protein_coding,-1,5872,chr5_31187558_31193430
Eif2b5,16,20498817,20509323,protein_coding,1,10506,chr16_20498817_20509323
Eif2d,1,131153181,131187658,protein_coding,1,34477,chr1_131153181_131187658
Eif2s1,12,78861819,78887010,protein_coding,1,25191,chr12_78861819_78887010
Eif2s2,2,154871410,154892935,protein_coding,-1,21525,chr2_154871410_154892935
Eif2s3x,X,94188707,94212862,protein_coding,-1,24155,chrX_94188707_94212862
Eif2s3x-ps1,15,75967227,75968335,processed_pseudogene,-1,1108,chr15_75967227_75968335
Eif2s3y,Y,1010543,1028847,protein_coding,1,18304,chrY_1010543_1028847
Eif3a,19,60761117,60790658,protein_coding,-1,29541,chr19_60761117_60790658
Eif3b,5,140419328,140443360,protein_coding,1,24032,chr5_140419328_140443360
Eif3c,7,126546455,126566411,protein_coding,-1,19956,chr7_126546455_126566411
Eif3d,15,77958998,77970813,protein_coding,-1,11815,chr15_77958998_77970813
Eif3e,15,43250058,43282719,protein_coding,-1,32661,chr15_43250058_43282719
Eif3f,7,108934417,108942951,protein_coding,1,8534,chr7_108934417_108942951
Eif3g,9,20894349,20898623,protein_coding,-1,4274,chr9_20894349_20898623
Eif3h,15,51786558,51865523,protein_coding,-1,78965,chr15_51786558_51865523
Eif3i,4,129591960,129600648,protein_coding,-1,8688,chr4_129591960_129600648
Eif3j1,2,122028546,122056598,protein_coding,1,28052,chr2_122028546_122056598
Eif3j2,18,43475418,43477796,protein_coding,-1,2378,chr18_43475418_43477796
Eif3k,7,28971372,28981864,protein_coding,-1,10492,chr7_28971372_28981864
Eif3l,15,79075179,79094405,protein_coding,1,19226,chr15_79075179_79094405
Eif3m,2,104999656,105017080,protein_coding,-1,17424,chr2_104999656_105017080
Eif3s6-ps1,11,9737152,9737621,processed_pseudogene,-1,469,chr11_9737152_9737621
Eif3s6-ps2,18,90310868,90312190,processed_pseudogene,-1,1322,chr18_90310868_90312190
Eif3s6-ps3,17,15845280,15846628,processed_pseudogene,1,1348,chr17_15845280_15846628
Eif3s6-ps4,6,19317215,19319378,processed_pseudogene,-1,2163,chr6_19317215_19319378
Eif4a-ps4,1,60703932,60705149,processed_pseudogene,1,1217,chr1_60703932_60705149
Eif4a1,11,69666936,69672423,protein_coding,-1,5487,chr11_69666936_69672423
Eif4a2,16,23107444,23114136,protein_coding,1,6692,chr16_23107444_23114136
Eif4a3,11,119288363,119300089,protein_coding,-1,11726,chr11_119288363_119300089
Eif4b,15,102073773,102097173,protein_coding,1,23400,chr15_102073773_102097173
Eif4e,3,138526179,138559696,protein_coding,1,33517,chr3_138526179_138559696
Eif4e1b,13,54783998,54788459,protein_coding,1,4461,chr13_54783998_54788459
Eif4e2,1,87213914,87240488,protein_coding,1,26574,chr1_87213914_87240488
Eif4e3,6,99625135,99666771,protein_coding,-1,41636,chr6_99625135_99666771
Eif4ebp1,8,27260329,27276674,protein_coding,1,16345,chr8_27260329_27276674
Eif4ebp2,10,61428491,61452661,protein_coding,-1,24170,chr10_61428491_61452661
Eif4ebp3,18,36664060,36665917,protein_coding,1,1857,chr18_36664060_36665917
Eif4enif1,11,3202392,3244588,protein_coding,1,42196,chr11_3202392_3244588
Eif4g1,16,20668313,20692884,protein_coding,1,24571,chr16_20668313_20692884
Eif4g2,7,111067750,111083030,protein_coding,-1,15280,chr7_111067750_111083030
Eif4g3,4,137993022,138208508,protein_coding,1,215486,chr4_137993022_138208508
Eif4h,5,134619721,134639490,protein_coding,-1,19769,chr5_134619721_134639490
Eif5,12,111538016,111546752,protein_coding,1,8736,chr12_111538016_111546752
Eif5a,11,69916714,69921958,protein_coding,-1,5244,chr11_69916714_69921958
Eif5a2,3,28781276,28798846,protein_coding,1,17570,chr3_28781276_28798846
Eif5al3-ps,5,90132229,90132675,processed_pseudogene,1,446,chr5_90132229_90132675
Eif5b,1,37998010,38055579,protein_coding,1,57569,chr1_37998010_38055579
Eif6,2,155819832,155826925,protein_coding,-1,7093,chr2_155819832_155826925
Elac1,18,73735038,73754479,protein_coding,-1,19441,chr18_73735038_73754479
Elac2,11,64979038,65002069,protein_coding,1,23031,chr11_64979038_65002069
Elavl1,8,4285382,4325413,protein_coding,-1,40031,chr8_4285382_4325413
Elavl2,4,91250763,91400785,protein_coding,-1,150022,chr4_91250763_91400785
Elavl3,9,22015005,22052023,protein_coding,-1,37018,chr9_22015005_22052023
Elavl4,4,110203722,110351909,protein_coding,-1,148187,chr4_110203722_110351909
Eldr,11,16935154,16951282,processed_transcript,-1,16128,chr11_16935154_16951282
Elf1,14,79481194,79582494,protein_coding,1,101300,chr14_79481194_79582494
Elf2,3,51252720,51340663,protein_coding,-1,87943,chr3_51252720_51340663
Elf4,X,48411046,48463132,protein_coding,-1,52086,chrX_48411046_48463132
Elf5,2,103411688,103450989,protein_coding,1,39301,chr2_103411688_103450989
Elfn1,5,139907943,139974722,protein_coding,1,66779,chr5_139907943_139974722
Elfn2,15,78667331,78718771,protein_coding,-1,51440,chr15_78667331_78718771
Elk1,X,20933395,20950608,protein_coding,-1,17213,chrX_20933395_20950608
Elk3,10,93247414,93311135,protein_coding,-1,63721,chr10_93247414_93311135
Elk4,1,132007607,132032612,protein_coding,1,25005,chr1_132007607_132032612
Ell,8,70539457,70592858,protein_coding,1,53401,chr8_70539457_70592858
Ell2,13,75706757,75772364,protein_coding,1,65607,chr13_75706757_75772364
Ell3,2,121439010,121444278,protein_coding,-1,5268,chr2_121439010_121444278
Elmo1,13,20090596,20608353,protein_coding,1,517757,chr13_20090596_20608353
Elmo2,2,165288031,165326479,protein_coding,-1,38448,chr2_165288031_165326479
Elmo3,8,105305601,105310760,protein_coding,1,5159,chr8_105305601_105310760
Elmod1,9,53911457,53975301,protein_coding,-1,63844,chr9_53911457_53975301
Elmod2,8,83312632,83332486,protein_coding,-1,19854,chr8_83312632_83332486
Elmod3,6,72565922,72598413,protein_coding,-1,32491,chr6_72565922_72598413
Elmsan1,12,84149176,84218881,protein_coding,-1,69705,chr12_84149176_84218881
Eln,5,134702593,134747323,protein_coding,-1,44730,chr5_134702593_134747323
Elof1,9,22112989,22117172,protein_coding,-1,4183,chr9_22112989_22117172
Elovl1,4,118428093,118432953,protein_coding,1,4860,chr4_118428093_118432953
Elovl2,13,41182381,41220405,protein_coding,-1,38024,chr13_41182381_41220405
Elovl3,19,46131897,46135694,protein_coding,1,3797,chr19_46131897_46135694
Elovl4,9,83778692,83806277,protein_coding,-1,27585,chr9_83778692_83806277
Elovl5,9,77917364,77984519,protein_coding,1,67155,chr9_77917364_77984519
Elovl6,3,129532355,129638495,protein_coding,1,106140,chr3_129532355_129638495
Elovl7,13,108214404,108285683,protein_coding,1,71279,chr13_108214404_108285683
Elp2,18,24602866,24639507,protein_coding,1,36641,chr18_24602866_24639507
Elp3,14,65530449,65593075,protein_coding,-1,62626,chr14_65530449_65593075
Elp4,2,105701027,105904564,protein_coding,-1,203537,chr2_105701027_105904564
Elp5,11,69968222,69982517,protein_coding,-1,14295,chr11_69968222_69982517
Elp6,9,110305173,110322102,protein_coding,1,16929,chr9_110305173_110322102
Emb,13,117208536,117274415,protein_coding,1,65879,chr13_117208536_117274415
Emc1,4,139352587,139378730,protein_coding,1,26143,chr4_139352587_139378730
Emc10,7,44489937,44496529,protein_coding,-1,6592,chr7_44489937_44496529
Emc2,15,43477229,43527763,protein_coding,1,50534,chr15_43477229_43527763
Emc3,6,113514874,113531652,protein_coding,-1,16778,chr6_113514874_113531652
Emc4,2,112363011,112368027,protein_coding,-1,5016,chr2_112363011_112368027
Emc6,11,73175519,73177037,protein_coding,-1,1518,chr11_73175519_73177037
Emc7,2,112454997,112472162,protein_coding,1,17165,chr2_112454997_112472162
Emc8,8,120653914,120668573,protein_coding,-1,14659,chr8_120653914_120668573
Emc9,14,55581516,55585302,protein_coding,-1,3786,chr14_55581516_55585302
Emcn,3,137341067,137432185,protein_coding,1,91118,chr3_137341067_137432185
Emd,X,74254687,74261548,protein_coding,1,6861,chrX_74254687_74261548
Eme1,11,94644996,94653964,protein_coding,-1,8968,chr11_94644996_94653964
Eme2,17,24888486,24895087,protein_coding,-1,6601,chr17_24888486_24895087
Emg1,6,124704085,124712178,protein_coding,-1,8093,chr6_124704085_124712178
Emid1,11,5106265,5152257,protein_coding,-1,45992,chr11_5106265_5152257
Emilin1,5,30913402,30921277,protein_coding,1,7875,chr5_30913402_30921277
Emilin2,17,71252172,71311978,protein_coding,-1,59806,chr17_71252172_71311978
Emilin3,2,160906437,160912328,protein_coding,-1,5891,chr2_160906437_160912328
Eml1,12,108370957,108539617,protein_coding,1,168660,chr12_108370957_108539617
Eml2,7,19176421,19206482,protein_coding,1,30061,chr7_19176421_19206482
Eml3,19,8929552,8941582,protein_coding,1,12030,chr19_8929552_8941582
Eml4,17,83350931,83480361,protein_coding,1,129430,chr17_83350931_83480361
Eml5,12,98786805,98901484,protein_coding,-1,114679,chr12_98786805_98901484
Eml6,11,29743048,30026033,protein_coding,-1,282985,chr11_29743048_30026033
Emp1,6,135362545,135383173,protein_coding,1,20628,chr6_135362545_135383173
Emp2,16,10281749,10313968,protein_coding,-1,32219,chr16_10281749_10313968
Emp3,7,45918023,45921404,protein_coding,-1,3381,chr7_45918023_45921404
Emx1,6,85187438,85204462,protein_coding,1,17024,chr6_85187438_85204462
Emx2,19,59458372,59465357,protein_coding,1,6985,chr19_59458372_59465357
Emx2os,19,59425104,59458635,antisense,-1,33531,chr19_59425104_59458635
En2,5,28165694,28172166,protein_coding,1,6472,chr5_28165694_28172166
Enah,1,181896384,182019990,protein_coding,-1,123606,chr1_181896384_182019990
Enam,5,88487975,88506049,protein_coding,1,18074,chr5_88487975_88506049
Enc1,13,97241105,97253034,protein_coding,1,11929,chr13_97241105_97253034
Endod1,9,14353990,14381507,protein_coding,-1,27517,chr9_14353990_14381507
Endog,2,30171493,30174069,protein_coding,1,2576,chr2_30171493_30174069
Endou,15,97711015,97731339,protein_coding,-1,20324,chr15_97711015_97731339
Endov,11,119491347,119511437,protein_coding,1,20090,chr11_119491347_119511437
Eng,2,32646595,32682669,protein_coding,1,36074,chr2_32646595_32682669
Engase,11,118476829,118489209,protein_coding,1,12380,chr11_118476829_118489209
Enho,4,41638144,41640324,protein_coding,-1,2180,chr4_41638144_41640324
Enkd1,8,105703651,105708210,protein_coding,-1,4559,chr8_105703651_105708210
Enkur,2,21180731,21205365,protein_coding,-1,24634,chr2_21180731_21205365
Eno1,4,150236721,150248879,protein_coding,1,12158,chr4_150236721_150248879
Eno1b,18,48045335,48048412,protein_coding,1,3077,chr18_48045335_48048412
Eno2,6,124760053,124769673,protein_coding,-1,9620,chr6_124760053_124769673
Eno3,11,70657202,70662513,protein_coding,1,5311,chr11_70657202_70662513
Eno4,19,58943425,58971421,protein_coding,1,27996,chr19_58943425_58971421
Enoph1,5,100039985,100068760,protein_coding,1,28775,chr5_100039985_100068760
Enox1,14,77156763,77721760,protein_coding,1,564997,chr14_77156763_77721760
Enox2,X,49009707,49288259,protein_coding,-1,278552,chrX_49009707_49288259
Enpep,3,129269175,129332720,protein_coding,-1,63545,chr3_129269175_129332720
Enpp1,10,24637914,24712159,protein_coding,-1,74245,chr10_24637914_24712159
Enpp2,15,54838901,54952892,protein_coding,-1,113991,chr15_54838901_54952892
Enpp3,10,24772406,24842823,protein_coding,-1,70417,chr10_24772406_24842823
Enpp4,17,44096308,44105809,protein_coding,-1,9501,chr17_44096308_44105809
Enpp5,17,44078813,44086567,protein_coding,1,7754,chr17_44078813_44086567
Enpp6,8,46986887,47096762,protein_coding,1,109875,chr8_46986887_47096762
Ensa,3,95624993,95632102,protein_coding,1,7109,chr3_95624993_95632102
Enthd1,15,80452240,80565156,protein_coding,-1,112916,chr15_80452240_80565156
Entpd1,19,40612366,40741602,protein_coding,1,129236,chr19_40612366_40741602
Entpd2,2,25395874,25401321,protein_coding,1,5447,chr2_25395874_25401321
Entpd3,9,120539818,120568327,protein_coding,1,28509,chr9_120539818_120568327
Entpd5,12,84373857,84409029,protein_coding,-1,35172,chr12_84373857_84409029
Entpd6,2,150749042,150771675,protein_coding,1,22633,chr2_150749042_150771675
Entpd7,19,43689672,43733697,protein_coding,1,44025,chr19_43689672_43733697
Eny2,15,44428042,44438256,protein_coding,1,10214,chr15_44428042_44438256
Eogt,6,97110024,97149182,protein_coding,-1,39158,chr6_97110024_97149182
Eomes,9,118478212,118486132,protein_coding,1,7920,chr9_118478212_118486132
Ep300,15,81585351,81652077,protein_coding,1,66726,chr15_81585351_81652077
Ep400,5,110664373,110770717,protein_coding,-1,106344,chr5_110664373_110770717
Epas1,17,86753700,86833410,protein_coding,1,79710,chr17_86753700_86833410
Epc1,18,6435951,6516108,protein_coding,-1,80157,chr18_6435951_6516108
Epc2,2,49451486,49551948,protein_coding,1,100462,chr2_49451486_49551948
Epcam,17,87635979,87651129,protein_coding,1,15150,chr17_87635979_87651129
Epdr1,13,19591706,19619927,protein_coding,-1,28221,chr13_19591706_19619927
Epg5,18,77893980,78035013,protein_coding,1,141033,chr18_77893980_78035013
Epgn,5,91027464,91035215,protein_coding,1,7751,chr5_91027464_91035215
Epha1,6,42358487,42373268,protein_coding,-1,14781,chr6_42358487_42373268
Epha10,4,124880899,124917800,protein_coding,1,36901,chr4_124880899_124917800
Epha2,4,141301240,141329384,protein_coding,1,28144,chr4_141301240_141329384
Epha3,16,63543534,63864175,protein_coding,-1,320641,chr16_63543534_63864175
Epha4,1,77367185,77515088,protein_coding,-1,147903,chr1_77367185_77515088
Epha5,5,84054761,84417382,protein_coding,-1,362621,chr5_84054761_84417382
Epha6,16,59653483,60605531,protein_coding,-1,952048,chr16_59653483_60605531
Epha7,4,28813131,28967499,protein_coding,1,154368,chr4_28813131_28967499
Epha8,4,136929419,136956816,protein_coding,-1,27397,chr4_136929419_136956816
Ephb1,9,101922128,102354693,protein_coding,-1,432565,chr9_101922128_102354693
Ephb2,4,136647539,136835988,protein_coding,-1,188449,chr4_136647539_136835988
Ephb3,16,21204755,21223305,protein_coding,1,18550,chr16_21204755_21223305
Ephb4,5,137350109,137378669,protein_coding,1,28560,chr5_137350109_137378669
Ephb6,6,41605482,41620509,protein_coding,1,15027,chr6_41605482_41620509
Ephx1,1,180976210,181020904,protein_coding,-1,44694,chr1_180976210_181020904
Ephx2,14,66084374,66124500,protein_coding,-1,40126,chr14_66084374_66124500
Ephx3,17,32183770,32189549,protein_coding,-1,5779,chr17_32183770_32189549
Ephx4,5,107402736,107430035,protein_coding,1,27299,chr5_107402736_107430035
Epm2a,10,11343404,11459644,protein_coding,1,116240,chr10_11343404_11459644
Epm2aip1,9,111271929,111279093,protein_coding,1,7164,chr9_111271929_111279093
Epn1,7,5080235,5098178,protein_coding,1,17943,chr7_5080235_5098178
Epn2,11,61517249,61579687,protein_coding,-1,62438,chr11_61517249_61579687
Epn3,11,94489599,94499974,protein_coding,-1,10375,chr11_94489599_94499974
Epor,9,21958897,21963506,protein_coding,-1,4609,chr9_21958897_21963506
Eppk1,15,76101481,76120195,protein_coding,-1,18714,chr15_76101481_76120195
Eprs,1,185363044,185428360,protein_coding,1,65316,chr1_185363044_185428360
Eps15,4,109280268,109387817,protein_coding,1,107549,chr4_109280268_109387817
Eps15l1,8,72340999,72421460,protein_coding,-1,80461,chr8_72340999_72421460
Eps8,6,137477245,137654876,protein_coding,-1,177631,chr6_137477245_137654876
Eps8l1,7,4460674,4480487,protein_coding,1,19813,chr7_4460674_4480487
Eps8l2,7,141338880,141363020,protein_coding,1,24140,chr7_141338880_141363020
Eps8l3,3,107877229,107892900,protein_coding,1,15671,chr3_107877229_107892900
Epsti1,14,77904239,78002657,protein_coding,1,98418,chr14_77904239_78002657
Epx,11,87864000,87875536,protein_coding,-1,11536,chr11_87864000_87875536
Epyc,10,97644068,97682454,protein_coding,1,38386,chr10_97644068_97682454
Eqtn,4,94907267,94928843,protein_coding,-1,21576,chr4_94907267_94928843
Eral1,11,78073376,78080383,protein_coding,-1,7007,chr11_78073376_78080383
Erap1,13,74639568,74693201,protein_coding,1,53633,chr13_74639568_74693201
Erbb2,11,98412470,98437716,protein_coding,1,25246,chr11_98412470_98437716
Erbb3,10,128567523,128589652,protein_coding,-1,22129,chr10_128567523_128589652
Erbb4,1,68032186,69108059,protein_coding,-1,1075873,chr1_68032186_69108059
Erc1,6,119570796,119848167,protein_coding,-1,277371,chr6_119570796_119848167
Erc2,14,27622428,28478537,protein_coding,1,856109,chr14_27622428_28478537
Ercc1,7,19344778,19356524,protein_coding,1,11746,chr7_19344778_19356524
Ercc2,7,19382010,19395694,protein_coding,1,13684,chr7_19382010_19395694
Ercc3,18,32240300,32270151,protein_coding,1,29851,chr18_32240300_32270151
Ercc4,16,13109684,13150617,protein_coding,1,40933,chr16_13109684_13150617
Ercc5,1,44147744,44181260,protein_coding,1,33516,chr1_44147744_44181260
Ercc6,14,32513521,32580990,protein_coding,1,67469,chr14_32513521_32580990
Ercc6l,X,102141716,102157091,protein_coding,-1,15375,chrX_102141716_102157091
Ercc6l2,13,63815240,63900302,protein_coding,1,85062,chr13_63815240_63900302
Ercc8,13,108158731,108195364,protein_coding,1,36633,chr13_108158731_108195364
Erdr1,X,170009659,170019281,lincRNA,1,9622,chrX_170009659_170019281
Erf,7,25242561,25250761,protein_coding,-1,8200,chr7_25242561_25250761
Erg,16,95359169,95586593,protein_coding,-1,227424,chr16_95359169_95586593
Ergic1,17,26561489,26656934,protein_coding,1,95445,chr17_26561489_26656934
Ergic2,6,148179079,148212374,protein_coding,-1,33295,chr6_148179079_148212374
Ergic3,2,156008045,156018279,protein_coding,1,10234,chr2_156008045_156018279
Erh,12,80634022,80644341,protein_coding,-1,10319,chr12_80634022_80644341
Eri1,8,35465253,35496196,protein_coding,-1,30943,chr8_35465253_35496196
Eri2,7,119768679,119794058,protein_coding,-1,25379,chr7_119768679_119794058
Eri3,4,117550365,117674297,protein_coding,1,123932,chr4_117550365_117674297
Erich1,8,14027561,14090301,protein_coding,-1,62740,chr8_14027561_14090301
Erich2,2,70508819,70540884,protein_coding,1,32065,chr2_70508819_70540884
Erich3,3,154663859,154767790,protein_coding,1,103931,chr3_154663859_154767790
Erich4,7,25614620,25615892,protein_coding,-1,1272,chr7_25614620_25615892
Erich5,15,34453305,34473892,protein_coding,1,20587,chr15_34453305_34473892
Erich6,3,58616300,58637207,protein_coding,-1,20907,chr3_58616300_58637207
Erlec1,11,30930774,30954335,protein_coding,-1,23561,chr11_30930774_30954335
Erlin1,19,44034944,44069785,protein_coding,-1,34841,chr19_44034944_44069785
Erlin2,8,27023261,27040328,protein_coding,1,17067,chr8_27023261_27040328
Ermap,4,119175457,119190011,protein_coding,-1,14554,chr4_119175457_119190011
Ermard,17,15041208,15090044,protein_coding,1,48836,chr17_15041208_15090044
Ermn,2,58045113,58052864,protein_coding,-1,7751,chr2_58045113_58052864
Ermp1,19,29608214,29648415,protein_coding,-1,40201,chr19_29608214_29648415
Ern1,11,106394650,106487852,protein_coding,-1,93202,chr11_106394650_106487852
Ern2,7,122169893,122186207,protein_coding,-1,16314,chr7_122169893_122186207
Ero1l,14,45283087,45318771,protein_coding,-1,35684,chr14_45283087_45318771
Ero1lb,13,12565874,12611396,protein_coding,1,45522,chr13_12565874_12611396
Erp27,6,136907311,136922180,protein_coding,-1,14869,chr6_136907311_136922180
Erp29,5,121428590,121452506,protein_coding,-1,23916,chr5_121428590_121452506
Erp44,4,48193323,48279558,protein_coding,-1,86235,chr4_48193323_48279558
Errfi1,4,150853919,150868892,protein_coding,1,14973,chr4_150853919_150868892
Esam,9,37528078,37538319,protein_coding,1,10241,chr9_37528078_37538319
Esco1,18,10566507,10610352,protein_coding,-1,43845,chr18_10566507_10610352
Esco2,14,65819038,65833994,protein_coding,-1,14956,chr14_65819038_65833994
Esd,14,74732297,74750765,protein_coding,1,18468,chr14_74732297_74750765
Esf1,2,140119883,140170564,protein_coding,-1,50681,chr2_140119883_140170564
Esm1,13,113209659,113218098,protein_coding,1,8439,chr13_113209659_113218098
Esp24,17,39036695,39040227,protein_coding,1,3532,chr17_39036695_39040227
Espl1,15,102296266,102324357,protein_coding,1,28091,chr15_102296266_102324357
Espn,4,152120331,152152371,protein_coding,-1,32040,chr4_152120331_152152371
Espnl,1,91322075,91348306,protein_coding,1,26231,chr1_91322075_91348306
Esr1,10,4611593,5005614,protein_coding,1,394021,chr10_4611593_5005614
Esr2,12,76120419,76177259,protein_coding,-1,56840,chr12_76120419_76177259
Esrp1,4,11331933,11386783,protein_coding,-1,54850,chr4_11331933_11386783
Esrp2,8,106130319,106136974,protein_coding,-1,6655,chr8_106130319_106136974
Esrra,19,6910977,6921840,protein_coding,-1,10863,chr19_6910977_6921840
Esrrb,12,86361117,86521628,protein_coding,1,160511,chr12_86361117_86521628
Esrrg,1,187608791,188214885,protein_coding,1,606094,chr1_187608791_188214885
Esyt1,10,128509965,128525871,protein_coding,-1,15906,chr10_128509965_128525871
Esyt2,12,116281196,116391050,protein_coding,1,109854,chr12_116281196_116391050
Esyt3,9,99309963,99358557,protein_coding,-1,48594,chr9_99309963_99358557
Etaa1,11,17938756,17953875,protein_coding,-1,15119,chr11_17938756_17953875
Etf1,18,34902785,34932007,protein_coding,-1,29222,chr18_34902785_34932007
Etfa,9,55454508,55512243,protein_coding,-1,57735,chr9_55454508_55512243
Etfb,7,43444083,43457800,protein_coding,1,13717,chr7_43444083_43457800
Etfdh,3,79603788,79629500,protein_coding,-1,25712,chr3_79603788_79629500
Ethe1,7,24587543,24608925,protein_coding,1,21382,chr7_24587543_24608925
Etl4,2,19909780,20810713,protein_coding,1,900933,chr2_19909780_20810713
Etnk1,6,143167221,143232307,protein_coding,1,65086,chr6_143167221_143232307
Etnk2,1,133363572,133380336,protein_coding,1,16764,chr1_133363572_133380336
Etnppl,3,130617448,130637521,protein_coding,1,20073,chr3_130617448_130637521
Etohd2,13,59769497,59775407,antisense,1,5910,chr13_59769497_59775407
Ets1,9,32636221,32757820,protein_coding,1,121599,chr9_32636221_32757820
Ets2,16,95702075,95721051,protein_coding,1,18976,chr16_95702075_95721051
Etv1,12,38779380,38870484,protein_coding,1,91104,chr12_38779380_38870484
Etv2,7,30633616,30635852,protein_coding,-1,2236,chr7_30633616_30635852
Etv3,3,87525407,87540156,protein_coding,1,14749,chr3_87525407_87540156
Etv4,11,101769742,101785371,protein_coding,-1,15629,chr11_101769742_101785371
Etv5,16,22381309,22439719,protein_coding,-1,58410,chr16_22381309_22439719
Etv6,6,134035700,134270158,protein_coding,1,234458,chr6_134035700_134270158
Eva1a,6,82041043,82093099,protein_coding,1,52056,chr6_82041043_82093099
Eva1b,4,126147744,126149875,protein_coding,1,2131,chr4_126147744_126149875
Eva1c,16,90826719,90905109,protein_coding,1,78390,chr16_90826719_90905109
Evc,5,37289098,37336894,protein_coding,-1,47796,chr5_37289098_37336894
Evc2,5,37338499,37425055,protein_coding,1,86556,chr5_37338499_37425055
Evi2a,11,79526560,79530609,protein_coding,-1,4049,chr11_79526560_79530609
Evi2b,11,79515056,79523762,protein_coding,-1,8706,chr11_79515056_79523762
Evi5,5,107744795,107875107,protein_coding,-1,130312,chr5_107744795_107875107
Evi5l,8,4166567,4211257,protein_coding,1,44690,chr8_4166567_4211257
Evl,12,108554720,108688516,protein_coding,1,133796,chr12_108554720_108688516
Evpl,11,116220559,116238077,protein_coding,-1,17518,chr11_116220559_116238077
Evx2,2,74652991,74659557,protein_coding,-1,6566,chr2_74652991_74659557
Ewsr1,11,5069689,5099266,protein_coding,-1,29577,chr11_5069689_5099266
Exd1,2,119516505,119547627,protein_coding,-1,31122,chr2_119516505_119547627
Exd2,12,80463095,80500227,protein_coding,1,37132,chr12_80463095_80500227
Exo1,1,175880581,175913489,protein_coding,1,32908,chr1_175880581_175913489
Exo5,4,120921196,120925017,protein_coding,-1,3821,chr4_120921196_120925017
Exoc1,5,76529311,76570294,protein_coding,1,40983,chr5_76529311_76570294
Exoc2,13,30813919,30974093,protein_coding,-1,160174,chr13_30813919_30974093
Exoc3,13,74169488,74208732,protein_coding,-1,39244,chr13_74169488_74208732
Exoc3l,8,105289924,105296101,protein_coding,-1,6177,chr8_105289924_105296101
Exoc3l2,7,19463331,19496762,protein_coding,1,33431,chr7_19463331_19496762
Exoc3l4,12,111417017,111431678,protein_coding,1,14661,chr12_111417017_111431678
Exoc4,6,33249085,33973979,protein_coding,1,724894,chr6_33249085_33973979
Exoc5,14,49004090,49066653,protein_coding,-1,62563,chr14_49004090_49066653
Exoc6,19,37520879,37684059,protein_coding,1,163180,chr19_37520879_37684059
Exoc6b,6,84618487,85069513,protein_coding,-1,451026,chr6_84618487_85069513
Exoc7,11,116288001,116307233,protein_coding,-1,19232,chr11_116288001_116307233
Exoc8,8,124893108,124897705,protein_coding,-1,4597,chr8_124893108_124897705
Exog,9,119444943,119465517,protein_coding,1,20574,chr9_119444943_119465517
Exosc1,19,41922292,41933423,protein_coding,-1,11131,chr19_41922292_41933423
Exosc10,4,148558429,148582401,protein_coding,1,23972,chr4_148558429_148582401
Exosc2,2,31670715,31681349,protein_coding,1,10634,chr2_31670715_31681349
Exosc3,4,45316613,45342732,protein_coding,-1,26119,chr4_45316613_45342732
Exosc4,15,76327397,76330677,protein_coding,1,3280,chr15_76327397_76330677
Exosc5,7,25659164,25671368,protein_coding,1,12204,chr7_25659164_25671368
Exosc6,8,111056339,111057664,protein_coding,1,1325,chr8_111056339_111057664
Exosc7,9,123113215,123136129,protein_coding,1,22914,chr9_123113215_123136129
Exosc8,3,54728678,54735393,protein_coding,-1,6715,chr3_54728678_54735393
Exosc9,3,36552606,36565727,protein_coding,1,13121,chr3_36552606_36565727
Exph5,9,53301670,53377514,protein_coding,1,75844,chr9_53301670_53377514
Ext1,15,53064038,53346159,protein_coding,-1,282121,chr15_53064038_53346159
Ext2,2,93661028,93822568,protein_coding,-1,161540,chr2_93661028_93822568
Extl1,4,134356372,134383850,protein_coding,-1,27478,chr4_134356372_134383850
Extl2,3,116007462,116029017,protein_coding,1,21555,chr3_116007462_116029017
Extl3,14,65052060,65149855,protein_coding,-1,97795,chr14_65052060_65149855
Eya1,1,14168954,14310235,protein_coding,-1,141281,chr1_14168954_14310235
Eya2,2,165595032,165771727,protein_coding,1,176695,chr2_165595032_165771727
Eya3,4,132638987,132724765,protein_coding,1,85778,chr4_132638987_132724765
Eya4,10,23102963,23350786,protein_coding,-1,247823,chr10_23102963_23350786
Ezh1,11,101191115,101226463,protein_coding,-1,35348,chr11_101191115_101226463
Ezh2,6,47530139,47595341,protein_coding,-1,65202,chr6_47530139_47595341
Ezr,17,6738041,6782784,protein_coding,-1,44743,chr17_6738041_6782784
F10,8,13037308,13056676,protein_coding,1,19368,chr8_13037308_13056676
F11,8,45241174,45262031,protein_coding,-1,20857,chr8_45241174_45262031
F11r,1,171437535,171464603,protein_coding,1,27068,chr1_171437535_171464603
F12,13,55417958,55426793,protein_coding,-1,8835,chr13_55417958_55426793
F13a1,13,36867178,37050244,protein_coding,-1,183066,chr13_36867178_37050244
F2,2,91625320,91636414,protein_coding,-1,11094,chr2_91625320_91636414
F2r,13,95601803,95618487,protein_coding,-1,16684,chr13_95601803_95618487
F2rl1,13,95511732,95525227,protein_coding,-1,13495,chr13_95511732_95525227
F2rl2,13,95696853,95702739,protein_coding,1,5886,chr13_95696853_95702739
F2rl3,8,72761880,72763874,protein_coding,1,1994,chr8_72761880_72763874
F3,3,121723537,121735048,protein_coding,1,11511,chr3_121723537_121735048
F420014N23Rik,10,127195249,127202643,lincRNA,1,7394,chr10_127195249_127202643
F5,1,164151838,164220277,protein_coding,1,68439,chr1_164151838_164220277
F630028O10Rik,X,96239926,96243636,antisense,1,3710,chrX_96239926_96243636
F630040K05Rik,17,45734506,45788594,lincRNA,1,54088,chr17_45734506_45788594
F630042J09Rik,13,67278577,67283361,lincRNA,1,4784,chr13_67278577_67283361
F630206G17Rik,11,45808087,45841171,processed_transcript,1,33084,chr11_45808087_45841171
F7,8,13026034,13035809,protein_coding,1,9775,chr8_13026034_13035809
F730016J06Rik,2,28095477,28127731,lincRNA,1,32254,chr2_28095477_28127731
F730035M05Rik,12,70227841,70234165,lincRNA,1,6324,chr12_70227841_70234165
F730043M19Rik,12,33111711,33147597,bidirectional_promoter_lncRNA,-1,35886,chr12_33111711_33147597
F730311O21Rik,1,132342023,132349626,lincRNA,1,7603,chr1_132342023_132349626
F8,X,75172715,75382615,protein_coding,-1,209900,chrX_75172715_75382615
F830016B08Rik,18,60293380,60303016,protein_coding,1,9636,chr18_60293380_60303016
F830045P16Rik,2,129458359,129536602,protein_coding,-1,78243,chr2_129458359_129536602
F830208F22Rik,CHR_MG3700_PATCH,77793259,77796743,lncRNA;processed_transcript,-1,3484,chrCHR_MG3700_PATCH_77793259_77796743
F8a,X,73228291,73230795,protein_coding,1,2504,chrX_73228291_73230795
F9,X,59999464,60030759,protein_coding,1,31295,chrX_59999464_60030759
Fa2h,8,111345135,111393824,protein_coding,-1,48689,chr8_111345135_111393824
Faah,4,115967145,116017926,protein_coding,-1,50781,chr4_115967145_116017926
Fabp12,3,10244209,10301183,protein_coding,-1,56974,chr3_10244209_10301183
Fabp3,4,130308595,130315463,protein_coding,1,6868,chr4_130308595_130315463
Fabp3-ps1,10,86731987,86732388,processed_pseudogene,-1,401,chr10_86731987_86732388
Fabp4,3,10204088,10208576,protein_coding,-1,4488,chr3_10204088_10208576
Fabp5,3,10012548,10016607,protein_coding,1,4059,chr3_10012548_10016607
Fabp5l2,18,7581516,7581920,processed_pseudogene,1,404,chr18_7581516_7581920
Fabp7,10,57784881,57788450,protein_coding,1,3569,chr10_57784881_57788450
Fadd,7,144577318,144582463,protein_coding,-1,5145,chr7_144577318_144582463
Fads1,19,10182888,10196877,protein_coding,1,13989,chr19_10182888_10196877
Fads2,19,10062765,10101746,protein_coding,-1,38981,chr19_10062765_10101746
Fads3,19,10041569,10060110,protein_coding,1,18541,chr19_10041569_10060110
Fads6,11,115279622,115297663,protein_coding,-1,18041,chr11_115279622_115297663
Faf1,4,109676588,109963960,protein_coding,1,287372,chr4_109676588_109963960
Faf2,13,54621784,54664063,protein_coding,1,42279,chr13_54621784_54664063
Fah,7,84585159,84606722,protein_coding,-1,21563,chr7_84585159_84606722
Fahd1,17,24848892,24850364,protein_coding,-1,1472,chr17_24848892_24850364
Fahd2a,2,127436215,127444565,protein_coding,-1,8350,chr2_127436215_127444565
Faim,9,98986373,99002021,protein_coding,1,15648,chr9_98986373_99002021
Faim2,15,99497012,99528165,protein_coding,-1,31153,chr15_99497012_99528165
Fam102a,2,32535332,32569756,protein_coding,1,34424,chr2_32535332_32569756
Fam102b,3,108970997,109027607,protein_coding,-1,56610,chr3_108970997_109027607
Fam104a,11,113661319,113684155,protein_coding,-1,22836,chr11_113661319_113684155
Fam107a,14,8296274,8318023,protein_coding,-1,21749,chr14_8296274_8318023
Fam107b,2,3570488,3782142,protein_coding,1,211654,chr2_3570488_3782142
Fam110a,2,151969398,151980219,protein_coding,-1,10821,chr2_151969398_151980219
Fam110b,4,5644090,6108223,protein_coding,1,464133,chr4_5644090_6108223
Fam110c,12,31073861,31080251,protein_coding,1,6390,chr12_31073861_31080251
Fam111a,19,12545740,12589768,protein_coding,1,44028,chr19_12545740_12589768
Fam114a1,5,64970071,65041886,protein_coding,1,71815,chr5_64970071_65041886
Fam114a2,11,57482993,57518617,protein_coding,-1,35624,chr11_57482993_57518617
Fam117a,11,95337018,95381872,protein_coding,1,44854,chr11_95337018_95381872
Fam117b,1,59913006,59985346,protein_coding,1,72340,chr1_59913006_59985346
Fam118a,15,85028948,85062830,protein_coding,1,33882,chr15_85028948_85062830
Fam118b,9,35216965,35267805,protein_coding,-1,50840,chr9_35216965_35267805
Fam120a,13,48879219,48968017,protein_coding,-1,88798,chr13_48879219_48968017
Fam120b,17,15396202,15433583,protein_coding,1,37381,chr17_15396202_15433583
Fam120c,X,151344175,151471842,protein_coding,1,127667,chrX_151344175_151471842
Fam122a,19,24476502,24477356,protein_coding,-1,854,chr19_24476502_24477356
Fam122b,X,53243415,53269805,protein_coding,-1,26390,chrX_53243415_53269805
Fam124a,14,62555737,62608486,protein_coding,1,52749,chr14_62555737_62608486
Fam126a,5,23915276,24030690,protein_coding,-1,115414,chr5_23915276_24030690
Fam126b,1,58522806,58586323,protein_coding,-1,63517,chr1_58522806_58586323
Fam129a,1,151571186,151721939,protein_coding,1,150753,chr1_151571186_151721939
Fam129b,2,32876114,32925254,protein_coding,1,49140,chr2_32876114_32925254
Fam129c,8,71597648,71607936,protein_coding,1,10288,chr8_71597648_71607936
Fam131a,16,20693241,20703048,protein_coding,1,9807,chr16_20693241_20703048
Fam131b,6,42315312,42324643,protein_coding,-1,9331,chr6_42315312_42324643
Fam131c,4,141368220,141384175,protein_coding,1,15955,chr4_141368220_141384175
Fam133b,5,3543833,3570238,protein_coding,1,26405,chr5_3543833_3570238
Fam135a,1,24011093,24100341,protein_coding,-1,89248,chr1_24011093_24100341
Fam135b,15,71431609,71727838,protein_coding,-1,296229,chr15_71431609_71727838
Fam136a,6,86365646,86370058,protein_coding,1,4412,chr6_86365646_86370058
Fam136b-ps,15,31276491,31276902,processed_pseudogene,1,411,chr15_31276491_31276902
Fam13a,6,58932090,59024549,protein_coding,-1,92459,chr6_58932090_59024549
Fam13b,18,34442351,34506831,protein_coding,-1,64480,chr18_34442351_34506831
Fam13c,10,70440481,70558736,protein_coding,1,118255,chr10_70440481_70558736
Fam149a,8,45336717,45382291,protein_coding,-1,45574,chr8_45336717_45382291
Fam149b,14,20348162,20383491,protein_coding,1,35329,chr14_20348162_20383491
Fam151b,13,92449625,92484015,protein_coding,-1,34390,chr13_92449625_92484015
Fam155a,8,9205902,9771161,protein_coding,-1,565259,chr8_9205902_9771161
Fam160a1,3,85660061,85817291,protein_coding,-1,157230,chr3_85660061_85817291
Fam160a2,7,105371211,105400054,protein_coding,-1,28843,chr7_105371211_105400054
Fam160b1,19,57360680,57389586,protein_coding,1,28906,chr19_57360680_57389586
Fam160b2,14,70583296,70599835,protein_coding,-1,16539,chr14_70583296_70599835
Fam161a,11,23007531,23030788,protein_coding,1,23257,chr11_23007531_23030788
Fam161b,12,84345309,84361833,protein_coding,-1,16524,chr12_84345309_84361833
Fam162a,16,36043761,36071594,protein_coding,-1,27833,chr16_36043761_36071594
Fam163a,1,156075966,156205026,protein_coding,-1,129060,chr1_156075966_156205026
Fam163b,2,27110380,27142491,protein_coding,-1,32111,chr2_27110380_27142491
Fam166a,2,25218745,25222280,protein_coding,1,3535,chr2_25218745_25222280
Fam166b,4,43427019,43429134,protein_coding,-1,2115,chr4_43427019_43429134
Fam167a,14,63436394,63465498,protein_coding,1,29104,chr14_63436394_63465498
Fam167b,4,129576815,129578549,protein_coding,-1,1734,chr4_129576815_129578549
Fam168a,7,100706635,100841656,protein_coding,1,135021,chr7_100706635_100841656
Fam168b,1,34813219,34843065,protein_coding,-1,29846,chr1_34813219_34843065
Fam169a,13,97067286,97131013,protein_coding,1,63727,chr13_97067286_97131013
Fam169b,7,68273839,68363092,protein_coding,1,89253,chr7_68273839_68363092
Fam171a1,2,3114224,3227806,protein_coding,1,113582,chr2_3114224_3227806
Fam171a2,11,102436981,102447682,protein_coding,-1,10701,chr11_102436981_102447682
Fam171b,2,83812636,83883486,protein_coding,1,70850,chr2_83812636_83883486
Fam172a,13,77702033,78166235,protein_coding,1,464202,chr13_77702033_78166235
Fam173a,17,25790080,25792901,protein_coding,-1,2821,chr17_25790080_25792901
Fam174a,1,95313623,95335284,protein_coding,1,21661,chr1_95313623_95335284
Fam174b,7,73740302,73776919,protein_coding,1,36617,chr7_73740302_73776919
Fam177a,12,55124469,55142104,protein_coding,1,17635,chr12_55124469_55142104
Fam178b,1,36562692,36683183,protein_coding,-1,120491,chr1_36562692_36683183
Fam181a,12,103310975,103317065,protein_coding,1,6090,chr12_103310975_103317065
Fam181b,7,93079865,93081867,protein_coding,1,2002,chr7_93079865_93081867
Fam183b,11,58792797,58801960,protein_coding,-1,9163,chr11_58792797_58801960
Fam184a,10,53633145,53751123,protein_coding,-1,117978,chr10_53633145_53751123
Fam184b,5,45529705,45639614,protein_coding,-1,109909,chr5_45529705_45639614
Fam185a,5,21424958,21482124,protein_coding,1,57166,chr5_21424958_21482124
Fam186b,15,99271018,99295888,protein_coding,-1,24870,chr15_99271018_99295888
Fam187a,11,102885169,102886731,protein_coding,1,1562,chr11_102885169_102886731
Fam189a1,7,64756091,65156570,protein_coding,-1,400479,chr7_64756091_65156570
Fam189a2,19,23972750,24031019,protein_coding,-1,58269,chr19_23972750_24031019
Fam189b,3,89183143,89189295,protein_coding,1,6152,chr3_89183143_89189295
Fam192a,8,94574138,94601997,protein_coding,-1,27859,chr8_94574138_94601997
Fam193a,5,34369933,34486456,protein_coding,1,116523,chr5_34369933_34486456
Fam193b,13,55539316,55571120,protein_coding,-1,31804,chr13_55539316_55571120
Fam199x,X,137049594,137082503,protein_coding,1,32909,chrX_137049594_137082503
Fam204a,19,60198586,60226701,protein_coding,-1,28115,chr19_60198586_60226701
Fam207a,10,77486661,77515785,protein_coding,-1,29124,chr10_77486661_77515785
Fam209,2,172472520,172474331,protein_coding,1,1811,chr2_172472520_172474331
Fam20a,11,109669749,109722279,protein_coding,-1,52530,chr11_109669749_109722279
Fam20b,1,156678532,156719086,protein_coding,-1,40554,chr1_156678532_156719086
Fam20c,5,138754514,138810077,protein_coding,1,55563,chr5_138754514_138810077
Fam210a,18,68260187,68300333,protein_coding,-1,40146,chr18_68260187_68300333
Fam210b,2,172345565,172355749,protein_coding,1,10184,chr2_172345565_172355749
Fam214a,9,74952884,75032468,protein_coding,1,79584,chr9_74952884_75032468
Fam214b,4,43032414,43046220,protein_coding,-1,13806,chr4_43032414_43046220
Fam216a,5,122364580,122372364,protein_coding,-1,7784,chr5_122364580_122372364
Fam216b,14,78081021,78089007,protein_coding,-1,7986,chr14_78081021_78089007
Fam217a,13,34909960,34924310,protein_coding,-1,14350,chr13_34909960_34924310
Fam217b,2,178414524,178424428,protein_coding,1,9904,chr2_178414524_178424428
Fam219a,4,41517691,41569538,protein_coding,-1,51847,chr4_41517691_41569538
Fam219aos,4,41517437,41518929,antisense,1,1492,chr4_41517437_41518929
Fam219b,9,57537528,57543184,protein_coding,1,5656,chr9_57537528_57543184
Fam220-ps,X,75143688,75144470,processed_pseudogene,1,782,chrX_75143688_75144470
Fam220a,5,143548706,143564531,protein_coding,1,15825,chr5_143548706_143564531
Fam221a,6,49367739,49390539,protein_coding,1,22800,chr6_49367739_49390539
Fam221b,4,43659622,43669145,protein_coding,-1,9523,chr4_43659622_43669145
Fam222a,5,114568016,114613220,protein_coding,1,45204,chr5_114568016_114613220
Fam222b,11,78094660,78156700,protein_coding,1,62040,chr11_78094660_78156700
Fam227a,15,79609576,79658956,protein_coding,-1,49380,chr15_79609576_79658956
Fam227b,2,125983483,126152004,protein_coding,-1,168521,chr2_125983483_126152004
Fam228a,12,4713670,4738430,protein_coding,-1,24760,chr12_4713670_4738430
Fam228b,12,4739888,4769267,protein_coding,-1,29379,chr12_4739888_4769267
Fam229a,4,129491190,129491956,protein_coding,1,766,chr4_129491190_129491956
Fam229b,10,39118804,39133914,protein_coding,-1,15110,chr10_39118804_39133914
Fam32a,8,72219730,72224418,protein_coding,1,4688,chr8_72219730_72224418
Fam3a,X,74384719,74393272,protein_coding,-1,8553,chrX_74384719_74393272
Fam3c,6,22306520,22356243,protein_coding,-1,49723,chr6_22306520_22356243
Fam43a,16,30599723,30602797,protein_coding,1,3074,chr16_30599723_30602797
Fam43b,4,138394092,138396528,protein_coding,-1,2436,chr4_138394092_138396528
Fam45a,19,60811585,60836227,protein_coding,1,24642,chr19_60811585_60836227
Fam47e,5,92555069,92591279,protein_coding,1,36210,chr5_92555069_92591279
Fam49a,12,12262139,12380965,protein_coding,1,118826,chr12_12262139_12380965
Fam49b,15,63929097,64060478,protein_coding,-1,131381,chr15_63929097_64060478
Fam50a,X,74313033,74320149,protein_coding,1,7116,chrX_74313033_74320149
Fam53a,5,33600347,33629635,protein_coding,-1,29288,chr5_33600347_33629635
Fam53b,7,132712082,132813886,protein_coding,-1,101804,chr7_132712082_132813886
Fam53c,18,34758906,34773760,protein_coding,1,14854,chr18_34758906_34773760
Fam57a,11,76179671,76214827,protein_coding,1,35156,chr11_76179671_76214827
Fam57b,7,126797668,126830219,protein_coding,1,32551,chr7_126797668_126830219
Fam71a,1,191162584,191164817,protein_coding,-1,2233,chr1_191162584_191164817
Fam71d,12,78691535,78734516,protein_coding,1,42981,chr12_78691535_78734516
Fam71e1,7,44496581,44501486,protein_coding,1,4905,chr7_44496581_44501486
Fam71e2,7,4753226,4771302,protein_coding,-1,18076,chr7_4753226_4771302
Fam71f2,6,29279593,29290680,protein_coding,1,11087,chr6_29279593_29290680
Fam72a,1,131527903,131539872,protein_coding,1,11969,chr1_131527903_131539872
Fam76a,4,132899213,132922558,protein_coding,-1,23345,chr4_132899213_132922558
Fam76b,9,13827716,13854987,protein_coding,1,27271,chr9_13827716_13854987
Fam78a,2,32050055,32084857,protein_coding,-1,34802,chr2_32050055_32084857
Fam78b,1,167001417,167091302,protein_coding,1,89885,chr1_167001417_167091302
Fam81a,9,70088511,70142560,protein_coding,-1,54049,chr9_70088511_70142560
Fam81b,13,76201708,76305072,protein_coding,-1,103364,chr13_76201708_76305072
Fam83a,15,57985419,58011009,protein_coding,1,25590,chr15_57985419_58011009
Fam83b,9,76490054,76567116,protein_coding,-1,77062,chr9_76490054_76567116
Fam83c,2,155827548,155834854,protein_coding,-1,7306,chr2_155827548_155834854
Fam83d,2,158768093,158786637,protein_coding,1,18544,chr2_158768093_158786637
Fam83e,7,45721212,45729492,protein_coding,1,8280,chr7_45721212_45729492
Fam83f,15,80671847,80700425,protein_coding,1,28578,chr15_80671847_80700425
Fam83g,11,61684091,61709951,protein_coding,1,25860,chr11_61684091_61709951
Fam83h,15,76001093,76014336,protein_coding,-1,13243,chr15_76001093_76014336
Fam89a,8,124740257,124751832,protein_coding,-1,11575,chr8_124740257_124751832
Fam89b,19,5728087,5729653,protein_coding,-1,1566,chr19_5728087_5729653
Fam92a,4,12153409,12172015,protein_coding,-1,18606,chr4_12153409_12172015
Fam92b,8,120166397,120177466,protein_coding,-1,11069,chr8_120166397_120177466
Fam98a,17,75537086,75551946,protein_coding,-1,14860,chr17_75537086_75551946
Fam98b,2,117249739,117271540,protein_coding,1,21801,chr2_117249739_117271540
Fam98c,7,29152510,29156234,protein_coding,-1,3724,chr7_29152510_29156234
Fan1,7,64346758,64374095,protein_coding,-1,27337,chr7_64346758_64374095
Fanca,8,123268300,123318576,protein_coding,-1,50276,chr8_123268300_123318576
Fancb,X,164980592,164997272,protein_coding,1,16680,chrX_164980592_164997272
Fancc,13,63285043,63497278,protein_coding,-1,212235,chr13_63285043_63497278
Fancd2,6,113531682,113597017,protein_coding,1,65335,chr6_113531682_113597017
Fancd2os,6,113596761,113600715,protein_coding,-1,3954,chr6_113596761_113600715
Fance,17,28313519,28326572,protein_coding,1,13053,chr17_28313519_28326572
Fancf,7,51860577,51862267,protein_coding,-1,1690,chr7_51860577_51862267
Fancg,4,43002343,43010506,protein_coding,-1,8163,chr4_43002343_43010506
Fanci,7,79391929,79450264,protein_coding,1,58335,chr7_79391929_79450264
Fancl,11,26386135,26471876,protein_coding,1,85741,chr11_26386135_26471876
Fancm,12,65075603,65132058,protein_coding,1,56455,chr12_65075603_65132058
Fank1,7,133776861,133881532,protein_coding,1,104671,chr7_133776861_133881532
Fap,2,62500943,62574075,protein_coding,-1,73132,chr2_62500943_62574075
Far1,7,113513834,113571511,protein_coding,1,57677,chr7_113513834_113571511
Far1os,7,113530489,113564987,antisense,-1,34498,chr7_113530489_113564987
Far2,6,148047259,148182758,protein_coding,1,135499,chr6_148047259_148182758
Farp1,14,121035200,121283744,protein_coding,1,248544,chr14_121035200_121283744
Farp2,1,93512079,93621976,protein_coding,1,109897,chr1_93512079_93621976
Fars2,13,36117412,36726280,protein_coding,1,608868,chr13_36117412_36726280
Farsa,8,84856989,84869257,protein_coding,1,12268,chr8_84856989_84869257
Farsb,1,78417975,78488897,protein_coding,-1,70922,chr1_78417975_78488897
Fas,19,34290666,34327772,protein_coding,1,37106,chr19_34290666_34327772
Fasl,1,161780689,161788495,protein_coding,-1,7806,chr1_161780689_161788495
Fasn,11,120805846,120824547,protein_coding,-1,18701,chr11_120805846_120824547
Fastk,5,24438440,24445287,protein_coding,-1,6847,chr5_24438440_24445287
Fastkd1,2,69686815,69713516,protein_coding,-1,26701,chr2_69686815_69713516
Fastkd2,1,63730614,63754655,protein_coding,1,24041,chr1_63730614_63754655
Fastkd3,13,68582234,68592338,protein_coding,1,10104,chr13_68582234_68592338
Fastkd5,2,130613840,130630027,protein_coding,-1,16187,chr2_130613840_130630027
Fat1,8,44935447,45052257,protein_coding,1,116810,chr8_44935447_45052257
Fat2,11,55250609,55336564,protein_coding,-1,85955,chr11_55250609_55336564
Fat3,9,15910189,16501285,protein_coding,-1,591096,chr9_15910189_16501285
Fat4,3,38886940,39011985,protein_coding,1,125045,chr3_38886940_39011985
Fate1,X,71972986,71989046,protein_coding,1,16060,chrX_71972986_71989046
Fau,19,6057844,6059524,protein_coding,1,1680,chr19_6057844_6059524
Fau-ps1,2,141838789,141839339,processed_pseudogene,1,550,chr2_141838789_141839339
Fau-ps2,11,3196454,3196824,processed_pseudogene,-1,370,chr11_3196454_3196824
Faxc,4,21931329,21996839,protein_coding,1,65510,chr4_21931329_21996839
Fbf1,11,116142285,116168166,protein_coding,-1,25881,chr11_116142285_116168166
Fbl,7,28169710,28179269,protein_coding,1,9559,chr7_28169710_28179269
Fblim1,4,141576062,141606096,protein_coding,-1,30034,chr4_141576062_141606096
Fbll1,11,35797382,35798884,protein_coding,-1,1502,chr11_35797382_35798884
Fbln1,15,85205949,85286535,protein_coding,1,80586,chr15_85205949_85286535
Fbln2,6,91212455,91272540,protein_coding,1,60085,chr6_91212455_91272540
Fbln5,12,101746565,101819055,protein_coding,-1,72490,chr12_101746565_101819055
Fbln7,2,128862981,128897034,protein_coding,1,34053,chr2_128862981_128897034
Fbn1,2,125300594,125507993,protein_coding,-1,207399,chr2_125300594_125507993
Fbn2,18,58008623,58210487,protein_coding,-1,201864,chr18_58008623_58210487
Fbp1,13,62864753,62888282,protein_coding,-1,23529,chr13_62864753_62888282
Fbp2,13,62836877,62858422,protein_coding,-1,21545,chr13_62836877_62858422
Fbrs,7,127479199,127491711,protein_coding,1,12512,chr7_127479199_127491711
Fbrsl1,5,110361754,110448602,protein_coding,-1,86848,chr5_110361754_110448602
Fbxl12,9,20618118,20644767,protein_coding,-1,26649,chr9_20618118_20644767
Fbxl12os,9,20607458,20617271,antisense,1,9813,chr9_20607458_20617271
Fbxl13,5,21483847,21645634,protein_coding,-1,161787,chr5_21483847_21645634
Fbxl14,6,119479668,119482630,protein_coding,1,2962,chr6_119479668_119482630
Fbxl15,19,46328184,46330446,protein_coding,1,2262,chr19_46328184_46330446
Fbxl16,17,25809085,25821255,protein_coding,1,12170,chr17_25809085_25821255
Fbxl17,17,63057452,63500017,protein_coding,-1,442565,chr17_63057452_63500017
Fbxl18,5,142866946,142895421,protein_coding,-1,28475,chr5_142866946_142895421
Fbxl19,7,127744543,127769483,protein_coding,1,24940,chr7_127744543_127769483
Fbxl2,9,113963637,114046191,protein_coding,-1,82554,chr9_113963637_114046191
Fbxl20,11,98082556,98150403,protein_coding,-1,67847,chr11_98082556_98150403
Fbxl21,13,56522472,56537898,protein_coding,1,15426,chr13_56522472_56537898
Fbxl22,9,66508375,66514609,protein_coding,-1,6234,chr9_66508375_66514609
Fbxl3,14,103080239,103099566,protein_coding,-1,19327,chr14_103080239_103099566
Fbxl4,4,22357543,22434091,protein_coding,1,76548,chr4_22357543_22434091
Fbxl5,5,43744615,43821638,protein_coding,-1,77023,chr5_43744615_43821638
Fbxl6,15,76535721,76538746,protein_coding,-1,3025,chr15_76535721_76538746
Fbxl7,15,26540459,26895580,protein_coding,-1,355121,chr15_26540459_26895580
Fbxl8,8,105264648,105269326,protein_coding,1,4678,chr8_105264648_105269326
Fbxo10,4,45034247,45084604,protein_coding,-1,50357,chr4_45034247_45084604
Fbxo11,17,87990859,88065291,protein_coding,-1,74432,chr17_87990859_88065291
Fbxo15,18,84934782,84981473,protein_coding,1,46691,chr18_84934782_84981473
Fbxo16,14,65266618,65323973,protein_coding,1,57355,chr14_65266618_65323973
Fbxo17,7,28716804,28738144,protein_coding,1,21340,chr7_28716804_28738144
Fbxo2,4,148160621,148166424,protein_coding,1,5803,chr4_148160621_148166424
Fbxo21,5,117976730,118010201,protein_coding,1,33471,chr5_117976730_118010201
Fbxo22,9,55208925,55224433,protein_coding,1,15508,chr9_55208925_55224433
Fbxo24,5,137612503,137629002,protein_coding,-1,16499,chr5_137612503_137629002
Fbxo25,8,13907803,13940522,protein_coding,1,32719,chr8_13907803_13940522
Fbxo27,7,28692849,28699338,protein_coding,1,6489,chr7_28692849_28699338
Fbxo28,1,182313102,182341629,protein_coding,-1,28527,chr1_182313102_182341629
Fbxo3,2,104027721,104063240,protein_coding,1,35519,chr2_104027721_104063240
Fbxo30,10,11281330,11298052,protein_coding,1,16722,chr10_11281330_11298052
Fbxo31,8,121549440,121578806,protein_coding,-1,29366,chr8_121549440_121578806
Fbxo32,15,58175879,58214932,protein_coding,-1,39053,chr15_58175879_58214932
Fbxo33,12,59200655,59219725,protein_coding,-1,19070,chr12_59200655_59219725
Fbxo34,14,47450421,47531962,protein_coding,1,81541,chr14_47450421_47531962
Fbxo36,1,84839841,84900487,protein_coding,1,60646,chr1_84839841_84900487
Fbxo38,18,62504155,62548695,protein_coding,-1,44540,chr18_62504155_62548695
Fbxo4,15,3965445,3979573,protein_coding,-1,14128,chr15_3965445_3979573
Fbxo40,16,36963460,36990467,protein_coding,-1,27007,chr16_36963460_36990467
Fbxo41,6,85469574,85502994,protein_coding,-1,33420,chr6_85469574_85502994
Fbxo42,4,141147913,141204062,protein_coding,1,56149,chr4_141147913_141204062
Fbxo43,15,36150060,36164884,protein_coding,-1,14824,chr15_36150060_36164884
Fbxo44,4,148152800,148160482,protein_coding,-1,7682,chr4_148152800_148160482
Fbxo45,16,32230112,32247158,protein_coding,-1,17046,chr16_32230112_32247158
Fbxo46,7,19119859,19140172,protein_coding,1,20313,chr7_19119859_19140172
Fbxo47,11,97853826,97884154,protein_coding,-1,30328,chr11_97853826_97884154
Fbxo48,11,16951375,16954772,protein_coding,1,3397,chr11_16951375_16954772
Fbxo5,10,5799160,5805600,protein_coding,-1,6440,chr10_5799160_5805600
Fbxo6,4,148145716,148152140,protein_coding,-1,6424,chr4_148145716_148152140
Fbxo7,10,86021972,86051873,protein_coding,1,29901,chr10_86021972_86051873
Fbxo8,8,56551090,56593939,protein_coding,1,42849,chr8_56551090_56593939
Fbxo9,9,78081499,78109065,protein_coding,-1,27566,chr9_78081499_78109065
Fbxw10,11,62847069,62877465,protein_coding,1,30396,chr11_62847069_62877465
Fbxw11,11,32642724,32746816,protein_coding,1,104092,chr11_32642724_32746816
Fbxw15,9,109552602,109568262,protein_coding,-1,15660,chr9_109552602_109568262
Fbxw17,13,50417864,50433780,protein_coding,1,15916,chr13_50417864_50433780
Fbxw2,2,34804514,34826311,protein_coding,-1,21797,chr2_34804514_34826311
Fbxw22,9,109378400,109404296,protein_coding,-1,25896,chr9_109378400_109404296
Fbxw27,9,109766045,109790670,protein_coding,-1,24625,chr9_109766045_109790670
Fbxw4,19,45578254,45660312,protein_coding,-1,82058,chr19_45578254_45660312
Fbxw5,2,25500750,25505471,protein_coding,1,4721,chr2_25500750_25505471
Fbxw7,3,84815268,84979198,protein_coding,1,163930,chr3_84815268_84979198
Fbxw8,5,118064965,118155464,protein_coding,-1,90499,chr5_118064965_118155464
Fbxw9,8,85060055,85067124,protein_coding,1,7069,chr8_85060055_85067124
Fcamr,1,130800902,130814740,protein_coding,1,13838,chr1_130800902_130814740
Fcer1g,1,171229572,171234365,protein_coding,-1,4793,chr1_171229572_171234365
Fcer2a,8,3681737,3694175,protein_coding,-1,12438,chr8_3681737_3694175
Fcf1,12,84970897,84983303,protein_coding,1,12406,chr12_84970897_84983303
Fcgr1,3,96282909,96293969,protein_coding,-1,11060,chr3_96282909_96293969
Fcgr2b,1,170958617,170976547,protein_coding,-1,17930,chr1_170958617_170976547
Fcgr3,1,171051174,171064935,protein_coding,-1,13761,chr1_171051174_171064935
Fcgrt,7,45092990,45103851,protein_coding,-1,10861,chr7_45092990_45103851
Fcho1,8,71708387,71725716,protein_coding,-1,17329,chr8_71708387_71725716
Fcho2,13,98723403,98815449,protein_coding,-1,92046,chr13_98723403_98815449
Fchsd1,18,37957431,37969774,protein_coding,-1,12343,chr18_37957431_37969774
Fchsd2,7,101092863,101284405,protein_coding,1,191542,chr7_101092863_101284405
Fcna,2,25624666,25628030,protein_coding,-1,3364,chr2_25624666_25628030
Fcnb,2,28076378,28084885,protein_coding,-1,8507,chr2_28076378_28084885
Fcor,8,3671188,3672362,protein_coding,-1,1174,chr8_3671188_3672362
Fcrl1,3,87376387,87402934,protein_coding,1,26547,chr3_87376387_87402934
Fcrl5,3,87435773,87500678,protein_coding,1,64905,chr3_87435773_87500678
Fcrl6,1,172596642,172602551,protein_coding,-1,5909,chr1_172596642_172602551
Fcrlb,1,170907273,170912941,protein_coding,-1,5668,chr1_170907273_170912941
Fcrls,3,87250758,87263738,protein_coding,-1,12980,chr3_87250758_87263738
Fdft1,14,63145150,63179578,protein_coding,-1,34428,chr14_63145150_63179578
Fdps,3,89093588,89101959,protein_coding,-1,8371,chr3_89093588_89101959
Fdx1,9,51943306,51963556,protein_coding,-1,20250,chr9_51943306_51963556
Fdxacb1,9,50768236,50773348,protein_coding,1,5112,chr9_50768236_50773348
Fdxr,11,115268024,115277050,protein_coding,-1,9026,chr11_115268024_115277050
Fech,18,64452914,64490251,protein_coding,-1,37337,chr18_64452914_64490251
Fem1a,17,56256810,56263610,protein_coding,1,6800,chr17_56256810_56263610
Fem1b,9,62791821,62811934,protein_coding,-1,20113,chr9_62791821_62811934
Fem1c,18,46501746,46525971,protein_coding,-1,24225,chr18_46501746_46525971
Fen1,19,10199132,10204169,protein_coding,-1,5037,chr19_10199132_10204169
Fendrr,8,121054882,121083110,processed_transcript,-1,28228,chr8_121054882_121083110
Fer,17,63863062,64139496,protein_coding,1,276434,chr17_63863062_64139496
Fer1l4,2,156019139,156052947,protein_coding,-1,33808,chr2_156019139_156052947
Fer1l5,1,36372291,36422110,protein_coding,1,49819,chr1_36372291_36422110
Fer1l6,15,58510048,58673541,protein_coding,1,163493,chr15_58510048_58673541
Ferd3l,12,33928425,33929310,protein_coding,1,885,chr12_33928425_33929310
Fermt1,2,132904389,132945906,protein_coding,-1,41517,chr2_132904389_132945906
Fermt2,14,45458795,45530118,protein_coding,-1,71323,chr14_45458795_45530118
Fermt3,19,6998958,7019469,protein_coding,-1,20511,chr19_6998958_7019469
Fes,7,80377756,80387946,protein_coding,-1,10190,chr7_80377756_80387946
Fev,1,74881509,74885419,protein_coding,-1,3910,chr1_74881509_74885419
Fez1,9,36821864,36878924,protein_coding,1,57060,chr9_36821864_36878924
Fez2,17,78369212,78418152,protein_coding,-1,48940,chr17_78369212_78418152
Fezf1,6,23245044,23248362,protein_coding,-1,3318,chr6_23245044_23248362
Fezf2,14,12342094,12348189,protein_coding,-1,6095,chr14_12342094_12348189
Ffar4,19,38097071,38114263,protein_coding,1,17192,chr19_38097071_38114263
Fga,3,83026076,83033627,protein_coding,1,7551,chr3_83026076_83033627
Fgd1,X,151046150,151089521,protein_coding,1,43371,chrX_151046150_151089521
Fgd2,17,29360914,29379661,protein_coding,1,18747,chr17_29360914_29379661
Fgd3,13,49261554,49320311,protein_coding,-1,58757,chr13_49261554_49320311
Fgd4,16,16416917,16600549,protein_coding,-1,183632,chr16_16416917_16600549
Fgd5,6,91978878,92076004,protein_coding,1,97126,chr6_91978878_92076004
Fgd6,10,94036001,94145339,protein_coding,1,109338,chr10_94036001_94145339
Fgf1,18,38838673,38929472,protein_coding,-1,90799,chr18_38838673_38929472
Fgf10,13,118669791,118792115,protein_coding,1,122324,chr13_118669791_118792115
Fgf11,11,69796068,69801857,protein_coding,-1,5789,chr11_69796068_69801857
Fgf12,16,28160098,28753068,protein_coding,-1,592970,chr16_28160098_28753068
Fgf13,X,59062145,59568071,protein_coding,-1,505926,chrX_59062145_59568071
Fgf14,14,123977907,124677127,protein_coding,-1,699220,chr14_123977907_124677127
Fgf15,7,144896531,144900953,protein_coding,1,4422,chr7_144896531_144900953
Fgf16,X,105764279,105774939,protein_coding,1,10660,chrX_105764279_105774939
Fgf17,14,70636203,70642268,protein_coding,-1,6065,chr14_70636203_70642268
Fgf18,11,33117430,33147400,protein_coding,-1,29970,chr11_33117430_33147400
Fgf2,3,37348346,37410108,protein_coding,1,61762,chr3_37348346_37410108
Fgf21,7,45613886,45615490,protein_coding,-1,1604,chr7_45613886_45615490
Fgf22,10,79755076,79758596,protein_coding,1,3520,chr10_79755076_79758596
Fgf23,6,127072902,127081408,protein_coding,1,8506,chr6_127072902_127081408
Fgf2os,3,37335332,37349740,antisense,-1,14408,chr3_37335332_37349740
Fgf3,7,144838083,144844436,protein_coding,1,6353,chr7_144838083_144844436
Fgf5,5,98254184,98277030,protein_coding,1,22846,chr5_98254184_98277030
Fgf6,6,127015586,127028187,protein_coding,1,12601,chr6_127015586_127028187
Fgf7,2,126034658,126091185,protein_coding,1,56527,chr2_126034658_126091185
Fgf8,19,45736798,45742915,protein_coding,-1,6117,chr19_45736798_45742915
Fgf9,14,58070547,58112720,protein_coding,1,42173,chr14_58070547_58112720
Fgfbp3,19,36917550,36919615,protein_coding,-1,2065,chr19_36917550_36919615
Fgfr1,8,25513654,25575718,protein_coding,1,62064,chr8_25513654_25575718
Fgfr1op,17,8165501,8196804,protein_coding,1,31303,chr17_8165501_8196804
Fgfr1op2,6,146577203,146599198,protein_coding,1,21995,chr6_146577203_146599198
Fgfr2,7,130162451,133123350,protein_coding,-1,2960899,chr7_130162451_133123350
Fgfr3,5,33721674,33737068,protein_coding,1,15394,chr5_33721674_33737068
Fgfr4,13,55152640,55168759,protein_coding,1,16119,chr13_55152640_55168759
Fgfrl1,5,108692382,108706924,protein_coding,1,14542,chr5_108692382_108706924
Fggy,4,95557507,95926939,protein_coding,1,369432,chr4_95557507_95926939
Fgl1,8,41191434,41215156,protein_coding,-1,23722,chr8_41191434_41215156
Fgl2,5,21372642,21378374,protein_coding,1,5732,chr5_21372642_21378374
Fgr,4,132974095,133001910,protein_coding,1,27815,chr4_132974095_133001910
Fh1,1,175600374,175625635,protein_coding,-1,25261,chr1_175600374_175625635
Fhad1,4,141890438,142015082,protein_coding,-1,124644,chr4_141890438_142015082
Fhad1os2,4,141885654,141897282,antisense,1,11628,chr4_141885654_141897282
Fhdc1,3,84442198,84480429,protein_coding,-1,38231,chr3_84442198_84480429
Fhit,14,9550092,11162035,protein_coding,-1,1611943,chr14_9550092_11162035
Fhl1,X,56731787,56793346,protein_coding,1,61559,chrX_56731787_56793346
Fhl2,1,43123074,43196984,protein_coding,-1,73910,chr1_43123074_43196984
Fhl3,4,124700701,124708611,protein_coding,1,7910,chr4_124700701_124708611
Fhl4,10,85096287,85102495,protein_coding,-1,6208,chr10_85096287_85102495
Fhod1,8,105329163,105347953,protein_coding,-1,18790,chr8_105329163_105347953
Fhod3,18,24708623,25133501,protein_coding,1,424878,chr18_24708623_25133501
Fibcd1,2,31813290,31846005,protein_coding,-1,32715,chr2_31813290_31846005
Fibin,2,110360917,110363183,protein_coding,-1,2266,chr2_110360917_110363183
Fibp,19,5460615,5465051,protein_coding,1,4436,chr19_5460615_5465051
Ficd,5,113735803,113740600,protein_coding,1,4797,chr5_113735803_113740600
Fig4,10,41188172,41303260,protein_coding,-1,115088,chr10_41188172_41303260
Figla,6,86016171,86020996,protein_coding,1,4825,chr6_86016171_86020996
Fign,2,63971507,64098038,protein_coding,-1,126531,chr2_63971507_64098038
Fignl1,11,11787431,11808962,protein_coding,-1,21531,chr11_11787431_11808962
Fignl2,15,101050194,101078567,protein_coding,-1,28373,chr15_101050194_101078567
Filip1,9,79805094,80012851,protein_coding,-1,207757,chr9_79805094_80012851
Filip1l,16,57353093,57573126,protein_coding,1,220033,chr16_57353093_57573126
Fip1l1,5,74535449,74598800,protein_coding,1,63351,chr5_74535449_74598800
Firre,X,50555744,50635321,processed_transcript,-1,79577,chrX_50555744_50635321
Fis1,5,136953275,136966234,protein_coding,1,12959,chr5_136953275_136966234
Fitm1,14,55575617,55576954,protein_coding,1,1337,chr14_55575617_55576954
Fitm2,2,163466379,163472629,protein_coding,-1,6250,chr2_163466379_163472629
Fiz1,7,5007059,5014697,protein_coding,-1,7638,chr7_5007059_5014697
Fjx1,2,102449366,102452499,protein_coding,-1,3133,chr2_102449366_102452499
Fkbp10,11,100415697,100424824,protein_coding,1,9127,chr11_100415697_100424824
Fkbp11,15,98724366,98728198,protein_coding,-1,3832,chr15_98724366_98728198
Fkbp14,6,54577604,54597308,protein_coding,-1,19704,chr6_54577604_54597308
Fkbp15,4,62300342,62360548,protein_coding,-1,60206,chr4_62300342_62360548
Fkbp1a,2,151542483,151561692,protein_coding,1,19209,chr2_151542483_151561692
Fkbp1a-ps1,14,76636537,76636864,processed_pseudogene,-1,327,chr14_76636537_76636864
Fkbp1a-ps2,10,21410263,21410573,processed_pseudogene,-1,310,chr10_21410263_21410573
Fkbp1a-ps3,16,80949649,80949966,processed_pseudogene,1,317,chr16_80949649_80949966
Fkbp1b,12,4833174,4841591,protein_coding,-1,8417,chr12_4833174_4841591
Fkbp2,19,6977741,6980501,protein_coding,-1,2760,chr19_6977741_6980501
Fkbp3,12,65062424,65074007,protein_coding,-1,11583,chr12_65062424_65074007
Fkbp4,6,128429735,128438677,protein_coding,-1,8942,chr6_128429735_128438677
Fkbp5,17,28399094,28517527,protein_coding,-1,118433,chr17_28399094_28517527
Fkbp6,5,135291704,135350044,protein_coding,-1,58340,chr5_135291704_135350044
Fkbp7,2,76663044,76673116,protein_coding,-1,10072,chr2_76663044_76673116
Fkbp8,8,70527724,70535328,protein_coding,1,7604,chr8_70527724_70535328
Fkbp9,6,56832059,56879358,protein_coding,1,47299,chr6_56832059_56879358
Fkbpl,17,34644764,34646324,protein_coding,1,1560,chr17_34644764_34646324
Fkrp,7,16809246,16816732,protein_coding,-1,7486,chr7_16809246_16816732
Fktn,4,53713998,53777890,protein_coding,1,63892,chr4_53713998_53777890
Flad1,3,89401004,89411870,protein_coding,-1,10866,chr3_89401004_89411870
Flcn,11,59791408,59810016,protein_coding,-1,18608,chr11_59791408_59810016
Flg,3,93273523,93293686,protein_coding,1,20163,chr3_93273523_93293686
Flg2,3,93197278,93221391,protein_coding,1,24113,chr3_93197278_93221391
Fli1,9,32422204,32542861,protein_coding,-1,120657,chr9_32422204_32542861
Flii,11,60714123,60727263,protein_coding,-1,13140,chr11_60714123_60727263
Flna,X,74223461,74249820,protein_coding,-1,26359,chrX_74223461_74249820
Flnb,14,7817957,7951588,protein_coding,1,133631,chr14_7817957_7951588
Flnc,6,29433256,29461883,protein_coding,1,28627,chr6_29433256_29461883
Flot1,17,35823230,35832791,protein_coding,1,9561,chr17_35823230_35832791
Flot2,11,78037931,78060434,protein_coding,1,22503,chr11_78037931_78060434
Flrt1,19,7092001,7105729,protein_coding,-1,13728,chr19_7092001_7105729
Flrt2,12,95692226,95785215,protein_coding,1,92989,chr12_95692226_95785215
Flrt3,2,140650914,140671469,protein_coding,-1,20555,chr2_140650914_140671469
Flt1,5,147561604,147726011,protein_coding,-1,164407,chr5_147561604_147726011
Flt3,5,147330741,147400489,protein_coding,-1,69748,chr5_147330741_147400489
Flt3l,7,45129788,45136432,protein_coding,-1,6644,chr7_45129788_45136432
Flt4,11,49609263,49652739,protein_coding,1,43476,chr11_49609263_49652739
Flywch1,17,23752793,23771602,protein_coding,-1,18809,chr17_23752793_23771602
Flywch2,17,23776916,23786081,protein_coding,-1,9165,chr17_23776916_23786081
Fmn1,2,113327736,113716767,protein_coding,1,389031,chr2_113327736_113716767
Fmn2,1,174501825,174822729,protein_coding,1,320904,chr1_174501825_174822729
Fmnl1,11,103171107,103198901,protein_coding,1,27794,chr11_103171107_103198901
Fmnl2,2,52857860,53133804,protein_coding,1,275944,chr2_52857860_53133804
Fmnl3,15,99317225,99370482,protein_coding,-1,53257,chr15_99317225_99370482
Fmo1,1,162829561,162866610,protein_coding,-1,37049,chr1_162829561_162866610
Fmo2,1,162874317,162898726,protein_coding,-1,24409,chr1_162874317_162898726
Fmo3,1,162953800,162984528,protein_coding,-1,30728,chr1_162953800_162984528
Fmo4,1,162793188,162813972,protein_coding,-1,20784,chr1_162793188_162813972
Fmo5,3,97628804,97655282,protein_coding,1,26478,chr3_97628804_97655282
Fmo6,1,162916551,162937515,protein_coding,-1,20964,chr1_162916551_162937515
Fmod,1,134037254,134048277,protein_coding,1,11023,chr1_134037254_134048277
Fmr1,X,68678541,68717963,protein_coding,1,39422,chrX_68678541_68717963
Fmr1nb,X,68761839,68804567,protein_coding,1,42728,chrX_68761839_68804567
Fn1,1,71585520,71653200,protein_coding,-1,67680,chr1_71585520_71653200
Fn3k,11,121434913,121450491,protein_coding,1,15578,chr11_121434913_121450491
Fn3krp,11,121421401,121431288,protein_coding,1,9887,chr11_121421401_121431288
Fnbp1,2,31026206,31142008,protein_coding,-1,115802,chr2_31026206_31142008
Fnbp1l,3,122538719,122619715,protein_coding,-1,80996,chr3_122538719_122619715
Fnbp4,2,90745370,90781021,protein_coding,1,35651,chr2_90745370_90781021
Fndc1,17,7738569,7827302,protein_coding,-1,88733,chr17_7738569_7827302
Fndc3a,14,72537946,72710003,protein_coding,-1,172057,chr14_72537946_72710003
Fndc3b,3,27416162,27711307,protein_coding,-1,295145,chr3_27416162_27711307
Fndc4,5,31292242,31296080,protein_coding,-1,3838,chr5_31292242_31296080
Fndc5,4,129136999,129144593,protein_coding,1,7594,chr4_129136999_129144593
Fndc7,3,108853678,108890008,protein_coding,-1,36330,chr3_108853678_108890008
Fndc8,11,82892124,82900801,protein_coding,1,8677,chr11_82892124_82900801
Fndc9,11,46235531,46239872,protein_coding,1,4341,chr11_46235531_46239872
Fnip1,11,54438199,54518235,protein_coding,1,80036,chr11_54438199_54518235
Fnip2,3,79455974,79567796,protein_coding,-1,111822,chr3_79455974_79567796
Fnta,8,25998722,26015650,protein_coding,-1,16928,chr8_25998722_26015650
Fntb,12,76765589,76921412,protein_coding,1,155823,chr12_76765589_76921412
Focad,4,88094629,88411011,protein_coding,1,316382,chr4_88094629_88411011
Folh1,7,86718977,86775943,protein_coding,-1,56966,chr7_86718977_86775943
Folr1,7,101858331,101870788,protein_coding,-1,12457,chr7_101858331_101870788
Folr2,7,101839988,101857194,protein_coding,-1,17206,chr7_101839988_101857194
Fopnl,16,14299244,14317405,protein_coding,-1,18161,chr16_14299244_14317405
Fos,12,85473890,85477273,protein_coding,1,3383,chr12_85473890_85477273
Fosb,7,19302696,19310051,protein_coding,-1,7355,chr7_19302696_19310051
Fosl1,19,5447547,5455946,protein_coding,1,8399,chr19_5447547_5455946
Fosl2,5,32135801,32157842,protein_coding,1,22041,chr5_32135801_32157842
Foxa1,12,57540628,57546916,protein_coding,-1,6288,chr12_57540628_57546916
Foxa3,7,19013284,19023538,protein_coding,-1,10254,chr7_19013284_19023538
Foxc1,13,31806633,31812476,protein_coding,1,5843,chr13_31806633_31812476
Foxc2,8,121116171,121118895,protein_coding,1,2724,chr8_121116171_121118895
Foxd1,13,98354242,98359305,protein_coding,1,5063,chr13_98354242_98359305
Foxd2,4,114906282,114908873,protein_coding,-1,2591,chr4_114906282_114908873
Foxd4,19,24899236,24901197,protein_coding,-1,1961,chr19_24899236_24901197
Foxf1,8,121084386,121088144,protein_coding,1,3758,chr8_121084386_121088144
Foxf2,13,31625816,31631403,protein_coding,1,5587,chr13_31625816_31631403
Foxg1,12,49382660,49386861,protein_coding,1,4201,chr12_49382660_49386861
Foxh1,15,76668225,76669948,protein_coding,-1,1723,chr15_76668225_76669948
Foxj1,11,116330704,116335399,protein_coding,-1,4695,chr11_116330704_116335399
Foxj2,6,122819914,122845366,protein_coding,1,25452,chr6_122819914_122845366
Foxj3,4,119537004,119629119,protein_coding,1,92115,chr4_119537004_119629119
Foxk1,5,142401497,142462011,protein_coding,1,60514,chr5_142401497_142462011
Foxk2,11,121259990,121309896,protein_coding,1,49906,chr11_121259990_121309896
Foxl1,8,121127940,121130644,protein_coding,1,2704,chr8_121127940_121130644
Foxl2,9,98955288,98958543,protein_coding,1,3255,chr9_98955288_98958543
Foxl2os,9,98949781,98955299,processed_transcript,-1,5518,chr9_98949781_98955299
Foxm1,6,128362967,128376146,protein_coding,1,13179,chr6_128362967_128376146
Foxn1,11,78357577,78386558,protein_coding,-1,28981,chr11_78357577_78386558
Foxn2,17,88440711,88490533,protein_coding,1,49822,chr17_88440711_88490533
Foxn3,12,99190078,99563582,protein_coding,-1,373504,chr12_99190078_99563582
Foxn4,5,114254164,114273807,protein_coding,-1,19643,chr5_114254164_114273807
Foxo1,3,52268336,52353221,protein_coding,1,84885,chr3_52268336_52353221
Foxo3,10,42181841,42276755,protein_coding,-1,94914,chr10_42181841_42276755
Foxo4,X,101254528,101260873,protein_coding,1,6345,chrX_101254528_101260873
Foxo6,4,120267079,120287349,protein_coding,-1,20270,chr4_120267079_120287349
Foxo6os,4,120291350,120303892,antisense,1,12542,chr4_120291350_120303892
Foxp1,6,98925338,99522721,protein_coding,-1,597383,chr6_98925338_99522721
Foxp2,6,14901349,15441977,protein_coding,1,540628,chr6_14901349_15441977
Foxp3,X,7573644,7595245,protein_coding,1,21601,chrX_7573644_7595245
Foxp4,17,47867133,47924645,protein_coding,-1,57512,chr17_47867133_47924645
Foxq1,13,31556134,31560976,protein_coding,1,4842,chr13_31556134_31560976
Foxr1,9,44433773,44441136,protein_coding,-1,7363,chr9_44433773_44441136
Foxr2,X,153118786,153132861,protein_coding,1,14075,chrX_153118786_153132861
Foxred1,9,35204206,35211055,protein_coding,-1,6849,chr9_35204206_35211055
Foxred2,15,77940522,77956722,protein_coding,-1,16200,chr15_77940522_77956722
Foxs1,2,152931898,152933208,protein_coding,-1,1310,chr2_152931898_152933208
Fpgs,2,32682609,32704145,protein_coding,-1,21536,chr2_32682609_32704145
Fpgt,3,155084918,155093403,protein_coding,-1,8485,chr3_155084918_155093403
Fpr1,17,17876471,17883940,protein_coding,-1,7469,chr17_17876471_17883940
Fpr2,17,17887824,17893952,protein_coding,1,6128,chr17_17887824_17893952
Fra10ac1,19,38188481,38224156,protein_coding,-1,35675,chr19_38188481_38224156
Fras1,5,96373955,96784728,protein_coding,1,410773,chr5_96373955_96784728
Frat1,19,41829970,41832583,protein_coding,1,2613,chr19_41829970_41832583
Frat2,19,41845972,41848132,protein_coding,-1,2160,chr19_41845972_41848132
Frem1,4,82897920,83052339,protein_coding,-1,154419,chr4_82897920_83052339
Frem2,3,53513938,53657355,protein_coding,-1,143417,chr3_53513938_53657355
Frem3,8,80611080,80695356,protein_coding,1,84276,chr8_80611080_80695356
Frg1,8,41397459,41417074,protein_coding,-1,19615,chr8_41397459_41417074
Frk,10,34483399,34611278,protein_coding,1,127879,chr10_34483399_34611278
Frmd3,4,74013442,74202214,protein_coding,1,188772,chr4_74013442_74202214
Frmd4a,2,4017717,4614043,protein_coding,1,596326,chr2_4017717_4614043
Frmd4b,6,97286867,97617541,protein_coding,-1,330674,chr6_97286867_97617541
Frmd5,2,121545529,121807087,protein_coding,-1,261558,chr2_121545529_121807087
Frmd6,12,70825514,70902234,protein_coding,1,76720,chr12_70825514_70902234
Frmd7,X,50895180,50942710,protein_coding,-1,47530,chrX_50895180_50942710
Frmd8,19,5849702,5875274,protein_coding,-1,25572,chr19_5849702_5875274
Frmd8os,19,5845623,5851388,antisense,1,5765,chr19_5845623_5851388
Frmpd1,4,45184875,45285936,protein_coding,1,101061,chr4_45184875_45285936
Frmpd1os,4,45234723,45243990,antisense,-1,9267,chr4_45234723_45243990
Frmpd3,X,140342263,140435467,protein_coding,1,93204,chrX_140342263_140435467
Frmpd4,X,167471309,168577231,protein_coding,-1,1105922,chrX_167471309_168577231
Frrs1,3,116859464,116908177,protein_coding,1,48713,chr3_116859464_116908177
Frrs1l,4,56957173,56990391,protein_coding,-1,33218,chr4_56957173_56990391
Frs2,10,117069427,117148534,protein_coding,-1,79107,chr10_117069427_117148534
Frs3,17,47689030,47704286,protein_coding,1,15256,chr17_47689030_47704286
Frs3os,17,47699971,47701996,antisense,-1,2025,chr17_47699971_47701996
Fry,5,150118645,150497753,protein_coding,1,379108,chr5_150118645_150497753
Fryl,5,73019987,73256619,protein_coding,-1,236632,chr5_73019987_73256619
Frzb,2,80411970,80447625,protein_coding,-1,35655,chr2_80411970_80447625
Fsbp,4,11579665,11587591,protein_coding,1,7926,chr4_11579665_11587591
Fscn1,5,142960343,142973185,protein_coding,1,12842,chr5_142960343_142973185
Fscn2,11,120361534,120368168,protein_coding,1,6634,chr11_120361534_120368168
Fscn3,6,28427789,28438622,protein_coding,1,10833,chr6_28427789_28438622
Fsd1,17,55986509,55996881,protein_coding,1,10372,chr17_55986509_55996881
Fsd1l,4,53631471,53707009,protein_coding,1,75538,chr4_53631471_53707009
Fsd2,7,81533308,81566944,protein_coding,-1,33636,chr7_81533308_81566944
Fsip1,2,118130424,118256966,protein_coding,-1,126542,chr2_118130424_118256966
Fsip2,2,82943634,83008937,protein_coding,1,65303,chr2_82943634_83008937
Fst,13,114452290,114458951,protein_coding,-1,6661,chr13_114452290_114458951
Fstl1,16,37776873,37836514,protein_coding,1,59641,chr16_37776873_37836514
Fstl3,10,79777272,79782630,protein_coding,1,5358,chr10_79777272_79782630
Fstl4,11,52764634,53188538,protein_coding,1,423904,chr11_52764634_53188538
Fstl5,3,76074270,76710019,protein_coding,1,635749,chr3_76074270_76710019
Ftcd,10,76575648,76590338,protein_coding,1,14690,chr10_76575648_76590338
Fth-ps2,6,39653450,39653965,processed_pseudogene,-1,515,chr6_39653450_39653965
Fth-ps3,8,86915157,86915514,processed_pseudogene,1,357,chr8_86915157_86915514
Fth1,19,9980598,9985098,protein_coding,1,4500,chr19_9980598_9985098
Ftl1,7,45457944,45459884,protein_coding,-1,1940,chr7_45457944_45459884
Fto,8,91313525,91668439,protein_coding,1,354914,chr8_91313525_91668439
Ftsj1,X,8238668,8252406,protein_coding,-1,13738,chrX_8238668_8252406
Ftsj3,11,106249142,106256079,protein_coding,-1,6937,chr11_106249142_106256079
Ftx,X,103560907,103623790,lincRNA,-1,62883,chrX_103560907_103623790
Fubp1,3,152210422,152236826,protein_coding,1,26404,chr3_152210422_152236826
Fubp3,2,31572651,31617526,protein_coding,1,44875,chr2_31572651_31617526
Fuca1,4,135920735,135940311,protein_coding,1,19576,chr4_135920735_135940311
Fuca2,10,13499540,13519035,protein_coding,1,19495,chr10_13499540_13519035
Fundc1,X,17556564,17572325,protein_coding,-1,15761,chrX_17556564_17572325
Fundc2,X,75382399,75396459,protein_coding,1,14060,chrX_75382399_75396459
Fuom,7,140096770,140102441,protein_coding,-1,5671,chr7_140096770_140102441
Furin,7,80388585,80405436,protein_coding,-1,16851,chr7_80388585_80405436
Fus,7,127967457,127985701,protein_coding,1,18244,chr7_127967457_127985701
Fut1,7,45617289,45621059,protein_coding,1,3770,chr7_45617289_45621059
Fut10,8,31187331,31261738,protein_coding,1,74407,chr8_31187331_31261738
Fut11,14,20694968,20701016,protein_coding,1,6048,chr14_20694968_20701016
Fut2,7,45648591,45666394,protein_coding,-1,17803,chr7_45648591_45666394
Fut4,9,14748320,14752393,protein_coding,-1,4073,chr9_14748320_14752393
Fut7,2,25423267,25426374,protein_coding,1,3107,chr2_25423267_25426374
Fut8,12,77238125,77476338,protein_coding,1,238213,chr12_77238125_77476338
Fut9,4,25609332,25800244,protein_coding,-1,190912,chr4_25609332_25800244
Fuz,7,44896079,44902631,protein_coding,1,6552,chr7_44896079_44902631
Fv1,4,147868979,147870358,protein_coding,1,1379,chr4_147868979_147870358
Fxn,19,24261453,24280605,protein_coding,-1,19152,chr19_24261453_24280605
Fxr1,3,34019943,34070322,protein_coding,1,50379,chr3_34019943_34070322
Fxr2,11,69632990,69653297,protein_coding,1,20307,chr11_69632990_69653297
Fxyd1,7,31051678,31057199,protein_coding,-1,5521,chr7_31051678_31057199
Fxyd2,9,45399669,45410278,protein_coding,1,10609,chr9_45399669_45410278
Fxyd4,6,117933559,117937692,protein_coding,-1,4133,chr6_117933559_117937692
Fxyd5,7,31032722,31042481,protein_coding,-1,9759,chr7_31032722_31042481
Fxyd6,9,45370185,45396159,protein_coding,1,25974,chr9_45370185_45396159
Fxyd7,7,31042513,31051467,protein_coding,-1,8954,chr7_31042513_31051467
Fyb,15,6522853,6663313,protein_coding,1,140460,chr15_6522853_6663313
Fyco1,9,123789500,123851899,protein_coding,-1,62399,chr9_123789500_123851899
Fyn,10,39368855,39565381,protein_coding,1,196526,chr10_39368855_39565381
Fyttd1,16,32877500,32908875,protein_coding,1,31375,chr16_32877500_32908875
Fzd1,5,4753839,4758035,protein_coding,-1,4196,chr5_4753839_4758035
Fzd10,5,128600844,128604093,protein_coding,1,3249,chr5_128600844_128604093
Fzd2,11,102604396,102608058,protein_coding,1,3662,chr11_102604396_102608058
Fzd3,14,65192449,65262463,protein_coding,-1,70014,chr14_65192449_65262463
Fzd4,7,89404355,89413134,protein_coding,1,8779,chr7_89404355_89413134
Fzd5,1,64730558,64737751,protein_coding,-1,7193,chr1_64730558_64737751
Fzd6,15,38869185,39038188,protein_coding,1,169003,chr15_38869185_39038188
Fzd7,1,59482424,59486955,protein_coding,1,4531,chr1_59482424_59486955
Fzd8,18,9212163,9218136,protein_coding,1,5973,chr18_9212163_9218136
Fzd9,5,135248938,135251230,protein_coding,-1,2292,chr5_135248938_135251230
Fzr1,10,81366222,81378516,protein_coding,-1,12294,chr10_81366222_81378516
G0s2,1,193272161,193273217,protein_coding,-1,1056,chr1_193272161_193273217
G2e3,12,51348061,51376986,protein_coding,1,28925,chr12_51348061_51376986
G3bp1,11,55469685,55504838,protein_coding,1,35153,chr11_55469685_55504838
G3bp2,5,92052146,92083719,protein_coding,-1,31573,chr5_92052146_92083719
G430095P16Rik,8,84723007,84726844,protein_coding,1,3837,chr8_84723007_84726844
G530011O06Rik,X,169975043,169978917,processed_transcript,-1,3874,chrX_169975043_169978917
G630016G05Rik,2,116067225,116085911,lincRNA,1,18686,chr2_116067225_116085911
G630018N14Rik,13,31349901,31408922,lincRNA,-1,59021,chr13_31349901_31408922
G630064G18Rik,8,36985573,37024238,antisense,-1,38665,chr8_36985573_37024238
G6pc,11,101367561,101377903,protein_coding,1,10342,chr11_101367561_101377903
G6pc2,2,69211073,69227841,protein_coding,1,16768,chr2_69211073_69227841
G6pc3,11,102189620,102194081,protein_coding,1,4461,chr11_102189620_102194081
G6pd2,5,61808816,61811163,protein_coding,1,2347,chr5_61808816_61811163
G6pdx,X,74409483,74429194,protein_coding,-1,19711,chrX_74409483_74429194
G730013B05Rik,16,50526245,50559459,lincRNA,1,33214,chr16_50526245_50559459
G930009F23Rik,15,38436225,38455134,lincRNA,-1,18909,chr15_38436225_38455134
Gaa,11,119267887,119285454,protein_coding,1,17567,chr11_119267887_119285454
Gab1,8,80764438,80880519,protein_coding,-1,116081,chr8_80764438_80880519
Gab2,7,97081586,97308946,protein_coding,1,227360,chr7_97081586_97308946
Gab3,X,74966843,75085458,protein_coding,-1,118615,chrX_74966843_75085458
Gabarap,11,69991143,69994951,protein_coding,1,3808,chr11_69991143_69994951
Gabarapl1,6,129533160,129542346,protein_coding,1,9186,chr6_129533160_129542346
Gabarapl2,8,111940703,111953612,protein_coding,1,12909,chr8_111940703_111953612
Gabbr1,17,37045966,37075067,protein_coding,1,29101,chr17_37045966_37075067
Gabbr2,4,46662305,46991873,protein_coding,-1,329568,chr4_46662305_46991873
Gabpa,16,84834925,84863779,protein_coding,1,28854,chr16_84834925_84863779
Gabpb1,2,126627442,126676337,protein_coding,-1,48895,chr2_126627442_126676337
Gabpb2,3,95181766,95217916,protein_coding,-1,36150,chr3_95181766_95217916
Gabra1,11,42130939,42182930,protein_coding,-1,51991,chr11_42130939_42182930
Gabra2,5,70957597,71095849,protein_coding,-1,138252,chr5_70957597_71095849
Gabra3,X,72432681,72656848,protein_coding,-1,224167,chrX_72432681_72656848
Gabra4,5,71569749,71658308,protein_coding,-1,88559,chr5_71569749_71658308
Gabra5,7,57407672,57510059,protein_coding,-1,102387,chr7_57407672_57510059
Gabrb1,5,71658113,72149037,protein_coding,1,490924,chr5_71658113_72149037
Gabrb2,11,42419757,42629028,protein_coding,1,209271,chr11_42419757_42629028
Gabrb3,7,57419692,57828802,protein_coding,1,409110,chr7_57419692_57828802
Gabrd,4,155384980,155398112,protein_coding,-1,13132,chr4_155384980_155398112
Gabrg1,5,70751047,70842617,protein_coding,-1,91570,chr5_70751047_70842617
Gabrg2,11,41910203,42000857,protein_coding,-1,90654,chr11_41910203_42000857
Gabrg3,7,56716465,57387188,protein_coding,-1,670723,chr7_56716465_57387188
Gabrq,X,72825178,72842602,protein_coding,1,17424,chrX_72825178_72842602
Gabrr1,4,33132521,33163588,protein_coding,1,31067,chr4_33132521_33163588
Gabrr2,4,33062999,33095865,protein_coding,1,32866,chr4_33062999_33095865
Gabrr3,16,59407332,59464504,protein_coding,1,57172,chr16_59407332_59464504
Gad1,2,70553072,70602014,protein_coding,1,48942,chr2_70553072_70602014
Gad1-ps,10,99444044,99445819,processed_pseudogene,1,1775,chr10_99444044_99445819
Gad1os,2,70489940,70563357,antisense,-1,73417,chr2_70489940_70563357
Gad2,2,22622205,22693874,protein_coding,1,71669,chr2_22622205_22693874
Gadd45a,6,67035096,67037457,protein_coding,-1,2361,chr6_67035096_67037457
Gadd45b,10,80930073,80932204,protein_coding,1,2131,chr10_80930073_80932204
Gadd45g,13,51846678,51848468,protein_coding,1,1790,chr13_51846678_51848468
Gadd45gip1,8,84831522,84835482,protein_coding,1,3960,chr8_84831522_84835482
Gadl1,9,115909455,116076176,protein_coding,1,166721,chr9_115909455_116076176
Gak,5,108569411,108629755,protein_coding,-1,60344,chr5_108569411_108629755
Gal,19,3409915,3414544,protein_coding,-1,4629,chr19_3409915_3414544
Gal3st1,11,3983636,3999326,protein_coding,1,15690,chr11_3983636_3999326
Gal3st2,1,93861306,93876494,protein_coding,1,15188,chr1_93861306_93876494
Gal3st3,19,5298331,5308738,protein_coding,1,10407,chr19_5298331_5308738
Gal3st4,5,138264921,138272840,protein_coding,-1,7919,chr5_138264921_138272840
Galc,12,98202294,98259459,protein_coding,-1,57165,chr12_98202294_98259459
Gale,4,135963727,135968178,protein_coding,1,4451,chr4_135963727_135968178
Galk1,11,116008457,116012719,protein_coding,-1,4262,chr11_116008457_116012719
Galk2,2,125859109,125984299,protein_coding,1,125190,chr2_125859109_125984299
Galm,17,80127471,80185101,protein_coding,1,57630,chr17_80127471_80185101
Galns,8,122578242,122611463,protein_coding,-1,33221,chr8_122578242_122611463
Galnt1,18,24205344,24286818,protein_coding,1,81474,chr18_24205344_24286818
Galnt10,11,57645442,57787514,protein_coding,1,142072,chr11_57645442_57787514
Galnt11,5,25221904,25265918,protein_coding,1,44014,chr5_25221904_25265918
Galnt12,4,47091909,47123070,protein_coding,1,31161,chr4_47091909_47123070
Galnt13,2,54436317,55118309,protein_coding,1,681992,chr2_54436317_55118309
Galnt14,17,73493228,73710453,protein_coding,-1,217225,chr17_73493228_73710453
Galnt15,14,32028989,32062197,protein_coding,1,33208,chr14_32028989_32062197
Galnt16,12,80518277,80630972,protein_coding,1,112695,chr12_80518277_80630972
Galnt18,7,111471661,111779977,protein_coding,-1,308316,chr7_111471661_111779977
Galnt2,8,124231391,124345724,protein_coding,1,114333,chr8_124231391_124345724
Galnt3,2,66082766,66124994,protein_coding,-1,42228,chr2_66082766_66124994
Galnt4,10,99108159,99113247,protein_coding,1,5088,chr10_99108159_99113247
Galnt5,2,57997884,58045860,protein_coding,1,47976,chr2_57997884_58045860
Galnt6,15,100691813,100729376,protein_coding,-1,37563,chr15_100691813_100729376
Galnt7,8,57523828,57653032,protein_coding,-1,129204,chr8_57523828_57653032
Galnt9,5,110544355,110621380,protein_coding,1,77025,chr5_110544355_110621380
Galntl6,8,57774052,58912640,protein_coding,-1,1138588,chr8_57774052_58912640
Galr1,18,82392380,82406777,protein_coding,-1,14397,chr18_82392380_82406777
Galr2,11,116280939,116283938,protein_coding,1,2999,chr11_116280939_116283938
Galr3,15,79041885,79043558,protein_coding,1,1673,chr15_79041885_79043558
Galt,4,41755228,41758695,protein_coding,1,3467,chr4_41755228_41758695
Gamt,10,80258151,80261012,protein_coding,-1,2861,chr10_80258151_80261012
Gan,8,117158135,117215997,protein_coding,1,57862,chr8_117158135_117215997
Ganab,19,8898071,8916672,protein_coding,1,18601,chr19_8898071_8916672
Ganc,2,120403896,120461700,protein_coding,1,57804,chr2_120403896_120461700
Gap43,16,42248442,42340651,protein_coding,-1,92209,chr16_42248442_42340651
Gapdh,6,125161715,125166467,protein_coding,-1,4752,chr6_125161715_125166467
Gapdhs,7,30729775,30743681,protein_coding,-1,13906,chr7_30729775_30743681
Gapt,13,110352616,110357199,protein_coding,-1,4583,chr13_110352616_110357199
Gapvd1,2,34674594,34755232,protein_coding,-1,80638,chr2_34674594_34755232
Gar1,3,129824912,129831396,protein_coding,-1,6484,chr3_129824912_129831396
Garnl3,2,32986224,33131654,protein_coding,-1,145430,chr2_32986224_33131654
Gars,6,55038007,55079500,protein_coding,1,41493,chr6_55038007_55079500
Gart,16,91621186,91646952,protein_coding,-1,25766,chr16_91621186_91646952
Gas1,13,60174405,60177365,protein_coding,-1,2960,chr13_60174405_60177365
Gas2,7,51862015,51994975,protein_coding,1,132960,chr7_51862015_51994975
Gas2l1,11,5054132,5065327,protein_coding,-1,11195,chr11_5054132_5065327
Gas2l2,11,83421902,83429455,protein_coding,-1,7553,chr11_83421902_83429455
Gas2l3,10,89408823,89443967,protein_coding,-1,35144,chr10_89408823_89443967
Gas5,1,161034422,161038539,processed_transcript,1,4117,chr1_161034422_161038539
Gas6,8,13465374,13494490,protein_coding,-1,29116,chr8_13465374_13494490
Gas7,11,67455091,67688990,protein_coding,1,233899,chr11_67455091_67688990
Gas8,8,123518834,123536650,protein_coding,1,17816,chr8_123518834_123536650
Gast,11,100334407,100336996,protein_coding,1,2589,chr11_100334407_100336996
Gata1,X,7959260,7978071,protein_coding,-1,18811,chrX_7959260_7978071
Gata2,6,88193891,88207032,protein_coding,1,13141,chr6_88193891_88207032
Gata3,2,9857078,9890034,protein_coding,-1,32956,chr2_9857078_9890034
Gata5,2,180325133,180334699,protein_coding,-1,9566,chr2_180325133_180334699
Gata6,18,11052064,11085635,protein_coding,1,33571,chr18_11052064_11085635
Gatad1,5,3632932,3657185,protein_coding,-1,24253,chr5_3632932_3657185
Gatad2a,8,69907076,69996384,protein_coding,-1,89308,chr8_69907076_69996384
Gatad2b,3,90293178,90363407,protein_coding,1,70229,chr3_90293178_90363407
Gatb,3,85574119,85655622,protein_coding,1,81503,chr3_85574119_85655622
Gatc,5,115333239,115341178,protein_coding,-1,7939,chr5_115333239_115341178
Gatm,2,122594467,122611303,protein_coding,-1,16836,chr2_122594467_122611303
Gba,3,89202928,89208966,protein_coding,1,6038,chr3_89202928_89208966
Gba2,4,43566928,43578873,protein_coding,-1,11945,chr4_43566928_43578873
Gbe1,16,70313949,70569716,protein_coding,1,255767,chr16_70313949_70569716
Gbf1,19,46152509,46286510,protein_coding,1,134001,chr19_46152509_46286510
Gbgt1,2,28496891,28505415,protein_coding,1,8524,chr2_28496891_28505415
Gbp11,5,105323042,105346472,polymorphic_pseudogene,-1,23430,chr5_105323042_105346472
Gbp2,3,142620602,142638008,protein_coding,1,17406,chr3_142620602_142638008
Gbp2-ps,3,142658948,142669383,unprocessed_pseudogene,1,10435,chr3_142658948_142669383
Gbp3,3,142560026,142573209,protein_coding,1,13183,chr3_142560026_142573209
Gbp4,5,105115767,105139586,protein_coding,-1,23819,chr5_105115767_105139586
Gbp5,3,142493978,142522344,protein_coding,1,28366,chr3_142493978_142522344
Gbp6,5,105270702,105293698,protein_coding,-1,22996,chr5_105270702_105293698
Gbp7,3,142530342,142550149,protein_coding,1,19807,chr3_142530342_142550149
Gbp9,5,105077630,105139539,protein_coding,-1,61909,chr5_105077630_105139539
Gca,2,62664285,62694109,protein_coding,1,29824,chr2_62664285_62694109
Gcat,15,79030874,79042531,protein_coding,1,11657,chr15_79030874_79042531
Gcc1,6,28416091,28428390,protein_coding,-1,12299,chr6_28416091_28428390
Gcc2,10,58255497,58330096,protein_coding,1,74599,chr10_58255497_58330096
Gcdh,8,84886393,84893921,protein_coding,-1,7528,chr8_84886393_84893921
Gcfc2,6,81923669,81959915,protein_coding,1,36246,chr6_81923669_81959915
Gcg,2,62474530,62483650,protein_coding,-1,9120,chr2_62474530_62483650
Gcgr,11,120530699,120538986,protein_coding,1,8287,chr11_120530699_120538986
Gch1,14,47153895,47189413,protein_coding,-1,35518,chr14_47153895_47189413
Gchfr,2,119167773,119172390,protein_coding,1,4617,chr2_119167773_119172390
Gck,11,5900820,5950081,protein_coding,-1,49261,chr11_5900820_5950081
Gckr,5,31297443,31327314,protein_coding,1,29871,chr5_31297443_31327314
Gclc,9,77754535,77794485,protein_coding,1,39950,chr9_77754535_77794485
Gclm,3,122245557,122270732,protein_coding,1,25175,chr3_122245557_122270732
Gcnt1,19,17326141,17372844,protein_coding,-1,46703,chr19_17326141_17372844
Gcnt2,13,40859754,40960892,protein_coding,1,101138,chr13_40859754_40960892
Gcnt3,9,70031496,70038088,protein_coding,-1,6592,chr9_70031496_70038088
Gcnt4,13,96924689,96950906,protein_coding,1,26217,chr13_96924689_96950906
Gcnt7,2,172450313,172458596,protein_coding,-1,8283,chr2_172450313_172458596
Gcsh,8,116981810,116993537,protein_coding,-1,11727,chr8_116981810_116993537
Gda,19,21391307,21473445,protein_coding,-1,82138,chr19_21391307_21473445
Gdap1,1,17145362,17164271,protein_coding,1,18909,chr1_17145362_17164271
Gdap1l1,2,163438476,163455324,protein_coding,1,16848,chr2_163438476_163455324
Gdap2,3,100162381,100206981,protein_coding,1,44600,chr3_100162381_100206981
Gde1,7,118688545,118705778,protein_coding,-1,17233,chr7_118688545_118705778
Gdf10,14,33923587,33937983,protein_coding,1,14396,chr14_33923587_33937983
Gdf11,10,128882295,128891718,protein_coding,-1,9423,chr10_128882295_128891718
Gdf15,8,70629393,70632456,protein_coding,-1,3063,chr8_70629393_70632456
Gdf3,6,122605403,122610087,protein_coding,-1,4684,chr6_122605403_122610087
Gdf5,2,155941023,155945367,protein_coding,-1,4344,chr2_155941023_155945367
Gdf6,4,9844372,9862345,protein_coding,1,17973,chr4_9844372_9862345
Gdf7,12,8297918,8301954,protein_coding,-1,4036,chr12_8297918_8301954
Gdf9,11,53431023,53437904,protein_coding,1,6881,chr11_53431023_53437904
Gdi1,X,74304998,74311862,protein_coding,1,6864,chrX_74304998_74311862
Gdi2,13,3538063,3567871,protein_coding,1,29808,chr13_3538063_3567871
Gdnf,15,7810846,7837575,protein_coding,1,26729,chr15_7810846_7837575
Gdpd1,11,87033867,87074062,protein_coding,-1,40195,chr11_87033867_87074062
Gdpd2,X,100729873,100738895,protein_coding,1,9022,chrX_100729873_100738895
Gdpd3,7,126766334,126775649,protein_coding,1,9315,chr7_126766334_126775649
Gdpd4,7,97919955,98049663,protein_coding,1,129708,chr7_97919955_98049663
Gdpd5,7,99381414,99461877,protein_coding,1,80463,chr7_99381414_99461877
Gdpgp1,7,80232865,80242061,protein_coding,1,9196,chr7_80232865_80242061
Gem,4,11704457,11714752,protein_coding,1,10295,chr4_11704457_11714752
Gemin2,12,59013393,59028470,protein_coding,1,15077,chr12_59013393_59028470
Gemin4,11,76210571,76217664,protein_coding,-1,7093,chr11_76210571_76217664
Gemin5,11,58120002,58168539,protein_coding,-1,48537,chr11_58120002_58168539
Gemin6,17,80224441,80228497,protein_coding,1,4056,chr17_80224441_80228497
Gemin7,7,19564946,19577595,protein_coding,-1,12649,chr7_19564946_19577595
Gemin8,X,166170454,166190512,protein_coding,1,20058,chrX_166170454_166190512
Gen1,12,11238920,11265801,protein_coding,-1,26881,chr12_11238920_11265801
Get4,5,139252324,139270051,protein_coding,1,17727,chr5_139252324_139270051
Gfap,11,102887336,102900912,protein_coding,-1,13576,chr11_102887336_102900912
Gfer,17,24693187,24696156,protein_coding,-1,2969,chr17_24693187_24696156
Gfm1,3,67430096,67476529,protein_coding,1,46433,chr3_67430096_67476529
Gfm2,13,97137937,97181195,protein_coding,1,43258,chr13_97137937_97181195
Gfod1,13,43195245,43304172,protein_coding,-1,108927,chr13_43195245_43304172
Gfod2,8,105713854,105758664,protein_coding,-1,44810,chr8_105713854_105758664
Gfpt1,6,87042846,87092197,protein_coding,1,49351,chr6_87042846_87092197
Gfpt2,11,49794178,49838613,protein_coding,1,44435,chr11_49794178_49838613
Gfra1,19,58235604,58455909,protein_coding,-1,220305,chr19_58235604_58455909
Gfra2,14,70890120,70979838,protein_coding,1,89718,chr14_70890120_70979838
Gfra4,2,131039632,131043088,protein_coding,-1,3456,chr2_131039632_131043088
Gfral,9,76164102,76213657,protein_coding,-1,49555,chr9_76164102_76213657
Gfy,7,45176349,45179569,protein_coding,-1,3220,chr7_45176349_45179569
Gga1,15,78877190,78894585,protein_coding,1,17395,chr15_78877190_78894585
Gga2,7,121986722,122021222,protein_coding,-1,34500,chr7_121986722_122021222
Gga3,11,115584255,115604051,protein_coding,-1,19796,chr11_115584255_115604051
Ggact,14,122816223,122913757,protein_coding,-1,97534,chr14_122816223_122913757
Ggct,6,54982580,54992950,protein_coding,-1,10370,chr6_54982580_54992950
Ggcx,6,72414307,72430712,protein_coding,1,16405,chr6_72414307_72430712
Ggh,4,20042052,20066750,protein_coding,1,24698,chr4_20042052_20066750
Ggn,7,29170210,29173976,protein_coding,1,3766,chr7_29170210_29173976
Ggnbp1,17,27017987,27037624,protein_coding,1,19637,chr17_27017987_27037624
Ggnbp2,11,84832361,84870817,protein_coding,-1,38456,chr11_84832361_84870817
Ggps1,13,14050659,14063488,protein_coding,-1,12829,chr13_14050659_14063488
Ggt1,10,75561604,75586200,protein_coding,1,24596,chr10_75561604_75586200
Ggt5,10,75589340,75617200,protein_coding,1,27860,chr10_75589340_75617200
Ggt6,11,72435526,72438400,protein_coding,1,2874,chr11_72435526_72438400
Ggt7,2,155490379,155518237,protein_coding,-1,27858,chr2_155490379_155518237
Ggta1,2,35400179,35463231,protein_coding,-1,63052,chr2_35400179_35463231
Ghdc,11,100766032,100770957,protein_coding,-1,4925,chr11_100766032_100770957
Ghitm,14,37120092,37135272,protein_coding,-1,15180,chr14_37120092_37135272
Ghr,15,3317760,3583492,protein_coding,-1,265732,chr15_3317760_3583492
Ghrh,2,157329497,157347506,protein_coding,-1,18009,chr2_157329497_157347506
Ghrl,6,113716119,113719880,protein_coding,-1,3761,chr6_113716119_113719880
Gid4,11,60417145,60450927,protein_coding,1,33782,chr11_60417145_60450927
Gid8,2,180710117,180718733,protein_coding,1,8616,chr2_180710117_180718733
Gigyf1,5,137518548,137527935,protein_coding,1,9387,chr5_137518548_137527935
Gigyf2,1,87326998,87450796,protein_coding,1,123798,chr1_87326998_87450796
Gimap1,6,48739054,48743795,protein_coding,1,4741,chr6_48739054_48743795
Gimap1os,6,48738346,48741444,processed_transcript,-1,3098,chr6_48738346_48741444
Gimap4,6,48684549,48692060,protein_coding,1,7511,chr6_48684549_48692060
Gimap6,6,48701582,48708225,protein_coding,-1,6643,chr6_48701582_48708225
Gimap7,6,48718621,48724636,protein_coding,1,6015,chr6_48718621_48724636
Gimap8,6,48647234,48660875,protein_coding,1,13641,chr6_48647234_48660875
Gimap9,6,48676129,48679114,protein_coding,1,2985,chr6_48676129_48679114
Gin1,1,97770172,97793709,protein_coding,1,23537,chr1_97770172_97793709
Ginm1,10,7693711,7792824,protein_coding,-1,99113,chr10_7693711_7792824
Gins1,2,150905400,150931280,protein_coding,1,25880,chr2_150905400_150931280
Gins2,8,120578633,120589304,protein_coding,-1,10671,chr8_120578633_120589304
Gins3,8,95633453,95645060,protein_coding,1,11607,chr8_95633453_95645060
Gins4,8,23226616,23237659,protein_coding,-1,11043,chr8_23226616_23237659
Gipc1,8,83652677,83664694,protein_coding,1,12017,chr8_83652677_83664694
Gipc2,3,152093533,152166230,protein_coding,-1,72697,chr3_152093533_152166230
Gipc3,10,81335265,81343266,protein_coding,-1,8001,chr10_81335265_81343266
Gipr,7,19156061,19166127,protein_coding,-1,10066,chr7_19156061_19166127
Git1,11,77493562,77507786,protein_coding,1,14224,chr11_77493562_77507786
Git2,5,114727407,114775517,protein_coding,-1,48110,chr5_114727407_114775517
Gja1,10,56377330,56402513,protein_coding,1,25183,chr10_56377330_56402513
Gja3,14,57034460,57058100,protein_coding,-1,23640,chr14_57034460_57058100
Gja4,4,127311421,127314039,protein_coding,-1,2618,chr4_127311421_127314039
Gja5,3,96904693,97077416,protein_coding,1,172723,chr3_96904693_97077416
Gja6,X,160902116,160907052,protein_coding,-1,4936,chrX_160902116_160907052
Gja8,3,96913566,96926020,protein_coding,-1,12454,chr3_96913566_96926020
Gjb1,X,101376378,101385629,protein_coding,1,9251,chrX_101376378_101385629
Gjb2,14,57098600,57104702,protein_coding,-1,6102,chr14_57098600_57104702
Gjb6,14,57123303,57133611,protein_coding,-1,10308,chr14_57123303_57133611
Gjc1,11,102799579,102819700,protein_coding,-1,20121,chr11_102799579_102819700
Gjc2,11,59175568,59183213,protein_coding,-1,7645,chr11_59175568_59183213
Gjc3,5,137953461,137963098,protein_coding,-1,9637,chr5_137953461_137963098
Gjd2,2,114009601,114013619,protein_coding,-1,4018,chr2_114009601_114013619
Gjd3,11,98982180,98983016,protein_coding,-1,836,chr11_98982180_98983016
Gjd4,18,9278607,9282809,protein_coding,-1,4202,chr18_9278607_9282809
Gje1,10,14715623,14718214,protein_coding,-1,2591,chr10_14715623_14718214
Gk2,5,97455142,97457021,protein_coding,-1,1879,chr5_97455142_97457021
Gk5,9,96119362,96184608,protein_coding,1,65246,chr9_96119362_96184608
Gkap1,13,58233346,58275699,protein_coding,-1,42353,chr13_58233346_58275699
Gkn1,6,87345650,87350942,protein_coding,-1,5292,chr6_87345650_87350942
Gkn3,6,87383256,87388935,protein_coding,-1,5679,chr6_87383256_87388935
Gla,X,134588149,134601125,protein_coding,-1,12976,chrX_134588149_134601125
Glb1,9,114401076,114474898,protein_coding,1,73822,chr9_114401076_114474898
Glb1l,1,75198236,75210813,protein_coding,-1,12577,chr1_75198236_75210813
Glb1l2,9,26763044,26806468,protein_coding,-1,43424,chr9_26763044_26806468
Glb1l3,9,26817953,26860890,protein_coding,-1,42937,chr9_26817953_26860890
Glcci1,6,8509600,8597548,protein_coding,1,87948,chr6_8509600_8597548
Glce,9,62057248,62122655,protein_coding,-1,65407,chr9_62057248_62122655
Gldc,19,30098447,30175429,protein_coding,-1,76982,chr19_30098447_30175429
Gldn,9,54286486,54341786,protein_coding,1,55300,chr9_54286486_54341786
Gldnos,9,54268578,54301570,antisense,-1,32992,chr9_54268578_54301570
Gle1,2,29935426,29960371,protein_coding,1,24945,chr2_29935426_29960371
Glg1,8,111154421,111259216,protein_coding,-1,104795,chr8_111154421_111259216
Gli1,10,127329882,127341974,protein_coding,-1,12092,chr10_127329882_127341974
Gli2,1,118834132,119053619,protein_coding,-1,219487,chr1_118834132_119053619
Gli3,13,15463235,15730026,protein_coding,1,266791,chr13_15463235_15730026
Glipr1,10,111985448,112002631,protein_coding,-1,17183,chr10_111985448_112002631
Glipr1l1,10,112060189,112078510,protein_coding,1,18321,chr10_112060189_112078510
Glipr1l3,10,112141754,112160327,protein_coding,-1,18573,chr10_112141754_112160327
Glipr2,4,43957401,43979118,protein_coding,1,21717,chr4_43957401_43979118
Glis1,4,107434591,107635061,protein_coding,1,200470,chr4_107434591_107635061
Glis2,16,4594713,4624924,protein_coding,1,30211,chr16_4594713_4624924
Glis3,19,28258851,28680077,protein_coding,-1,421226,chr19_28258851_28680077
Glmn,5,107548967,107597888,protein_coding,-1,48921,chr5_107548967_107597888
Glmp,3,88325023,88331313,protein_coding,1,6290,chr3_88325023_88331313
Glns-ps1,11,19720355,19721472,processed_pseudogene,1,1117,chr11_19720355_19721472
Glo1,17,30584936,30626871,protein_coding,-1,41935,chr17_30584936_30626871
Glod4,11,76120987,76243725,protein_coding,-1,122738,chr11_76120987_76243725
Glod5,X,8004200,8018492,protein_coding,-1,14292,chrX_8004200_8018492
Glp2r,11,67661502,67771153,protein_coding,-1,109651,chr11_67661502_67771153
Glra1,11,55514238,55608198,protein_coding,-1,93960,chr11_55514238_55608198
Glra2,X,165129017,165327393,protein_coding,-1,198376,chrX_165129017_165327393
Glra3,8,55940460,56130070,protein_coding,1,189610,chr8_55940460_56130070
Glra4,X,136757674,136780141,protein_coding,-1,22467,chrX_136757674_136780141
Glrb,3,80843599,80913660,protein_coding,-1,70061,chr3_80843599_80913660
Glrp1,1,88499871,88510066,protein_coding,-1,10195,chr1_88499871_88510066
Glrx,13,75839868,75850154,protein_coding,1,10286,chr13_75839868_75850154
Glrx2,1,143716338,143749676,protein_coding,1,33338,chr1_143716338_143749676
Glrx3,7,137437614,137468594,protein_coding,1,30980,chr7_137437614_137468594
Glrx5,12,105032688,105042906,protein_coding,1,10218,chr12_105032688_105042906
Gls,1,52163448,52233232,protein_coding,-1,69784,chr1_52163448_52233232
Gls2,10,128194457,128210004,protein_coding,1,15547,chr10_128194457_128210004
Glt1d1,5,127632262,127709374,protein_coding,1,77112,chr5_127632262_127709374
Glt28d2,3,85869849,85887516,protein_coding,-1,17667,chr3_85869849_85887516
Glt8d1,14,31001400,31011991,protein_coding,1,10591,chr14_31001400_31011991
Glt8d2,10,82650433,82690650,protein_coding,-1,40217,chr10_82650433_82690650
Gltp,5,114669398,114690984,protein_coding,-1,21586,chr5_114669398_114690984
Gltpd2,11,70519196,70520736,protein_coding,1,1540,chr11_70519196_70520736
Glud-ps,7,125075351,125076007,processed_pseudogene,1,656,chr7_125075351_125076007
Glud1,14,34310727,34345265,protein_coding,1,34538,chr14_34310727_34345265
Glul,1,153899944,153909723,protein_coding,1,9779,chr1_153899944_153909723
Glyat,19,12633308,12653911,protein_coding,1,20603,chr19_12633308_12653911
Glyatl3,17,40904618,40914350,protein_coding,-1,9732,chr17_40904618_40914350
Glyctk,9,106152857,106158138,protein_coding,-1,5281,chr9_106152857_106158138
Glyr1,16,5013909,5049863,protein_coding,-1,35954,chr16_5013909_5049863
Gm10015,8,61364019,61364483,processed_pseudogene,-1,464,chr8_61364019_61364483
Gm10029,13,6662565,6662894,processed_pseudogene,-1,329,chr13_6662565_6662894
Gm10030,9,110989499,111008029,processed_transcript,1,18530,chr9_110989499_111008029
Gm10033,8,69366510,69395539,protein_coding,-1,29029,chr8_69366510_69395539
Gm10036,18,15832794,15833327,processed_pseudogene,1,533,chr18_15832794_15833327
Gm10039,11,100361716,100362126,processed_pseudogene,-1,410,chr11_100361716_100362126
Gm10043,8,22958207,22958441,processed_pseudogene,-1,234,chr8_22958207_22958441
Gm10044,14,7744792,7791652,transcribed_unprocessed_pseudogene,-1,46860,chr14_7744792_7791652
Gm10045,17,29308138,29308620,transcribed_processed_pseudogene,1,482,chr17_29308138_29308620
Gm10046,7,27765673,27770972,transcribed_unprocessed_pseudogene,1,5299,chr7_27765673_27770972
Gm10051,5,133475123,133475536,processed_pseudogene,1,413,chr5_133475123_133475536
Gm10052,9,123689233,123690192,processed_pseudogene,-1,959,chr9_123689233_123690192
Gm10053,19,24875686,24876631,protein_coding,1,945,chr19_24875686_24876631
Gm10054,12,17233612,17234042,processed_pseudogene,1,430,chr12_17233612_17234042
Gm10059,5,33759366,33759536,processed_pseudogene,1,170,chr5_33759366_33759536
Gm10060,8,19784746,19784856,processed_pseudogene,1,110,chr8_19784746_19784856
Gm10062,5,25659806,25661282,lincRNA,-1,1476,chr5_25659806_25661282
Gm10069,6,128438757,128503281,antisense,1,64524,chr6_128438757_128503281
Gm10073,8,106573009,106573350,processed_pseudogene,-1,341,chr8_106573009_106573350
Gm10076,14,105681828,105682211,lincRNA,1,383,chr14_105681828_105682211
Gm10080,9,44374744,44375181,processed_pseudogene,-1,437,chr9_44374744_44375181
Gm10086,5,108517179,108517532,processed_pseudogene,1,353,chr5_108517179_108517532
Gm10087,7,110526792,110527121,processed_pseudogene,1,329,chr7_110526792_110527121
Gm10095,12,86845778,86846467,processed_pseudogene,-1,689,chr12_86845778_86846467
Gm10105,9,35589081,35589350,processed_pseudogene,-1,269,chr9_35589081_35589350
Gm10108,5,13121448,13121766,processed_pseudogene,-1,318,chr5_13121448_13121766
Gm10120,10,128011776,128012132,processed_pseudogene,1,356,chr10_128011776_128012132
Gm10123,9,96895658,96896147,processed_pseudogene,1,489,chr9_96895658_96896147
Gm10125,18,5491503,5593505,processed_transcript,-1,102002,chr18_5491503_5593505
Gm10126,13,73988966,73989133,processed_pseudogene,-1,167,chr13_73988966_73989133
Gm10128,14,7640895,7643972,protein_coding,-1,3077,chr14_7640895_7643972
Gm10130,2,150311431,150363071,protein_coding,1,51640,chr2_150311431_150363071
Gm10131,8,34111002,34111737,protein_coding,-1,735,chr8_34111002_34111737
Gm10132,14,77251847,77252314,processed_pseudogene,-1,467,chr14_77251847_77252314
Gm10136,19,29003408,29003842,processed_pseudogene,-1,434,chr19_29003408_29003842
Gm10145,10,27936364,27936825,processed_pseudogene,1,461,chr10_27936364_27936825
Gm10146,10,78393320,78393628,processed_pseudogene,1,308,chr10_78393320_78393628
Gm10154,4,83505185,83505538,processed_pseudogene,-1,353,chr4_83505185_83505538
Gm10155,7,126299434,126299916,processed_pseudogene,-1,482,chr7_126299434_126299916
Gm10156,7,107863039,107863500,processed_pseudogene,1,461,chr7_107863039_107863500
Gm10157,9,118837613,118837955,processed_pseudogene,-1,342,chr9_118837613_118837955
Gm10161,7,75366055,75366258,processed_pseudogene,1,203,chr7_75366055_75366258
Gm10163,9,88390837,88391317,processed_pseudogene,1,480,chr9_88390837_88391317
Gm10171,1,172144274,172144901,processed_pseudogene,-1,627,chr1_172144274_172144901
Gm10175,7,23946646,23947290,transcribed_processed_pseudogene,-1,644,chr7_23946646_23947290
Gm10177,9,37252922,37253365,transcribed_processed_pseudogene,1,443,chr9_37252922_37253365
Gm10179,7,12085925,12086612,processed_pseudogene,-1,687,chr7_12085925_12086612
Gm10182,9,22321105,22321377,processed_pseudogene,-1,272,chr9_22321105_22321377
Gm10184,17,89908462,89910449,protein_coding,-1,1987,chr17_89908462_89910449
Gm10190,17,80373218,80373541,protein_coding,-1,323,chr17_80373218_80373541
Gm10193,1,105764444,105764674,processed_pseudogene,1,230,chr1_105764444_105764674
Gm10220,5,26114764,26121421,protein_coding,-1,6657,chr5_26114764_26121421
Gm10221,5,24581554,24581862,processed_pseudogene,-1,308,chr5_24581554_24581862
Gm10222,1,24612407,24612700,unprocessed_pseudogene,-1,293,chr1_24612407_24612700
Gm10224,6,122698414,122699028,processed_pseudogene,-1,614,chr6_122698414_122699028
Gm10231,17,5816200,5816640,processed_pseudogene,-1,440,chr17_5816200_5816640
Gm10232,17,3044014,3044733,processed_pseudogene,-1,719,chr17_3044014_3044733
Gm10233,14,66045080,66045707,processed_pseudogene,1,627,chr14_66045080_66045707
Gm10240,15,68309819,68310301,processed_pseudogene,1,482,chr15_68309819_68310301
Gm10241,16,20176727,20177012,processed_pseudogene,-1,285,chr16_20176727_20177012
Gm10242,6,48939798,48940127,processed_pseudogene,-1,329,chr6_48939798_48940127
Gm10243,6,48523518,48523850,processed_pseudogene,1,332,chr6_48523518_48523850
Gm10244,6,39419887,39421294,antisense,1,1407,chr6_39419887_39421294
Gm10247,16,8922060,8922389,processed_pseudogene,-1,329,chr16_8922060_8922389
Gm10248,14,23038194,23094571,antisense,-1,56377,chr14_23038194_23094571
Gm10250,15,5120654,5121135,processed_pseudogene,-1,481,chr15_5120654_5121135
Gm10254,3,54810384,54811250,processed_pseudogene,-1,866,chr3_54810384_54811250
Gm10257,13,100946405,100946815,processed_pseudogene,-1,410,chr13_100946405_100946815
Gm10259,3,25211016,25212605,processed_pseudogene,-1,1589,chr3_25211016_25212605
Gm10263,13,73317844,73318143,processed_pseudogene,1,299,chr13_73317844_73318143
Gm10269,18,20682594,20682963,processed_pseudogene,-1,369,chr18_20682594_20682963
Gm10273,10,59395755,59396384,processed_pseudogene,1,629,chr10_59395755_59396384
Gm10275,10,29698746,29699380,transcribed_processed_pseudogene,-1,634,chr10_29698746_29699380
Gm10277,11,77785453,77787747,protein_coding,-1,2294,chr11_77785453_77787747
Gm10280,8,113067262,113093334,lincRNA,1,26072,chr8_113067262_113093334
Gm10282,8,72304110,72305260,protein_coding,-1,1150,chr8_72304110_72305260
Gm10284,8,57550299,57551303,processed_pseudogene,1,1004,chr8_57550299_57551303
Gm10288,3,146838811,146839347,processed_pseudogene,-1,536,chr3_146838811_146839347
Gm10290,5,28538570,28539568,processed_pseudogene,1,998,chr5_28538570_28539568
Gm10291,3,78917258,78918256,processed_pseudogene,1,998,chr3_78917258_78918256
Gm10292,3,68333196,68333780,processed_pseudogene,1,584,chr3_68333196_68333780
Gm10293,3,52612835,52613836,processed_pseudogene,1,1001,chr3_52612835_52613836
Gm10297,7,60753363,60754013,processed_pseudogene,-1,650,chr7_60753363_60754013
Gm10312,13,60771675,60772163,processed_pseudogene,1,488,chr13_60771675_60772163
Gm10313,8,46254677,46255678,processed_pseudogene,-1,1001,chr8_46254677_46255678
Gm10327,10,33808497,33809498,processed_pseudogene,-1,1001,chr10_33808497_33809498
Gm10335,10,14523078,14523545,processed_pseudogene,1,467,chr10_14523078_14523545
Gm10338,14,7580617,7595592,protein_coding,-1,14975,chr14_7580617_7595592
Gm10340,14,3133997,3141609,protein_coding,1,7612,chr14_3133997_3141609
Gm10350,18,7043909,7044135,processed_pseudogene,-1,226,chr18_7043909_7044135
Gm10354,5,14974113,14978935,protein_coding,-1,4822,chr5_14974113_14978935
Gm10355,3,101306563,101307079,processed_pseudogene,-1,516,chr3_101306563_101307079
Gm10356,3,47050382,47051639,processed_pseudogene,-1,1257,chr3_47050382_47051639
Gm10357,13,8289850,8290113,processed_pseudogene,-1,263,chr13_8289850_8290113
Gm10358,8,75405340,75406589,protein_coding,-1,1249,chr8_75405340_75406589
Gm10359,5,105862701,105863702,processed_pseudogene,-1,1001,chr5_105862701_105863702
Gm10362,15,73428359,73428910,processed_pseudogene,-1,551,chr15_73428359_73428910
Gm10364,14,55038462,55042979,transcribed_processed_pseudogene,1,4517,chr14_55038462_55042979
Gm10369,5,134676490,134680145,antisense,1,3655,chr5_134676490_134680145
Gm10371,14,47097679,47116161,antisense,-1,18482,chr14_47097679_47116161
Gm10373,15,43430943,43477036,lincRNA,-1,46093,chr15_43430943_43477036
Gm10384,15,36870501,36879816,lincRNA,-1,9315,chr15_36870501_36879816
Gm10389,15,10600293,10611651,antisense,1,11358,chr15_10600293_10611651
Gm10390,5,120121096,120139263,antisense,-1,18167,chr5_120121096_120139263
Gm10406,14,7006115,7027449,protein_coding,-1,21334,chr14_7006115_7027449
Gm10409,14,3412614,3433800,protein_coding,1,21186,chr14_3412614_3433800
Gm10410,14,4938879,4967273,unprocessed_pseudogene,1,28394,chr14_4938879_4967273
Gm10419,5,108367769,108378239,lincRNA,1,10470,chr5_108367769_108378239
Gm10421,12,117144530,117151651,processed_transcript,-1,7121,chr12_117144530_117151651
Gm1043,5,37085370,37229547,protein_coding,1,144177,chr5_37085370_37229547
Gm10432,12,100276609,100302315,processed_transcript,1,25706,chr12_100276609_100302315
Gm10433,12,100187968,100193540,processed_transcript,1,5572,chr12_100187968_100193540
Gm10440,5,54349991,54358543,lincRNA,1,8552,chr5_54349991_54358543
Gm10443,6,86334031,86334240,processed_pseudogene,1,209,chr6_86334031_86334240
Gm10444,6,85140505,85143649,unprocessed_pseudogene,1,3144,chr6_85140505_85143649
Gm10445,6,84412942,84423838,lincRNA,-1,10896,chr6_84412942_84423838
Gm10451,12,76444497,76451336,lincRNA,1,6839,chr12_76444497_76451336
Gm10466,11,24721006,24730722,lincRNA,-1,9716,chr11_24721006_24730722
Gm10471,5,26082574,26089291,protein_coding,-1,6717,chr5_26082574_26089291
Gm10477,X,56523582,56525432,unprocessed_pseudogene,1,1850,chrX_56523582_56525432
Gm10479,12,20426913,20435417,lincRNA,1,8504,chr12_20426913_20435417
Gm10481,5,13042433,13043434,processed_pseudogene,-1,1001,chr5_13042433_13043434
Gm10505,17,27325035,27344833,processed_transcript,1,19798,chr17_27325035_27344833
Gm10509,17,21690180,21691022,processed_pseudogene,1,842,chr17_21690180_21691022
Gm10516,1,192136896,192151026,antisense,1,14130,chr1_192136896_192151026
Gm10532,18,75514645,75522806,antisense,1,8161,chr18_75514645_75522806
Gm10538,1,132729355,132732826,antisense,1,3471,chr1_132729355_132732826
Gm10548,18,34207775,34221772,transcribed_processed_pseudogene,-1,13997,chr18_34207775_34221772
Gm10549,18,33464163,33474710,lincRNA,1,10547,chr18_33464163_33474710
Gm10556,18,4812486,4850959,lincRNA,1,38473,chr18_4812486_4850959
Gm10557,18,4198320,4198938,processed_pseudogene,-1,618,chr18_4198320_4198938
Gm10561,1,55226251,55235622,antisense,1,9371,chr1_55226251_55235622
Gm10566,1,15268802,15269797,processed_pseudogene,-1,995,chr1_15268802_15269797
Gm10575,7,141461481,141467771,processed_transcript,-1,6290,chr7_141461481_141467771
Gm10584,7,132315664,132318291,antisense,1,2627,chr7_132315664_132318291
Gm10600,4,42232136,42233438,transcribed_unprocessed_pseudogene,1,1302,chr4_42232136_42233438
Gm10601,4,41809083,41810504,unprocessed_pseudogene,1,1421,chr4_41809083_41810504
Gm10603,7,100446737,100474846,antisense,-1,28109,chr7_100446737_100474846
Gm10608,9,119162730,119163405,processed_pseudogene,1,675,chr9_119162730_119163405
Gm10610,7,83536192,83550258,lincRNA,-1,14066,chr7_83536192_83550258
Gm10614,8,120589531,120593801,bidirectional_promoter_lncRNA,1,4270,chr8_120589531_120593801
Gm10634,9,88719629,88806264,antisense,1,86635,chr9_88719629_88806264
Gm10635,9,79444037,79519302,lincRNA,-1,75265,chr9_79444037_79519302
Gm10636,3,146367153,146378944,lincRNA,-1,11791,chr3_146367153_146378944
Gm10638,8,86745453,86748655,antisense,1,3202,chr8_86745453_86748655
Gm10640,7,31155668,31170641,antisense,1,14973,chr7_31155668_31170641
Gm10649,8,76605226,76900621,bidirectional_promoter_lncRNA,-1,295395,chr8_76605226_76900621
Gm10651,7,27949155,27949763,processed_pseudogene,-1,608,chr7_27949155_27949763
Gm10653,9,62841477,62868000,transcribed_processed_pseudogene,-1,26523,chr9_62841477_62868000
Gm10658,9,57056630,57071966,antisense,-1,15336,chr9_57056630_57071966
Gm10684,9,45107176,45135606,lincRNA,-1,28430,chr9_45107176_45135606
Gm10687,9,44122186,44134485,antisense,-1,12299,chr9_44122186_44134485
Gm10689,8,25454273,25454704,processed_pseudogene,1,431,chr8_25454273_25454704
Gm1070,6,71293765,71302880,transcribed_unprocessed_pseudogene,1,9115,chr6_71293765_71302880
Gm10705,3,87207545,87208005,processed_pseudogene,-1,460,chr3_87207545_87208005
Gm10706,9,14704642,14719058,antisense,1,14416,chr9_14704642_14719058
Gm10709,9,7751725,7752204,processed_pseudogene,1,479,chr9_7751725_7752204
Gm10710,3,83125276,83129246,lincRNA,-1,3970,chr3_83125276_83129246
Gm10714,2,174125038,174183918,antisense,-1,58880,chr2_174125038_174183918
Gm10731,3,40754957,40855123,processed_pseudogene,-1,100166,chr3_40754957_40855123
Gm10732,13,118603418,118658743,lincRNA,-1,55325,chr13_118603418_118658743
Gm10745,3,11823229,11844359,lincRNA,-1,21130,chr3_11823229_11844359
Gm10747,10,117043746,117045101,lincRNA,1,1355,chr10_117043746_117045101
Gm10754,10,97681414,97967090,lincRNA,-1,285676,chr10_97681414_97967090
Gm10767,13,66904914,66909236,protein_coding,1,4322,chr13_66904914_66909236
Gm10774,2,126709354,126709557,processed_pseudogene,-1,203,chr2_126709354_126709557
Gm10778,10,81649059,81667361,protein_coding,1,18302,chr10_81649059_81667361
Gm10782,13,56362900,56368857,lincRNA,1,5957,chr13_56362900_56368857
Gm10784,13,49945096,49945333,processed_pseudogene,-1,237,chr13_49945096_49945333
Gm10785,16,91688898,91715642,antisense,1,26744,chr16_91688898_91715642
Gm10787,10,77011995,77022214,lincRNA,1,10219,chr10_77011995_77022214
Gm10790,13,41865915,41913092,processed_transcript,1,47177,chr13_41865915_41913092
Gm10791,16,84972214,84979451,antisense,1,7237,chr16_84972214_84979451
Gm10814,19,6012620,6018462,antisense,1,5842,chr19_6012620_6018462
Gm10819,19,16267061,16267621,processed_pseudogene,-1,560,chr19_16267061_16267621
Gm10825,10,22402883,22407470,lincRNA,1,4587,chr10_22402883_22407470
Gm10832,16,11031956,11036420,lincRNA,1,4464,chr16_11031956_11036420
Gm10845,14,79860521,79869176,lincRNA,-1,8655,chr14_79860521_79869176
Gm10847,14,74926445,74933133,antisense,1,6688,chr14_74926445_74933133
Gm10848,2,14706834,14739722,antisense,-1,32888,chr2_14706834_14739722
Gm10851,2,11521706,11530836,antisense,1,9130,chr2_11521706_11530836
Gm10855,2,6932541,6935081,sense_intronic,-1,2540,chr2_6932541_6935081
Gm10863,15,79166041,79227524,processed_transcript,1,61483,chr15_79166041_79227524
Gm10865,15,78994955,79011041,antisense,-1,16086,chr15_78994955_79011041
Gm10913,16,36209277,36209739,processed_pseudogene,1,462,chr16_36209277_36209739
Gm10916,14,50769248,50769730,processed_pseudogene,1,482,chr14_50769248_50769730
Gm10923,15,85116870,85117287,processed_pseudogene,1,417,chr15_85116870_85117287
Gm10941,10,77257776,77259223,bidirectional_promoter_lncRNA,-1,1447,chr10_77257776_77259223
Gm10961,3,107631322,107633090,protein_coding,1,1768,chr3_107631322_107633090
Gm10988,7,30151841,30152928,processed_pseudogene,1,1087,chr7_30151841_30152928
Gm11025,12,57272847,57273312,processed_pseudogene,-1,465,chr12_57272847_57273312
Gm1110,9,26879567,26923111,protein_coding,-1,43544,chr9_26879567_26923111
Gm11100,14,13918334,13951132,protein_coding,1,32798,chr14_13918334_13951132
Gm11110,17,57091370,57105942,lincRNA,-1,14572,chr17_57091370_57105942
Gm11127,17,36055816,36058371,protein_coding,-1,2555,chr17_36055816_36058371
Gm11149,9,49518288,49572591,antisense,1,54303,chr9_49518288_49572591
Gm11185,4,83193988,83194994,processed_pseudogene,1,1006,chr4_83193988_83194994
Gm11186,11,53111451,53120056,antisense,-1,8605,chr11_53111451_53120056
Gm11189,11,53200684,53201058,processed_pseudogene,1,374,chr11_53200684_53201058
Gm11190,11,77912127,77929288,lincRNA,-1,17161,chr11_77912127_77929288
Gm11198,11,79371257,79372230,processed_pseudogene,-1,973,chr11_79371257_79372230
Gm11201,11,79023597,79031057,antisense,1,7460,chr11_79023597_79031057
Gm11203,11,79897222,79897962,processed_pseudogene,1,740,chr11_79897222_79897962
Gm11205,11,79704630,79705420,lincRNA,1,790,chr11_79704630_79705420
Gm11211,4,62723516,62727537,lincRNA,-1,4021,chr4_62723516_62727537
Gm11213,4,63596901,63605261,protein_coding,-1,8360,chr4_63596901_63605261
Gm11214,4,63662359,63663379,protein_coding,-1,1020,chr4_63662359_63663379
Gm11217,4,64254053,64276603,lincRNA,-1,22550,chr4_64254053_64276603
Gm11218,4,64856926,64858139,processed_pseudogene,-1,1213,chr4_64856926_64858139
Gm11221,4,69691978,69692574,processed_pseudogene,1,596,chr4_69691978_69692574
Gm11222,4,69853947,69854684,processed_pseudogene,1,737,chr4_69853947_69854684
Gm11223,4,69925630,69926079,processed_pseudogene,-1,449,chr4_69925630_69926079
Gm11224,4,69954166,69955276,processed_pseudogene,-1,1110,chr4_69954166_69955276
Gm11225,4,70047157,70048205,processed_pseudogene,1,1048,chr4_70047157_70048205
Gm11227,4,71072673,71073143,processed_pseudogene,1,470,chr4_71072673_71073143
Gm1123,9,99006790,99035715,protein_coding,-1,28925,chr9_99006790_99035715
Gm11231,4,71678013,71679718,processed_pseudogene,1,1705,chr4_71678013_71679718
Gm11240,4,73791246,73798372,processed_transcript,1,7126,chr4_73791246_73798372
Gm11241,4,75902260,75903155,processed_pseudogene,-1,895,chr4_75902260_75903155
Gm11242,4,76692143,76694599,processed_pseudogene,1,2456,chr4_76692143_76694599
Gm11245,4,76837779,76838815,processed_pseudogene,1,1036,chr4_76837779_76838815
Gm11249,4,67930881,67931739,processed_pseudogene,1,858,chr4_67930881_67931739
Gm11251,4,73029819,73036074,processed_pseudogene,1,6255,chr4_73029819_73036074
Gm11254,4,74663683,74664335,processed_pseudogene,1,652,chr4_74663683_74664335
Gm11255,4,75324501,75325680,processed_pseudogene,1,1179,chr4_75324501_75325680
Gm11258,4,74688107,74689324,processed_pseudogene,-1,1217,chr4_74688107_74689324
Gm11260,4,78233986,78234927,processed_pseudogene,1,941,chr4_78233986_78234927
Gm11263,4,79327708,79328456,processed_pseudogene,1,748,chr4_79327708_79328456
Gm11264,4,82033312,82065890,lincRNA,-1,32578,chr4_82033312_82065890
Gm11270,13,21296248,21296718,processed_pseudogene,-1,470,chr13_21296248_21296718
Gm11278,13,21875233,21876229,processed_pseudogene,-1,996,chr13_21875233_21876229
Gm11279,13,21903156,21904784,processed_pseudogene,1,1628,chr13_21903156_21904784
Gm11281,13,21953053,21953628,processed_pseudogene,-1,575,chr13_21953053_21953628
Gm11282,13,21956708,21958123,processed_pseudogene,-1,1415,chr13_21956708_21958123
Gm11284,13,22163886,22165807,processed_pseudogene,-1,1921,chr13_22163886_22165807
Gm11285,13,22083466,22083787,unprocessed_pseudogene,-1,321,chr13_22083466_22083787
Gm11295,13,22282354,22283548,processed_pseudogene,1,1194,chr13_22282354_22283548
Gm11298,13,22464296,22467857,processed_pseudogene,1,3561,chr13_22464296_22467857
Gm11307,13,22675660,22676969,processed_pseudogene,1,1309,chr13_22675660_22676969
Gm11335,13,23527011,23530943,lincRNA,-1,3932,chr13_23527011_23530943
Gm11338,13,23728548,23730106,unprocessed_pseudogene,1,1558,chr13_23728548_23730106
Gm11342,13,24335937,24414803,antisense,-1,78866,chr13_24335937_24414803
Gm11343,13,24195897,24196495,processed_pseudogene,1,598,chr13_24195897_24196495
Gm11346,13,24596347,24604925,transcribed_processed_pseudogene,-1,8578,chr13_24596347_24604925
Gm11349,13,25582271,25583386,processed_pseudogene,-1,1115,chr13_25582271_25583386
Gm11350,13,25680274,25681143,processed_pseudogene,-1,869,chr13_25680274_25681143
Gm11351,13,25921033,25986293,lincRNA,-1,65260,chr13_25921033_25986293
Gm11353,13,26492554,26493180,processed_pseudogene,1,626,chr13_26492554_26493180
Gm11359,13,27683199,27690868,unprocessed_pseudogene,-1,7669,chr13_27683199_27690868
Gm11383,13,33120516,33121322,processed_pseudogene,-1,806,chr13_33120516_33121322
Gm11392,13,33718276,33722055,unprocessed_pseudogene,1,3779,chr13_33718276_33722055
Gm11401,11,6242378,6242721,processed_pseudogene,1,343,chr11_6242378_6242721
Gm11404,4,69291621,69295121,processed_pseudogene,-1,3500,chr4_69291621_69295121
Gm11405,4,74228197,74229752,processed_pseudogene,1,1555,chr4_74228197_74229752
Gm1141,X,71920947,71940870,protein_coding,1,19923,chrX_71920947_71940870
Gm11413,4,83378317,83390668,antisense,-1,12351,chr4_83378317_83390668
Gm11416,11,81046794,81048771,processed_pseudogene,1,1977,chr11_81046794_81048771
Gm11418,11,81587361,81593478,antisense,1,6117,chr11_81587361_81593478
Gm11419,11,81985406,81988769,lincRNA,1,3363,chr11_81985406_81988769
Gm11423,11,82779601,82781042,antisense,-1,1441,chr11_82779601_82781042
Gm11424,11,82971092,82971920,processed_pseudogene,1,828,chr11_82971092_82971920
Gm11426,11,82633353,82636309,lincRNA,1,2956,chr11_82633353_82636309
Gm11427,11,83224454,83260960,transcribed_unprocessed_pseudogene,1,36506,chr11_83224454_83260960
Gm11434,11,83800464,83801092,processed_pseudogene,1,628,chr11_83800464_83801092
Gm11437,11,84148351,84167476,protein_coding,-1,19125,chr11_84148351_84167476
Gm11445,2,159777676,159778207,processed_pseudogene,-1,531,chr2_159777676_159778207
Gm11448,2,161287220,161287669,processed_pseudogene,1,449,chr2_161287220_161287669
Gm11451,2,162898894,162899523,processed_pseudogene,-1,629,chr2_162898894_162899523
Gm11452,2,162907924,162908613,processed_pseudogene,1,689,chr2_162907924_162908613
Gm11453,2,162982255,162983261,processed_pseudogene,-1,1006,chr2_162982255_162983261
Gm11454,2,163122606,163143959,lincRNA,1,21353,chr2_163122606_163143959
Gm11456,2,164642945,164643200,processed_pseudogene,-1,255,chr2_164642945_164643200
Gm11462,2,165959789,165960350,processed_pseudogene,1,561,chr2_165959789_165960350
Gm11465,2,165880025,165882056,antisense,1,2031,chr2_165880025_165882056
Gm11468,2,166273908,166294831,lincRNA,1,20923,chr2_166273908_166294831
Gm11470,2,167007131,167009039,processed_pseudogene,-1,1908,chr2_167007131_167009039
Gm11472,2,167087184,167087739,processed_pseudogene,-1,555,chr2_167087184_167087739
Gm11474,2,167535166,167535442,processed_pseudogene,-1,276,chr2_167535166_167535442
Gm11476,2,167553314,167607845,processed_transcript,1,54531,chr2_167553314_167607845
Gm11478,11,86630428,86631026,processed_pseudogene,-1,598,chr11_86630428_86631026
Gm11482,4,63634421,63639440,lincRNA,1,5019,chr4_63634421_63639440
Gm11488,4,73497615,73498477,processed_pseudogene,-1,862,chr4_73497615_73498477
Gm11500,11,92770031,92770973,processed_pseudogene,-1,942,chr11_92770031_92770973
Gm11502,11,93650759,93651969,processed_pseudogene,1,1210,chr11_93650759_93651969
Gm11507,11,87944403,87944814,processed_pseudogene,1,411,chr11_87944403_87944814
Gm11510,11,88432986,88433514,processed_pseudogene,-1,528,chr11_88432986_88433514
Gm11513,11,95032759,95038283,antisense,1,5524,chr11_95032759_95038283
Gm11514,11,95176813,95177244,processed_pseudogene,1,431,chr11_95176813_95177244
Gm11516,11,90859767,90861348,processed_pseudogene,-1,1581,chr11_90859767_90861348
Gm11517,11,96795439,96795825,processed_pseudogene,-1,386,chr11_96795439_96795825
Gm11524,11,96870195,96871001,processed_pseudogene,1,806,chr11_96870195_96871001
Gm11525,11,96918941,96922493,antisense,-1,3552,chr11_96918941_96922493
Gm11529,11,96448323,96464547,processed_transcript,-1,16224,chr11_96448323_96464547
Gm11531,11,96392112,96392666,processed_pseudogene,1,554,chr11_96392112_96392666
Gm11533,11,97037007,97037483,processed_pseudogene,1,476,chr11_97037007_97037483
Gm11539,11,96248633,96249189,processed_pseudogene,1,556,chr11_96248633_96249189
Gm11541,11,94694498,94704499,protein_coding,-1,10001,chr11_94694498_94704499
Gm11549,3,36515057,36532384,protein_coding,-1,17327,chr3_36515057_36532384
Gm11550,3,36539383,36540081,processed_pseudogene,-1,698,chr3_36539383_36540081
Gm11557,11,99678126,99679133,processed_pseudogene,1,1007,chr11_99678126_99679133
Gm11560,11,99932162,99933109,processed_pseudogene,1,947,chr11_99932162_99933109
Gm11578,1,60592251,60592709,processed_pseudogene,-1,458,chr1_60592251_60592709
Gm11581,1,60809116,60815639,processed_pseudogene,1,6523,chr1_60809116_60815639
Gm11582,1,60948230,60982012,processed_pseudogene,-1,33782,chr1_60948230_60982012
Gm11585,11,102124072,102124640,processed_pseudogene,1,568,chr11_102124072_102124640
Gm11592,11,97280128,97282897,antisense,1,2769,chr11_97280128_97282897
Gm11598,11,100243273,100243629,processed_pseudogene,1,356,chr11_100243273_100243629
Gm11604,11,98185366,98186107,processed_pseudogene,1,741,chr11_98185366_98186107
Gm11605,1,63364720,63365365,processed_pseudogene,-1,645,chr1_63364720_63365365
Gm11608,1,63266848,63273120,lincRNA,-1,6272,chr1_63266848_63273120
Gm11620,11,105164776,105166620,processed_pseudogene,-1,1844,chr11_105164776_105166620
Gm11621,11,104928216,104928804,processed_pseudogene,1,588,chr11_104928216_104928804
Gm11625,11,101476226,101476521,processed_pseudogene,1,295,chr11_101476226_101476521
Gm11627,11,102576398,102579461,protein_coding,-1,3063,chr11_102576398_102579461
Gm11634,11,101593743,101599256,protein_coding,-1,5513,chr11_101593743_101599256
Gm11637,11,102731301,102732063,processed_pseudogene,-1,762,chr11_102731301_102732063
Gm11643,11,103600242,103601105,processed_pseudogene,-1,863,chr11_103600242_103601105
Gm11652,11,105773518,105774784,processed_pseudogene,1,1266,chr11_105773518_105774784
Gm11653,11,105875905,105876913,processed_pseudogene,1,1008,chr11_105875905_105876913
Gm11658,11,109159187,109160194,processed_pseudogene,-1,1007,chr11_109159187_109160194
Gm11661,11,104565400,104566726,transcribed_processed_pseudogene,-1,1326,chr11_104565400_104566726
Gm11662,11,104679105,104680655,processed_pseudogene,-1,1550,chr11_104679105_104680655
Gm11665,11,104556789,104557777,antisense,-1,988,chr11_104556789_104557777
Gm11675,11,111276100,111276931,processed_pseudogene,1,831,chr11_111276100_111276931
Gm11677,11,111724648,111725624,processed_pseudogene,-1,976,chr11_111724648_111725624
Gm11681,11,112792731,112799008,lincRNA,-1,6277,chr11_112792731_112799008
Gm11682,11,110544507,110546399,lincRNA,1,1892,chr11_110544507_110546399
Gm11687,2,144142488,144143373,processed_pseudogene,-1,885,chr2_144142488_144143373
Gm11689,11,114664608,114664909,processed_pseudogene,1,301,chr11_114664608_114664909
Gm11696,11,109352835,109363654,antisense,-1,10819,chr11_109352835_109363654
Gm11701,2,144364127,144365627,processed_pseudogene,-1,1500,chr2_144364127_144365627
Gm11708,11,107003909,107004740,processed_pseudogene,-1,831,chr11_107003909_107004740
Gm11713,11,107410390,107413549,antisense,1,3159,chr11_107410390_107413549
Gm11716,11,107338050,107344804,antisense,1,6754,chr11_107338050_107344804
Gm11718,11,107191094,107191630,processed_pseudogene,1,536,chr11_107191094_107191630
Gm11732,11,117426178,117438866,processed_transcript,1,12688,chr11_117426178_117438866
Gm11734,11,117523603,117532205,lincRNA,1,8602,chr11_117523603_117532205
Gm11735,11,116739062,116749833,unprocessed_pseudogene,-1,10771,chr11_116739062_116749833
Gm11738,11,118114855,118118279,antisense,1,3424,chr11_118114855_118118279
Gm11743,2,144756329,144758582,processed_pseudogene,1,2253,chr2_144756329_144758582
Gm11747,11,118444200,118454995,antisense,-1,10795,chr11_118444200_118454995
Gm11760,4,74044388,74045183,processed_pseudogene,1,795,chr4_74044388_74045183
Gm11762,11,119548630,119569046,processed_transcript,1,20416,chr11_119548630_119569046
Gm11764,2,145892082,145892704,processed_pseudogene,1,622,chr2_145892082_145892704
Gm11765,4,81455943,81461732,processed_pseudogene,-1,5789,chr4_81455943_81461732
Gm11769,11,120150562,120152341,processed_transcript,1,1779,chr11_120150562_120152341
Gm11783,4,3258349,3259233,processed_pseudogene,1,884,chr4_3258349_3259233
Gm11784,4,3386846,3388691,unprocessed_pseudogene,1,1845,chr4_3386846_3388691
Gm11787,4,3496978,3516515,unprocessed_pseudogene,-1,19537,chr4_3496978_3516515
Gm11788,11,120489406,120492394,antisense,-1,2988,chr11_120489406_120492394
Gm11793,11,121106147,121107127,processed_pseudogene,-1,980,chr11_121106147_121107127
Gm11796,4,5854516,5855487,processed_pseudogene,-1,971,chr4_5854516_5855487
Gm11802,4,6688169,6704160,antisense,1,15991,chr4_6688169_6704160
Gm11805,4,3720427,3721026,processed_pseudogene,-1,599,chr4_3720427_3721026
Gm11808,4,3973092,3973595,protein_coding,-1,503,chr4_3973092_3973595
Gm11809,4,8672633,8673582,processed_pseudogene,-1,949,chr4_8672633_8673582
Gm11810,4,8456166,8456498,processed_pseudogene,-1,332,chr4_8456166_8456498
Gm11814,4,10438815,10439743,processed_pseudogene,-1,928,chr4_10438815_10439743
Gm11816,4,9283972,9287391,antisense,-1,3419,chr4_9283972_9287391
Gm11820,4,13076140,13096806,lincRNA,1,20666,chr4_13076140_13096806
Gm11821,4,11400346,11401324,processed_pseudogene,1,978,chr4_11400346_11401324
Gm11824,4,14170066,14170911,processed_pseudogene,1,845,chr4_14170066_14170911
Gm11826,4,13482755,13483192,processed_pseudogene,-1,437,chr4_13482755_13483192
Gm11827,4,11122805,11126998,lincRNA,1,4193,chr4_11122805_11126998
Gm11829,4,11133327,11133608,processed_pseudogene,1,281,chr4_11133327_11133608
Gm11832,4,11611139,11615007,antisense,-1,3868,chr4_11611139_11615007
Gm11833,4,11649647,11650499,processed_pseudogene,-1,852,chr4_11649647_11650499
Gm11836,4,14433891,14434331,processed_pseudogene,1,440,chr4_14433891_14434331
Gm11837,4,14929908,14953030,antisense,1,23122,chr4_14929908_14953030
Gm11839,4,12114284,12116236,processed_pseudogene,1,1952,chr4_12114284_12116236
Gm11841,4,12125290,12127252,processed_pseudogene,1,1962,chr4_12125290_12127252
Gm11844,4,15022582,15031987,antisense,1,9405,chr4_15022582_15031987
Gm11847,4,12232833,12233951,processed_pseudogene,1,1118,chr4_12232833_12233951
Gm11848,4,17032688,17033660,processed_pseudogene,-1,972,chr4_17032688_17033660
Gm11853,4,18472189,18474298,processed_pseudogene,1,2109,chr4_18472189_18474298
Gm11855,4,15819074,15821370,processed_pseudogene,-1,2296,chr4_15819074_15821370
Gm11857,4,15636169,15636492,processed_pseudogene,1,323,chr4_15636169_15636492
Gm11860,4,18009218,18010227,processed_pseudogene,-1,1009,chr4_18009218_18010227
Gm11864,4,16390445,16391664,processed_pseudogene,-1,1219,chr4_16390445_16391664
Gm11865,4,16246269,16249514,processed_pseudogene,1,3245,chr4_16246269_16249514
Gm11868,4,18844202,18845679,processed_pseudogene,-1,1477,chr4_18844202_18845679
Gm11869,4,15969572,15969928,processed_pseudogene,-1,356,chr4_15969572_15969928
Gm11870,4,16011005,16012326,processed_pseudogene,-1,1321,chr4_16011005_16012326
Gm11873,4,20391096,20392399,processed_pseudogene,1,1303,chr4_20391096_20392399
Gm11875,4,21626380,21627178,processed_pseudogene,1,798,chr4_21626380_21627178
Gm11877,4,19298333,19299184,processed_pseudogene,1,851,chr4_19298333_19299184
Gm11878,4,22519628,22520027,processed_pseudogene,1,399,chr4_22519628_22520027
Gm11884,4,23260784,23392503,lincRNA,1,131719,chr4_23260784_23392503
Gm11885,4,22006762,22008189,processed_pseudogene,-1,1427,chr4_22006762_22008189
Gm11889,4,23517362,23518440,processed_pseudogene,-1,1078,chr4_23517362_23518440
Gm11892,4,24238100,24239301,processed_pseudogene,1,1201,chr4_24238100_24239301
Gm11893,4,25541791,25542281,processed_pseudogene,-1,490,chr4_25541791_25542281
Gm11895,4,25867989,25868455,processed_pseudogene,-1,466,chr4_25867989_25868455
Gm11896,4,25538850,25539669,processed_pseudogene,1,819,chr4_25538850_25539669
Gm11897,4,25353702,25354529,processed_pseudogene,-1,827,chr4_25353702_25354529
Gm11907,4,28353783,28354789,processed_pseudogene,1,1006,chr4_28353783_28354789
Gm11914,4,27867149,27867655,processed_pseudogene,-1,506,chr4_27867149_27867655
Gm11920,4,30701973,30702535,processed_pseudogene,-1,562,chr4_30701973_30702535
Gm11922,4,31380472,31380946,processed_pseudogene,1,474,chr4_31380472_31380946
Gm11927,4,32051738,32052914,processed_pseudogene,1,1176,chr4_32051738_32052914
Gm11929,4,32207148,32208092,processed_pseudogene,1,944,chr4_32207148_32208092
Gm11930,4,33201764,33201953,processed_pseudogene,1,189,chr4_33201764_33201953
Gm11931,4,33053838,33054284,processed_pseudogene,-1,446,chr4_33053838_33054284
Gm11942,4,32964888,32965232,processed_pseudogene,1,344,chr4_32964888_32965232
Gm11944,11,3308996,3320722,processed_transcript,1,11726,chr11_3308996_3320722
Gm11946,11,3530157,3536856,processed_transcript,1,6699,chr11_3530157_3536856
Gm11949,11,3625477,3625848,processed_pseudogene,-1,371,chr11_3625477_3625848
Gm11951,11,3633012,3633442,processed_pseudogene,-1,430,chr11_3633012_3633442
Gm11952,11,3872955,3873775,processed_pseudogene,1,820,chr11_3872955_3873775
Gm11953,11,3951714,3952716,processed_pseudogene,1,1002,chr11_3951714_3952716
Gm11956,11,4230754,4231265,processed_pseudogene,-1,511,chr11_4230754_4231265
Gm11957,11,4129372,4130150,processed_pseudogene,-1,778,chr11_4129372_4130150
Gm11960,11,4561780,4564637,transcribed_processed_pseudogene,1,2857,chr11_4561780_4564637
Gm11961,11,4620275,4630011,antisense,-1,9736,chr11_4620275_4630011
Gm11962,11,5495192,5495446,processed_pseudogene,-1,254,chr11_5495192_5495446
Gm11963,11,5498840,5505699,antisense,1,6859,chr11_5498840_5505699
Gm11964,11,5634139,5634582,processed_pseudogene,1,443,chr11_5634139_5634582
Gm11967,11,5915315,5916731,antisense,1,1416,chr11_5915315_5916731
Gm11977,11,6781678,6783138,processed_pseudogene,-1,1460,chr11_6781678_6783138
Gm11978,11,6650148,6660233,transcribed_processed_pseudogene,-1,10085,chr11_6650148_6660233
Gm11980,11,6685824,6686809,processed_pseudogene,1,985,chr11_6685824_6686809
Gm11992,11,9048594,9069356,protein_coding,1,20762,chr11_9048594_9069356
Gm11993,11,9149778,9150597,processed_pseudogene,-1,819,chr11_9149778_9150597
Gm11996,11,10239337,10240251,processed_pseudogene,1,914,chr11_10239337_10240251
Gm12002,11,12314514,12351028,antisense,1,36514,chr11_12314514_12351028
Gm12003,11,12936834,12937938,processed_pseudogene,-1,1104,chr11_12936834_12937938
Gm12004,11,12997666,12998383,processed_pseudogene,1,717,chr11_12997666_12998383
Gm12007,11,14722617,14723213,processed_pseudogene,1,596,chr11_14722617_14723213
Gm12009,11,15049158,15050257,processed_pseudogene,1,1099,chr11_15049158_15050257
Gm12010,11,15482306,15489473,processed_pseudogene,1,7167,chr11_15482306_15489473
Gm12011,11,16236929,16237546,processed_pseudogene,1,617,chr11_16236929_16237546
Gm12014,11,17017852,17022080,processed_pseudogene,1,4228,chr11_17017852_17022080
Gm12017,11,17973788,17974790,processed_pseudogene,-1,1002,chr11_17973788_17974790
Gm12018,11,18095986,18103384,lincRNA,1,7398,chr11_18095986_18103384
Gm12019,11,18206413,18206944,processed_pseudogene,-1,531,chr11_18206413_18206944
Gm12020,11,18325630,18327671,processed_pseudogene,-1,2041,chr11_18325630_18327671
Gm12021,11,18508037,18509940,processed_pseudogene,-1,1903,chr11_18508037_18509940
Gm12024,11,18577227,18578479,processed_pseudogene,-1,1252,chr11_18577227_18578479
Gm12026,11,19383685,19384708,processed_pseudogene,1,1023,chr11_19383685_19384708
Gm12033,11,20335012,20336013,processed_pseudogene,-1,1001,chr11_20335012_20336013
Gm12034,11,20446412,20446810,processed_pseudogene,1,398,chr11_20446412_20446810
Gm12035,11,20574567,20575189,processed_pseudogene,-1,622,chr11_20574567_20575189
Gm12041,11,21227655,21228256,processed_pseudogene,1,601,chr11_21227655_21228256
Gm12045,11,21491314,21491886,processed_pseudogene,1,572,chr11_21491314_21491886
Gm12046,11,21493625,21493955,processed_pseudogene,-1,330,chr11_21493625_21493955
Gm12047,11,21877007,21877950,processed_pseudogene,-1,943,chr11_21877007_21877950
Gm12052,11,22617408,22618487,lincRNA,1,1079,chr11_22617408_22618487
Gm12056,11,22734038,22737937,lincRNA,1,3899,chr11_22734038_22737937
Gm12057,11,22758599,22760025,processed_pseudogene,-1,1426,chr11_22758599_22760025
Gm12058,11,22786811,22787247,processed_pseudogene,-1,436,chr11_22786811_22787247
Gm12059,11,23067998,23075574,processed_transcript,1,7576,chr11_23067998_23075574
Gm12067,11,24552438,24553962,processed_pseudogene,-1,1524,chr11_24552438_24553962
Gm12069,11,25301263,25322786,lincRNA,1,21523,chr11_25301263_25322786
Gm12070,11,26786633,26787634,processed_pseudogene,1,1001,chr11_26786633_26787634
Gm12080,11,28046035,28049117,processed_pseudogene,1,3082,chr11_28046035_28049117
Gm12085,11,29333383,29334322,processed_pseudogene,-1,939,chr11_29333383_29334322
Gm12091,11,29601784,29602613,processed_pseudogene,-1,829,chr11_29601784_29602613
Gm12092,11,29612324,29645509,lincRNA,-1,33185,chr11_29612324_29645509
Gm12096,11,30528295,30529401,processed_pseudogene,1,1106,chr11_30528295_30529401
Gm12098,11,30568182,30568898,processed_pseudogene,-1,716,chr11_30568182_30568898
Gm12099,11,30705152,30705901,processed_pseudogene,-1,749,chr11_30705152_30705901
Gm12102,11,31003295,31003898,processed_pseudogene,-1,603,chr11_31003295_31003898
Gm12103,11,30822309,30822670,processed_pseudogene,-1,361,chr11_30822309_30822670
Gm12104,11,30906942,30907920,processed_pseudogene,-1,978,chr11_30906942_30907920
Gm12108,11,32095261,32101228,lincRNA,-1,5967,chr11_32095261_32101228
Gm12109,11,32185005,32185701,processed_pseudogene,1,696,chr11_32185005_32185701
Gm12110,11,32880362,32880940,processed_pseudogene,-1,578,chr11_32880362_32880940
Gm12111,11,32903137,32926160,lincRNA,-1,23023,chr11_32903137_32926160
Gm12115,11,33172919,33173365,processed_pseudogene,1,446,chr11_33172919_33173365
Gm12117,11,33275758,33276737,protein_coding,-1,979,chr11_33275758_33276737
Gm12118,11,33438449,33438980,processed_pseudogene,1,531,chr11_33438449_33438980
Gm12119,11,33695894,33697908,antisense,1,2014,chr11_33695894_33697908
Gm12121,11,34141827,34143421,lincRNA,1,1594,chr11_34141827_34143421
Gm12129,11,38219069,38220215,processed_pseudogene,1,1146,chr11_38219069_38220215
Gm12130,11,38493330,38520013,lincRNA,-1,26683,chr11_38493330_38520013
Gm12136,11,40569317,40570525,processed_pseudogene,-1,1208,chr11_40569317_40570525
Gm12138,11,40672906,40673856,processed_pseudogene,-1,950,chr11_40672906_40673856
Gm12142,11,41591122,41592034,processed_pseudogene,1,912,chr11_41591122_41592034
Gm12149,11,43615117,43616329,processed_pseudogene,-1,1212,chr11_43615117_43616329
Gm12153,11,43959089,44134987,lincRNA,1,175898,chr11_43959089_44134987
Gm12161,11,45280594,45280954,processed_pseudogene,-1,360,chr11_45280594_45280954
Gm12163,11,45813604,45813992,processed_pseudogene,1,388,chr11_45813604_45813992
Gm12164,11,45829319,45829869,processed_pseudogene,1,550,chr11_45829319_45829869
Gm12165,11,46036440,46036781,processed_pseudogene,1,341,chr11_46036440_46036781
Gm12166,11,46051354,46052321,protein_coding,-1,967,chr11_46051354_46052321
Gm12168,11,46450980,46451347,processed_pseudogene,-1,367,chr11_46450980_46451347
Gm12169,11,46524212,46538156,protein_coding,1,13944,chr11_46524212_46538156
Gm12171,11,46544209,46557067,lincRNA,1,12858,chr11_46544209_46557067
Gm12174,11,46727818,46728630,processed_pseudogene,1,812,chr11_46727818_46728630
Gm12179,11,48551253,48552524,processed_pseudogene,-1,1271,chr11_48551253_48552524
Gm12180,11,48568355,48569015,processed_pseudogene,1,660,chr11_48568355_48569015
Gm12182,11,48734554,48735561,processed_pseudogene,-1,1007,chr11_48734554_48735561
Gm12183,11,48751867,48753714,processed_pseudogene,-1,1847,chr11_48751867_48753714
Gm12184,11,48825346,48826655,protein_coding,-1,1309,chr11_48825346_48826655
Gm12185,11,48904656,48992226,protein_coding,-1,87570,chr11_48904656_48992226
Gm12186,11,48996674,48997713,processed_pseudogene,-1,1039,chr11_48996674_48997713
Gm12188,11,49000950,49088543,processed_pseudogene,-1,87593,chr11_49000950_49088543
Gm12191,11,49678710,49679057,processed_pseudogene,-1,347,chr11_49678710_49679057
Gm12192,11,49697880,49698366,processed_pseudogene,1,486,chr11_49697880_49698366
Gm12194,11,50126907,50127918,processed_pseudogene,-1,1011,chr11_50126907_50127918
Gm12196,11,50347628,50347889,processed_pseudogene,1,261,chr11_50347628_50347889
Gm12201,11,51106631,51107869,processed_pseudogene,1,1238,chr11_51106631_51107869
Gm12216,11,53783418,53859256,protein_coding,-1,75838,chr11_53783418_53859256
Gm12219,11,53967063,53967505,processed_pseudogene,-1,442,chr11_53967063_53967505
Gm12220,11,53929305,53929476,unprocessed_pseudogene,-1,171,chr11_53929305_53929476
Gm12221,11,54158926,54160056,processed_pseudogene,1,1130,chr11_54158926_54160056
Gm12222,11,54199433,54199692,processed_pseudogene,1,259,chr11_54199433_54199692
Gm12223,11,54247600,54254495,antisense,1,6895,chr11_54247600_54254495
Gm12226,11,54401092,54401967,processed_pseudogene,1,875,chr11_54401092_54401967
Gm12235,11,55463840,55464009,processed_pseudogene,-1,169,chr11_55463840_55464009
Gm12236,11,55514846,55527715,antisense,1,12869,chr11_55514846_55527715
Gm12238,11,55482706,55482829,sense_intronic,1,123,chr11_55482706_55482829
Gm12241,11,56459349,56460074,processed_pseudogene,1,725,chr11_56459349_56460074
Gm12242,11,57449107,57449844,processed_pseudogene,1,737,chr11_57449107_57449844
Gm12245,11,57948729,57949085,processed_pseudogene,-1,356,chr11_57948729_57949085
Gm12247,11,58097104,58097773,processed_pseudogene,-1,669,chr11_58097104_58097773
Gm12248,11,58063552,58093134,protein_coding,-1,29582,chr11_58063552_58093134
Gm12250,11,58187739,58189012,processed_pseudogene,1,1273,chr11_58187739_58189012
Gm12251,11,58392769,58393560,processed_pseudogene,-1,791,chr11_58392769_58393560
Gm12253,11,58432559,58441622,protein_coding,1,9063,chr11_58432559_58441622
Gm12261,11,59577992,59578636,processed_pseudogene,-1,644,chr11_59577992_59578636
Gm12263,11,59474284,59475765,processed_pseudogene,-1,1481,chr11_59474284_59475765
Gm12266,11,60343245,60344206,processed_pseudogene,1,961,chr11_60343245_60344206
Gm12267,11,60449210,60449970,processed_pseudogene,-1,760,chr11_60449210_60449970
Gm12268,11,60446743,60447184,processed_pseudogene,1,441,chr11_60446743_60447184
Gm12271,11,61416402,61416815,processed_pseudogene,-1,413,chr11_61416402_61416815
Gm12274,11,61973966,61974350,processed_pseudogene,-1,384,chr11_61973966_61974350
Gm12279,11,62550047,62551041,antisense,-1,994,chr11_62550047_62551041
Gm12285,11,63241243,63241475,processed_pseudogene,-1,232,chr11_63241243_63241475
Gm12286,11,63312310,63313311,processed_pseudogene,-1,1001,chr11_63312310_63313311
Gm12289,11,64012615,64015224,antisense,1,2609,chr11_64012615_64015224
Gm12290,11,64164573,64182171,lincRNA,1,17598,chr11_64164573_64182171
Gm12292,11,64840600,64843753,lincRNA,-1,3153,chr11_64840600_64843753
Gm12293,11,65169844,65170433,processed_pseudogene,-1,589,chr11_65169844_65170433
Gm12295,11,65277654,65365798,lincRNA,-1,88144,chr11_65277654_65365798
Gm12297,11,66563607,66564585,processed_pseudogene,1,978,chr11_66563607_66564585
Gm12304,11,68095580,68095964,processed_pseudogene,-1,384,chr11_68095580_68095964
Gm12310,11,69950798,69951289,processed_pseudogene,1,491,chr11_69950798_69951289
Gm12312,11,70358138,70358781,processed_pseudogene,1,643,chr11_70358138_70358781
Gm12315,11,70623027,70625561,lincRNA,-1,2534,chr11_70623027_70625561
Gm12318,11,70762107,70762379,processed_pseudogene,-1,272,chr11_70762107_70762379
Gm12320,11,70748705,70755151,lincRNA,-1,6446,chr11_70748705_70755151
Gm12321,11,71057166,71057969,processed_pseudogene,-1,803,chr11_71057166_71057969
Gm12322,11,70909257,70909645,processed_pseudogene,-1,388,chr11_70909257_70909645
Gm12326,11,71739397,71740466,lincRNA,-1,1069,chr11_71739397_71740466
Gm12327,11,73641786,73645155,unprocessed_pseudogene,1,3369,chr11_73641786_73645155
Gm12331,11,74077519,74078140,processed_pseudogene,-1,621,chr11_74077519_74078140
Gm12332,11,74322546,74323467,processed_pseudogene,1,921,chr11_74322546_74323467
Gm12335,11,75066436,75066762,processed_pseudogene,-1,326,chr11_75066436_75066762
Gm12337,11,75427753,75428152,processed_pseudogene,1,399,chr11_75427753_75428152
Gm12338,11,75599763,75599954,processed_pseudogene,-1,191,chr11_75599763_75599954
Gm12341,11,76514069,76514571,processed_pseudogene,1,502,chr11_76514069_76514571
Gm12344,11,77107852,77108180,processed_pseudogene,-1,328,chr11_77107852_77108180
Gm12345,11,77149628,77150525,processed_pseudogene,1,897,chr11_77149628_77150525
Gm12346,11,77293444,77295898,transcribed_processed_pseudogene,1,2454,chr11_77293444_77295898
Gm12348,11,100401508,100402252,processed_transcript,1,744,chr11_100401508_100402252
Gm12350,4,34485832,34486293,processed_pseudogene,1,461,chr4_34485832_34486293
Gm12359,11,98797707,98810087,antisense,-1,12380,chr11_98797707_98810087
Gm12361,4,34919129,34920520,processed_pseudogene,1,1391,chr4_34919129_34920520
Gm12362,4,34941008,34941349,processed_pseudogene,-1,341,chr4_34941008_34941349
Gm12363,4,34842985,34843652,processed_pseudogene,1,667,chr4_34842985_34843652
Gm12365,4,35436214,35436781,processed_pseudogene,1,567,chr4_35436214_35436781
Gm12366,4,35202103,35202975,processed_pseudogene,-1,872,chr4_35202103_35202975
Gm12369,4,36003238,36004179,processed_pseudogene,-1,941,chr4_36003238_36004179
Gm12370,4,36444070,36444875,processed_pseudogene,1,805,chr4_36444070_36444875
Gm12371,4,36952966,36988032,lincRNA,1,35066,chr4_36952966_36988032
Gm12374,4,37249403,37332515,lincRNA,1,83112,chr4_37249403_37332515
Gm12382,4,38663809,38664730,processed_pseudogene,1,921,chr4_38663809_38664730
Gm12384,4,39823430,39824348,processed_pseudogene,1,918,chr4_39823430_39824348
Gm12385,4,39767618,39768412,processed_pseudogene,1,794,chr4_39767618_39768412
Gm12397,4,40912741,40913355,processed_pseudogene,-1,614,chr4_40912741_40913355
Gm12399,3,98669854,98678331,unprocessed_pseudogene,-1,8477,chr3_98669854_98678331
Gm12400,3,98680832,98688182,unprocessed_pseudogene,-1,7350,chr3_98680832_98688182
Gm12403,4,41168646,41169604,processed_pseudogene,1,958,chr4_41168646_41169604
Gm12404,4,41520694,41525823,processed_transcript,1,5129,chr4_41520694_41525823
Gm12405,4,41642185,41643077,antisense,1,892,chr4_41642185_41643077
Gm12407,4,41791989,41793601,unprocessed_pseudogene,-1,1612,chr4_41791989_41793601
Gm12408,4,45639744,45646111,lincRNA,1,6367,chr4_45639744_45646111
Gm12409,4,45762377,45764223,processed_transcript,-1,1846,chr4_45762377_45764223
Gm12411,4,45550017,45550499,processed_pseudogene,1,482,chr4_45550017_45550499
Gm12413,4,85245451,85245762,processed_pseudogene,-1,311,chr4_85245451_85245762
Gm12416,4,84104895,84105902,processed_pseudogene,1,1007,chr4_84104895_84105902
Gm12418,4,84915896,84916837,processed_pseudogene,1,941,chr4_84915896_84916837
Gm12419,4,84923554,84924189,processed_pseudogene,-1,635,chr4_84923554_84924189
Gm12420,4,84697863,84698910,processed_pseudogene,1,1047,chr4_84697863_84698910
Gm12426,4,47197487,47208459,antisense,-1,10972,chr4_47197487_47208459
Gm12428,3,98821038,98821764,processed_pseudogene,1,726,chr3_98821038_98821764
Gm12430,4,47453632,47454953,processed_pseudogene,1,1321,chr4_47453632_47454953
Gm12435,4,48344215,48345230,processed_pseudogene,-1,1015,chr4_48344215_48345230
Gm12444,4,46243014,46243890,processed_pseudogene,-1,876,chr4_46243014_46243890
Gm12445,4,46273819,46274840,processed_pseudogene,-1,1021,chr4_46273819_46274840
Gm12447,4,46327296,46327765,processed_pseudogene,1,469,chr4_46327296_46327765
Gm12451,4,49396112,49407732,unprocessed_pseudogene,1,11620,chr4_49396112_49407732
Gm12452,4,49412307,49412637,processed_pseudogene,1,330,chr4_49412307_49412637
Gm12460,4,51190107,51190463,processed_pseudogene,1,356,chr4_51190107_51190463
Gm12463,4,44752277,44753125,processed_pseudogene,-1,848,chr4_44752277_44753125
Gm12464,3,100413560,100414575,processed_pseudogene,1,1015,chr3_100413560_100414575
Gm12466,4,52240903,52241522,processed_pseudogene,1,619,chr4_52240903_52241522
Gm12468,4,53877925,53878328,processed_pseudogene,1,403,chr4_53877925_53878328
Gm12474,3,100489664,100523920,lincRNA,1,34256,chr3_100489664_100523920
Gm12475,4,52360823,52362211,processed_pseudogene,-1,1388,chr4_52360823_52362211
Gm12479,4,54853128,54854712,processed_pseudogene,1,1584,chr4_54853128_54854712
Gm12481,4,43664043,43664339,processed_pseudogene,1,296,chr4_43664043_43664339
Gm12482,4,52821488,52822117,processed_pseudogene,1,629,chr4_52821488_52822117
Gm12486,3,101206859,101207399,processed_pseudogene,-1,540,chr3_101206859_101207399
Gm12490,3,101260917,101261476,processed_pseudogene,1,559,chr3_101260917_101261476
Gm12492,4,43798896,43800255,processed_pseudogene,-1,1359,chr4_43798896_43800255
Gm12496,4,53401948,53404030,lincRNA,-1,2082,chr4_53401948_53404030
Gm12497,3,107979632,107979868,processed_pseudogene,1,236,chr3_107979632_107979868
Gm12500,3,108085584,108088011,antisense,1,2427,chr3_108085584_108088011
Gm12501,3,108239383,108239911,processed_pseudogene,-1,528,chr3_108239383_108239911
Gm12503,4,44092632,44109311,processed_transcript,1,16679,chr4_44092632_44109311
Gm12504,4,44121893,44124123,transcribed_processed_pseudogene,1,2230,chr4_44121893_44124123
Gm12506,4,55605149,55636901,lincRNA,1,31752,chr4_55605149_55636901
Gm12508,4,55254740,55255219,processed_pseudogene,1,479,chr4_55254740_55255219
Gm12519,4,55969023,55993739,lincRNA,-1,24716,chr4_55969023_55993739
Gm12522,3,108379277,108383741,processed_transcript,-1,4464,chr3_108379277_108383741
Gm12527,4,59368303,59368866,processed_pseudogene,-1,563,chr4_59368303_59368866
Gm12530,4,57172071,57176554,antisense,1,4483,chr4_57172071_57176554
Gm12532,3,37182885,37188593,lincRNA,1,5708,chr3_37182885_37188593
Gm12536,4,57300096,57307305,lincRNA,1,7209,chr4_57300096_57307305
Gm12537,4,57370953,57371954,processed_pseudogene,-1,1001,chr4_57370953_57371954
Gm12538,4,57413711,57414196,processed_pseudogene,-1,485,chr4_57413711_57414196
Gm12539,4,57455561,57457549,processed_pseudogene,-1,1988,chr4_57455561_57457549
Gm12543,4,59833677,59834219,transcribed_processed_pseudogene,1,542,chr4_59833677_59834219
Gm12565,3,37599424,37600072,processed_pseudogene,-1,648,chr3_37599424_37600072
Gm12568,11,46243571,46244194,processed_pseudogene,-1,623,chr11_46243571_46244194
Gm12569,11,51220473,51235053,protein_coding,1,14580,chr11_51220473_51235053
Gm12570,11,58688073,58689102,processed_pseudogene,-1,1029,chr11_58688073_58689102
Gm12571,11,78149196,78149438,processed_pseudogene,-1,242,chr11_78149196_78149438
Gm12576,11,83817682,83849493,lincRNA,-1,31811,chr11_83817682_83849493
Gm12577,4,58483252,58483825,processed_pseudogene,-1,573,chr4_58483252_58483825
Gm12582,3,37077655,37078351,processed_pseudogene,1,696,chr3_37077655_37078351
Gm12583,3,37108174,37109026,processed_pseudogene,1,852,chr3_37108174_37109026
Gm12586,11,121856773,121861227,unprocessed_pseudogene,1,4454,chr11_121856773_121861227
Gm12589,11,121803107,121810319,lincRNA,1,7212,chr11_121803107_121810319
Gm12591,11,121968211,121970685,unprocessed_pseudogene,-1,2474,chr11_121968211_121970685
Gm12596,4,59260051,59263269,lincRNA,1,3218,chr4_59260051_59263269
Gm12598,11,11312433,11313262,processed_pseudogene,1,829,chr11_11312433_11313262
Gm12599,11,11436984,11437775,processed_pseudogene,1,791,chr11_11436984_11437775
Gm12604,4,87580789,87581560,processed_pseudogene,1,771,chr4_87580789_87581560
Gm12608,4,89442217,89444644,processed_pseudogene,-1,2427,chr4_89442217_89444644
Gm12609,4,89381957,89399880,processed_transcript,1,17923,chr4_89381957_89399880
Gm12610,4,89421848,89463487,processed_transcript,1,41639,chr4_89421848_89463487
Gm12611,11,60816375,60817747,processed_pseudogene,1,1372,chr11_60816375_60817747
Gm12617,11,60692695,60693075,processed_pseudogene,-1,380,chr11_60692695_60693075
Gm12618,11,60818796,60819278,processed_pseudogene,-1,482,chr11_60818796_60819278
Gm12622,11,60560924,60561305,processed_pseudogene,-1,381,chr11_60560924_60561305
Gm12623,11,60573567,60575549,processed_pseudogene,-1,1982,chr11_60573567_60575549
Gm12628,11,60571623,60572210,unprocessed_pseudogene,-1,587,chr11_60571623_60572210
Gm12630,4,86817794,86818577,processed_pseudogene,-1,783,chr4_86817794_86818577
Gm12632,4,90856883,90857377,processed_pseudogene,1,494,chr4_90856883_90857377
Gm12634,4,90368731,90369722,processed_pseudogene,1,991,chr4_90368731_90369722
Gm12635,4,90452874,90453625,processed_pseudogene,1,751,chr4_90452874_90453625
Gm12636,4,90543747,90544370,processed_pseudogene,-1,623,chr4_90543747_90544370
Gm12641,4,93106988,93109914,processed_pseudogene,1,2926,chr4_93106988_93109914
Gm12642,4,93265413,93266288,processed_pseudogene,-1,875,chr4_93265413_93266288
Gm12644,4,91156682,91157287,processed_pseudogene,1,605,chr4_91156682_91157287
Gm12650,4,93802333,93802590,processed_pseudogene,1,257,chr4_93802333_93802590
Gm12653,4,91365379,91365939,processed_pseudogene,1,560,chr4_91365379_91365939
Gm12656,4,94497032,94497608,processed_pseudogene,1,576,chr4_94497032_94497608
Gm12657,4,94599385,94599795,processed_pseudogene,1,410,chr4_94599385_94599795
Gm12664,11,16643009,16643921,processed_pseudogene,-1,912,chr11_16643009_16643921
Gm12666,4,92190744,92191749,protein_coding,-1,1005,chr4_92190744_92191749
Gm12669,4,91805547,91806555,processed_pseudogene,-1,1008,chr4_91805547_91806555
Gm12671,4,91851668,91852669,processed_pseudogene,-1,1001,chr4_91851668_91852669
Gm12684,4,99430256,99431254,processed_pseudogene,-1,998,chr4_99430256_99431254
Gm12687,4,99615817,99616522,processed_pseudogene,-1,705,chr4_99615817_99616522
Gm12691,4,98146065,98150261,transcribed_processed_pseudogene,-1,4196,chr4_98146065_98150261
Gm12692,4,98234745,98235290,processed_pseudogene,-1,545,chr4_98234745_98235290
Gm12693,4,94935621,94936103,processed_pseudogene,1,482,chr4_94935621_94936103
Gm12696,4,97521428,97522332,processed_pseudogene,-1,904,chr4_97521428_97522332
Gm12700,4,100581278,100581734,processed_pseudogene,1,456,chr4_100581278_100581734
Gm12709,4,102967266,102989755,antisense,-1,22489,chr4_102967266_102989755
Gm12715,4,103563402,103564529,processed_pseudogene,1,1127,chr4_103563402_103564529
Gm12716,4,103543374,103544727,processed_pseudogene,-1,1353,chr4_103543374_103544727
Gm12717,4,103940959,103941941,processed_pseudogene,1,982,chr4_103940959_103941941
Gm12722,4,105374454,105374946,processed_pseudogene,-1,492,chr4_105374454_105374946
Gm12727,4,106098924,106099282,processed_pseudogene,1,358,chr4_106098924_106099282
Gm12728,4,105789869,105794711,protein_coding,1,4842,chr4_105789869_105794711
Gm12733,11,77644144,77644910,processed_pseudogene,-1,766,chr11_77644144_77644910
Gm12734,11,77542133,77543080,processed_pseudogene,1,947,chr11_77542133_77543080
Gm12738,4,108450807,108451342,processed_pseudogene,-1,535,chr4_108450807_108451342
Gm12741,4,108731742,108732297,processed_pseudogene,1,555,chr4_108731742_108732297
Gm12749,4,109373701,109374859,processed_pseudogene,-1,1158,chr4_109373701_109374859
Gm12751,4,34354043,34354423,processed_pseudogene,1,380,chr4_34354043_34354423
Gm12752,4,34380171,34380981,processed_pseudogene,-1,810,chr4_34380171_34380981
Gm12755,7,33998012,34006461,unprocessed_pseudogene,1,8449,chr7_33998012_34006461
Gm12757,7,33879295,33880094,processed_pseudogene,1,799,chr7_33879295_33880094
Gm12758,7,34234377,34240207,antisense,1,5830,chr7_34234377_34240207
Gm12774,7,34383659,34384074,processed_pseudogene,1,415,chr7_34383659_34384074
Gm12781,7,34653184,34660416,antisense,1,7232,chr7_34653184_34660416
Gm12786,4,107017935,107022499,antisense,-1,4564,chr4_107017935_107022499
Gm12787,4,98268083,98268575,processed_pseudogene,-1,492,chr4_98268083_98268575
Gm12791,4,101875347,101876001,processed_pseudogene,1,654,chr4_101875347_101876001
Gm12792,4,101895964,101896982,processed_pseudogene,-1,1018,chr4_101895964_101896982
Gm12799,4,102046568,102049127,processed_pseudogene,-1,2559,chr4_102046568_102049127
Gm128,3,95236920,95241598,protein_coding,-1,4678,chr3_95236920_95241598
Gm12804,4,111290118,111291116,processed_pseudogene,1,998,chr4_111290118_111291116
Gm12805,4,111319558,111320605,processed_pseudogene,-1,1047,chr4_111319558_111320605
Gm12807,4,110512771,110513732,processed_pseudogene,-1,961,chr4_110512771_110513732
Gm12816,4,112955075,112956286,processed_pseudogene,-1,1211,chr4_112955075_112956286
Gm12830,4,114821722,114856166,protein_coding,1,34444,chr4_114821722_114856166
Gm12833,4,115480800,115481276,processed_pseudogene,1,476,chr4_115480800_115481276
Gm12834,4,115238754,115241582,processed_pseudogene,-1,2828,chr4_115238754_115241582
Gm12842,4,117825181,117825656,processed_pseudogene,-1,475,chr4_117825181_117825656
Gm12844,4,117728718,117729299,processed_pseudogene,-1,581,chr4_117728718_117729299
Gm12846,4,98664366,98666137,processed_pseudogene,1,1771,chr4_98664366_98666137
Gm12848,4,115652389,115653480,processed_pseudogene,1,1091,chr4_115652389_115653480
Gm12851,4,98855614,98856034,processed_pseudogene,1,420,chr4_98855614_98856034
Gm12852,4,99103060,99103778,processed_pseudogene,-1,718,chr4_99103060_99103778
Gm12853,4,118632847,118636062,antisense,-1,3215,chr4_118632847_118636062
Gm12855,4,118791081,118791593,processed_pseudogene,-1,512,chr4_118791081_118791593
Gm12857,4,118522018,118522609,processed_pseudogene,1,591,chr4_118522018_118522609
Gm12859,4,118490782,118497642,processed_pseudogene,-1,6860,chr4_118490782_118497642
Gm12864,4,118987014,118988019,processed_pseudogene,1,1005,chr4_118987014_118988019
Gm12870,4,107327484,107328499,processed_pseudogene,-1,1015,chr4_107327484_107328499
Gm12874,4,122592984,122594068,processed_pseudogene,1,1084,chr4_122592984_122594068
Gm12882,4,121114789,121115305,processed_pseudogene,-1,516,chr4_121114789_121115305
Gm12892,4,121984265,122009338,processed_pseudogene,1,25073,chr4_121984265_122009338
Gm12899,4,107688128,107688678,processed_pseudogene,1,550,chr4_107688128_107688678
Gm12900,4,123274900,123275472,processed_pseudogene,-1,572,chr4_123274900_123275472
Gm12901,4,123258046,123258904,processed_pseudogene,1,858,chr4_123258046_123258904
Gm12906,4,107760025,107760465,processed_pseudogene,-1,440,chr4_107760025_107760465
Gm12907,4,107765080,107770601,lincRNA,1,5521,chr4_107765080_107770601
Gm12912,4,75147609,75148989,processed_pseudogene,1,1380,chr4_75147609_75148989
Gm12915,4,124735730,124751354,processed_transcript,-1,15624,chr4_124735730_124751354
Gm12916,4,124293693,124299848,lincRNA,-1,6155,chr4_124293693_124299848
Gm12917,4,124718999,124719637,processed_pseudogene,1,638,chr4_124718999_124719637
Gm12918,4,10848420,10849055,processed_pseudogene,1,635,chr4_10848420_10849055
Gm12919,4,10853843,10855436,processed_pseudogene,1,1593,chr4_10853843_10855436
Gm12920,4,10813543,10814728,processed_pseudogene,1,1185,chr4_10813543_10814728
Gm12922,4,123709219,123710027,processed_pseudogene,-1,808,chr4_123709219_123710027
Gm12924,4,123435617,123435934,processed_pseudogene,1,317,chr4_123435617_123435934
Gm12925,4,123665881,123671217,antisense,1,5336,chr4_123665881_123671217
Gm12933,4,126665254,126666125,processed_pseudogene,1,871,chr4_126665254_126666125
Gm12943,4,127141279,127141488,processed_pseudogene,-1,209,chr4_127141279_127141488
Gm12947,4,127408379,127408798,processed_pseudogene,-1,419,chr4_127408379_127408798
Gm12955,4,119519126,119520082,processed_pseudogene,-1,956,chr4_119519126_119520082
Gm12956,4,119509648,119510061,processed_pseudogene,-1,413,chr4_119509648_119510061
Gm12957,4,119520990,119521366,processed_pseudogene,1,376,chr4_119520990_119521366
Gm12961,4,111790621,111791670,processed_pseudogene,-1,1049,chr4_111790621_111791670
Gm12963,4,130024256,130047774,antisense,-1,23518,chr4_130024256_130047774
Gm12966,4,129899093,129899902,processed_pseudogene,1,809,chr4_129899093_129899902
Gm12967,4,129761628,129761916,processed_pseudogene,-1,288,chr4_129761628_129761916
Gm12969,4,128868393,128869396,processed_pseudogene,-1,1003,chr4_128868393_128869396
Gm12976,4,129261965,129265010,lincRNA,1,3045,chr4_129261965_129265010
Gm12977,4,133871830,133876533,antisense,1,4703,chr4_133871830_133876533
Gm12983,4,135290366,135290675,processed_pseudogene,-1,309,chr4_135290366_135290675
Gm12984,4,135307349,135309519,antisense,1,2170,chr4_135307349_135309519
Gm12986,4,136608840,136609806,processed_pseudogene,-1,966,chr4_136608840_136609806
Gm12988,4,135756218,135756695,processed_pseudogene,-1,477,chr4_135756218_135756695
Gm12989,4,135715868,135716598,processed_pseudogene,-1,730,chr4_135715868_135716598
Gm12992,4,131899478,131920029,processed_transcript,-1,20551,chr4_131899478_131920029
Gm12996,4,116824903,116830603,antisense,1,5700,chr4_116824903_116830603
Gm12998,4,116945732,116946534,processed_pseudogene,-1,802,chr4_116945732_116946534
Gm13003,4,137159082,137165066,lincRNA,-1,5984,chr4_137159082_137165066
Gm13005,4,137219760,137220399,processed_pseudogene,-1,639,chr4_137219760_137220399
Gm13007,4,135997523,135997887,processed_pseudogene,1,364,chr4_135997523_135997887
Gm13015,4,117148923,117149126,processed_pseudogene,1,203,chr4_117148923_117149126
Gm13021,4,140422524,140431931,lincRNA,1,9407,chr4_140422524_140431931
Gm13024,4,145390943,145391660,processed_pseudogene,1,717,chr4_145390943_145391660
Gm13025,4,140679753,140684617,lincRNA,1,4864,chr4_140679753_140684617
Gm13031,4,140947666,140957902,antisense,-1,10236,chr4_140947666_140957902
Gm13033,4,132884763,132886626,processed_pseudogene,1,1863,chr4_132884763_132886626
Gm13034,4,146067752,146070928,processed_pseudogene,1,3176,chr4_146067752_146070928
Gm13036,4,146058776,146059523,processed_pseudogene,1,747,chr4_146058776_146059523
Gm13039,4,143166603,143167396,processed_pseudogene,1,793,chr4_143166603_143167396
Gm13042,4,143458378,143460538,processed_pseudogene,-1,2160,chr4_143458378_143460538
Gm13047,4,141084864,141085678,processed_pseudogene,1,814,chr4_141084864_141085678
Gm13056,4,141278439,141279794,lincRNA,1,1355,chr4_141278439_141279794
Gm13067,4,150049013,150056976,lincRNA,1,7963,chr4_150049013_150056976
Gm13076,4,141356888,141357091,processed_pseudogene,-1,203,chr4_141356888_141357091
Gm13082,4,143671124,143671684,processed_pseudogene,1,560,chr4_143671124_143671684
Gm13104,4,144041033,144042478,processed_pseudogene,-1,1445,chr4_144041033_144042478
Gm13120,4,144296692,144298137,processed_pseudogene,1,1445,chr4_144296692_144298137
Gm13121,4,144526411,144527042,processed_pseudogene,-1,631,chr4_144526411_144527042
Gm13126,4,144545506,144548568,processed_pseudogene,-1,3062,chr4_144545506_144548568
Gm13127,4,144587244,144588632,processed_pseudogene,1,1388,chr4_144587244_144588632
Gm13133,4,154550282,154557645,antisense,1,7363,chr4_154550282_154557645
Gm13135,4,147275976,147279096,processed_pseudogene,1,3120,chr4_147275976_147279096
Gm13136,4,147735477,147738426,processed_pseudogene,-1,2949,chr4_147735477_147738426
Gm13140,4,146942476,146945825,processed_pseudogene,1,3349,chr4_146942476_146945825
Gm13142,4,147102327,147103981,processed_pseudogene,1,1654,chr4_147102327_147103981
Gm13146,4,147187708,147188487,processed_pseudogene,1,779,chr4_147187708_147188487
Gm13148,4,147745817,147746561,processed_pseudogene,-1,744,chr4_147745817_147746561
Gm13160,4,147086358,147086984,processed_pseudogene,-1,626,chr4_147086358_147086984
Gm13161,4,147443471,147444029,processed_pseudogene,1,558,chr4_147443471_147444029
Gm13171,4,155502316,155502706,processed_pseudogene,-1,390,chr4_155502316_155502706
Gm13172,4,152677748,152678003,processed_pseudogene,-1,255,chr4_152677748_152678003
Gm13176,2,4834136,4834612,processed_pseudogene,-1,476,chr2_4834136_4834612
Gm13179,2,4586024,4587287,antisense,-1,1263,chr2_4586024_4587287
Gm13181,2,3686362,3687430,processed_pseudogene,1,1068,chr2_3686362_3687430
Gm13182,2,3550757,3551068,processed_pseudogene,1,311,chr2_3550757_3551068
Gm13192,2,4959545,4959752,processed_pseudogene,-1,207,chr2_4959545_4959752
Gm13194,2,4942174,4942484,processed_pseudogene,1,310,chr2_4942174_4942484
Gm13196,2,4700238,4700616,processed_pseudogene,1,378,chr2_4700238_4700616
Gm13197,2,5283650,5283874,processed_pseudogene,1,224,chr2_5283650_5283874
Gm13198,2,5156392,5157217,processed_pseudogene,1,825,chr2_5156392_5157217
Gm13199,2,5862080,5862934,protein_coding,-1,854,chr2_5862080_5862934
Gm13207,4,148031554,148032326,processed_pseudogene,1,772,chr4_148031554_148032326
Gm13212,4,145585166,145625345,protein_coding,1,40179,chr4_145585166_145625345
Gm13213,4,133638210,133638683,processed_pseudogene,-1,473,chr4_133638210_133638683
Gm13215,4,132148413,132148884,processed_pseudogene,-1,471,chr4_132148413_132148884
Gm13216,2,5603571,5604161,processed_pseudogene,1,590,chr2_5603571_5604161
Gm13217,2,9041124,9042484,unprocessed_pseudogene,-1,1360,chr2_9041124_9042484
Gm13223,4,145455633,145456379,processed_pseudogene,1,746,chr4_145455633_145456379
Gm13226,4,145576889,145577292,processed_pseudogene,-1,403,chr4_145576889_145577292
Gm13231,4,145641357,145644399,processed_pseudogene,1,3042,chr4_145641357_145644399
Gm13234,4,145632504,145633250,processed_pseudogene,1,746,chr4_145632504_145633250
Gm13238,4,145837219,145837998,processed_pseudogene,1,779,chr4_145837219_145837998
Gm13239,4,145689842,145690478,processed_pseudogene,1,636,chr4_145689842_145690478
Gm13249,4,145646771,145647115,processed_pseudogene,-1,344,chr4_145646771_145647115
Gm13257,4,133479356,133482526,antisense,-1,3170,chr4_133479356_133482526
Gm13260,2,11607433,11608696,processed_pseudogene,-1,1263,chr2_11607433_11608696
Gm13261,2,10339283,10374041,processed_transcript,-1,34758,chr2_10339283_10374041
Gm13262,2,9906178,9914678,antisense,1,8500,chr2_9906178_9914678
Gm13266,2,14512591,14542811,processed_transcript,1,30220,chr2_14512591_14542811
Gm13267,2,5895510,5900131,antisense,1,4621,chr2_5895510_5900131
Gm13268,2,14626889,14627321,processed_pseudogene,-1,432,chr2_14626889_14627321
Gm13269,2,14740372,14767024,antisense,-1,26652,chr2_14740372_14767024
Gm13292,2,11409031,11410030,processed_pseudogene,-1,999,chr2_11409031_11410030
Gm13293,2,11339488,11344111,lincRNA,1,4623,chr2_11339488_11344111
Gm13294,2,11098933,11100262,processed_pseudogene,-1,1329,chr2_11098933_11100262
Gm13296,2,11420224,11421220,processed_pseudogene,1,996,chr2_11420224_11421220
Gm13297,2,11090830,11091763,processed_pseudogene,1,933,chr2_11090830_11091763
Gm13301,4,42216908,42236330,transcribed_unprocessed_pseudogene,1,19422,chr4_42216908_42236330
Gm13305,4,42158842,42168603,protein_coding,-1,9761,chr4_42158842_42168603
Gm13306,4,42153436,42158839,protein_coding,1,5403,chr4_42153436_42158839
Gm13310,2,12082612,12083992,processed_pseudogene,-1,1380,chr2_12082612_12083992
Gm13313,2,15127600,15128683,processed_pseudogene,1,1083,chr2_15127600_15128683
Gm13315,2,14721134,14722124,processed_pseudogene,1,990,chr2_14721134_14722124
Gm13316,2,14811848,14812538,processed_pseudogene,-1,690,chr2_14811848_14812538
Gm13321,2,12421627,12422026,processed_pseudogene,-1,399,chr2_12421627_12422026
Gm13323,2,17796834,17797984,processed_pseudogene,-1,1150,chr2_17796834_17797984
Gm13325,2,17169225,17170030,processed_pseudogene,1,805,chr2_17169225_17170030
Gm13326,2,16978821,16979831,processed_pseudogene,-1,1010,chr2_16978821_16979831
Gm13328,2,20235045,20236064,processed_pseudogene,-1,1019,chr2_20235045_20236064
Gm13332,2,19101701,19103098,processed_pseudogene,-1,1397,chr2_19101701_19103098
Gm13333,2,18758984,18759764,processed_pseudogene,1,780,chr2_18758984_18759764
Gm13337,2,22067826,22069419,processed_pseudogene,1,1593,chr2_22067826_22069419
Gm13338,2,22713511,22713871,processed_pseudogene,1,360,chr2_22713511_22713871
Gm13347,2,19677251,19678603,processed_pseudogene,1,1352,chr2_19677251_19678603
Gm13348,2,19634034,19636986,antisense,-1,2952,chr2_19634034_19636986
Gm1335,2,93940299,93940878,processed_pseudogene,-1,579,chr2_93940299_93940878
Gm13350,2,18249365,18249843,processed_pseudogene,-1,478,chr2_18249365_18249843
Gm13355,2,18641786,18642102,processed_pseudogene,-1,316,chr2_18641786_18642102
Gm13359,2,26722387,26723081,processed_pseudogene,-1,694,chr2_26722387_26723081
Gm13360,2,20037096,20037894,processed_pseudogene,-1,798,chr2_20037096_20037894
Gm13361,2,19965967,19967397,processed_pseudogene,-1,1430,chr2_19965967_19967397
Gm13363,2,19992921,19993442,processed_pseudogene,1,521,chr2_19992921_19993442
Gm13365,2,15396748,15397720,processed_pseudogene,1,972,chr2_15396748_15397720
Gm13368,2,15481912,15482341,processed_pseudogene,1,429,chr2_15481912_15482341
Gm13370,2,24985984,24986466,processed_pseudogene,1,482,chr2_24985984_24986466
Gm13372,2,28025417,28030437,processed_transcript,-1,5020,chr2_28025417_28030437
Gm13373,2,28315016,28324050,lincRNA,-1,9034,chr2_28315016_28324050
Gm13375,2,20969054,20969997,antisense,1,943,chr2_20969054_20969997
Gm13377,2,21044808,21141954,unprocessed_pseudogene,-1,97146,chr2_21044808_21141954
Gm13378,2,21244105,21244440,processed_pseudogene,1,335,chr2_21244105_21244440
Gm13379,2,21442909,21443529,processed_pseudogene,-1,620,chr2_21442909_21443529
Gm13383,2,6255946,6257266,lincRNA,-1,1320,chr2_6255946_6257266
Gm13384,2,6132208,6133956,processed_pseudogene,-1,1748,chr2_6132208_6133956
Gm13386,2,28807708,28807831,processed_pseudogene,-1,123,chr2_28807708_28807831
Gm13387,2,25122603,25145396,lincRNA,-1,22793,chr2_25122603_25145396
Gm13388,2,6431786,6436033,antisense,-1,4247,chr2_6431786_6436033
Gm13394,2,28933610,28934609,processed_pseudogene,-1,999,chr2_28933610_28934609
Gm13396,2,29093835,29094105,processed_pseudogene,-1,270,chr2_29093835_29094105
Gm13397,2,27034680,27035557,processed_pseudogene,1,877,chr2_27034680_27035557
Gm13398,2,27037285,27040853,protein_coding,1,3568,chr2_27037285_27040853
Gm13400,2,30923978,30924357,processed_pseudogene,-1,379,chr2_30923978_30924357
Gm13406,2,34436327,34436582,processed_pseudogene,-1,255,chr2_34436327_34436582
Gm13408,2,34564999,34565796,processed_pseudogene,1,797,chr2_34564999_34565796
Gm13410,2,24178834,24180317,processed_pseudogene,1,1483,chr2_24178834_24180317
Gm13413,2,32406055,32406656,processed_pseudogene,1,601,chr2_32406055_32406656
Gm13414,2,34649514,34650240,processed_pseudogene,-1,726,chr2_34649514_34650240
Gm13415,2,24440418,24486855,processed_transcript,1,46437,chr2_24440418_24486855
Gm13416,2,24592902,24594513,processed_pseudogene,-1,1611,chr2_24592902_24594513
Gm13418,2,24494068,24495011,processed_pseudogene,1,943,chr2_24494068_24495011
Gm13420,2,29744919,29751685,protein_coding,-1,6766,chr2_29744919_29751685
Gm13422,2,23235236,23235739,processed_pseudogene,1,503,chr2_23235236_23235739
Gm13423,2,23202033,23203683,processed_pseudogene,1,1650,chr2_23202033_23203683
Gm13426,2,31551901,31552695,processed_pseudogene,-1,794,chr2_31551901_31552695
Gm13429,2,36202314,36212903,processed_transcript,1,10589,chr2_36202314_36212903
Gm13435,2,37207051,37208073,processed_pseudogene,1,1022,chr2_37207051_37208073
Gm13436,2,36807826,36808392,processed_pseudogene,-1,566,chr2_36807826_36808392
Gm13444,2,35483384,35483905,processed_pseudogene,-1,521,chr2_35483384_35483905
Gm13445,2,35491213,35491519,processed_pseudogene,-1,306,chr2_35491213_35491519
Gm13446,2,35549538,35558702,processed_transcript,-1,9164,chr2_35549538_35558702
Gm13450,2,34964738,34964904,processed_pseudogene,-1,166,chr2_34964738_34964904
Gm13451,2,39558142,39558733,processed_pseudogene,-1,591,chr2_39558142_39558733
Gm13453,2,40127504,40127860,processed_pseudogene,-1,356,chr2_40127504_40127860
Gm13456,2,40555752,40557116,processed_pseudogene,1,1364,chr2_40555752_40557116
Gm13461,2,41987473,41988829,processed_pseudogene,-1,1356,chr2_41987473_41988829
Gm13462,2,40958391,40959351,processed_pseudogene,1,960,chr2_40958391_40959351
Gm13464,2,43518464,43519398,processed_pseudogene,-1,934,chr2_43518464_43519398
Gm13466,2,45809472,45810470,processed_pseudogene,1,998,chr2_45809472_45810470
Gm13470,2,46419535,46442710,lincRNA,-1,23175,chr2_46419535_46442710
Gm13474,2,38973947,38976816,unprocessed_pseudogene,1,2869,chr2_38973947_38976816
Gm13477,2,44788265,44790951,processed_pseudogene,1,2686,chr2_44788265_44790951
Gm13478,2,45647191,45647603,processed_pseudogene,1,412,chr2_45647191_45647603
Gm13479,2,45357265,45404035,lincRNA,1,46770,chr2_45357265_45404035
Gm13481,2,48062548,48457245,lincRNA,-1,394697,chr2_48062548_48457245
Gm13483,2,50296810,50433967,lincRNA,1,137157,chr2_50296810_50433967
Gm13486,2,50409332,50409613,processed_pseudogene,1,281,chr2_50409332_50409613
Gm13487,2,50522124,50522987,processed_pseudogene,-1,863,chr2_50522124_50522987
Gm13490,2,51656966,51732009,lincRNA,-1,75043,chr2_51656966_51732009
Gm13493,2,51871126,51871618,processed_pseudogene,-1,492,chr2_51871126_51871618
Gm13497,2,51241831,51295945,lincRNA,1,54114,chr2_51241831_51295945
Gm13498,2,50909684,50911849,processed_pseudogene,1,2165,chr2_50909684_50911849
Gm13500,2,51231987,51232810,processed_pseudogene,1,823,chr2_51231987_51232810
Gm13501,2,53397509,53398487,processed_pseudogene,-1,978,chr2_53397509_53398487
Gm13502,2,53696121,53696804,processed_pseudogene,-1,683,chr2_53696121_53696804
Gm13503,2,53551926,53552371,processed_pseudogene,1,445,chr2_53551926_53552371
Gm13505,2,54240569,54241385,processed_pseudogene,1,816,chr2_54240569_54241385
Gm13510,2,49185018,49185446,processed_pseudogene,1,428,chr2_49185018_49185446
Gm13517,2,55775548,55777042,processed_pseudogene,1,1494,chr2_55775548_55777042
Gm13527,2,57079748,57080438,processed_pseudogene,1,690,chr2_57079748_57080438
Gm13530,2,33489782,33503632,lincRNA,1,13850,chr2_33489782_33503632
Gm13531,2,57425167,57425709,processed_pseudogene,-1,542,chr2_57425167_57425709
Gm13534,2,58108060,58108572,processed_pseudogene,1,512,chr2_58108060_58108572
Gm13535,2,57272564,57275686,processed_pseudogene,-1,3122,chr2_57272564_57275686
Gm13543,2,37672208,37673003,processed_pseudogene,1,795,chr2_37672208_37673003
Gm13544,2,58276779,58286902,antisense,1,10123,chr2_58276779_58286902
Gm13547,2,29759312,29764089,protein_coding,1,4777,chr2_29759312_29764089
Gm13549,2,59398986,59399781,processed_pseudogene,-1,795,chr2_59398986_59399781
Gm13551,2,59396488,59396917,processed_pseudogene,1,429,chr2_59396488_59396917
Gm13552,2,59564268,59564684,processed_pseudogene,-1,416,chr2_59564268_59564684
Gm13559,2,58740639,58741501,processed_pseudogene,1,862,chr2_58740639_58741501
Gm13561,2,62357071,62470913,antisense,1,113842,chr2_62357071_62470913
Gm13562,2,26352645,26371952,processed_transcript,1,19307,chr2_26352645_26371952
Gm13566,2,60577537,60578678,processed_pseudogene,1,1141,chr2_60577537_60578678
Gm13570,2,60098406,60098714,processed_pseudogene,-1,308,chr2_60098406_60098714
Gm13571,2,60338188,60371234,antisense,1,33046,chr2_60338188_60371234
Gm13572,2,60037141,60038837,lincRNA,1,1696,chr2_60037141_60038837
Gm13578,2,64867999,64868588,processed_pseudogene,-1,589,chr2_64867999_64868588
Gm13582,2,60964376,60975151,lincRNA,-1,10775,chr2_60964376_60975151
Gm13584,2,38359580,38363980,antisense,-1,4400,chr2_38359580_38363980
Gm13588,2,38490104,38490238,processed_pseudogene,1,134,chr2_38490104_38490238
Gm13590,2,62668783,62670370,processed_pseudogene,-1,1587,chr2_62668783_62670370
Gm13592,2,65277417,65278426,processed_pseudogene,1,1009,chr2_65277417_65278426
Gm13597,2,68554555,68554929,processed_pseudogene,1,374,chr2_68554555_68554929
Gm13599,2,67309659,67396491,antisense,-1,86832,chr2_67309659_67396491
Gm13600,2,66863262,66864775,processed_pseudogene,1,1513,chr2_66863262_66864775
Gm13601,2,67491044,67516525,antisense,-1,25481,chr2_67491044_67516525
Gm13607,2,68081791,68082329,processed_pseudogene,1,538,chr2_68081791_68082329
Gm13608,2,31985059,31986464,processed_pseudogene,1,1405,chr2_31985059_31986464
Gm13611,2,32271845,32272162,processed_pseudogene,1,317,chr2_32271845_32272162
Gm13612,2,68831017,68831406,processed_pseudogene,1,389,chr2_68831017_68831406
Gm13623,2,69766182,69766806,processed_pseudogene,1,624,chr2_69766182_69766806
Gm13624,2,69799151,69799612,processed_pseudogene,-1,461,chr2_69799151_69799612
Gm13629,2,66440880,66546026,antisense,1,105146,chr2_66440880_66546026
Gm13630,2,66409494,66421588,processed_transcript,1,12094,chr2_66409494_66421588
Gm13642,2,71412537,71412917,processed_pseudogene,-1,380,chr2_71412537_71412917
Gm13649,2,77335359,77335964,processed_pseudogene,1,605,chr2_77335359_77335964
Gm13651,2,77291331,77292440,processed_pseudogene,1,1109,chr2_77291331_77292440
Gm13652,2,75124871,75137798,lincRNA,-1,12927,chr2_75124871_75137798
Gm13657,2,75777188,75782306,processed_transcript,1,5118,chr2_75777188_75782306
Gm13665,2,73116748,73117275,processed_pseudogene,1,527,chr2_73116748_73117275
Gm13666,2,73131745,73132543,processed_pseudogene,1,798,chr2_73131745_73132543
Gm13668,2,73959669,73960669,processed_pseudogene,-1,1000,chr2_73959669_73960669
Gm13669,2,75808358,75808814,processed_pseudogene,1,456,chr2_75808358_75808814
Gm13673,2,79359865,79360395,processed_pseudogene,1,530,chr2_79359865_79360395
Gm13674,2,80131930,80132752,processed_pseudogene,1,822,chr2_80131930_80132752
Gm13675,2,82507216,82507744,processed_pseudogene,1,528,chr2_82507216_82507744
Gm13676,2,82543932,82544522,processed_pseudogene,-1,590,chr2_82543932_82544522
Gm13677,2,82122517,82123111,processed_pseudogene,-1,594,chr2_82122517_82123111
Gm13679,2,83390129,83390612,processed_pseudogene,1,483,chr2_83390129_83390612
Gm13680,2,83353157,83353949,processed_pseudogene,-1,792,chr2_83353157_83353949
Gm13683,2,83451864,83458559,processed_pseudogene,1,6695,chr2_83451864_83458559
Gm13687,2,80499230,80499511,processed_pseudogene,1,281,chr2_80499230_80499511
Gm13688,2,80602733,80603340,processed_pseudogene,1,607,chr2_80602733_80603340
Gm13689,2,80549712,80550396,processed_pseudogene,-1,684,chr2_80549712_80550396
Gm13690,2,80629284,80629568,processed_pseudogene,-1,284,chr2_80629284_80629568
Gm13700,2,80861155,80862282,processed_pseudogene,-1,1127,chr2_80861155_80862282
Gm13707,2,73421909,73429142,antisense,1,7233,chr2_73421909_73429142
Gm13709,2,73370909,73379297,antisense,1,8388,chr2_73370909_73379297
Gm13710,2,84500760,84531322,lincRNA,-1,30562,chr2_84500760_84531322
Gm13712,2,85156101,85158642,unprocessed_pseudogene,-1,2541,chr2_85156101_85158642
Gm13715,2,85233675,85243678,lincRNA,1,10003,chr2_85233675_85243678
Gm13717,6,29750761,29751125,processed_pseudogene,1,364,chr6_29750761_29751125
Gm13719,2,86325641,86328569,processed_pseudogene,-1,2928,chr2_86325641_86328569
Gm13722,2,86090336,86093401,processed_pseudogene,-1,3065,chr2_86090336_86093401
Gm13728,2,87278915,87279314,processed_pseudogene,1,399,chr2_87278915_87279314
Gm13729,2,87304739,87305144,processed_pseudogene,1,405,chr2_87304739_87305144
Gm13730,2,87199934,87201395,processed_pseudogene,-1,1461,chr2_87199934_87201395
Gm13732,2,87264915,87265449,processed_pseudogene,1,534,chr2_87264915_87265449
Gm13733,2,87123834,87124368,processed_pseudogene,-1,534,chr2_87123834_87124368
Gm13735,2,87236572,87237241,processed_pseudogene,1,669,chr2_87236572_87237241
Gm13736,2,87526145,87526397,processed_pseudogene,1,252,chr2_87526145_87526397
Gm13743,2,87562997,87563720,processed_pseudogene,-1,723,chr2_87562997_87563720
Gm13744,2,87559920,87560769,processed_pseudogene,-1,849,chr2_87559920_87560769
Gm13748,1,64078654,64090782,antisense,1,12128,chr1_64078654_64090782
Gm13749,1,63964727,63968999,lincRNA,1,4272,chr1_63964727_63968999
Gm13750,1,64150201,64150665,processed_pseudogene,1,464,chr1_64150201_64150665
Gm13751,1,63844827,63845578,processed_pseudogene,-1,751,chr1_63844827_63845578
Gm13758,2,88572052,88579744,processed_pseudogene,1,7692,chr2_88572052_88579744
Gm13761,2,89181374,89182180,processed_pseudogene,-1,806,chr2_89181374_89182180
Gm13767,2,90358171,90383161,unprocessed_pseudogene,-1,24990,chr2_90358171_90383161
Gm13768,2,90174097,90195152,unprocessed_pseudogene,1,21055,chr2_90174097_90195152
Gm13770,2,91523580,91523884,processed_pseudogene,-1,304,chr2_91523580_91523884
Gm13772,2,90804260,90804576,processed_pseudogene,-1,316,chr2_90804260_90804576
Gm13776,2,91716159,91717419,processed_pseudogene,-1,1260,chr2_91716159_91717419
Gm13782,6,30673944,30682266,antisense,1,8322,chr6_30673944_30682266
Gm13785,2,92312154,92312843,processed_pseudogene,1,689,chr2_92312154_92312843
Gm13787,2,91344022,91344189,processed_pseudogene,-1,167,chr2_91344022_91344189
Gm13788,2,94590821,94591421,processed_pseudogene,-1,600,chr2_94590821_94591421
Gm13791,2,92856167,92913663,processed_transcript,-1,57496,chr2_92856167_92913663
Gm13803,2,97949191,97949679,processed_pseudogene,-1,488,chr2_97949191_97949679
Gm13809,2,99555251,99555878,processed_pseudogene,1,627,chr2_99555251_99555878
Gm13810,2,100626697,100628043,processed_pseudogene,-1,1346,chr2_100626697_100628043
Gm13817,2,92529694,92540980,lincRNA,-1,11286,chr2_92529694_92540980
Gm13830,5,115301120,115319208,lincRNA,1,18088,chr5_115301120_115319208
Gm13835,6,31141979,31142663,processed_pseudogene,-1,684,chr6_31141979_31142663
Gm13840,5,115515263,115515947,sense_intronic,1,684,chr5_115515263_115515947
Gm13841,5,115801677,115802159,processed_pseudogene,-1,482,chr5_115801677_115802159
Gm13848,6,31658173,31666131,lincRNA,-1,7958,chr6_31658173_31666131
Gm13853,6,33984989,33992411,lincRNA,-1,7422,chr6_33984989_33992411
Gm13854,6,33375111,33377446,processed_pseudogene,-1,2335,chr6_33375111_33377446
Gm13858,6,34379467,34380445,unprocessed_pseudogene,-1,978,chr6_34379467_34380445
Gm13861,6,34651354,34653894,lincRNA,-1,2540,chr6_34651354_34653894
Gm13864,6,34786679,34787463,processed_pseudogene,1,784,chr6_34786679_34787463
Gm13866,2,102209412,102210379,processed_pseudogene,-1,967,chr2_102209412_102210379
Gm13870,2,104537437,104538459,processed_pseudogene,1,1022,chr2_104537437_104538459
Gm13880,2,103819003,103819476,processed_pseudogene,-1,473,chr2_103819003_103819476
Gm13882,2,104291574,104292575,processed_pseudogene,1,1001,chr2_104291574_104292575
Gm13884,2,104556661,104557489,processed_pseudogene,1,828,chr2_104556661_104557489
Gm13886,2,104820179,104821361,processed_pseudogene,1,1182,chr2_104820179_104821361
Gm13888,2,105031866,105032287,processed_pseudogene,-1,421,chr2_105031866_105032287
Gm13889,2,93955810,93957201,protein_coding,-1,1391,chr2_93955810_93957201
Gm13899,6,17711687,17712941,processed_pseudogene,-1,1254,chr6_17711687_17712941
Gm13902,2,106926565,106927169,processed_pseudogene,-1,604,chr2_106926565_106927169
Gm13904,2,107010938,107011774,processed_pseudogene,1,836,chr2_107010938_107011774
Gm13912,2,108183716,108291319,lincRNA,-1,107603,chr2_108183716_108291319
Gm13914,2,108733212,108734202,processed_pseudogene,-1,990,chr2_108733212_108734202
Gm13915,2,108572594,108573524,processed_pseudogene,1,930,chr2_108572594_108573524
Gm13923,2,109022687,109025444,lincRNA,1,2757,chr2_109022687_109025444
Gm13924,2,109458248,109458733,processed_pseudogene,-1,485,chr2_109458248_109458733
Gm13928,2,111926259,111927990,processed_pseudogene,1,1731,chr2_111926259_111927990
Gm13930,2,111740105,111740834,processed_pseudogene,1,729,chr2_111740105_111740834
Gm13932,2,109791925,109792534,processed_pseudogene,-1,609,chr2_109791925_109792534
Gm13935,2,110418170,110419619,processed_pseudogene,-1,1449,chr2_110418170_110419619
Gm13937,2,110209178,110210165,processed_pseudogene,-1,987,chr2_110209178_110210165
Gm13941,2,111088372,111105982,protein_coding,-1,17610,chr2_111088372_111105982
Gm13944,2,77462669,77480938,antisense,1,18269,chr2_77462669_77480938
Gm13961,2,111182635,111187406,processed_pseudogene,1,4771,chr2_111182635_111187406
Gm13964,2,113500679,113504034,antisense,-1,3355,chr2_113500679_113504034
Gm13974,2,114854093,115043972,lincRNA,1,189879,chr2_114854093_115043972
Gm13982,2,117414392,117417697,lincRNA,-1,3305,chr2_117414392_117417697
Gm13983,2,118483313,118484177,processed_pseudogene,-1,864,chr2_118483313_118484177
Gm13985,2,117806678,117812813,lincRNA,-1,6135,chr2_117806678_117812813
Gm13986,2,117857291,118111202,processed_transcript,-1,253911,chr2_117857291_118111202
Gm13990,2,116848099,116877168,antisense,-1,29069,chr2_116848099_116877168
Gm13991,2,116527843,116528490,processed_pseudogene,-1,647,chr2_116527843_116528490
Gm14006,2,128557254,128558234,processed_pseudogene,-1,980,chr2_128557254_128558234
Gm14010,2,128423654,128424565,lincRNA,1,911,chr2_128423654_128424565
Gm14015,2,106463823,106523103,lincRNA,-1,59280,chr2_106463823_106523103
Gm14016,2,118594079,118594564,processed_pseudogene,1,485,chr2_118594079_118594564
Gm14018,2,121485432,121491512,unprocessed_pseudogene,1,6080,chr2_121485432_121491512
Gm14020,2,121718530,121719191,processed_pseudogene,1,661,chr2_121718530_121719191
Gm14021,2,121700765,121701725,processed_pseudogene,-1,960,chr2_121700765_121701725
Gm14023,2,129297370,129307826,processed_transcript,1,10456,chr2_129297370_129307826
Gm14026,2,129168700,129170488,processed_pseudogene,1,1788,chr2_129168700_129170488
Gm14028,2,128952972,128953450,processed_pseudogene,-1,478,chr2_128952972_128953450
Gm14032,2,55292065,55293090,processed_pseudogene,1,1025,chr2_55292065_55293090
Gm14034,2,54356341,54356891,processed_pseudogene,-1,550,chr2_54356341_54356891
Gm14035,2,54284115,54285589,processed_pseudogene,1,1474,chr2_54284115_54285589
Gm14038,2,134762824,134763630,processed_pseudogene,-1,806,chr2_134762824_134763630
Gm14040,2,129493570,129515807,sense_intronic,-1,22237,chr2_129493570_129515807
Gm14041,2,129565047,129566068,antisense,-1,1021,chr2_129565047_129566068
Gm14044,2,130384883,130385329,processed_pseudogene,-1,446,chr2_130384883_130385329
Gm14046,2,129749901,129750409,processed_pseudogene,1,508,chr2_129749901_129750409
Gm14048,2,130880866,130882133,processed_pseudogene,1,1267,chr2_130880866_130882133
Gm14049,2,130987984,130988619,processed_pseudogene,1,635,chr2_130987984_130988619
Gm14051,2,132144533,132220250,antisense,1,75717,chr2_132144533_132220250
Gm14052,2,132099869,132100899,processed_pseudogene,1,1030,chr2_132099869_132100899
Gm14056,2,136399062,136399703,processed_pseudogene,1,641,chr2_136399062_136399703
Gm14057,2,130803501,130803982,transcribed_processed_pseudogene,-1,481,chr2_130803501_130803982
Gm14061,2,138589392,138649122,lincRNA,1,59730,chr2_138589392_138649122
Gm14062,2,137870046,137876831,lincRNA,-1,6785,chr2_137870046_137876831
Gm14064,2,137663435,137829244,lincRNA,1,165809,chr2_137663435_137829244
Gm14065,2,138872023,138872607,unprocessed_pseudogene,1,584,chr2_138872023_138872607
Gm14082,2,143150830,143151630,processed_pseudogene,-1,800,chr2_143150830_143151630
Gm14089,2,118997068,119000684,antisense,1,3616,chr2_118997068_119000684
Gm14092,2,145550652,145554982,antisense,-1,4330,chr2_145550652_145554982
Gm14094,2,133199611,133200220,processed_pseudogene,1,609,chr2_133199611_133200220
Gm14103,2,133047187,133047552,processed_pseudogene,-1,365,chr2_133047187_133047552
Gm14108,2,148071346,148071839,processed_pseudogene,-1,493,chr2_148071346_148071839
Gm14111,2,146754707,146755705,processed_pseudogene,-1,998,chr2_146754707_146755705
Gm14113,2,147289755,147290730,processed_pseudogene,1,975,chr2_147289755_147290730
Gm14114,2,146828327,146839732,lincRNA,-1,11405,chr2_146828327_146839732
Gm14117,2,146305547,146306389,processed_pseudogene,1,842,chr2_146305547_146306389
Gm14121,2,150499466,150500845,transcribed_processed_pseudogene,-1,1379,chr2_150499466_150500845
Gm14122,2,150398256,150399399,processed_pseudogene,-1,1143,chr2_150398256_150399399
Gm14124,2,150257517,150270300,protein_coding,1,12783,chr2_150257517_150270300
Gm14125,2,150305528,150306516,transcribed_processed_pseudogene,1,988,chr2_150305528_150306516
Gm14128,2,150521093,150522300,processed_pseudogene,1,1207,chr2_150521093_150522300
Gm14130,2,149743175,149744161,processed_pseudogene,1,986,chr2_149743175_149744161
Gm14131,2,149356687,149357405,processed_pseudogene,1,718,chr2_149356687_149357405
Gm14132,2,149333071,149334789,processed_pseudogene,-1,1718,chr2_149333071_149334789
Gm14137,2,119174509,119177575,protein_coding,1,3066,chr2_119174509_119177575
Gm14138,2,119187517,119188261,processed_pseudogene,1,744,chr2_119187517_119188261
Gm14139,2,150181755,150193279,protein_coding,1,11524,chr2_150181755_150193279
Gm14140,2,150110582,150111576,processed_pseudogene,-1,994,chr2_150110582_150111576
Gm14141,2,150992182,150992964,processed_pseudogene,1,782,chr2_150992182_150992964
Gm14147,2,151098245,151103818,protein_coding,1,5573,chr2_151098245_151103818
Gm14148,2,151374008,151375047,processed_pseudogene,1,1039,chr2_151374008_151375047
Gm14149,2,151205195,151231614,lincRNA,1,26419,chr2_151205195_151231614
Gm14150,2,151458956,151460309,processed_pseudogene,1,1353,chr2_151458956_151460309
Gm14151,2,151086786,151092350,protein_coding,-1,5564,chr2_151086786_151092350
Gm14156,2,152467394,152467876,processed_pseudogene,1,482,chr2_152467394_152467876
Gm14162,2,152745707,152746307,processed_pseudogene,1,600,chr2_152745707_152746307
Gm14164,2,152345669,152375324,processed_transcript,1,29655,chr2_152345669_152375324
Gm14165,2,152353615,152354566,processed_pseudogene,1,951,chr2_152353615_152354566
Gm14167,2,151540731,151542348,antisense,-1,1617,chr2_151540731_151542348
Gm14169,2,156609206,156613422,processed_transcript,-1,4216,chr2_156609206_156613422
Gm14172,2,156632825,156633468,processed_pseudogene,-1,643,chr2_156632825_156633468
Gm14173,2,156410897,156411174,processed_pseudogene,-1,277,chr2_156410897_156411174
Gm14175,2,119284792,119285032,unprocessed_pseudogene,1,240,chr2_119284792_119285032
Gm14176,2,157901536,157902012,processed_pseudogene,1,476,chr2_157901536_157902012
Gm14197,2,154284213,154285261,processed_pseudogene,-1,1048,chr2_154284213_154285261
Gm14204,2,158595472,158610723,processed_transcript,-1,15251,chr2_158595472_158610723
Gm14210,2,135811945,135812927,lincRNA,-1,982,chr2_135811945_135812927
Gm14213,2,121049799,121050566,processed_pseudogene,1,767,chr2_121049799_121050566
Gm14214,2,154769255,154770030,protein_coding,-1,775,chr2_154769255_154770030
Gm14227,2,155198632,155199260,processed_pseudogene,-1,628,chr2_155198632_155199260
Gm14230,2,156833049,156839892,lincRNA,-1,6843,chr2_156833049_156839892
Gm14231,2,156789812,156790403,processed_pseudogene,-1,591,chr2_156789812_156790403
Gm14232,2,131159537,131171342,antisense,1,11805,chr2_131159537_131171342
Gm14234,2,168417730,168418574,processed_pseudogene,-1,844,chr2_168417730_168418574
Gm14239,2,155459501,155460892,processed_pseudogene,-1,1391,chr2_155459501_155460892
Gm14240,2,156056128,156056673,processed_pseudogene,1,545,chr2_156056128_156056673
Gm14245,2,127688405,127690247,processed_pseudogene,1,1842,chr2_127688405_127690247
Gm14248,2,156889464,156890007,processed_pseudogene,1,543,chr2_156889464_156890007
Gm14251,2,156322402,156322680,processed_pseudogene,1,278,chr2_156322402_156322680
Gm14253,2,156347202,156347840,processed_pseudogene,-1,638,chr2_156347202_156347840
Gm14263,2,170954079,170954824,processed_pseudogene,-1,745,chr2_170954079_170954824
Gm14264,2,170652434,170662465,lincRNA,-1,10031,chr2_170652434_170662465
Gm14269,2,170463514,170463819,processed_pseudogene,-1,305,chr2_170463514_170463819
Gm14270,2,170285035,170285880,processed_pseudogene,1,845,chr2_170285035_170285880
Gm14273,2,172324334,172338663,antisense,1,14329,chr2_172324334_172338663
Gm14274,2,172100621,172101235,processed_pseudogene,1,614,chr2_172100621_172101235
Gm14276,2,156994173,156994892,processed_pseudogene,-1,719,chr2_156994173_156994892
Gm14278,2,156888854,156915383,unprocessed_pseudogene,-1,26529,chr2_156888854_156915383
Gm14281,2,131846395,131847688,processed_pseudogene,1,1293,chr2_131846395_131847688
Gm14285,2,131561614,131563179,antisense,1,1565,chr2_131561614_131563179
Gm14288,2,175789357,175801093,protein_coding,-1,11736,chr2_175789357_175801093
Gm14292,2,179177425,179177880,processed_pseudogene,1,455,chr2_179177425_179177880
Gm14295,2,176798612,176811223,protein_coding,1,12611,chr2_176798612_176811223
Gm14303,2,172509521,172509691,processed_pseudogene,-1,170,chr2_172509521_172509691
Gm14305,2,176708328,176721813,protein_coding,1,13485,chr2_176708328_176721813
Gm14308,2,176613364,176636344,protein_coding,-1,22980,chr2_176613364_176636344
Gm14317,2,164550530,164559730,lincRNA,1,9200,chr2_164550530_164559730
Gm14321,2,167777467,167782569,lincRNA,1,5102,chr2_167777467_167782569
Gm14322,2,177759288,177770472,protein_coding,1,11184,chr2_177759288_177770472
Gm14325,2,177831791,177840336,protein_coding,-1,8545,chr2_177831791_177840336
Gm14326,2,177935993,177957297,protein_coding,-1,21304,chr2_177935993_177957297
Gm14327,2,177897096,177905784,protein_coding,1,8688,chr2_177897096_177905784
Gm14328,18,74303524,74303931,processed_pseudogene,-1,407,chr18_74303524_74303931
Gm14335,6,115638250,115639059,processed_pseudogene,-1,809,chr6_115638250_115639059
Gm14342,2,180829490,180889660,lincRNA,-1,60170,chr2_180829490_180889660
Gm14344,2,180836481,180848914,lincRNA,1,12433,chr2_180836481_180848914
Gm14373,X,5699727,5701884,processed_pseudogene,-1,2157,chrX_5699727_5701884
Gm14377,7,47110851,47125990,antisense,1,15139,chr7_47110851_47125990
Gm14379,X,7375925,7378042,processed_transcript,1,2117,chrX_7375925_7378042
Gm14388,7,122442023,122442499,processed_pseudogene,1,476,chr7_122442023_122442499
Gm14390,2,176754399,176757439,unprocessed_pseudogene,-1,3040,chr2_176754399_176757439
Gm14391,2,175191065,175206917,protein_coding,-1,15852,chr2_175191065_175206917
Gm14393,2,175061549,175067781,protein_coding,-1,6232,chr2_175061549_175067781
Gm14400,2,177225473,177228963,unprocessed_pseudogene,-1,3490,chr2_177225473_177228963
Gm14401,2,177074320,177087347,protein_coding,1,13027,chr2_177074320_177087347
Gm14403,2,177498215,177509763,protein_coding,1,11548,chr2_177498215_177509763
Gm14405,2,176851851,176855548,unprocessed_pseudogene,-1,3697,chr2_176851851_176855548
Gm14406,2,177569204,177578210,protein_coding,-1,9006,chr2_177569204_177578210
Gm14408,2,176831140,176836730,protein_coding,1,5590,chr2_176831140_176836730
Gm14409,2,177264654,177267036,protein_coding,-1,2382,chr2_177264654_177267036
Gm14410,2,177183453,177206421,protein_coding,-1,22968,chr2_177183453_177206421
Gm14411,2,177125463,177127709,unprocessed_pseudogene,-1,2246,chr2_177125463_177127709
Gm14412,2,177314520,177324307,protein_coding,-1,9787,chr2_177314520_177324307
Gm14414,2,177460275,177460847,processed_pseudogene,1,572,chr2_177460275_177460847
Gm14418,2,177387124,177398320,protein_coding,-1,11196,chr2_177387124_177398320
Gm14419,2,177000956,177012787,protein_coding,1,11831,chr2_177000956_177012787
Gm14425,2,74855706,74856311,transcribed_processed_pseudogene,1,605,chr2_74855706_74856311
Gm14427,2,74886372,74887006,processed_pseudogene,-1,634,chr2_74886372_74887006
Gm14437,2,165442264,165450485,antisense,1,8221,chr2_165442264_165450485
Gm14440,2,175275125,175286805,protein_coding,1,11680,chr2_175275125_175286805
Gm14441,2,22913293,22913832,processed_pseudogene,-1,539,chr2_22913293_22913832
Gm14450,X,5984772,5985011,processed_pseudogene,1,239,chrX_5984772_5985011
Gm14460,2,78512698,78513336,processed_pseudogene,-1,638,chr2_78512698_78513336
Gm14461,2,78237547,78302230,lincRNA,1,64683,chr2_78237547_78302230
Gm14465,2,79161029,79161595,processed_pseudogene,-1,566,chr2_79161029_79161595
Gm14470,X,10680964,10681429,processed_pseudogene,1,465,chrX_10680964_10681429
Gm14472,2,153413849,153414130,processed_pseudogene,1,281,chr2_153413849_153414130
Gm14473,X,10865077,10865633,processed_pseudogene,-1,556,chrX_10865077_10865633
Gm14480,X,10696932,10697364,processed_pseudogene,-1,432,chrX_10696932_10697364
Gm14486,2,30658468,30678011,lincRNA,-1,19543,chr2_30658468_30678011
Gm14487,2,30534729,30539022,lincRNA,1,4293,chr2_30534729_30539022
Gm14488,2,30713147,30720057,processed_transcript,-1,6910,chr2_30713147_30720057
Gm14491,X,11913091,11913289,processed_pseudogene,-1,198,chrX_11913091_11913289
Gm14494,2,153826171,153826605,processed_pseudogene,1,434,chr2_153826171_153826605
Gm14502,X,8830322,8830434,unprocessed_pseudogene,-1,112,chrX_8830322_8830434
Gm14503,X,9037157,9038320,processed_pseudogene,-1,1163,chrX_9037157_9038320
Gm14504,X,8922486,8923982,processed_pseudogene,-1,1496,chrX_8922486_8923982
Gm14506,X,13490498,13491033,processed_pseudogene,-1,535,chrX_13490498_13491033
Gm14510,X,8959312,8960403,processed_pseudogene,1,1091,chrX_8959312_8960403
Gm14517,X,15524425,15524761,processed_pseudogene,-1,336,chrX_15524425_15524761
Gm14527,X,29619027,29646381,unprocessed_pseudogene,-1,27354,chrX_29619027_29646381
Gm14532,6,31356743,31372369,lincRNA,1,15626,chr6_31356743_31372369
Gm14534,X,12944610,12944966,processed_pseudogene,-1,356,chrX_12944610_12944966
Gm14537,X,20391709,20392501,processed_pseudogene,1,792,chrX_20391709_20392501
Gm14538,X,20528256,20529582,processed_pseudogene,1,1326,chrX_20528256_20529582
Gm14539,X,20581141,20581314,processed_pseudogene,-1,173,chrX_20581141_20581314
Gm14554,X,35804769,35820640,unprocessed_pseudogene,1,15871,chrX_35804769_35820640
Gm14561,X,22226375,22228343,processed_pseudogene,-1,1968,chrX_22226375_22228343
Gm14562,X,22438876,22439418,processed_pseudogene,-1,542,chrX_22438876_22439418
Gm14563,X,22205170,22205523,processed_pseudogene,-1,353,chrX_22205170_22205523
Gm14567,X,38969817,38969990,processed_pseudogene,1,173,chrX_38969817_38969990
Gm14575,X,40661423,40661982,processed_pseudogene,1,559,chrX_40661423_40661982
Gm14578,X,42888730,42889120,processed_pseudogene,-1,390,chrX_42888730_42889120
Gm14584,X,53418331,53418967,processed_pseudogene,1,636,chrX_53418331_53418967
Gm14585,X,53314533,53315166,processed_pseudogene,1,633,chrX_53314533_53315166
Gm14586,X,52772342,52772749,processed_pseudogene,-1,407,chrX_52772342_52772749
Gm14607,X,52878243,52878733,processed_pseudogene,1,490,chrX_52878243_52878733
Gm14608,X,47586018,47587570,processed_pseudogene,1,1552,chrX_47586018_47587570
Gm14612,X,50373144,50374024,processed_pseudogene,1,880,chrX_50373144_50374024
Gm14615,X,42128195,42130723,processed_pseudogene,-1,2528,chrX_42128195_42130723
Gm14620,X,50542402,50542784,processed_pseudogene,-1,382,chrX_50542402_50542784
Gm14623,X,55862223,55876613,unprocessed_pseudogene,1,14390,chrX_55862223_55876613
Gm14627,X,56190932,56191498,processed_pseudogene,1,566,chrX_56190932_56191498
Gm14630,X,57631709,57631954,processed_pseudogene,-1,245,chrX_57631709_57631954
Gm14634,X,12762278,12821492,processed_transcript,1,59214,chrX_12762278_12821492
Gm14635,X,12339782,12354996,lincRNA,-1,15214,chrX_12339782_12354996
Gm14637,2,170576054,170578424,antisense,1,2370,chr2_170576054_170578424
Gm14639,X,56155528,56156393,processed_pseudogene,-1,865,chrX_56155528_56156393
Gm14648,X,47900345,47900827,processed_pseudogene,1,482,chrX_47900345_47900827
Gm14652,X,45786326,45786560,processed_pseudogene,-1,234,chrX_45786326_45786560
Gm14659,X,63184686,63186526,processed_pseudogene,-1,1840,chrX_63184686_63186526
Gm14660,X,60818208,60818782,processed_pseudogene,1,574,chrX_60818208_60818782
Gm14665,X,61389027,61389583,processed_pseudogene,1,556,chrX_61389027_61389583
Gm14667,X,64842692,64844041,processed_pseudogene,-1,1349,chrX_64842692_64844041
Gm14668,X,65936349,65938476,processed_pseudogene,1,2127,chrX_65936349_65938476
Gm14673,X,64944129,64945031,processed_pseudogene,1,902,chrX_64944129_64945031
Gm14676,X,64750401,64751258,processed_pseudogene,-1,857,chrX_64750401_64751258
Gm14678,X,62646725,62647206,processed_pseudogene,1,481,chrX_62646725_62647206
Gm14679,X,62372093,62372814,processed_pseudogene,1,721,chrX_62372093_62372814
Gm14685,X,73117047,73129262,protein_coding,1,12215,chrX_73117047_73129262
Gm14695,X,74783672,74786540,unprocessed_pseudogene,1,2868,chrX_74783672_74786540
Gm14696,X,49313319,49345237,lincRNA,-1,31918,chrX_49313319_49345237
Gm14698,X,68821093,68825318,protein_coding,1,4225,chrX_68821093_68825318
Gm14710,X,76153331,76162605,unprocessed_pseudogene,-1,9274,chrX_76153331_76162605
Gm14712,X,76301183,76301954,processed_pseudogene,-1,771,chrX_76301183_76301954
Gm14719,X,49660960,49661299,processed_pseudogene,1,339,chrX_49660960_49661299
Gm14730,X,71197127,71198171,processed_pseudogene,1,1044,chrX_71197127_71198171
Gm14735,X,72467302,72470389,processed_pseudogene,1,3087,chrX_72467302_72470389
Gm14739,X,82687021,82687822,processed_pseudogene,-1,801,chrX_82687021_82687822
Gm14741,X,82757430,82758438,processed_pseudogene,-1,1008,chrX_82757430_82758438
Gm14745,X,78416198,78417293,processed_pseudogene,1,1095,chrX_78416198_78417293
Gm14746,X,77717052,77717983,processed_pseudogene,-1,931,chrX_77717052_77717983
Gm14752,X,78405676,78409435,processed_pseudogene,1,3759,chrX_78405676_78409435
Gm14760,X,80193854,80194852,processed_pseudogene,-1,998,chrX_80193854_80194852
Gm14762,X,85825892,85834831,lincRNA,1,8939,chrX_85825892_85834831
Gm14768,X,80362549,80363233,processed_pseudogene,1,684,chrX_80362549_80363233
Gm14769,X,84063333,84063764,processed_pseudogene,1,431,chrX_84063333_84063764
Gm14774,X,88036371,88036906,processed_pseudogene,-1,535,chrX_88036371_88036906
Gm14776,X,87771339,87772352,processed_pseudogene,-1,1013,chrX_87771339_87772352
Gm14780,X,93527573,93530309,processed_pseudogene,1,2736,chrX_93527573_93530309
Gm14783,X,91345675,91346337,processed_pseudogene,1,662,chrX_91345675_91346337
Gm14785,X,91550084,91551230,processed_pseudogene,1,1146,chrX_91550084_91551230
Gm14797,X,89111017,89112496,processed_pseudogene,-1,1479,chrX_89111017_89112496
Gm14806,X,95380371,95382480,processed_pseudogene,-1,2109,chrX_95380371_95382480
Gm14808,X,99459025,99460753,antisense,1,1728,chrX_99459025_99460753
Gm14815,X,98513900,98514387,processed_pseudogene,-1,487,chrX_98513900_98514387
Gm14824,X,105327739,105328475,processed_pseudogene,-1,736,chrX_105327739_105328475
Gm14826,X,94317560,94318460,processed_pseudogene,-1,900,chrX_94317560_94318460
Gm14827,X,94442732,94447727,lincRNA,1,4995,chrX_94442732_94447727
Gm14828,X,100337514,100338668,processed_pseudogene,1,1154,chrX_100337514_100338668
Gm14829,X,100329692,100330829,processed_pseudogene,1,1137,chrX_100329692_100330829
Gm14840,X,102657741,102658334,processed_pseudogene,-1,593,chrX_102657741_102658334
Gm14843,X,101479348,101479559,processed_pseudogene,1,211,chrX_101479348_101479559
Gm14845,X,101691545,101691850,processed_pseudogene,-1,305,chrX_101691545_101691850
Gm14849,X,108060304,108065130,processed_pseudogene,1,4826,chrX_108060304_108065130
Gm14856,X,106176314,106176926,processed_pseudogene,1,612,chrX_106176314_106176926
Gm14857,X,106281912,106285096,processed_pseudogene,-1,3184,chrX_106281912_106285096
Gm14858,X,102252522,102365498,processed_transcript,1,112976,chrX_102252522_102365498
Gm14859,X,102208402,102208758,processed_pseudogene,1,356,chrX_102208402_102208758
Gm14861,X,103486934,103487388,processed_pseudogene,1,454,chrX_103486934_103487388
Gm14864,X,9046087,9047173,processed_pseudogene,-1,1086,chrX_9046087_9047173
Gm14869,X,109120801,109121684,processed_pseudogene,-1,883,chrX_109120801_109121684
Gm14877,X,106611903,106612775,processed_pseudogene,1,872,chrX_106611903_106612775
Gm14890,X,59196963,59197638,processed_pseudogene,1,675,chrX_59196963_59197638
Gm14894,X,114662197,114662466,processed_pseudogene,1,269,chrX_114662197_114662466
Gm14896,X,114036527,114037877,processed_pseudogene,1,1350,chrX_114036527_114037877
Gm14900,X,112012720,112013452,processed_pseudogene,1,732,chrX_112012720_112013452
Gm14911,X,117663894,117664882,processed_pseudogene,-1,988,chrX_117663894_117664882
Gm14921,X,112660521,112661428,processed_pseudogene,-1,907,chrX_112660521_112661428
Gm14925,X,96194051,96194488,processed_pseudogene,1,437,chrX_96194051_96194488
Gm14930,X,120442035,120442686,processed_pseudogene,-1,651,chrX_120442035_120442686
Gm14932,X,121416143,121416789,processed_pseudogene,1,646,chrX_121416143_121416789
Gm14933,X,96358704,96359681,processed_pseudogene,-1,977,chrX_96358704_96359681
Gm14935,X,96548629,96550336,processed_pseudogene,1,1707,chrX_96548629_96550336
Gm14936,X,112980864,113009754,lincRNA,-1,28890,chrX_112980864_113009754
Gm14943,X,121816927,121819838,processed_pseudogene,1,2911,chrX_121816927_121819838
Gm14947,X,122452368,122452670,processed_pseudogene,1,302,chrX_122452368_122452670
Gm14957,X,126129808,126171027,unprocessed_pseudogene,-1,41219,chrX_126129808_126171027
Gm14994,X,136348178,136349269,processed_pseudogene,-1,1091,chrX_136348178_136349269
Gm15000,X,138522506,138523748,processed_pseudogene,-1,1242,chrX_138522506_138523748
Gm15001,X,138741796,138744444,processed_pseudogene,-1,2648,chrX_138741796_138744444
Gm15008,X,36910834,36911985,antisense,1,1151,chrX_36910834_36911985
Gm15013,X,139713681,139714481,protein_coding,-1,800,chrX_139713681_139714481
Gm15021,X,135615994,135616735,processed_pseudogene,1,741,chrX_135615994_135616735
Gm15026,X,136890258,136890715,processed_pseudogene,1,457,chrX_136890258_136890715
Gm15032,X,142622492,142622902,processed_pseudogene,-1,410,chrX_142622492_142622902
Gm15033,X,49944635,49945307,processed_pseudogene,1,672,chrX_49944635_49945307
Gm15040,X,137128110,137129835,processed_pseudogene,1,1725,chrX_137128110_137129835
Gm15049,X,142775885,142776347,processed_pseudogene,-1,462,chrX_142775885_142776347
Gm15065,X,75705409,75705681,processed_pseudogene,1,272,chrX_75705409_75705681
Gm15066,X,144285726,144288333,processed_pseudogene,-1,2607,chrX_144285726_144288333
Gm15071,X,144499327,144500692,processed_pseudogene,1,1365,chrX_144499327_144500692
Gm15078,X,141238425,141356959,processed_pseudogene,1,118534,chrX_141238425_141356959
Gm15083,6,114004789,114052265,antisense,1,47476,chr6_114004789_114052265
Gm15095,X,149848723,149850152,unprocessed_pseudogene,1,1429,chrX_149848723_149850152
Gm15104,X,150312601,150333065,lincRNA,-1,20464,chrX_150312601_150333065
Gm15105,X,150367713,150367916,processed_pseudogene,-1,203,chrX_150367713_150367916
Gm15131,X,150707021,150707615,processed_pseudogene,-1,594,chrX_150707021_150707615
Gm15132,X,150688145,150688796,processed_pseudogene,1,651,chrX_150688145_150688796
Gm15148,X,151493114,151493269,processed_pseudogene,-1,155,chrX_151493114_151493269
Gm15151,X,151758017,151758193,processed_pseudogene,-1,176,chrX_151758017_151758193
Gm15159,X,155237498,155238261,processed_pseudogene,1,763,chrX_155237498_155238261
Gm15160,X,155922917,155923823,processed_pseudogene,1,906,chrX_155922917_155923823
Gm15163,X,157016229,157017530,processed_pseudogene,-1,1301,chrX_157016229_157017530
Gm15165,X,93988318,93988819,processed_pseudogene,-1,501,chrX_93988318_93988819
Gm15172,X,157377939,157378984,processed_pseudogene,-1,1045,chrX_157377939_157378984
Gm15173,X,157612689,157613121,processed_pseudogene,-1,432,chrX_157612689_157613121
Gm15186,X,159588465,159589027,processed_pseudogene,1,562,chrX_159588465_159589027
Gm15187,X,159410247,159410510,processed_pseudogene,-1,263,chrX_159410247_159410510
Gm15190,X,159584783,159585058,processed_pseudogene,-1,275,chrX_159584783_159585058
Gm15191,X,151945368,151946367,processed_pseudogene,1,999,chrX_151945368_151946367
Gm15195,X,160269701,160269963,processed_pseudogene,-1,262,chrX_160269701_160269963
Gm15196,X,160309007,160309488,processed_pseudogene,-1,481,chrX_160309007_160309488
Gm15199,10,42740539,42758660,antisense,-1,18121,chr10_42740539_42758660
Gm15201,X,162735078,162736613,processed_transcript,-1,1535,chrX_162735078_162736613
Gm15204,X,162351596,162353876,processed_pseudogene,1,2280,chrX_162351596_162353876
Gm15209,X,162894755,162895154,processed_pseudogene,-1,399,chrX_162894755_162895154
Gm15223,X,166485602,166486427,processed_pseudogene,1,825,chrX_166485602_166486427
Gm15225,X,166062237,166070237,processed_pseudogene,1,8000,chrX_166062237_166070237
Gm15230,X,166857669,166864449,lincRNA,-1,6780,chrX_166857669_166864449
Gm15232,X,167088093,167102090,lincRNA,-1,13997,chrX_167088093_167102090
Gm15238,X,167776261,167777556,processed_pseudogene,1,1295,chrX_167776261_167777556
Gm15240,X,167987505,167988224,processed_pseudogene,1,719,chrX_167987505_167988224
Gm15241,X,160488549,160499870,antisense,-1,11321,chrX_160488549_160499870
Gm15256,X,4511847,4512729,processed_pseudogene,1,882,chrX_4511847_4512729
Gm15263,3,94832977,94833805,processed_pseudogene,1,828,chr3_94832977_94833805
Gm15264,3,94720023,94758116,unprocessed_pseudogene,-1,38093,chr3_94720023_94758116
Gm15266,X,152110432,152111461,unprocessed_pseudogene,-1,1029,chrX_152110432_152111461
Gm15267,X,152043049,152043512,processed_pseudogene,-1,463,chrX_152043049_152043512
Gm15283,12,73843039,73949814,antisense,-1,106775,chr12_73843039_73949814
Gm15290,13,111522350,111549911,lincRNA,-1,27561,chr13_111522350_111549911
Gm15294,X,141873409,141875235,protein_coding,-1,1826,chrX_141873409_141875235
Gm15302,8,21330947,21333576,processed_pseudogene,1,2629,chr8_21330947_21333576
Gm15303,8,21236674,21239297,processed_pseudogene,1,2623,chr8_21236674_21239297
Gm15304,8,21460958,21463597,processed_pseudogene,1,2639,chr8_21460958_21463597
Gm15310,16,94358941,94359312,transcribed_processed_pseudogene,-1,371,chr16_94358941_94359312
Gm15319,8,20337664,20363210,protein_coding,-1,25546,chr8_20337664_20363210
Gm15320,17,34389345,34402018,transcribed_unprocessed_pseudogene,-1,12673,chr17_34389345_34402018
Gm15327,13,111809141,111811039,processed_transcript,1,1898,chr13_111809141_111811039
Gm15328,18,16815721,16822783,lincRNA,1,7062,chr18_16815721_16822783
Gm15337,18,39367038,39389425,antisense,-1,22387,chr18_39367038_39389425
Gm15343,10,76564765,76570532,antisense,-1,5767,chr10_76564765_76570532
Gm15350,8,12828335,12833865,antisense,-1,5530,chr8_12828335_12833865
Gm15352,8,13021941,13022210,processed_pseudogene,1,269,chr8_13021941_13022210
Gm15355,8,65817311,65817595,processed_pseudogene,-1,284,chr8_65817311_65817595
Gm15361,X,74494379,74494822,processed_pseudogene,-1,443,chrX_74494379_74494822
Gm15362,X,74504015,74504402,processed_pseudogene,1,387,chrX_74504015_74504402
Gm15364,X,74510946,74511530,processed_pseudogene,1,584,chrX_74510946_74511530
Gm15366,8,19037428,19038446,processed_pseudogene,-1,1018,chr8_19037428_19038446
Gm15367,X,75010590,75011605,processed_pseudogene,1,1015,chrX_75010590_75011605
Gm15379,X,75458812,75459459,processed_pseudogene,1,647,chrX_75458812_75459459
Gm15381,15,91556762,91557917,processed_pseudogene,-1,1155,chr15_91556762_91557917
Gm15382,15,91822687,91823223,processed_pseudogene,1,536,chr15_91822687_91823223
Gm15383,15,91530924,91532366,processed_pseudogene,-1,1442,chr15_91530924_91532366
Gm15387,15,74093686,74094333,processed_pseudogene,-1,647,chr15_74093686_74094333
Gm15388,1,107137844,107138569,processed_pseudogene,-1,725,chr1_107137844_107138569
Gm15389,1,107687008,107693514,lincRNA,1,6506,chr1_107687008_107693514
Gm15394,1,121969217,121970524,processed_pseudogene,-1,1307,chr1_121969217_121970524
Gm15396,7,44579968,44590624,antisense,-1,10656,chr7_44579968_44590624
Gm15401,6,72629288,72637717,antisense,1,8429,chr6_72629288_72637717
Gm15403,17,91667079,91668305,processed_pseudogene,1,1226,chr17_91667079_91668305
Gm15408,5,149006962,149012776,lincRNA,1,5814,chr5_149006962_149012776
Gm15411,5,148995651,149015813,processed_transcript,-1,20162,chr5_148995651_149015813
Gm15412,7,96339483,96341964,antisense,-1,2481,chr7_96339483_96341964
Gm15413,7,96791433,96801549,antisense,-1,10116,chr7_96791433_96801549
Gm15417,3,89391850,89398779,antisense,1,6929,chr3_89391850_89398779
Gm15418,8,11187755,11204503,antisense,1,16748,chr8_11187755_11204503
Gm15420,17,27635343,27636868,antisense,1,1525,chr17_27635343_27636868
Gm15421,5,22528321,22529244,transcribed_processed_pseudogene,-1,923,chr5_22528321_22529244
Gm15422,14,123985276,123985816,processed_pseudogene,-1,540,chr14_123985276_123985816
Gm15423,1,176927999,176932711,antisense,-1,4712,chr1_176927999_176932711
Gm15425,17,8564258,8568860,processed_pseudogene,-1,4602,chr17_8564258_8568860
Gm15426,17,8765372,8765927,processed_pseudogene,-1,555,chr17_8765372_8765927
Gm15427,1,95498621,95499151,processed_pseudogene,1,530,chr1_95498621_95499151
Gm15428,1,156793512,156793844,processed_pseudogene,1,332,chr1_156793512_156793844
Gm15429,1,161726242,161727489,processed_pseudogene,-1,1247,chr1_161726242_161727489
Gm15432,X,29564014,29564208,processed_pseudogene,-1,194,chrX_29564014_29564208
Gm15441,3,96555765,96566801,antisense,-1,11036,chr3_96555765_96566801
Gm15442,3,78486808,78488637,processed_pseudogene,-1,1829,chr3_78486808_78488637
Gm15446,5,109923400,109943936,protein_coding,1,20536,chr5_109923400_109943936
Gm15452,1,8791923,8792162,processed_pseudogene,-1,239,chr1_8791923_8792162
Gm15455,1,33836124,33838680,processed_pseudogene,-1,2556,chr1_33836124_33838680
Gm15459,5,5781615,5783555,processed_pseudogene,-1,1940,chr5_5781615_5783555
Gm15464,1,60117255,60117685,processed_pseudogene,1,430,chr1_60117255_60117685
Gm15466,3,8882238,8882570,processed_pseudogene,-1,332,chr3_8882238_8882570
Gm15470,7,41490351,41491721,processed_pseudogene,1,1370,chr7_41490351_41491721
Gm15471,3,103803129,103808439,processed_transcript,1,5310,chr3_103803129_103808439
Gm15473,6,17058806,17064996,lincRNA,-1,6190,chr6_17058806_17064996
Gm15476,6,136383728,136384918,processed_pseudogene,1,1190,chr6_136383728_136384918
Gm15483,7,133738479,133738934,processed_pseudogene,-1,455,chr7_133738479_133738934
Gm15486,1,157497931,157511721,antisense,-1,13790,chr1_157497931_157511721
Gm15493,9,92334552,92335079,processed_pseudogene,-1,527,chr9_92334552_92335079
Gm15495,7,25442152,25443463,processed_pseudogene,-1,1311,chr7_25442152_25443463
Gm15496,3,31285587,31316891,antisense,1,31304,chr3_31285587_31316891
Gm15499,6,145441756,145444028,antisense,1,2272,chr6_145441756_145444028
Gm15500,7,114705217,114706235,transcribed_processed_pseudogene,-1,1018,chr7_114705217_114706235
Gm15501,7,93178983,93184176,transcribed_processed_pseudogene,-1,5193,chr7_93178983_93184176
Gm15506,7,98682336,98702928,transcribed_unitary_pseudogene,-1,20592,chr7_98682336_98702928
Gm15510,7,5046949,5057116,antisense,-1,10167,chr7_5046949_5057116
Gm15515,14,96231953,96232774,processed_pseudogene,1,821,chr14_96231953_96232774
Gm15517,7,44261447,44261891,protein_coding,1,444,chr7_44261447_44261891
Gm15518,16,49758576,49798870,antisense,-1,40294,chr16_49758576_49798870
Gm15519,6,112563642,112565207,processed_pseudogene,1,1565,chr6_112563642_112565207
Gm15520,9,29059799,29070199,antisense,1,10400,chr9_29059799_29070199
Gm15523,12,103336906,103348057,antisense,1,11151,chr12_103336906_103348057
Gm15527,6,54245742,54279076,processed_transcript,-1,33334,chr6_54245742_54279076
Gm15528,13,75929465,75930328,processed_pseudogene,-1,863,chr13_75929465_75930328
Gm1553,10,82486537,82492618,protein_coding,-1,6081,chr10_82486537_82492618
Gm15530,16,38685315,38685869,processed_pseudogene,-1,554,chr16_38685315_38685869
Gm15531,6,97890288,97890539,processed_pseudogene,-1,251,chr6_97890288_97890539
Gm15532,6,119892920,119893803,processed_pseudogene,1,883,chr6_119892920_119893803
Gm15534,6,64990947,64991508,processed_pseudogene,1,561,chr6_64990947_64991508
Gm15539,16,3927606,3928171,processed_pseudogene,1,565,chr16_3927606_3928171
Gm15542,7,140890887,140892080,processed_pseudogene,1,1193,chr7_140890887_140892080
Gm15544,7,80429210,80430740,processed_pseudogene,1,1530,chr7_80429210_80430740
Gm15545,7,44986900,44994597,antisense,1,7697,chr7_44986900_44994597
Gm15549,8,68798867,68799488,processed_pseudogene,1,621,chr8_68798867_68799488
Gm15550,6,43373805,43375552,processed_pseudogene,1,1747,chr6_43373805_43375552
Gm15551,3,126667329,126669044,antisense,-1,1715,chr3_126667329_126669044
Gm15558,16,10669248,10683539,antisense,-1,14291,chr16_10669248_10683539
Gm15564,16,35966752,35983230,antisense,-1,16478,chr16_35966752_35983230
Gm15565,9,120384911,120385337,processed_pseudogene,1,426,chr9_120384911_120385337
Gm15566,9,120316328,120316917,processed_pseudogene,1,589,chr9_120316328_120316917
Gm15568,10,10343115,10344327,processed_pseudogene,1,1212,chr10_10343115_10344327
Gm15569,15,86185728,86187152,antisense,1,1424,chr15_86185728_86187152
Gm15570,7,27271768,27272392,processed_pseudogene,-1,624,chr7_27271768_27272392
Gm15571,12,69141430,69142066,processed_pseudogene,-1,636,chr12_69141430_69142066
Gm15572,6,52843109,52843701,processed_pseudogene,-1,592,chr6_52843109_52843701
Gm15576,6,100726234,100726816,processed_pseudogene,1,582,chr6_100726234_100726816
Gm15577,3,156903863,156920780,antisense,-1,16917,chr3_156903863_156920780
Gm15580,7,143596439,143596994,processed_pseudogene,1,555,chr7_143596439_143596994
Gm15581,6,17206823,17385604,antisense,-1,178781,chr6_17206823_17385604
Gm15583,1,146725581,146729090,processed_pseudogene,1,3509,chr1_146725581_146729090
Gm15590,17,6131854,6132405,processed_pseudogene,-1,551,chr17_6131854_6132405
Gm15593,6,18144734,18145741,processed_pseudogene,1,1007,chr6_18144734_18145741
Gm15596,6,18156337,18157120,processed_pseudogene,-1,783,chr6_18156337_18157120
Gm15599,17,5110766,5112110,processed_pseudogene,-1,1344,chr17_5110766_5112110
Gm15603,1,10695123,10695614,processed_pseudogene,1,491,chr1_10695123_10695614
Gm15604,1,10554098,10555553,processed_pseudogene,-1,1455,chr1_10554098_10555553
Gm15607,5,135637139,135637496,processed_pseudogene,-1,357,chr5_135637139_135637496
Gm15610,5,8971948,8972142,processed_pseudogene,1,194,chr5_8971948_8972142
Gm15612,6,88842854,88847274,antisense,1,4420,chr6_88842854_88847274
Gm15614,5,32507184,32651065,antisense,-1,143881,chr5_32507184_32651065
Gm15616,5,72047205,72047579,processed_pseudogene,1,374,chr5_72047205_72047579
Gm15617,5,72032718,72033488,processed_pseudogene,-1,770,chr5_72032718_72033488
Gm15618,1,152407074,152407525,processed_pseudogene,-1,451,chr1_152407074_152407525
Gm15621,5,124472427,124472790,processed_pseudogene,1,363,chr5_124472427_124472790
Gm15624,6,83166152,83172755,antisense,-1,6603,chr6_83166152_83172755
Gm15625,9,55305288,55306380,processed_pseudogene,1,1092,chr9_55305288_55306380
Gm15627,5,134098412,134099208,lincRNA,-1,796,chr5_134098412_134099208
Gm15628,14,75136270,75136912,lincRNA,-1,642,chr14_75136270_75136912
Gm15631,6,105673064,105677581,lincRNA,-1,4517,chr6_105673064_105677581
Gm15636,12,108440530,108441270,processed_pseudogene,-1,740,chr12_108440530_108441270
Gm15638,16,45945606,45971370,antisense,1,25764,chr16_45945606_45971370
Gm15645,7,105762321,105863650,transcribed_processed_pseudogene,1,101329,chr7_105762321_105863650
Gm15651,16,22548553,22551149,antisense,1,2596,chr16_22548553_22551149
Gm15660,8,83352556,83353033,processed_pseudogene,1,477,chr8_83352556_83353033
Gm15661,7,88448675,88449230,processed_pseudogene,-1,555,chr7_88448675_88449230
Gm15663,10,105573953,105583874,processed_transcript,1,9921,chr10_105573953_105583874
Gm15665,16,37212918,37213764,processed_pseudogene,-1,846,chr16_37212918_37213764
Gm15666,10,105505804,105508599,transcribed_processed_pseudogene,-1,2795,chr10_105505804_105508599
Gm15667,14,30804379,30805160,processed_pseudogene,1,781,chr14_30804379_30805160
Gm15679,8,99011886,99032740,antisense,1,20854,chr8_99011886_99032740
Gm15681,8,99145386,99148089,processed_pseudogene,-1,2703,chr8_99145386_99148089
Gm15688,3,141457976,141465333,antisense,-1,7357,chr3_141457976_141465333
Gm15689,3,141662889,141682900,antisense,-1,20011,chr3_141662889_141682900
Gm15694,16,31987178,31987460,processed_pseudogene,-1,282,chr16_31987178_31987460
Gm15697,6,38542303,38546074,unprocessed_pseudogene,-1,3771,chr6_38542303_38546074
Gm15703,16,31924989,31925868,processed_pseudogene,1,879,chr16_31924989_31925868
Gm15706,6,145250529,145251849,lincRNA,1,1320,chr6_145250529_145251849
Gm15707,6,145315613,145316608,processed_pseudogene,-1,995,chr6_145315613_145316608
Gm15708,5,144277061,144280513,sense_intronic,1,3452,chr5_144277061_144280513
Gm15710,5,92140294,92140929,processed_pseudogene,-1,635,chr5_92140294_92140929
Gm15711,16,43312594,43313128,processed_pseudogene,1,534,chr16_43312594_43313128
Gm15712,16,43184573,43185728,processed_pseudogene,1,1155,chr16_43184573_43185728
Gm15713,16,43410518,43420196,antisense,-1,9678,chr16_43410518_43420196
Gm15715,5,21748231,21748513,processed_pseudogene,-1,282,chr5_21748231_21748513
Gm15719,5,21689541,21690175,processed_pseudogene,1,634,chr5_21689541_21690175
Gm15723,10,114801726,114816831,antisense,1,15105,chr10_114801726_114816831
Gm15731,5,8037294,8052707,antisense,-1,15413,chr5_8037294_8052707
Gm15732,5,37404384,37404863,processed_pseudogene,-1,479,chr5_37404384_37404863
Gm15736,5,113644963,113645682,antisense,1,719,chr5_113644963_113645682
Gm15738,16,13354374,13468755,antisense,-1,114381,chr16_13354374_13468755
Gm15740,13,76696619,76697910,processed_pseudogene,1,1291,chr13_76696619_76697910
Gm15741,4,114165123,114165876,processed_pseudogene,-1,753,chr4_114165123_114165876
Gm15742,16,30969393,30973518,sense_intronic,-1,4125,chr16_30969393_30973518
Gm15744,7,89761463,89761675,unprocessed_pseudogene,-1,212,chr7_89761463_89761675
Gm15753,5,137720354,137721740,unprocessed_pseudogene,-1,1386,chr5_137720354_137721740
Gm15754,5,118486967,118503500,transcribed_processed_pseudogene,1,16533,chr5_118486967_118503500
Gm15755,11,59375461,59379905,antisense,1,4444,chr11_59375461_59379905
Gm15760,16,20545212,20548456,transcribed_processed_pseudogene,-1,3244,chr16_20545212_20548456
Gm15762,6,147709982,147719451,lincRNA,-1,9469,chr6_147709982_147719451
Gm15764,CHR_MG3833_MG4220_PATCH,18416682,18422883,lncRNA;processed_transcript,1,6201,chrCHR_MG3833_MG4220_PATCH_18416682_18422883
Gm15765,14,45211523,45212432,processed_pseudogene,1,909,chr14_45211523_45212432
Gm15766,6,147271837,147272649,processed_pseudogene,1,812,chr6_147271837_147272649
Gm15770,5,142852616,142853199,processed_pseudogene,-1,583,chr5_142852616_142853199
Gm15772,5,3236431,3236868,processed_pseudogene,1,437,chr5_3236431_3236868
Gm15773,7,12603196,12604643,processed_pseudogene,1,1447,chr7_12603196_12604643
Gm15778,6,148699029,148699636,processed_pseudogene,-1,607,chr6_148699029_148699636
Gm15780,6,149072704,149073638,processed_pseudogene,1,934,chr6_149072704_149073638
Gm15783,6,149405822,149406685,processed_pseudogene,1,863,chr6_149405822_149406685
Gm15784,6,149361686,149363147,processed_pseudogene,1,1461,chr6_149361686_149363147
Gm15785,6,149433780,149434473,processed_pseudogene,-1,693,chr6_149433780_149434473
Gm15786,6,149401793,149402242,processed_pseudogene,1,449,chr6_149401793_149402242
Gm15787,5,110154400,110176504,processed_transcript,-1,22104,chr5_110154400_110176504
Gm15789,1,66783913,66786445,processed_pseudogene,1,2532,chr1_66783913_66786445
Gm15793,1,66849108,66849602,processed_pseudogene,-1,494,chr1_66849108_66849602
Gm15794,5,66197912,66201326,processed_pseudogene,-1,3414,chr5_66197912_66201326
Gm15801,19,40560537,40561058,processed_pseudogene,-1,521,chr19_40560537_40561058
Gm15806,16,14010762,14011716,processed_pseudogene,-1,954,chr16_14010762_14011716
Gm15807,16,14037734,14038861,processed_pseudogene,-1,1127,chr16_14037734_14038861
Gm15808,16,14067403,14068006,processed_pseudogene,1,603,chr16_14067403_14068006
Gm15816,8,23138794,23149585,antisense,-1,10791,chr8_23138794_23149585
Gm15824,5,64190033,64190987,processed_pseudogene,-1,954,chr5_64190033_64190987
Gm15826,1,66951829,66953469,processed_pseudogene,1,1640,chr1_66951829_66953469
Gm15828,16,67592705,67593226,processed_pseudogene,-1,521,chr16_67592705_67593226
Gm15833,1,44212162,44213118,processed_pseudogene,1,956,chr1_44212162_44213118
Gm15834,1,58505148,58523230,lincRNA,1,18082,chr1_58505148_58523230
Gm15843,1,72459499,72460027,processed_pseudogene,1,528,chr1_72459499_72460027
Gm15850,1,136126178,136131183,processed_transcript,-1,5005,chr1_136126178_136131183
Gm15870,6,127934689,127944839,antisense,-1,10150,chr6_127934689_127944839
Gm15877,7,12517405,12518368,processed_pseudogene,1,963,chr7_12517405_12518368
Gm15879,16,4032839,4037847,antisense,-1,5008,chr16_4032839_4037847
Gm15880,7,80636017,80644384,antisense,1,8367,chr7_80636017_80644384
Gm15881,8,58699846,58700787,processed_pseudogene,-1,941,chr8_58699846_58700787
Gm15894,8,110754992,110758970,antisense,1,3978,chr8_110754992_110758970
Gm15895,8,110805638,110807477,antisense,1,1839,chr8_110805638_110807477
Gm15897,16,11494821,11496306,processed_pseudogene,-1,1485,chr16_11494821_11496306
Gm15900,10,127948219,127948560,processed_pseudogene,-1,341,chr10_127948219_127948560
Gm15901,12,44923180,44924373,processed_pseudogene,1,1193,chr12_44923180_44924373
Gm15908,13,34652923,34666774,antisense,1,13851,chr13_34652923_34666774
Gm15910,10,120857629,120863326,antisense,1,5697,chr10_120857629_120863326
Gm15915,10,93674218,93683322,antisense,-1,9104,chr10_93674218_93683322
Gm15916,14,18831296,18832031,processed_pseudogene,1,735,chr14_18831296_18832031
Gm15927,7,3632114,3644887,processed_transcript,-1,12773,chr7_3632114_3644887
Gm15928,7,3993239,3993518,processed_pseudogene,-1,279,chr7_3993239_3993518
Gm15934,10,45287311,45289424,antisense,-1,2113,chr10_45287311_45289424
Gm15937,15,5208913,5210147,processed_pseudogene,1,1234,chr15_5208913_5210147
Gm15939,10,33624246,33662432,antisense,1,38186,chr10_33624246_33662432
Gm15941,15,37421134,37433414,antisense,-1,12280,chr15_37421134_37433414
Gm15946,17,12962768,12963190,processed_pseudogene,1,422,chr17_12962768_12963190
Gm15950,16,13919427,13921399,unprocessed_pseudogene,-1,1972,chr16_13919427_13921399
Gm15952,3,35933045,35990840,antisense,1,57795,chr3_35933045_35990840
Gm15958,18,66291274,66319645,antisense,1,28371,chr18_66291274_66319645
Gm15959,19,60815449,60815816,processed_pseudogene,-1,367,chr19_60815449_60815816
Gm15968,19,7703946,7705113,processed_pseudogene,-1,1167,chr19_7703946_7705113
Gm15970,16,27343111,27343944,processed_pseudogene,-1,833,chr16_27343111_27343944
Gm15972,18,23750447,23752305,antisense,-1,1858,chr18_23750447_23752305
Gm15974,17,68371280,68371810,processed_pseudogene,-1,530,chr17_68371280_68371810
Gm15991,8,67956769,67978051,antisense,1,21282,chr8_67956769_67978051
Gm15997,5,149489056,149538030,antisense,-1,48974,chr5_149489056_149538030
Gm15998,3,89315439,89318907,antisense,1,3468,chr3_89315439_89318907
Gm1600,16,10324105,10347591,lincRNA,-1,23486,chr16_10324105_10347591
Gm16005,17,27522573,27522844,processed_pseudogene,1,271,chr17_27522573_27522844
Gm16010,9,97015966,97022043,antisense,1,6077,chr9_97015966_97022043
Gm16011,16,45426845,45429506,processed_pseudogene,-1,2661,chr16_45426845_45429506
Gm16013,11,71429828,71436180,lincRNA,-1,6352,chr11_71429828_71436180
Gm16017,7,79412310,79412517,processed_pseudogene,-1,207,chr7_79412310_79412517
Gm16020,5,134463240,134463449,processed_pseudogene,1,209,chr5_134463240_134463449
Gm16023,4,155608300,155624755,processed_transcript,-1,16455,chr4_155608300_155624755
Gm16026,1,85266698,85285491,transcribed_unprocessed_pseudogene,1,18793,chr1_85266698_85285491
Gm16027,19,40615886,40616643,processed_pseudogene,1,757,chr19_40615886_40616643
Gm16030,15,7341914,7342516,processed_pseudogene,1,602,chr15_7341914_7342516
Gm16035,5,141373179,141380926,antisense,-1,7747,chr5_141373179_141380926
Gm16041,1,4970857,4976820,antisense,1,5963,chr1_4970857_4976820
Gm16044,7,128692689,128693138,processed_pseudogene,1,449,chr7_128692689_128693138
Gm1604b,17,7025568,7087597,protein_coding,1,62029,chr17_7025568_7087597
Gm16050,17,13500954,13511193,lincRNA,1,10239,chr17_13500954_13511193
Gm16062,11,59810080,59818491,antisense,1,8411,chr11_59810080_59818491
Gm16068,19,47606144,47617106,antisense,-1,10962,chr19_47606144_47617106
Gm16069,3,89180755,89182293,antisense,-1,1538,chr3_89180755_89182293
Gm16070,1,17676027,17727646,antisense,-1,51619,chr1_17676027_17727646
Gm16071,9,31094202,31094994,processed_pseudogene,1,792,chr9_31094202_31094994
Gm16072,18,12287404,12289780,processed_pseudogene,1,2376,chr18_12287404_12289780
Gm16073,9,65838167,65838683,processed_pseudogene,1,516,chr9_65838167_65838683
Gm16074,10,3992371,3992814,processed_pseudogene,1,443,chr10_3992371_3992814
Gm16083,1,130462576,130557075,antisense,1,94499,chr1_130462576_130557075
Gm16086,12,107079360,107099673,lincRNA,-1,20313,chr12_107079360_107099673
Gm16089,5,137615627,137615962,processed_pseudogene,1,335,chr5_137615627_137615962
Gm16090,18,20597964,20665260,antisense,-1,67296,chr18_20597964_20665260
Gm16096,9,40780742,40784181,processed_transcript,-1,3439,chr9_40780742_40784181
Gm16102,1,44644279,44644698,processed_pseudogene,1,419,chr1_44644279_44644698
Gm16103,1,43785910,43787188,processed_pseudogene,1,1278,chr1_43785910_43787188
Gm16104,10,81409575,81411579,antisense,1,2004,chr10_81409575_81411579
Gm16107,1,52873137,52873998,processed_pseudogene,-1,861,chr1_52873137_52873998
Gm16111,5,21889780,21890064,processed_pseudogene,1,284,chr5_21889780_21890064
Gm16116,8,114591303,114594900,antisense,-1,3597,chr8_114591303_114594900
Gm16118,8,114698439,114708006,antisense,-1,9567,chr8_114698439_114708006
Gm16123,6,12565518,12567222,processed_pseudogene,1,1704,chr6_12565518_12567222
Gm16124,9,53667246,53681265,antisense,1,14019,chr9_53667246_53681265
Gm16128,10,62935698,62936323,processed_pseudogene,1,625,chr10_62935698_62936323
Gm16130,9,58032274,58048997,antisense,1,16723,chr9_58032274_58048997
Gm16138,15,37331989,37332809,processed_pseudogene,-1,820,chr15_37331989_37332809
Gm16142,9,115990956,116001788,antisense,-1,10832,chr9_115990956_116001788
Gm16143,10,63055603,63057467,antisense,-1,1864,chr10_63055603_63057467
Gm16148,10,3946199,3947091,processed_pseudogene,-1,892,chr10_3946199_3947091
Gm16149,10,3869299,3869607,processed_pseudogene,-1,308,chr10_3869299_3869607
Gm16150,1,38235420,38246666,antisense,1,11246,chr1_38235420_38246666
Gm16152,1,38384949,38393974,antisense,1,9025,chr1_38384949_38393974
Gm16157,7,68266339,68276594,antisense,-1,10255,chr7_68266339_68276594
Gm16159,8,25548661,25556083,antisense,-1,7422,chr8_25548661_25556083
Gm16165,9,22669734,22670528,processed_pseudogene,-1,794,chr9_22669734_22670528
Gm16166,10,120928186,120928972,processed_pseudogene,1,786,chr10_120928186_120928972
Gm16168,17,10496446,10569396,antisense,1,72950,chr17_10496446_10569396
Gm16169,17,10807834,10826625,processed_transcript,1,18791,chr17_10807834_10826625
Gm16174,7,19816553,19818625,antisense,1,2072,chr7_19816553_19818625
Gm16184,7,19911825,19912397,processed_pseudogene,1,572,chr7_19911825_19912397
Gm16185,9,97085326,97088610,antisense,1,3284,chr9_97085326_97088610
Gm16193,8,41053110,41064706,antisense,1,11596,chr8_41053110_41064706
Gm16202,9,86316141,86316684,processed_pseudogene,-1,543,chr9_86316141_86316684
Gm16204,8,38076714,38079639,processed_pseudogene,1,2925,chr8_38076714_38079639
Gm16205,8,37787666,37788692,processed_pseudogene,-1,1026,chr8_37787666_37788692
Gm16206,3,53452619,53457797,antisense,1,5178,chr3_53452619_53457797
Gm16208,8,107029675,107031188,antisense,-1,1513,chr8_107029675_107031188
Gm16209,8,107037480,107038106,processed_pseudogene,-1,626,chr8_107037480_107038106
Gm16222,10,76078617,76080502,antisense,1,1885,chr10_76078617_76080502
Gm16223,5,42067960,42216798,protein_coding,1,148838,chr5_42067960_42216798
Gm16226,5,99682410,99715774,antisense,1,33364,chr5_99682410_99715774
Gm16228,5,99610625,99611433,processed_pseudogene,-1,808,chr5_99610625_99611433
Gm16230,10,127671604,127676724,antisense,-1,5120,chr10_127671604_127676724
Gm16233,3,144947561,144954878,antisense,1,7317,chr3_144947561_144954878
Gm16238,3,127691935,127692520,processed_pseudogene,-1,585,chr3_127691935_127692520
Gm16246,12,57441190,57450120,antisense,-1,8930,chr12_57441190_57450120
Gm16259,14,105292432,105292984,processed_pseudogene,-1,552,chr14_105292432_105292984
Gm16260,14,100219486,100219789,processed_pseudogene,1,303,chr14_100219486_100219789
Gm16261,14,60154151,60154355,processed_pseudogene,1,204,chr14_60154151_60154355
Gm16263,13,118695292,118715396,antisense,-1,20104,chr13_118695292_118715396
Gm16274,19,12568235,12568826,processed_pseudogene,-1,591,chr19_12568235_12568826
Gm16283,18,49755794,49757189,processed_transcript,1,1395,chr18_49755794_49757189
Gm16287,4,139175405,139180655,antisense,-1,5250,chr4_139175405_139180655
Gm16291,15,39797045,39812377,antisense,1,15332,chr15_39797045_39812377
Gm16294,15,40511322,40527277,lincRNA,-1,15955,chr15_40511322_40527277
Gm16300,15,47699709,47703827,processed_pseudogene,-1,4118,chr15_47699709_47703827
Gm16304,1,139133891,139134665,processed_pseudogene,-1,774,chr1_139133891_139134665
Gm16305,1,138991514,138992069,processed_pseudogene,-1,555,chr1_138991514_138992069
Gm16318,13,89662770,89663370,processed_pseudogene,1,600,chr13_89662770_89663370
Gm16322,9,42474555,42505662,antisense,1,31107,chr9_42474555_42505662
Gm16326,7,122131092,122131505,processed_pseudogene,1,413,chr7_122131092_122131505
Gm16341,1,86275509,86301375,antisense,-1,25866,chr1_86275509_86301375
Gm16342,11,102732405,102752861,unitary_pseudogene,1,20456,chr11_102732405_102752861
Gm16347,8,16433175,16437040,antisense,1,3865,chr8_16433175_16437040
Gm16348,8,41218139,41220894,processed_transcript,1,2755,chr8_41218139_41220894
Gm16350,8,14961066,14961586,antisense,-1,520,chr8_14961066_14961586
Gm16351,8,45547377,45605140,antisense,-1,57763,chr8_45547377_45605140
Gm16353,9,75132959,75134181,processed_pseudogene,-1,1222,chr9_75132959_75134181
Gm16357,2,176116023,176117866,unprocessed_pseudogene,-1,1843,chr2_176116023_176117866
Gm16364,10,39556071,39613682,antisense,-1,57611,chr10_39556071_39613682
Gm16368,12,88083697,88084131,protein_coding,1,434,chr12_88083697_88084131
Gm16372,12,24493207,24493656,processed_pseudogene,-1,449,chr12_24493207_24493656
Gm16373,X,116886881,116887183,processed_pseudogene,1,302,chrX_116886881_116887183
Gm16374,15,4885120,4886118,processed_pseudogene,1,998,chr15_4885120_4886118
Gm16378,8,122841731,122842072,processed_pseudogene,1,341,chr8_122841731_122842072
Gm16380,9,53884084,53884561,processed_pseudogene,1,477,chr9_53884084_53884561
Gm16385,16,64917983,64919084,processed_pseudogene,-1,1101,chr16_64917983_64919084
Gm16386,17,22777217,22807736,processed_pseudogene,-1,30519,chr17_22777217_22807736
Gm16391,17,76284415,76284861,processed_pseudogene,-1,446,chr17_76284415_76284861
Gm16397,X,134731571,134732064,processed_pseudogene,1,493,chrX_134731571_134732064
Gm16399,3,14802356,14802574,processed_pseudogene,-1,218,chr3_14802356_14802574
Gm16407,X,70400497,70401063,processed_pseudogene,1,566,chrX_70400497_70401063
Gm16409,14,73796544,73797290,processed_pseudogene,-1,746,chr14_73796544_73797290
Gm16410,X,134489370,134490143,processed_pseudogene,1,773,chrX_134489370_134490143
Gm16412,X,89005370,89005642,processed_pseudogene,1,272,chrX_89005370_89005642
Gm16415,18,42441019,42441507,processed_pseudogene,1,488,chr18_42441019_42441507
Gm16416,13,103397109,103397591,processed_pseudogene,1,482,chr13_103397109_103397591
Gm16418,1,166431705,166431875,processed_pseudogene,-1,170,chr1_166431705_166431875
Gm16419,13,12171526,12172150,processed_pseudogene,-1,624,chr13_12171526_12172150
Gm16421,X,122100927,122102483,processed_pseudogene,1,1556,chrX_122100927_122102483
Gm16423,X,39112661,39113607,processed_pseudogene,-1,946,chrX_39112661_39113607
Gm16425,8,19535454,19538583,processed_pseudogene,1,3129,chr8_19535454_19538583
Gm16433,6,108563605,108565588,processed_pseudogene,-1,1983,chr6_108563605_108565588
Gm16437,19,7668287,7668790,processed_pseudogene,1,503,chr19_7668287_7668790
Gm16439,14,44596665,44597228,processed_pseudogene,1,563,chr14_44596665_44597228
Gm16440,14,6380721,6390319,protein_coding,-1,9598,chr14_6380721_6390319
Gm16458,X,78059390,78066587,unprocessed_pseudogene,1,7197,chrX_78059390_78066587
Gm16459,X,162844838,162845523,processed_pseudogene,1,685,chrX_162844838_162845523
Gm16463,X,85241617,85242731,processed_pseudogene,1,1114,chrX_85241617_85242731
Gm16464,7,104501055,104502149,processed_pseudogene,-1,1094,chr7_104501055_104502149
Gm16465,X,91887301,91889565,processed_pseudogene,-1,2264,chrX_91887301_91889565
Gm1647,3,69131233,69157177,lincRNA,1,25944,chr3_69131233_69157177
Gm16470,19,40212382,40213379,processed_pseudogene,1,997,chr19_40212382_40213379
Gm16475,7,120553156,120556999,transcribed_unprocessed_pseudogene,1,3843,chr7_120553156_120556999
Gm16476,12,20615302,20615440,processed_pseudogene,1,138,chr12_20615302_20615440
Gm16477,7,131614188,131614988,processed_pseudogene,-1,800,chr7_131614188_131614988
Gm16478,7,51170517,51176537,processed_pseudogene,1,6020,chr7_51170517_51176537
Gm16479,X,8956307,8957238,processed_pseudogene,1,931,chrX_8956307_8957238
Gm16480,X,9066035,9066866,processed_pseudogene,-1,831,chrX_9066035_9066866
Gm16481,X,13238327,13239553,processed_pseudogene,1,1226,chrX_13238327_13239553
Gm16497,12,14261534,14285725,lincRNA,1,24191,chr12_14261534_14285725
Gm16499,6,53818743,53868183,antisense;lincRNA,1,49440,chr6_53818743_53868183
Gm16505,13,3358273,3363862,transcribed_unprocessed_pseudogene,1,5589,chr13_3358273_3363862
Gm16511,X,102830950,102833804,unprocessed_pseudogene,1,2854,chrX_102830950_102833804
Gm16518,11,3697430,3698326,processed_pseudogene,-1,896,chr11_3697430_3698326
Gm16519,17,70929058,70929546,processed_pseudogene,1,488,chr17_70929058_70929546
Gm16523,2,39157486,39162235,transcribed_processed_pseudogene,-1,4749,chr2_39157486_39162235
Gm16531,10,22414514,22444036,unprocessed_pseudogene,1,29522,chr10_22414514_22444036
Gm16537,15,99715543,99724474,antisense,-1,8931,chr15_99715543_99724474
Gm16547,1,181400464,181400756,processed_pseudogene,-1,292,chr1_181400464_181400756
Gm16551,9,74847983,74860134,processed_transcript,1,12151,chr9_74847983_74860134
Gm16553,8,3709804,3739044,antisense,1,29240,chr8_3709804_3739044
Gm16555,17,49817626,49821825,antisense,-1,4199,chr17_49817626_49821825
Gm16570,12,81589435,81589870,processed_pseudogene,-1,435,chr12_81589435_81589870
Gm16576,15,79742698,79757394,bidirectional_promoter_lncRNA,1,14696,chr15_79742698_79757394
Gm16580,17,26269337,26270384,processed_pseudogene,1,1047,chr17_26269337_26270384
Gm16581,1,55127297,55128287,processed_pseudogene,1,990,chr1_55127297_55128287
Gm16582,1,74850895,74879953,processed_transcript,1,29058,chr1_74850895_74879953
Gm16585,1,177786856,177787465,processed_pseudogene,1,609,chr1_177786856_177787465
Gm16589,8,4087658,4088575,processed_pseudogene,1,917,chr8_4087658_4088575
Gm16596,12,108537243,108555618,antisense,-1,18375,chr12_108537243_108555618
Gm16617,14,51986425,51988827,antisense,-1,2402,chr14_51986425_51988827
Gm16630,6,48130906,48159280,lincRNA,-1,28374,chr6_48130906_48159280
Gm16638,7,83597048,83631880,antisense,-1,34832,chr7_83597048_83631880
Gm16675,8,46668808,46739515,bidirectional_promoter_lncRNA,-1,70707,chr8_46668808_46739515
Gm16677,14,69327999,69337165,lincRNA,-1,9166,chr14_69327999_69337165
Gm16701,1,166974023,167000841,lincRNA,-1,26818,chr1_166974023_167000841
Gm16712,17,55954771,55959381,antisense,-1,4610,chr17_55954771_55959381
Gm1673,5,33983433,33985013,protein_coding,1,1580,chr5_33983433_33985013
Gm16740,3,95217457,95226658,antisense,1,9201,chr3_95217457_95226658
Gm16758,17,29890084,29897067,antisense,1,6983,chr17_29890084_29897067
Gm16759,9,63398601,63568691,processed_transcript,1,170090,chr9_63398601_63568691
Gm16793,8,35582503,35588972,bidirectional_promoter_lncRNA,-1,6469,chr8_35582503_35588972
Gm16794,9,95942045,95959393,antisense,-1,17348,chr9_95942045_95959393
Gm16796,2,170499357,170511927,antisense,-1,12570,chr2_170499357_170511927
Gm16835,14,119098965,119115074,processed_transcript,1,16109,chr14_119098965_119115074
Gm16845,9,22071002,22086122,antisense,1,15120,chr9_22071002_22086122
Gm16853,9,21405242,21411720,antisense,-1,6478,chr9_21405242_21411720
Gm16861,16,4935049,4939633,antisense,-1,4584,chr16_4935049_4939633
Gm16863,16,21247499,21296872,lincRNA,-1,49373,chr16_21247499_21296872
Gm16876,12,91684665,91693590,antisense,1,8925,chr12_91684665_91693590
Gm16894,1,40076228,40085851,antisense,-1,9623,chr1_40076228_40085851
Gm16897,1,194955759,194976960,antisense,-1,21201,chr1_194955759_194976960
Gm16938,7,98177194,98179401,processed_transcript,1,2207,chr7_98177194_98179401
Gm16973,14,56696280,56701268,lincRNA,-1,4988,chr14_56696280_56701268
Gm16976,14,44858671,44974944,transcribed_unprocessed_pseudogene,1,116273,chr14_44858671_44974944
Gm1698,8,27604351,27620452,lincRNA,1,16101,chr8_27604351_27620452
Gm16982,7,141610066,141613747,antisense,-1,3681,chr7_141610066_141613747
Gm16998,10,54075922,54081081,bidirectional_promoter_lncRNA,1,5159,chr10_54075922_54081081
Gm17014,2,78845286,78845453,processed_pseudogene,-1,167,chr2_78845286_78845453
Gm17019,5,15028950,15032998,protein_coding,-1,4048,chr5_15028950_15032998
Gm17021,9,123768114,123791289,sense_overlapping,-1,23175,chr9_123768114_123791289
Gm17025,15,81415560,81419188,antisense,-1,3628,chr15_81415560_81419188
Gm17031,12,106508242,106509910,processed_pseudogene,1,1668,chr12_106508242_106509910
Gm17039,13,67360671,67365679,antisense,1,5008,chr13_67360671_67365679
Gm17042,12,103744030,103754733,unprocessed_pseudogene,-1,10703,chr12_103744030_103754733
Gm17043,12,103786113,103804362,unprocessed_pseudogene,-1,18249,chr12_103786113_103804362
Gm17045,14,6034967,6035810,processed_pseudogene,1,843,chr14_6034967_6035810
Gm17046,14,5877076,5877925,processed_pseudogene,1,849,chr14_5877076_5877925
Gm17048,14,5958445,5959291,processed_pseudogene,1,846,chr14_5958445_5959291
Gm17052,12,107419141,107419429,processed_pseudogene,1,288,chr12_107419141_107419429
Gm17057,15,99819020,99834570,antisense,1,15550,chr15_99819020_99834570
Gm17059,10,59799199,59800254,antisense,-1,1055,chr10_59799199_59800254
Gm17060,6,49424061,49424884,processed_pseudogene,-1,823,chr6_49424061_49424884
Gm17066,14,105109390,105114676,processed_transcript,-1,5286,chr14_105109390_105114676
Gm17068,19,16277797,16278776,processed_pseudogene,1,979,chr19_16277797_16278776
Gm17075,2,96999624,97000293,processed_pseudogene,1,669,chr2_96999624_97000293
Gm17076,2,97039912,97041312,processed_pseudogene,1,1400,chr2_97039912_97041312
Gm17082,14,122121553,122122643,processed_pseudogene,1,1090,chr14_122121553_122122643
Gm17087,17,8565852,8566950,protein_coding,-1,1098,chr17_8565852_8566950
Gm17101,1,5063060,5064647,processed_pseudogene,1,1587,chr1_5063060_5064647
Gm17102,7,41393698,41397447,lincRNA,1,3749,chr7_41393698_41397447
Gm17115,17,32788394,32789591,bidirectional_promoter_lncRNA,1,1197,chr17_32788394_32789591
Gm17116,14,64111200,64114641,antisense,-1,3441,chr14_64111200_64114641
Gm17121,14,7565259,7566105,processed_pseudogene,1,846,chr14_7565259_7566105
Gm17137,7,126164033,126168403,transcribed_processed_pseudogene,1,4370,chr7_126164033_126168403
Gm17138,12,86714986,86715444,processed_pseudogene,1,458,chr12_86714986_86715444
Gm17147,6,65128571,65129002,processed_pseudogene,1,431,chr6_65128571_65129002
Gm1715,9,52679863,52798774,lincRNA,1,118911,chr9_52679863_52798774
Gm17171,2,20300817,20324670,antisense,-1,23853,chr2_20300817_20324670
Gm17177,13,3082188,3123373,transcribed_unprocessed_pseudogene,1,41185,chr13_3082188_3123373
Gm17190,13,96082054,96083231,protein_coding,1,1177,chr13_96082054_96083231
Gm17192,16,61460962,61461472,processed_pseudogene,1,510,chr16_61460962_61461472
Gm17197,19,56364262,56366241,antisense,1,1979,chr19_56364262_56366241
Gm1720,X,166662025,166689812,lincRNA,1,27787,chrX_166662025_166689812
Gm17202,5,107404823,107431910,antisense,-1,27087,chr5_107404823_107431910
Gm17205,9,107047803,107049009,processed_pseudogene,1,1206,chr9_107047803_107049009
Gm17212,3,69335502,69335760,processed_pseudogene,-1,258,chr3_69335502_69335760
Gm17213,3,69431009,69432368,processed_pseudogene,-1,1359,chr3_69431009_69432368
Gm17214,3,69320045,69320585,processed_pseudogene,-1,540,chr3_69320045_69320585
Gm17215,8,7381015,7428569,lincRNA,1,47554,chr8_7381015_7428569
Gm17219,7,110522066,110522658,processed_pseudogene,1,592,chr7_110522066_110522658
Gm17222,14,3210975,3211821,processed_pseudogene,-1,846,chr14_3210975_3211821
Gm17224,1,172213021,172213680,antisense,1,659,chr1_172213021_172213680
Gm17228,17,63346920,63347410,processed_pseudogene,-1,490,chr17_63346920_63347410
Gm17229,10,20515327,20519768,transcribed_processed_pseudogene,-1,4441,chr10_20515327_20519768
Gm17230,10,20625635,20629576,processed_pseudogene,1,3941,chr10_20625635_20629576
Gm17235,11,78576237,78577355,processed_pseudogene,1,1118,chr11_78576237_78577355
Gm17241,15,99706562,99706813,processed_pseudogene,-1,251,chr15_99706562_99706813
Gm17266,18,84798558,84836716,protein_coding,-1,38158,chr18_84798558_84836716
Gm17308,3,5090276,5094776,lincRNA,1,4500,chr3_5090276_5094776
Gm17322,9,57998041,58007451,lincRNA,1,9410,chr9_57998041_58007451
Gm17330,12,23968681,23968845,processed_pseudogene,-1,164,chr12_23968681_23968845
Gm17359,3,79336661,79464129,protein_coding,1,127468,chr3_79336661_79464129
Gm17382,17,26860271,26886202,lincRNA,-1,25931,chr17_26860271_26886202
Gm17383,18,82338462,82339816,processed_pseudogene,1,1354,chr18_82338462_82339816
Gm17399,9,118150231,118170376,lincRNA,1,20145,chr9_118150231_118170376
Gm17430,18,9726205,9726670,processed_pseudogene,-1,465,chr18_9726205_9726670
Gm17450,13,91220452,91220878,pseudogene,1,426,chr13_91220452_91220878
Gm17511,7,127286044,127286385,processed_pseudogene,-1,341,chr7_127286044_127286385
Gm17541,12,4689402,4689926,processed_pseudogene,-1,524,chr12_4689402_4689926
Gm17597,15,81800791,81802613,antisense,-1,1822,chr15_81800791_81802613
Gm17634,1,105356007,105361737,antisense,1,5730,chr1_105356007_105361737
Gm17644,1,12667563,12673090,lincRNA,1,5527,chr1_12667563_12673090
Gm17655,5,110046139,110072513,protein_coding,-1,26374,chr5_110046139_110072513
Gm17660,5,104070064,104077608,protein_coding,-1,7544,chr5_104070064_104077608
Gm17709,8,121972727,121973822,processed_pseudogene,-1,1095,chr8_121972727_121973822
Gm17733,6,115127600,115134835,bidirectional_promoter_lncRNA,-1,7235,chr6_115127600_115134835
Gm17740,14,69761171,69763538,processed_pseudogene,-1,2367,chr14_69761171_69763538
Gm17743,3,144779012,144780686,processed_pseudogene,1,1674,chr3_144779012_144780686
Gm17745,10,93335393,93348877,lincRNA,1,13484,chr10_93335393_93348877
Gm17746,12,25129174,25134931,lincRNA,1,5757,chr12_25129174_25134931
Gm17748,17,9421943,9422464,processed_pseudogene,-1,521,chr17_9421943_9422464
Gm17750,13,84025297,84064772,lincRNA,-1,39475,chr13_84025297_84064772
Gm17751,1,76489133,76502028,lincRNA,1,12895,chr1_76489133_76502028
Gm17752,1,112049436,112057110,processed_pseudogene,-1,7674,chr1_112049436_112057110
Gm17753,15,79015329,79025782,lincRNA,-1,10453,chr15_79015329_79025782
Gm17756,15,12765172,12765375,processed_pseudogene,-1,203,chr15_12765172_12765375
Gm17764,1,82822471,82822861,processed_pseudogene,-1,390,chr1_82822471_82822861
Gm17767,1,51507086,51596718,lincRNA,-1,89632,chr1_51507086_51596718
Gm17768,7,43078051,43096419,lincRNA,1,18368,chr7_43078051_43096419
Gm17771,3,19934242,19935388,processed_pseudogene,1,1146,chr3_19934242_19935388
Gm17775,3,113729232,113729489,processed_pseudogene,1,257,chr3_113729232_113729489
Gm17779,10,38928289,38928682,processed_pseudogene,1,393,chr10_38928289_38928682
Gm17782,17,36156531,36162079,unprocessed_pseudogene,-1,5548,chr17_36156531_36162079
Gm17786,8,121581765,121582191,processed_pseudogene,1,426,chr8_121581765_121582191
Gm17790,Y,1736187,1737414,processed_pseudogene,1,1227,chrY_1736187_1737414
Gm17791,7,41325815,41327315,processed_pseudogene,-1,1500,chr7_41325815_41327315
Gm17794,10,22791319,22792273,processed_pseudogene,1,954,chr10_22791319_22792273
Gm17795,10,40565916,40566672,processed_pseudogene,-1,756,chr10_40565916_40566672
Gm17796,1,131216877,131218089,processed_pseudogene,1,1212,chr1_131216877_131218089
Gm17797,6,92561777,92562773,processed_pseudogene,1,996,chr6_92561777_92562773
Gm17798,9,38184793,38185827,processed_pseudogene,1,1034,chr9_38184793_38185827
Gm17799,16,19723312,19723978,processed_pseudogene,1,666,chr16_19723312_19723978
Gm17800,19,24692400,24693370,processed_pseudogene,-1,970,chr19_24692400_24693370
Gm17802,19,12273011,12274610,processed_pseudogene,1,1599,chr19_12273011_12274610
Gm17805,14,12618668,12619241,processed_pseudogene,1,573,chr14_12618668_12619241
Gm17806,3,9656520,9656902,processed_pseudogene,1,382,chr3_9656520_9656902
Gm17807,12,116597253,116597550,processed_pseudogene,1,297,chr12_116597253_116597550
Gm17808,6,126931688,126932581,processed_pseudogene,1,893,chr6_126931688_126932581
Gm17809,16,55883072,55884491,processed_pseudogene,-1,1419,chr16_55883072_55884491
Gm17811,11,73389934,73390320,processed_pseudogene,1,386,chr11_73389934_73390320
Gm17812,6,120908673,120908990,processed_pseudogene,1,317,chr6_120908673_120908990
Gm17813,1,33657781,33658108,processed_pseudogene,1,327,chr1_33657781_33658108
Gm17814,17,26073146,26073988,processed_pseudogene,1,842,chr17_26073146_26073988
Gm17815,3,95804855,95805749,processed_pseudogene,1,894,chr3_95804855_95805749
Gm17816,12,4225785,4228401,processed_pseudogene,1,2616,chr12_4225785_4228401
Gm17819,19,17692763,17692900,processed_pseudogene,1,137,chr19_17692763_17692900
Gm17820,12,32486351,32487418,processed_pseudogene,-1,1067,chr12_32486351_32487418
Gm17821,12,67658527,67669276,processed_pseudogene,-1,10749,chr12_67658527_67669276
Gm17822,6,95240228,95240578,processed_pseudogene,-1,350,chr6_95240228_95240578
Gm17823,10,53299137,53300142,processed_pseudogene,-1,1005,chr10_53299137_53300142
Gm17825,6,71869212,71870005,processed_pseudogene,-1,793,chr6_71869212_71870005
Gm17826,7,16498732,16499529,processed_pseudogene,1,797,chr7_16498732_16499529
Gm17828,9,72292542,72293340,processed_pseudogene,-1,798,chr9_72292542_72293340
Gm17829,10,61510242,61510585,processed_pseudogene,-1,343,chr10_61510242_61510585
Gm17830,17,49304479,49312960,lincRNA,-1,8481,chr17_49304479_49312960
Gm17831,7,128154019,128154918,processed_pseudogene,1,899,chr7_128154019_128154918
Gm17833,5,114108926,114109990,processed_pseudogene,1,1064,chr5_114108926_114109990
Gm17837,1,18262395,18263379,processed_pseudogene,-1,984,chr1_18262395_18263379
Gm17838,7,55242137,55243942,processed_pseudogene,-1,1805,chr7_55242137_55243942
Gm17849,10,111179952,111180804,processed_pseudogene,1,852,chr10_111179952_111180804
Gm17850,7,11997725,11999663,processed_pseudogene,-1,1938,chr7_11997725_11999663
Gm17853,9,60548195,60549543,processed_pseudogene,1,1348,chr9_60548195_60549543
Gm17867,1,147503868,147506042,unprocessed_pseudogene,-1,2174,chr1_147503868_147506042
Gm17868,1,167141155,167141822,unprocessed_pseudogene,1,667,chr1_167141155_167141822
Gm17872,13,69654775,69655512,processed_pseudogene,-1,737,chr13_69654775_69655512
Gm17873,15,3929985,3930560,processed_pseudogene,1,575,chr15_3929985_3930560
Gm17875,9,65364887,65365946,processed_pseudogene,1,1059,chr9_65364887_65365946
Gm17877,3,9971188,9972001,processed_pseudogene,-1,813,chr3_9971188_9972001
Gm17878,13,56318325,56320334,processed_pseudogene,-1,2009,chr13_56318325_56320334
Gm17882,14,89371284,89371582,processed_pseudogene,-1,298,chr14_89371284_89371582
Gm17887,3,36421576,36422122,processed_pseudogene,1,546,chr3_36421576_36422122
Gm17890,13,17337599,17338355,processed_pseudogene,1,756,chr13_17337599_17338355
Gm17891,17,66227249,66228027,processed_pseudogene,-1,778,chr17_66227249_66228027
Gm17892,15,60397297,60398089,processed_pseudogene,1,792,chr15_60397297_60398089
Gm17893,2,37488675,37489444,processed_pseudogene,1,769,chr2_37488675_37489444
Gm17906,5,74883335,74884235,processed_pseudogene,1,900,chr5_74883335_74884235
Gm17907,7,55902602,55903311,processed_pseudogene,-1,709,chr7_55902602_55903311
Gm17909,7,67082843,67083749,processed_pseudogene,1,906,chr7_67082843_67083749
Gm17910,8,88728203,88729040,processed_pseudogene,-1,837,chr8_88728203_88729040
Gm17911,8,51453395,51454271,processed_pseudogene,1,876,chr8_51453395_51454271
Gm17916,1,115668988,115684624,transcribed_processed_pseudogene,-1,15636,chr1_115668988_115684624
Gm17917,10,27280718,27281670,processed_pseudogene,1,952,chr10_27280718_27281670
Gm17918,7,65173618,65174191,processed_pseudogene,-1,573,chr7_65173618_65174191
Gm17919,7,86541965,86542661,unprocessed_pseudogene,-1,696,chr7_86541965_86542661
Gm17921,17,68698911,68700327,processed_pseudogene,1,1416,chr17_68698911_68700327
Gm17922,14,93202100,93202901,processed_pseudogene,-1,801,chr14_93202100_93202901
Gm17931,7,99996776,99997409,processed_pseudogene,1,633,chr7_99996776_99997409
Gm17932,14,110556420,110557003,processed_pseudogene,1,583,chr14_110556420_110557003
Gm17934,3,6137823,6138244,processed_pseudogene,-1,421,chr3_6137823_6138244
Gm17936,5,8912971,8913958,processed_pseudogene,1,987,chr5_8912971_8913958
Gm17937,5,106610292,106611033,processed_pseudogene,1,741,chr5_106610292_106611033
Gm17938,13,67089485,67090130,processed_pseudogene,1,645,chr13_67089485_67090130
Gm17943,18,73730765,73731428,processed_pseudogene,1,663,chr18_73730765_73731428
Gm17948,17,32745182,32745820,processed_pseudogene,1,638,chr17_32745182_32745820
Gm17949,17,57011469,57021113,protein_coding,1,9644,chr17_57011469_57021113
Gm17951,3,57809762,57810257,processed_pseudogene,-1,495,chr3_57809762_57810257
Gm17954,3,113631578,113632184,processed_pseudogene,-1,606,chr3_113631578_113632184
Gm17956,3,104129424,104130261,processed_pseudogene,1,837,chr3_104129424_104130261
Gm17968,1,182127406,182128189,processed_pseudogene,-1,783,chr1_182127406_182128189
Gm17970,1,40353852,40354536,processed_pseudogene,1,684,chr1_40353852_40354536
Gm17971,1,55066264,55067069,processed_pseudogene,1,805,chr1_55066264_55067069
Gm17976,1,165941618,165943526,processed_pseudogene,1,1908,chr1_165941618_165943526
Gm17977,5,57899734,57900307,transcribed_processed_pseudogene,1,573,chr5_57899734_57900307
Gm17978,5,102159526,102160294,processed_pseudogene,1,768,chr5_102159526_102160294
Gm17980,10,88270883,88273231,processed_pseudogene,-1,2348,chr10_88270883_88273231
Gm17981,7,16514400,16515138,processed_pseudogene,-1,738,chr7_16514400_16515138
Gm17983,7,39583165,39583758,processed_pseudogene,-1,593,chr7_39583165_39583758
Gm17984,7,56804605,56805463,processed_pseudogene,-1,858,chr7_56804605_56805463
Gm17987,7,56879011,56879613,processed_pseudogene,1,602,chr7_56879011_56879613
Gm17992,7,108865424,108866495,processed_pseudogene,1,1071,chr7_108865424_108866495
Gm17994,8,57291520,57292052,processed_pseudogene,-1,532,chr8_57291520_57292052
Gm17995,8,88721079,88721608,processed_pseudogene,-1,529,chr8_88721079_88721608
Gm18000,8,83546440,83548267,processed_pseudogene,1,1827,chr8_83546440_83548267
Gm18001,8,83600013,83600700,processed_pseudogene,1,687,chr8_83600013_83600700
Gm18003,15,31730899,31733638,processed_pseudogene,-1,2739,chr15_31730899_31733638
Gm18006,6,6645334,6647278,processed_pseudogene,-1,1944,chr6_6645334_6647278
Gm18010,6,49172759,49172960,processed_pseudogene,1,201,chr6_49172759_49172960
Gm18011,6,49286721,49287285,processed_pseudogene,1,564,chr6_49286721_49287285
Gm18012,6,59942351,59943308,processed_pseudogene,1,957,chr6_59942351_59943308
Gm18014,9,72606381,72607197,processed_pseudogene,-1,816,chr9_72606381_72607197
Gm18021,16,74248893,74249754,processed_pseudogene,1,861,chr16_74248893_74249754
Gm18024,12,31198374,31199490,processed_pseudogene,-1,1116,chr12_31198374_31199490
Gm18025,12,34290274,34291135,processed_pseudogene,-1,861,chr12_34290274_34291135
Gm18029,12,31748059,31749195,processed_pseudogene,1,1136,chr12_31748059_31749195
Gm18030,12,69819647,69820377,processed_pseudogene,1,730,chr12_69819647_69820377
Gm18032,12,119352518,119353055,processed_pseudogene,1,537,chr12_119352518_119353055
Gm18033,1,29219700,29220249,processed_pseudogene,1,549,chr1_29219700_29220249
Gm18042,10,58555267,58556056,processed_pseudogene,1,789,chr10_58555267_58556056
Gm18065,13,18983930,18984455,processed_pseudogene,1,525,chr13_18983930_18984455
Gm18075,14,101702413,101703247,processed_pseudogene,-1,834,chr14_101702413_101703247
Gm18076,14,120815127,120815740,processed_pseudogene,-1,613,chr14_120815127_120815740
Gm18077,14,12653337,12653825,processed_pseudogene,1,488,chr14_12653337_12653825
Gm18078,14,16953606,16954197,processed_pseudogene,1,591,chr14_16953606_16954197
Gm18079,14,28724375,28725259,processed_pseudogene,1,884,chr14_28724375_28725259
Gm18086,18,42186175,42187772,processed_pseudogene,-1,1597,chr18_42186175_42187772
Gm18087,18,56915362,56916088,processed_pseudogene,-1,726,chr18_56915362_56916088
Gm18089,18,27008674,27009328,processed_pseudogene,1,654,chr18_27008674_27009328
Gm18095,15,99880199,99881216,processed_pseudogene,1,1017,chr15_99880199_99881216
Gm18101,9,120754979,120755526,processed_pseudogene,-1,547,chr9_120754979_120755526
Gm18103,9,57483810,57485304,processed_pseudogene,1,1494,chr9_57483810_57485304
Gm18112,12,46269750,46273884,unprocessed_pseudogene,-1,4134,chr12_46269750_46273884
Gm18113,12,69369514,69370023,processed_pseudogene,-1,509,chr12_69369514_69370023
Gm18115,12,36115082,36115702,processed_pseudogene,1,620,chr12_36115082_36115702
Gm18116,12,39765186,39765722,processed_pseudogene,1,536,chr12_39765186_39765722
Gm18117,1,47478868,47480198,processed_pseudogene,1,1330,chr1_47478868_47480198
Gm18119,10,77652744,77653359,processed_pseudogene,-1,615,chr10_77652744_77653359
Gm18120,10,50758184,50758694,processed_pseudogene,1,510,chr10_50758184_50758694
Gm18126,7,24287316,24288636,processed_pseudogene,-1,1320,chr7_24287316_24288636
Gm18127,7,57899963,57900687,processed_pseudogene,-1,724,chr7_57899963_57900687
Gm18128,7,42734409,42734919,processed_pseudogene,1,510,chr7_42734409_42734919
Gm18129,7,60272860,60280211,processed_pseudogene,1,7351,chr7_60272860_60280211
Gm18131,13,19412800,19413248,processed_pseudogene,1,448,chr13_19412800_19413248
Gm18132,13,35992132,35993431,processed_pseudogene,1,1299,chr13_35992132_35993431
Gm18134,13,98816752,98817265,processed_pseudogene,1,513,chr13_98816752_98817265
Gm18138,17,65513476,65513968,processed_pseudogene,-1,492,chr17_65513476_65513968
Gm18143,14,122513439,122513829,processed_pseudogene,-1,390,chr14_122513439_122513829
Gm18146,14,62779697,62780210,processed_pseudogene,1,513,chr14_62779697_62780210
Gm18147,14,75264217,75264967,processed_pseudogene,1,750,chr14_75264217_75264967
Gm18148,14,98922654,98923527,processed_pseudogene,1,873,chr14_98922654_98923527
Gm18149,18,68168448,68168967,processed_pseudogene,-1,519,chr18_68168448_68168967
Gm18150,18,37013848,37014634,unprocessed_pseudogene,1,786,chr18_37013848_37014634
Gm18152,15,54458700,54459280,processed_pseudogene,-1,580,chr15_54458700_54459280
Gm18153,15,44959341,44960364,processed_pseudogene,1,1023,chr15_44959341_44960364
Gm18159,6,142110456,142111525,processed_pseudogene,1,1069,chr6_142110456_142111525
Gm18163,3,113854736,113856378,processed_pseudogene,1,1642,chr3_113854736_113856378
Gm18169,16,47212370,47212895,processed_pseudogene,1,525,chr16_47212370_47212895
Gm1818,12,48555308,48559885,unprocessed_pseudogene,-1,4577,chr12_48555308_48559885
Gm18180,1,86014403,86015886,processed_pseudogene,-1,1483,chr1_86014403_86015886
Gm18182,1,117747031,117751372,unprocessed_pseudogene,-1,4341,chr1_117747031_117751372
Gm18183,1,142455200,142455814,processed_pseudogene,-1,614,chr1_142455200_142455814
Gm18186,1,165493422,165495001,processed_pseudogene,1,1579,chr1_165493422_165495001
Gm18189,10,31971719,31973669,processed_pseudogene,-1,1950,chr10_31971719_31973669
Gm18190,7,7265498,7278267,transcribed_unprocessed_pseudogene,-1,12769,chr7_7265498_7278267
Gm18194,7,12795723,12799164,transcribed_processed_pseudogene,-1,3441,chr7_12795723_12799164
Gm18204,7,11169504,11176743,processed_pseudogene,1,7239,chr7_11169504_11176743
Gm18205,7,12760708,12761548,processed_pseudogene,1,840,chr7_12760708_12761548
Gm18207,7,24860946,24861471,processed_pseudogene,1,525,chr7_24860946_24861471
Gm18212,8,82952512,82953400,processed_pseudogene,1,888,chr8_82952512_82953400
Gm18213,17,37608886,37609509,unprocessed_pseudogene,-1,623,chr17_37608886_37609509
Gm18214,17,22895714,22897595,processed_pseudogene,1,1881,chr17_22895714_22897595
Gm18216,14,44120072,44121253,unprocessed_pseudogene,-1,1181,chr14_44120072_44121253
Gm18217,18,59897554,59898094,processed_pseudogene,1,540,chr18_59897554_59898094
Gm18225,9,22295946,22296687,unprocessed_pseudogene,-1,741,chr9_22295946_22296687
Gm18227,9,22167479,22170652,unprocessed_pseudogene,1,3173,chr9_22167479_22170652
Gm18228,9,22204493,22205583,unprocessed_pseudogene,1,1090,chr9_22204493_22205583
Gm18234,16,27843362,27844412,processed_pseudogene,-1,1050,chr16_27843362_27844412
Gm18243,12,72120909,72121795,processed_pseudogene,-1,886,chr12_72120909_72121795
Gm18246,12,40917288,40918015,processed_pseudogene,1,727,chr12_40917288_40918015
Gm18254,7,35442566,35445237,unprocessed_pseudogene,-1,2671,chr7_35442566_35445237
Gm18255,7,102377573,102378337,processed_pseudogene,-1,764,chr7_102377573_102378337
Gm18256,7,44645428,44646334,processed_pseudogene,1,906,chr7_44645428_44646334
Gm18258,7,138899388,138900239,processed_pseudogene,1,851,chr7_138899388_138900239
Gm1826,2,87393483,87394644,processed_pseudogene,1,1161,chr2_87393483_87394644
Gm18269,17,21366847,21376348,processed_pseudogene,1,9501,chr17_21366847_21376348
Gm18272,17,32841313,32841646,unprocessed_pseudogene,1,333,chr17_32841313_32841646
Gm18273,17,32852991,32866300,transcribed_unprocessed_pseudogene,1,13309,chr17_32852991_32866300
Gm18275,14,19102467,19104133,processed_pseudogene,1,1666,chr14_19102467_19104133
Gm18276,14,24358359,24358954,processed_pseudogene,1,595,chr14_24358359_24358954
Gm18280,18,90459994,90483460,lincRNA,-1,23466,chr18_90459994_90483460
Gm18284,15,81674260,81674878,processed_pseudogene,-1,618,chr15_81674260_81674878
Gm18290,6,85920575,85921418,processed_pseudogene,-1,843,chr6_85920575_85921418
Gm18292,9,80451248,80452166,processed_pseudogene,1,918,chr9_80451248_80452166
Gm18293,19,33673329,33673541,processed_pseudogene,-1,212,chr19_33673329_33673541
Gm18294,3,64195574,64213677,unprocessed_pseudogene,-1,18103,chr3_64195574_64213677
Gm18300,1,9499338,9501522,processed_pseudogene,-1,2184,chr1_9499338_9501522
Gm18301,1,52134443,52135330,unprocessed_pseudogene,-1,887,chr1_52134443_52135330
Gm18304,1,84168188,84168733,processed_pseudogene,1,545,chr1_84168188_84168733
Gm18305,10,41362837,41364964,processed_pseudogene,-1,2127,chr10_41362837_41364964
Gm18325,6,115159097,115159931,processed_pseudogene,-1,834,chr6_115159097_115159931
Gm1833,1,96645420,96646170,processed_pseudogene,1,750,chr1_96645420_96646170
Gm18335,16,17702927,17703591,processed_pseudogene,1,664,chr16_17702927_17703591
Gm18338,12,38368671,38369230,processed_pseudogene,-1,559,chr12_38368671_38369230
Gm18342,1,85067394,85080236,unprocessed_pseudogene,-1,12842,chr1_85067394_85080236
Gm18343,5,25450305,25450908,processed_pseudogene,1,603,chr5_25450305_25450908
Gm18356,7,48293193,48294816,unprocessed_pseudogene,1,1623,chr7_48293193_48294816
Gm18360,7,85516723,85519417,unprocessed_pseudogene,1,2694,chr7_85516723_85519417
Gm18362,13,17894855,17895383,processed_pseudogene,1,528,chr13_17894855_17895383
Gm18367,14,115555923,115556522,processed_pseudogene,-1,599,chr14_115555923_115556522
Gm18368,14,78703810,78704563,processed_pseudogene,1,753,chr14_78703810_78704563
Gm18371,18,41892994,41895313,processed_pseudogene,-1,2319,chr18_41892994_41895313
Gm18379,19,43278634,43279207,processed_pseudogene,-1,573,chr19_43278634_43279207
Gm18380,19,26802075,26803218,processed_pseudogene,1,1143,chr19_26802075_26803218
Gm18382,3,62761443,62762024,processed_pseudogene,1,581,chr3_62761443_62762024
Gm18398,14,27714377,27715877,processed_pseudogene,1,1500,chr14_27714377_27715877
Gm18405,12,108991141,108991651,processed_pseudogene,-1,510,chr12_108991141_108991651
Gm18406,1,112404187,112404855,processed_pseudogene,-1,668,chr1_112404187_112404855
Gm18407,1,165643899,165644688,processed_pseudogene,-1,789,chr1_165643899_165644688
Gm18413,13,100153851,100154505,processed_pseudogene,-1,654,chr13_100153851_100154505
Gm18417,17,55850482,55851129,unprocessed_pseudogene,-1,647,chr17_55850482_55851129
Gm18422,6,100247229,100250345,transcribed_processed_pseudogene,1,3116,chr6_100247229_100250345
Gm18423,6,130776236,130777309,processed_pseudogene,1,1073,chr6_130776236_130777309
Gm18432,3,93234920,93236467,processed_pseudogene,1,1547,chr3_93234920_93236467
Gm18433,3,93689841,93708267,unprocessed_pseudogene,1,18426,chr3_93689841_93708267
Gm18441,12,118732439,118733055,processed_pseudogene,-1,616,chr12_118732439_118733055
Gm18445,1,173986926,174001972,unprocessed_pseudogene,-1,15046,chr1_173986926_174001972
Gm18451,5,54569905,54578012,processed_pseudogene,1,8107,chr5_54569905_54578012
Gm1848,X,21146844,21147640,processed_pseudogene,1,796,chrX_21146844_21147640
Gm18482,6,19773955,19777545,processed_pseudogene,-1,3590,chr6_19773955_19777545
Gm18484,6,46637292,46638282,processed_pseudogene,-1,990,chr6_46637292_46638282
Gm18487,9,84385307,84386555,processed_pseudogene,-1,1248,chr9_84385307_84386555
Gm18491,3,20782470,20784063,processed_pseudogene,-1,1593,chr3_20782470_20784063
Gm18492,3,131284127,131285144,processed_pseudogene,-1,1017,chr3_131284127_131285144
Gm18493,3,20804475,20806086,processed_pseudogene,1,1611,chr3_20804475_20806086
Gm18494,2,75302072,75303225,processed_pseudogene,-1,1153,chr2_75302072_75303225
Gm18499,12,87080656,87081676,processed_pseudogene,-1,1020,chr12_87080656_87081676
Gm18501,12,103641406,103642069,processed_pseudogene,-1,663,chr12_103641406_103642069
Gm18505,1,148650345,148651134,processed_pseudogene,-1,789,chr1_148650345_148651134
Gm18517,13,81085391,81087564,transcribed_processed_pseudogene,-1,2173,chr13_81085391_81087564
Gm18529,18,37305535,37306791,processed_pseudogene,1,1256,chr18_37305535_37306791
Gm18533,15,19204246,19205844,processed_pseudogene,1,1598,chr15_19204246_19205844
Gm18537,6,83548859,83550381,transcribed_processed_pseudogene,-1,1522,chr6_83548859_83550381
Gm18541,9,63898265,63898802,processed_pseudogene,1,537,chr9_63898265_63898802
Gm18553,1,138983864,138984497,processed_pseudogene,-1,633,chr1_138983864_138984497
Gm18555,5,109473396,109473979,processed_pseudogene,1,583,chr5_109473396_109473979
Gm18556,10,82056108,82057239,processed_pseudogene,-1,1131,chr10_82056108_82057239
Gm18557,10,16364798,16366574,processed_pseudogene,1,1776,chr10_16364798_16366574
Gm18558,7,35497455,35499717,processed_pseudogene,-1,2262,chr7_35497455_35499717
Gm18560,7,84919379,84920501,processed_pseudogene,-1,1122,chr7_84919379_84920501
Gm18561,7,127155069,127156006,processed_pseudogene,1,937,chr7_127155069_127156006
Gm18562,13,13323364,13350427,unprocessed_pseudogene,1,27063,chr13_13323364_13350427
Gm18564,17,15547816,15550462,processed_pseudogene,1,2646,chr17_15547816_15550462
Gm18580,14,111544201,111545092,processed_pseudogene,1,891,chr14_111544201_111545092
Gm18581,18,7107181,7108183,processed_pseudogene,-1,1002,chr18_7107181_7108183
Gm18582,15,23851740,23853910,processed_pseudogene,-1,2170,chr15_23851740_23853910
Gm18584,6,47432126,47433089,processed_pseudogene,-1,963,chr6_47432126_47433089
Gm18586,9,40929909,40930426,processed_pseudogene,-1,517,chr9_40929909_40930426
Gm18588,3,68902267,68902758,processed_pseudogene,-1,491,chr3_68902267_68902758
Gm1859,18,53221392,53221886,processed_pseudogene,-1,494,chr18_53221392_53221886
Gm18593,5,75048479,75050036,processed_pseudogene,1,1557,chr5_75048479_75050036
Gm18594,5,108821721,108823123,processed_pseudogene,1,1402,chr5_108821721_108823123
Gm18595,5,108972797,108975895,processed_pseudogene,1,3098,chr5_108972797_108975895
Gm18598,7,23446299,23446895,processed_pseudogene,1,596,chr7_23446299_23446895
Gm18599,7,114698520,114699644,processed_pseudogene,-1,1124,chr7_114698520_114699644
Gm18601,13,100392732,100394499,processed_pseudogene,1,1767,chr13_100392732_100394499
Gm18609,6,128185277,128188877,processed_pseudogene,1,3600,chr6_128185277_128188877
Gm18611,3,33730600,33733534,processed_pseudogene,1,2934,chr3_33730600_33733534
Gm18617,12,88072937,88073195,processed_pseudogene,-1,258,chr12_88072937_88073195
Gm18620,12,88339911,88340774,processed_pseudogene,-1,863,chr12_88339911_88340774
Gm18622,12,32930124,32930718,processed_pseudogene,1,594,chr12_32930124_32930718
Gm18625,12,87496093,87496363,processed_pseudogene,1,270,chr12_87496093_87496363
Gm18626,12,87518272,87520870,processed_pseudogene,1,2598,chr12_87518272_87520870
Gm18627,12,87865785,87868203,processed_pseudogene,1,2418,chr12_87865785_87868203
Gm18628,12,87927534,87928008,processed_pseudogene,1,474,chr12_87927534_87928008
Gm18629,12,88028811,88029757,processed_pseudogene,1,946,chr12_88028811_88029757
Gm18630,12,88153674,88156251,processed_pseudogene,1,2577,chr12_88153674_88156251
Gm18637,10,22052251,22054150,processed_pseudogene,1,1899,chr10_22052251_22054150
Gm18642,7,57026081,57027480,processed_pseudogene,1,1399,chr7_57026081_57027480
Gm18645,8,63522920,63525881,processed_pseudogene,1,2961,chr8_63522920_63525881
Gm18646,8,72515358,72516420,processed_pseudogene,1,1062,chr8_72515358_72516420
Gm18648,17,55700379,55701817,processed_pseudogene,1,1438,chr17_55700379_55701817
Gm18649,17,78752255,78752715,processed_pseudogene,1,460,chr17_78752255_78752715
Gm18652,18,45418589,45419153,processed_pseudogene,-1,564,chr18_45418589_45419153
Gm18655,9,102819861,102820950,processed_pseudogene,-1,1089,chr9_102819861_102820950
Gm18658,3,6378332,6378601,processed_pseudogene,-1,269,chr3_6378332_6378601
Gm1866,X,114592048,114592524,processed_pseudogene,-1,476,chrX_114592048_114592524
Gm18665,Y,1277313,1277582,unprocessed_pseudogene,-1,269,chrY_1277313_1277582
Gm18666,1,93906244,93916768,unprocessed_pseudogene,1,10524,chr1_93906244_93916768
Gm18667,1,138184101,138184584,processed_pseudogene,1,483,chr1_138184101_138184584
Gm18669,10,44169577,44170354,processed_pseudogene,-1,777,chr10_44169577_44170354
Gm18670,10,90749992,90750687,processed_pseudogene,-1,695,chr10_90749992_90750687
Gm18671,10,40548892,40549574,processed_pseudogene,1,682,chr10_40548892_40549574
Gm18681,14,30423270,30423883,processed_pseudogene,1,613,chr14_30423270_30423883
Gm18683,14,73933027,73933609,processed_pseudogene,1,582,chr14_73933027_73933609
Gm18688,6,131432053,131433911,processed_pseudogene,-1,1858,chr6_131432053_131433911
Gm18692,3,10753918,10754428,processed_pseudogene,-1,510,chr3_10753918_10754428
Gm18694,16,49369052,49370277,processed_pseudogene,1,1225,chr16_49369052_49370277
Gm18699,1,89048974,89049216,processed_pseudogene,1,242,chr1_89048974_89049216
Gm18700,1,100597075,100597627,processed_pseudogene,1,552,chr1_100597075_100597627
Gm18704,10,32369555,32370292,unprocessed_pseudogene,-1,737,chr10_32369555_32370292
Gm18705,10,91252145,91259344,processed_pseudogene,-1,7199,chr10_91252145_91259344
Gm18706,7,46091896,46092961,processed_pseudogene,-1,1065,chr7_46091896_46092961
Gm18709,8,120727263,120727943,processed_pseudogene,1,680,chr8_120727263_120727943
Gm18714,15,13713972,13714241,processed_pseudogene,-1,269,chr15_13713972_13714241
Gm18722,16,9104803,9107770,processed_pseudogene,-1,2967,chr16_9104803_9107770
Gm18723,16,56095714,56096839,processed_pseudogene,-1,1125,chr16_56095714_56096839
Gm18724,16,11046904,11048290,processed_pseudogene,1,1386,chr16_11046904_11048290
Gm18726,12,32710161,32712532,processed_pseudogene,1,2371,chr12_32710161_32712532
Gm18728,1,103171926,103268593,unprocessed_pseudogene,1,96667,chr1_103171926_103268593
Gm18730,10,121400713,121401291,processed_pseudogene,1,578,chr10_121400713_121401291
Gm18733,17,35278176,35279414,transcribed_unprocessed_pseudogene,-1,1238,chr17_35278176_35279414
Gm18734,17,35304206,35306317,unprocessed_pseudogene,-1,2111,chr17_35304206_35306317
Gm18735,17,50227643,50228369,processed_pseudogene,-1,726,chr17_50227643_50228369
Gm18736,17,65438128,65438697,processed_pseudogene,-1,569,chr17_65438128_65438697
Gm18737,17,37860807,37861743,processed_pseudogene,1,936,chr17_37860807_37861743
Gm18738,17,71483392,71483914,processed_pseudogene,1,522,chr17_71483392_71483914
Gm18741,15,19749723,19750440,processed_pseudogene,1,717,chr15_19749723_19750440
Gm18747,16,19018055,19018702,processed_pseudogene,-1,647,chr16_19018055_19018702
Gm18753,5,150446782,150447347,processed_pseudogene,1,565,chr5_150446782_150447347
Gm18755,10,130469511,130470609,processed_pseudogene,-1,1098,chr10_130469511_130470609
Gm18759,13,115163608,115164820,processed_pseudogene,-1,1212,chr13_115163608_115164820
Gm18760,14,30027687,30028351,processed_pseudogene,-1,664,chr14_30027687_30028351
Gm18762,14,50670388,50672234,processed_pseudogene,1,1846,chr14_50670388_50672234
Gm18763,18,7684530,7692726,processed_pseudogene,-1,8196,chr18_7684530_7692726
Gm18769,16,20960627,20961142,processed_pseudogene,-1,515,chr16_20960627_20961142
Gm18770,16,21021328,21021842,processed_pseudogene,1,514,chr16_21021328_21021842
Gm18771,16,21121830,21122523,processed_pseudogene,1,693,chr16_21121830_21122523
Gm18774,12,3216912,3228147,unprocessed_pseudogene,1,11235,chr12_3216912_3228147
Gm18775,1,17993010,17999622,transcribed_unprocessed_pseudogene,-1,6612,chr1_17993010_17999622
Gm18777,10,66740286,66741159,processed_pseudogene,-1,873,chr10_66740286_66741159
Gm18782,7,80979893,80981291,processed_pseudogene,1,1398,chr7_80979893_80981291
Gm18783,13,3124309,3125459,processed_pseudogene,-1,1150,chr13_3124309_3125459
Gm18784,17,39113387,39115485,processed_pseudogene,1,2098,chr17_39113387_39115485
Gm18786,18,74936280,74938320,processed_pseudogene,1,2040,chr18_74936280_74938320
Gm18787,15,55474780,55475563,transcribed_processed_pseudogene,-1,783,chr15_55474780_55475563
Gm18791,2,39153964,39154689,processed_pseudogene,1,725,chr2_39153964_39154689
Gm18795,12,101218185,101373116,transcribed_unprocessed_pseudogene,1,154931,chr12_101218185_101373116
Gm18796,Y,2298529,2314624,unprocessed_pseudogene,-1,16095,chrY_2298529_2314624
Gm18797,Y,2078596,2085281,unprocessed_pseudogene,1,6685,chrY_2078596_2085281
Gm18798,Y,2678944,2689032,unprocessed_pseudogene,1,10088,chrY_2678944_2689032
Gm18800,1,53326206,53342186,transcribed_unprocessed_pseudogene,-1,15980,chr1_53326206_53342186
Gm18805,7,73688235,73689167,processed_pseudogene,-1,932,chr7_73688235_73689167
Gm18806,7,81742345,81744316,processed_pseudogene,1,1971,chr7_81742345_81744316
Gm18813,14,34260332,34261683,processed_pseudogene,1,1351,chr14_34260332_34261683
Gm18821,9,71908843,71909551,processed_pseudogene,1,708,chr9_71908843_71909551
Gm18822,3,8615275,8616504,processed_pseudogene,-1,1229,chr3_8615275_8616504
Gm18827,12,91482053,91482842,processed_pseudogene,1,789,chr12_91482053_91482842
Gm18829,1,59950403,59952464,processed_pseudogene,-1,2061,chr1_59950403_59952464
Gm18830,5,21124017,21125412,processed_pseudogene,1,1395,chr5_21124017_21125412
Gm18838,6,61016851,61017736,processed_pseudogene,-1,885,chr6_61016851_61017736
Gm18840,6,124561215,124563785,unprocessed_pseudogene,1,2570,chr6_124561215_124563785
Gm18842,19,7402834,7403431,processed_pseudogene,-1,597,chr19_7402834_7403431
Gm18843,3,46413402,46414120,processed_pseudogene,1,718,chr3_46413402_46414120
Gm18848,12,101205723,101206514,processed_pseudogene,1,791,chr12_101205723_101206514
Gm18849,1,46056310,46058986,unprocessed_pseudogene,1,2676,chr1_46056310_46058986
Gm18851,7,11890770,11900556,unprocessed_pseudogene,-1,9786,chr7_11890770_11900556
Gm18854,7,12025451,12030404,unprocessed_pseudogene,1,4953,chr7_12025451_12030404
Gm18859,13,17820946,17821770,processed_pseudogene,1,824,chr13_17820946_17821770
Gm18860,8,71704205,71704968,processed_pseudogene,-1,763,chr8_71704205_71704968
Gm18862,6,86351851,86352984,unprocessed_pseudogene,1,1133,chr6_86351851_86352984
Gm18864,3,19708270,19709320,processed_pseudogene,-1,1050,chr3_19708270_19709320
Gm18867,3,57962194,57963372,processed_pseudogene,1,1178,chr3_57962194_57963372
Gm18875,1,123804540,123805421,processed_pseudogene,-1,881,chr1_123804540_123805421
Gm18879,13,13103874,13105410,processed_pseudogene,1,1536,chr13_13103874_13105410
Gm18883,13,112699679,112700036,processed_pseudogene,1,357,chr13_112699679_112700036
Gm18889,15,36119998,36120926,processed_pseudogene,-1,928,chr15_36119998_36120926
Gm18890,15,99883640,99884444,processed_pseudogene,1,804,chr15_99883640_99884444
Gm18891,9,25349498,25351664,processed_pseudogene,1,2166,chr9_25349498_25351664
Gm18892,9,40039891,40040771,processed_pseudogene,1,880,chr9_40039891_40040771
Gm18893,3,36213814,36214756,processed_pseudogene,-1,942,chr3_36213814_36214756
Gm18894,3,102074453,102075146,processed_pseudogene,1,693,chr3_102074453_102075146
Gm18899,12,78255890,78256435,processed_pseudogene,-1,545,chr12_78255890_78256435
Gm18903,10,29425706,29426573,unprocessed_pseudogene,1,867,chr10_29425706_29426573
Gm18904,10,119090342,119090848,processed_pseudogene,1,506,chr10_119090342_119090848
Gm18908,7,60132202,60133684,processed_pseudogene,1,1482,chr7_60132202_60133684
Gm18909,14,32154748,32156071,processed_pseudogene,-1,1323,chr14_32154748_32156071
Gm18910,18,79936152,79936953,processed_pseudogene,1,801,chr18_79936152_79936953
Gm18911,15,77701997,77703044,processed_pseudogene,1,1047,chr15_77701997_77703044
Gm18913,6,65432160,65433948,processed_pseudogene,1,1788,chr6_65432160_65433948
Gm18914,9,99260945,99261560,processed_pseudogene,-1,615,chr9_99260945_99261560
Gm18916,3,126278030,126279275,processed_pseudogene,1,1245,chr3_126278030_126279275
Gm18917,2,173749938,173750487,processed_pseudogene,1,549,chr2_173749938_173750487
Gm18921,12,119067065,119067430,processed_pseudogene,-1,365,chr12_119067065_119067430
Gm18924,8,72036069,72036588,processed_pseudogene,-1,519,chr8_72036069_72036588
Gm18929,18,57334305,57338193,unprocessed_pseudogene,1,3888,chr18_57334305_57338193
Gm18930,15,68762491,68764253,processed_pseudogene,1,1762,chr15_68762491_68764253
Gm18934,9,11277000,11278043,processed_pseudogene,-1,1043,chr9_11277000_11278043
Gm18939,12,39948444,39950632,transcribed_processed_pseudogene,-1,2188,chr12_39948444_39950632
Gm18940,12,66845590,66846460,processed_pseudogene,1,870,chr12_66845590_66846460
Gm18943,7,99247605,99248820,processed_pseudogene,-1,1215,chr7_99247605_99248820
Gm18944,7,108203145,108203787,processed_pseudogene,1,642,chr7_108203145_108203787
Gm18948,18,7548987,7549581,processed_pseudogene,1,594,chr18_7548987_7549581
Gm18949,15,34268527,34269829,processed_pseudogene,-1,1302,chr15_34268527_34269829
Gm18953,2,90239483,90241423,unprocessed_pseudogene,1,1940,chr2_90239483_90241423
Gm18954,12,41016855,41020252,processed_pseudogene,-1,3397,chr12_41016855_41020252
Gm18955,12,117723972,117724620,processed_pseudogene,1,648,chr12_117723972_117724620
Gm18956,1,3252757,3253236,processed_pseudogene,1,479,chr1_3252757_3253236
Gm18957,5,26355418,26357230,processed_pseudogene,1,1812,chr5_26355418_26357230
Gm18958,7,84801034,84803163,unprocessed_pseudogene,1,2129,chr7_84801034_84803163
Gm18959,7,99945062,99945716,processed_pseudogene,1,654,chr7_99945062_99945716
Gm18960,13,93420604,93421316,processed_pseudogene,-1,712,chr13_93420604_93421316
Gm18961,17,66823120,66823780,processed_pseudogene,1,660,chr17_66823120_66823780
Gm18969,1,101753814,101754543,processed_pseudogene,-1,729,chr1_101753814_101754543
Gm18972,10,27870091,27870720,processed_pseudogene,1,629,chr10_27870091_27870720
Gm18974,13,53888627,53890855,processed_pseudogene,1,2228,chr13_53888627_53890855
Gm18977,14,109523099,109524096,processed_pseudogene,1,997,chr14_109523099_109524096
Gm18979,15,91960740,91963518,processed_pseudogene,1,2778,chr15_91960740_91963518
Gm18981,6,118617626,118619224,processed_pseudogene,-1,1598,chr6_118617626_118619224
Gm18982,3,99180753,99181281,processed_pseudogene,-1,528,chr3_99180753_99181281
Gm18983,12,87480108,87482836,processed_pseudogene,1,2728,chr12_87480108_87482836
Gm18986,10,41378896,41380881,processed_pseudogene,-1,1985,chr10_41378896_41380881
Gm18988,7,66126954,66127699,processed_pseudogene,-1,745,chr7_66126954_66127699
Gm18990,13,78121070,78122718,processed_pseudogene,1,1648,chr13_78121070_78122718
Gm18991,8,11738621,11739366,processed_pseudogene,1,745,chr8_11738621_11739366
Gm18994,15,35733604,35734622,processed_pseudogene,1,1018,chr15_35733604_35734622
Gm18996,9,57328661,57329415,processed_pseudogene,-1,754,chr9_57328661_57329415
Gm18999,19,61255967,61258627,processed_pseudogene,1,2660,chr19_61255967_61258627
Gm19000,16,62601383,62602481,processed_pseudogene,1,1098,chr16_62601383_62602481
Gm19001,12,66482506,66484156,processed_pseudogene,1,1650,chr12_66482506_66484156
Gm19002,1,7315451,7316462,processed_pseudogene,1,1011,chr1_7315451_7316462
Gm19016,14,35548132,35549126,processed_pseudogene,-1,994,chr14_35548132_35549126
Gm19026,1,6429655,6441296,processed_pseudogene,-1,11641,chr1_6429655_6441296
Gm19028,1,27989910,27991782,processed_pseudogene,1,1872,chr1_27989910_27991782
Gm19029,1,100006021,100006584,processed_pseudogene,1,563,chr1_100006021_100006584
Gm19031,5,48665905,48667269,processed_pseudogene,1,1364,chr5_48665905_48667269
Gm19032,7,61882972,61883563,processed_pseudogene,1,591,chr7_61882972_61883563
Gm19034,14,24285109,24290650,unprocessed_pseudogene,1,5541,chr14_24285109_24290650
Gm19035,18,37079994,37082457,transcribed_processed_pseudogene,1,2463,chr18_37079994_37082457
Gm19040,6,114738534,114743259,processed_pseudogene,1,4725,chr6_114738534_114743259
Gm19046,12,36172368,36173665,processed_pseudogene,1,1297,chr12_36172368_36173665
Gm19052,18,10217043,10238921,transcribed_processed_pseudogene,1,21878,chr18_10217043_10238921
Gm19056,12,32929151,32929947,processed_pseudogene,-1,796,chr12_32929151_32929947
Gm19062,18,79859655,79861899,processed_pseudogene,-1,2244,chr18_79859655_79861899
Gm19065,6,128208119,128211644,transcribed_processed_pseudogene,1,3525,chr6_128208119_128211644
Gm19066,3,80088082,80089159,processed_pseudogene,-1,1077,chr3_80088082_80089159
Gm19076,18,63898332,63899031,processed_pseudogene,-1,699,chr18_63898332_63899031
Gm19077,15,66357521,66358484,processed_pseudogene,-1,963,chr15_66357521_66358484
Gm19078,6,71918899,71919844,processed_pseudogene,-1,945,chr6_71918899_71919844
Gm19084,12,15102442,15104203,processed_pseudogene,1,1761,chr12_15102442_15104203
Gm19085,1,91487729,91490009,processed_pseudogene,-1,2280,chr1_91487729_91490009
Gm19086,1,112151089,112151753,processed_pseudogene,1,664,chr1_112151089_112151753
Gm19087,1,151107915,151108860,processed_pseudogene,1,945,chr1_151107915_151108860
Gm19089,5,145818761,145835195,unprocessed_pseudogene,1,16434,chr5_145818761_145835195
Gm19090,10,119342492,119343265,processed_pseudogene,1,773,chr10_119342492_119343265
Gm19092,7,18626688,18627990,processed_pseudogene,-1,1302,chr7_18626688_18627990
Gm19093,7,11716716,11720271,unprocessed_pseudogene,1,3555,chr7_11716716_11720271
Gm19095,13,75199214,75199943,processed_pseudogene,1,729,chr13_75199214_75199943
Gm19097,14,61283780,61284788,processed_pseudogene,-1,1008,chr14_61283780_61284788
Gm19098,14,78829326,78831270,processed_pseudogene,-1,1944,chr14_78829326_78831270
Gm19100,18,38582850,38583455,processed_pseudogene,1,605,chr18_38582850_38583455
Gm19109,14,50552868,50553828,processed_pseudogene,1,960,chr14_50552868_50553828
Gm19113,9,26366831,26368658,processed_pseudogene,-1,1827,chr9_26366831_26368658
Gm19114,3,13838875,13840231,processed_pseudogene,-1,1356,chr3_13838875_13840231
Gm19120,14,80834332,80835019,processed_pseudogene,1,687,chr14_80834332_80835019
Gm19121,9,44955715,44956736,unprocessed_pseudogene,1,1021,chr9_44955715_44956736
Gm19134,12,62690053,62690539,processed_pseudogene,-1,486,chr12_62690053_62690539
Gm19136,1,150022190,150024256,processed_pseudogene,-1,2066,chr1_150022190_150024256
Gm19139,13,88509280,88511336,processed_pseudogene,-1,2056,chr13_88509280_88511336
Gm19140,8,36450380,36450800,processed_pseudogene,1,420,chr8_36450380_36450800
Gm19142,16,44803545,44805504,processed_pseudogene,-1,1959,chr16_44803545_44805504
Gm19144,12,69970386,69972795,processed_pseudogene,1,2409,chr12_69970386_69972795
Gm19161,10,9748423,9749159,processed_pseudogene,-1,736,chr10_9748423_9749159
Gm19163,13,3456991,3457770,processed_pseudogene,-1,779,chr13_3456991_3457770
Gm19165,6,59036889,59039322,processed_pseudogene,1,2433,chr6_59036889_59039322
Gm19166,3,142664444,142665506,processed_pseudogene,-1,1062,chr3_142664444_142665506
Gm19168,10,73372332,73376033,processed_pseudogene,-1,3701,chr10_73372332_73376033
Gm19169,10,123583588,123584833,processed_pseudogene,1,1245,chr10_123583588_123584833
Gm19174,9,18400542,18402855,processed_pseudogene,1,2313,chr9_18400542_18402855
Gm19175,3,17923708,17924623,processed_pseudogene,1,915,chr3_17923708_17924623
Gm19177,6,107881073,107881685,processed_pseudogene,1,612,chr6_107881073_107881685
Gm19178,9,18298833,18300651,processed_pseudogene,-1,1818,chr9_18298833_18300651
Gm19179,19,43544183,43544962,processed_pseudogene,1,779,chr19_43544183_43544962
Gm19181,10,107061044,107061983,processed_pseudogene,-1,939,chr10_107061044_107061983
Gm19183,17,72256258,72257146,processed_pseudogene,1,888,chr17_72256258_72257146
Gm19186,10,82566772,82567507,processed_pseudogene,1,735,chr10_82566772_82567507
Gm19187,7,56216362,56217253,processed_pseudogene,-1,891,chr7_56216362_56217253
Gm19193,9,95425630,95426359,processed_pseudogene,1,729,chr9_95425630_95426359
Gm19194,3,71672518,71677123,processed_pseudogene,1,4605,chr3_71672518_71677123
Gm19195,12,111860626,111861136,processed_pseudogene,-1,510,chr12_111860626_111861136
Gm19196,12,21543307,21554521,transcribed_unprocessed_pseudogene,1,11214,chr12_21543307_21554521
Gm19197,17,52008967,52009569,processed_pseudogene,1,602,chr17_52008967_52009569
Gm19200,X,103287167,103288970,processed_pseudogene,-1,1803,chrX_103287167_103288970
Gm19201,7,12182468,12183245,processed_pseudogene,-1,777,chr7_12182468_12183245
Gm19202,3,102685910,102686717,processed_pseudogene,-1,807,chr3_102685910_102686717
Gm19203,7,86906996,86907934,processed_pseudogene,-1,938,chr7_86906996_86907934
Gm19209,19,3821764,3822389,processed_pseudogene,-1,625,chr19_3821764_3822389
Gm19211,3,98522741,98526690,unprocessed_pseudogene,-1,3949,chr3_98522741_98526690
Gm19216,14,68113933,68115145,processed_pseudogene,1,1212,chr14_68113933_68115145
Gm19217,10,76133434,76140301,unprocessed_pseudogene,1,6867,chr10_76133434_76140301
Gm19219,9,65336174,65336897,processed_pseudogene,-1,723,chr9_65336174_65336897
Gm19221,12,69980886,69982468,processed_pseudogene,1,1582,chr12_69980886_69982468
Gm19222,14,65961121,65962888,processed_pseudogene,-1,1767,chr14_65961121_65962888
Gm19223,14,112578865,112580551,processed_pseudogene,-1,1686,chr14_112578865_112580551
Gm19228,9,82196479,82197195,processed_pseudogene,-1,716,chr9_82196479_82197195
Gm19236,15,52033369,52036066,processed_pseudogene,1,2697,chr15_52033369_52036066
Gm19238,12,99804389,99805648,processed_pseudogene,-1,1259,chr12_99804389_99805648
Gm19241,19,31913644,31914551,processed_pseudogene,1,907,chr19_31913644_31914551
Gm19243,3,117222960,117223602,processed_pseudogene,-1,642,chr3_117222960_117223602
Gm19244,6,57617025,57617277,processed_pseudogene,-1,252,chr6_57617025_57617277
Gm19246,7,42488801,42489055,processed_pseudogene,1,254,chr7_42488801_42489055
Gm19248,7,46967248,46967357,processed_pseudogene,1,109,chr7_46967248_46967357
Gm19252,6,14081331,14081635,processed_pseudogene,-1,304,chr6_14081331_14081635
Gm19253,6,49071630,49071936,processed_pseudogene,1,306,chr6_49071630_49071936
Gm19254,6,122414104,122414397,processed_pseudogene,1,293,chr6_122414104_122414397
Gm19257,1,82777028,82777210,processed_pseudogene,-1,182,chr1_82777028_82777210
Gm19276,15,10814792,10835214,lincRNA,1,20422,chr15_10814792_10835214
Gm19290,14,18095724,18096034,processed_pseudogene,1,310,chr14_18095724_18096034
Gm19299,9,67133560,67213918,lincRNA,1,80358,chr9_67133560_67213918
Gm19303,15,51231640,51395610,lincRNA,-1,163970,chr15_51231640_51395610
Gm19312,19,16413494,16414290,processed_pseudogene,1,796,chr19_16413494_16414290
Gm19324,9,8142541,8185129,unprocessed_pseudogene,1,42588,chr9_8142541_8185129
Gm19325,9,97047444,97067307,lincRNA,-1,19863,chr9_97047444_97067307
Gm19340,12,25282595,25282939,processed_pseudogene,1,344,chr12_25282595_25282939
Gm19345,7,19852003,19858350,protein_coding,1,6347,chr7_19852003_19858350
Gm19353,9,72289667,72290111,processed_pseudogene,1,444,chr9_72289667_72290111
Gm19366,7,128013029,128013184,processed_pseudogene,-1,155,chr7_128013029_128013184
Gm19395,10,53280281,53283686,antisense,1,3405,chr10_53280281_53283686
Gm19410,8,35765790,35818047,protein_coding,1,52257,chr8_35765790_35818047
Gm19412,17,33919279,33920485,antisense,-1,1206,chr17_33919279_33920485
Gm19426,2,84742169,84743655,protein_coding,-1,1486,chr2_84742169_84743655
Gm1943,8,109340691,109340864,processed_pseudogene,-1,173,chr8_109340691_109340864
Gm19434,6,135188480,135194960,antisense,1,6480,chr6_135188480_135194960
Gm19457,5,31356348,31356795,processed_pseudogene,-1,447,chr5_31356348_31356795
Gm19461,1,133250398,133269808,antisense,-1,19410,chr1_133250398_133269808
Gm19466,18,53639106,53705420,lincRNA,1,66314,chr18_53639106_53705420
Gm19480,1,44873486,44874152,processed_pseudogene,-1,666,chr1_44873486_44874152
Gm19500,18,57405415,57416150,processed_transcript,1,10735,chr18_57405415_57416150
Gm19505,19,6027538,6027865,processed_pseudogene,-1,327,chr19_6027538_6027865
Gm19519,18,57688646,57792360,antisense,-1,103714,chr18_57688646_57792360
Gm19522,16,42884370,42912065,antisense,-1,27695,chr16_42884370_42912065
Gm19554,12,105899841,105902150,lincRNA,1,2309,chr12_105899841_105902150
Gm19557,19,47512982,47516578,antisense,1,3596,chr19_47512982_47516578
Gm19563,12,38998654,38998923,processed_pseudogene,1,269,chr12_38998654_38998923
Gm19566,5,105980573,105981182,processed_pseudogene,-1,609,chr5_105980573_105981182
Gm19571,16,12381130,12381502,processed_pseudogene,-1,372,chr16_12381130_12381502
Gm19572,9,77851708,77852045,processed_pseudogene,1,337,chr9_77851708_77852045
Gm19582,1,87853347,87854299,antisense,-1,952,chr1_87853347_87854299
Gm19585,17,51986415,52163976,lincRNA,1,177561,chr17_51986415_52163976
Gm19589,1,88551517,88562167,lincRNA,1,10650,chr1_88551517_88562167
Gm19596,6,86147152,86148194,unprocessed_pseudogene,1,1042,chr6_86147152_86148194
Gm19599,12,49499008,49499365,processed_pseudogene,1,357,chr12_49499008_49499365
Gm19611,10,41046841,41049104,processed_pseudogene,-1,2263,chr10_41046841_41049104
Gm19619,5,91257571,91283421,lincRNA,-1,25850,chr5_91257571_91283421
Gm19620,5,100513187,100513620,processed_pseudogene,-1,433,chr5_100513187_100513620
Gm19637,1,54566703,54567281,processed_pseudogene,1,578,chr1_54566703_54567281
Gm19653,6,97449750,97451486,processed_pseudogene,1,1736,chr6_97449750_97451486
Gm1966,7,106596743,106604035,unprocessed_pseudogene,-1,7292,chr7_106596743_106604035
Gm1968,16,29957927,29979184,lincRNA,-1,21257,chr16_29957927_29979184
Gm19680,1,31615149,31616661,processed_pseudogene,1,1512,chr1_31615149_31616661
Gm19688,10,75619080,75619503,processed_pseudogene,-1,423,chr10_75619080_75619503
Gm1969,5,29832088,29833307,processed_pseudogene,-1,1219,chr5_29832088_29833307
Gm19705,1,136670769,136690804,lincRNA,1,20035,chr1_136670769_136690804
Gm19709,9,38786290,38786771,processed_pseudogene,-1,481,chr9_38786290_38786771
Gm19710,3,89998760,90021445,lincRNA,1,22685,chr3_89998760_90021445
Gm19716,14,59642312,59644384,transcribed_processed_pseudogene,1,2072,chr14_59642312_59644384
Gm1972,10,22224280,22253819,unprocessed_pseudogene,1,29539,chr10_22224280_22253819
Gm19744,8,48843665,48869901,processed_transcript,1,26236,chr8_48843665_48869901
Gm19757,6,105481266,105492668,lincRNA,-1,11402,chr6_105481266_105492668
Gm1976,17,94759944,94834799,processed_transcript,-1,74855,chr17_94759944_94834799
Gm19777,1,194819730,194820087,processed_pseudogene,-1,357,chr1_194819730_194820087
Gm19782,15,70011623,70077841,lincRNA,1,66218,chr15_70011623_70077841
Gm19786,12,18559615,18565108,unprocessed_pseudogene,1,5493,chr12_18559615_18565108
Gm1979,5,25999022,26004798,protein_coding,-1,5776,chr5_25999022_26004798
Gm19792,13,62336463,62340727,lincRNA,-1,4264,chr13_62336463_62340727
Gm19798,5,34060761,34061217,processed_pseudogene,-1,456,chr5_34060761_34061217
Gm1980,2,176298827,176302568,unprocessed_pseudogene,1,3741,chr2_176298827_176302568
Gm19801,10,25831134,25836156,processed_pseudogene,1,5022,chr10_25831134_25836156
Gm19807,17,37130909,37131575,processed_pseudogene,1,666,chr17_37130909_37131575
Gm19829,14,114308700,114310803,processed_pseudogene,-1,2103,chr14_114308700_114310803
Gm19840,15,22935487,22937241,processed_pseudogene,1,1754,chr15_22935487_22937241
Gm19866,13,59901233,59915822,lincRNA,-1,14589,chr13_59901233_59915822
Gm19880,7,28534772,28535089,processed_pseudogene,1,317,chr7_28534772_28535089
Gm19908,6,94349534,94349924,processed_pseudogene,1,390,chr6_94349534_94349924
Gm19921,8,53911739,53912441,processed_pseudogene,1,702,chr8_53911739_53912441
Gm19931,5,113817225,113817592,processed_pseudogene,1,367,chr5_113817225_113817592
Gm19935,8,90816145,90817393,protein_coding,-1,1248,chr8_90816145_90817393
Gm19936,9,56932431,56933268,processed_pseudogene,-1,837,chr9_56932431_56933268
Gm1995,12,87861366,87863967,processed_pseudogene,1,2601,chr12_87861366_87863967
Gm19950,7,119607681,119643469,antisense,-1,35788,chr7_119607681_119643469
Gm19963,7,119742856,119744110,processed_pseudogene,-1,1254,chr7_119742856_119744110
Gm19990,12,56253243,56266384,lincRNA,1,13141,chr12_56253243_56266384
Gm2000,1,156366040,156366484,protein_coding,1,444,chr1_156366040_156366484
Gm20005,5,149641610,149647790,lincRNA,1,6180,chr5_149641610_149647790
Gm20008,17,22713782,22716937,processed_pseudogene,-1,3155,chr17_22713782_22716937
Gm20026,17,26232564,26232881,processed_pseudogene,1,317,chr17_26232564_26232881
Gm20036,12,101913240,101915335,processed_transcript,1,2095,chr12_101913240_101915335
Gm20040,16,30092482,30092882,processed_pseudogene,-1,400,chr16_30092482_30092882
Gm20056,16,32408536,32409054,processed_pseudogene,1,518,chr16_32408536_32409054
Gm20063,12,61499660,61521820,lincRNA,-1,22160,chr12_61499660_61521820
Gm20075,13,96079216,96081376,protein_coding,-1,2160,chr13_96079216_96081376
Gm20083,7,73185744,73189446,lincRNA,1,3702,chr7_73185744_73189446
Gm20091,10,96408850,96409038,processed_pseudogene,-1,188,chr10_96408850_96409038
Gm20096,18,28602648,28602989,processed_pseudogene,-1,341,chr18_28602648_28602989
Gm20098,17,51882727,51965257,lincRNA,1,82530,chr17_51882727_51965257
Gm2011,3,40747101,40875388,transcribed_unprocessed_pseudogene,1,128287,chr3_40747101_40875388
Gm20110,10,99609171,99658134,lincRNA,1,48963,chr10_99609171_99658134
Gm20125,10,16906427,17095807,processed_transcript,-1,189380,chr10_16906427_17095807
Gm20128,3,58404701,58405117,processed_pseudogene,1,416,chr3_58404701_58405117
Gm20136,18,32499500,32500432,processed_pseudogene,-1,932,chr18_32499500_32500432
Gm20139,10,19141751,19206702,lincRNA,1,64951,chr10_19141751_19206702
Gm20147,18,8227514,8228006,processed_pseudogene,-1,492,chr18_8227514_8228006
Gm20149,10,21034304,21048899,antisense,-1,14595,chr10_21034304_21048899
Gm20150,15,59671628,59672113,processed_pseudogene,-1,485,chr15_59671628_59672113
Gm20156,5,41934397,41935672,processed_pseudogene,-1,1275,chr5_41934397_41935672
Gm20161,17,29652228,29658336,antisense,-1,6108,chr17_29652228_29658336
Gm20162,18,37434243,37435113,processed_pseudogene,1,870,chr18_37434243_37435113
Gm20164,16,20583109,20583424,processed_pseudogene,1,315,chr16_20583109_20583424
Gm20177,6,65247273,65247606,processed_pseudogene,1,333,chr6_65247273_65247606
Gm20219,17,56551414,56554387,protein_coding,-1,2973,chr17_56551414_56554387
Gm20223,5,55722617,55723421,processed_pseudogene,-1,804,chr5_55722617_55723421
Gm20239,5,27820970,27821951,processed_pseudogene,1,981,chr5_27820970_27821951
Gm20241,14,8687419,8687965,processed_pseudogene,1,546,chr14_8687419_8687965
Gm20257,1,58652641,58655831,transcribed_unprocessed_pseudogene,1,3190,chr1_58652641_58655831
Gm2027,12,44221745,44223373,processed_pseudogene,1,1628,chr12_44221745_44223373
Gm20275,9,59826257,59941077,antisense,-1,114820,chr9_59826257_59941077
Gm20294,18,66417328,66417803,processed_pseudogene,1,475,chr18_66417328_66417803
Gm20300,10,30603195,30606634,lincRNA,-1,3439,chr10_30603195_30606634
Gm20304,10,33463905,33464348,processed_pseudogene,1,443,chr10_33463905_33464348
Gm20319,16,26714446,26755502,antisense,-1,41056,chr16_26714446_26755502
Gm20324,15,82899080,82905818,antisense,1,6738,chr15_82899080_82905818
Gm2033,8,39718680,39720966,processed_pseudogene,-1,2286,chr8_39718680_39720966
Gm20336,12,22829733,22833361,unprocessed_pseudogene,-1,3628,chr12_22829733_22833361
Gm20337,12,80942673,80945396,bidirectional_promoter_lncRNA,-1,2723,chr12_80942673_80945396
Gm20356,3,74009217,74017277,lincRNA,-1,8060,chr3_74009217_74017277
Gm20362,6,79032044,79035869,lincRNA,1,3825,chr6_79032044_79035869
Gm20383,6,81984321,81992413,lincRNA,1,8092,chr6_81984321_81992413
Gm20387,6,110639753,110645916,antisense,-1,6163,chr6_110639753_110645916
Gm20389,3,154708658,154711343,antisense,-1,2685,chr3_154708658_154711343
Gm2040,5,75108635,75108923,processed_pseudogene,1,288,chr5_75108635_75108923
Gm20445,6,65882779,65883343,processed_pseudogene,1,564,chr6_65882779_65883343
Gm20465,5,33293614,33311150,lincRNA,-1,17536,chr5_33293614_33311150
Gm2048,14,20249415,20260932,unprocessed_pseudogene,-1,11517,chr14_20249415_20260932
Gm20482,7,8855847,8862851,transcribed_unprocessed_pseudogene,-1,7004,chr7_8855847_8862851
Gm20491,17,90792766,90794006,processed_pseudogene,-1,1240,chr17_90792766_90794006
Gm20492,10,127288514,127289681,processed_transcript,1,1167,chr10_127288514_127289681
Gm20501,7,141943704,141949539,bidirectional_promoter_lncRNA,-1,5835,chr7_141943704_141949539
Gm20511,11,103190710,103192896,antisense,-1,2186,chr11_103190710_103192896
Gm2053,1,4735046,4735676,processed_pseudogene,-1,630,chr1_4735046_4735676
Gm20541,17,38009647,38012396,unprocessed_pseudogene,1,2749,chr17_38009647_38012396
Gm20544,18,75365332,75367088,processed_transcript,-1,1756,chr18_75365332_75367088
Gm20553,7,3263777,3265192,unprocessed_pseudogene,-1,1415,chr7_3263777_3265192
Gm20560,6,73012043,73020360,antisense,1,8317,chr6_73012043_73020360
Gm20564,15,99915428,99915900,processed_pseudogene,-1,472,chr15_99915428_99915900
Gm20570,18,75767143,75767274,processed_pseudogene,1,131,chr18_75767143_75767274
Gm20574,17,40854036,40868141,unitary_pseudogene,1,14105,chr17_40854036_40868141
Gm2058,7,39588931,39589717,processed_pseudogene,1,786,chr7_39588931_39589717
Gm20587,1,20821331,20822516,processed_pseudogene,1,1185,chr1_20821331_20822516
Gm20589,6,113352636,113355165,processed_pseudogene,-1,2529,chr6_113352636_113355165
Gm2059,8,75079141,75079871,processed_pseudogene,1,730,chr8_75079141_75079871
Gm20593,18,79348434,79348699,processed_pseudogene,1,265,chr18_79348434_79348699
Gm20594,6,79817916,79818364,protein_coding,1,448,chr6_79817916_79818364
Gm20596,17,48055995,48056607,processed_pseudogene,-1,612,chr17_48055995_48056607
Gm20597,10,53498443,53518989,lincRNA,-1,20546,chr10_53498443_53518989
Gm20605,5,137629175,137642899,protein_coding,1,13724,chr5_137629175_137642899
Gm20609,10,71310745,71313977,lincRNA,1,3232,chr10_71310745_71313977
Gm2061,1,185447116,185455568,antisense,-1,8452,chr1_185447116_185455568
Gm20611,10,61031303,61038080,lincRNA,1,6777,chr10_61031303_61038080
Gm20616,19,26620822,26623419,antisense,-1,2597,chr19_26620822_26623419
Gm20627,3,96254619,96256277,processed_transcript,-1,1658,chr3_96254619_96256277
Gm20642,14,39220071,39250430,antisense,1,30359,chr14_39220071_39250430
Gm20652,3,88616457,88621061,antisense,-1,4604,chr3_88616457_88621061
Gm20655,10,17790522,17799921,antisense,-1,9399,chr10_17790522_17799921
Gm20670,7,64057602,64062958,lincRNA,1,5356,chr7_64057602_64062958
Gm20679,7,10194461,10205677,unprocessed_pseudogene,-1,11216,chr7_10194461_10205677
Gm20687,14,55054945,55098986,antisense,1,44041,chr14_55054945_55098986
Gm20717,15,64098317,64101397,antisense,1,3080,chr15_64098317_64101397
Gm20735,8,122445268,122451322,lincRNA,-1,6054,chr8_122445268_122451322
Gm20742,17,66193352,66199820,lincRNA,1,6468,chr17_66193352_66199820
Gm20743,1,164863133,164936775,processed_transcript,1,73642,chr1_164863133_164936775
Gm20745,9,68017964,68025714,lincRNA,-1,7750,chr9_68017964_68025714
Gm20751,13,43716791,43719038,lincRNA,1,2247,chr13_43716791_43719038
Gm20752,3,159076364,159308081,lincRNA,1,231717,chr3_159076364_159308081
Gm20753,1,106152625,106171524,lincRNA,-1,18899,chr1_106152625_106171524
Gm20754,3,73066316,73594830,lincRNA,1,528514,chr3_73066316_73594830
Gm20758,10,111854521,111874376,lincRNA,-1,19855,chr10_111854521_111874376
Gm2076,13,93293781,93294751,processed_pseudogene,1,970,chr13_93293781_93294751
Gm20760,4,146932742,146933389,processed_pseudogene,1,647,chr4_146932742_146933389
Gm20762,19,61305038,61305280,processed_pseudogene,-1,242,chr19_61305038_61305280
Gm20767,13,120140246,120155335,protein_coding,1,15089,chr13_120140246_120155335
Gm2077,3,3939144,3939462,processed_pseudogene,1,318,chr3_3939144_3939462
Gm20775,Y,10641257,10643107,unprocessed_pseudogene,-1,1850,chrY_10641257_10643107
Gm20778,8,20035108,20040320,unprocessed_pseudogene,1,5212,chr8_20035108_20040320
Gm20784,13,119962244,119963489,processed_pseudogene,1,1245,chr13_119962244_119963489
Gm20786,8,19942830,19943265,processed_pseudogene,-1,435,chr8_19942830_19943265
Gm20796,8,20882363,20888200,processed_pseudogene,-1,5837,chr8_20882363_20888200
Gm20797,8,20841352,20842350,unprocessed_pseudogene,-1,998,chr8_20841352_20842350
Gm2087,9,83431547,83454573,antisense,1,23026,chr9_83431547_83454573
Gm20939,17,94864918,94878321,lincRNA,1,13403,chr17_94864918_94878321
Gm20940,3,95964029,95964388,processed_pseudogene,-1,359,chr3_95964029_95964388
Gm20942,16,58555117,58555705,processed_pseudogene,-1,588,chr16_58555117_58555705
Gm20945,8,20869506,20870650,processed_pseudogene,-1,1144,chr8_20869506_20870650
Gm20946,8,20828353,20833219,unprocessed_pseudogene,1,4866,chr8_20828353_20833219
Gm20949,7,25421841,25422792,processed_pseudogene,-1,951,chr7_25421841_25422792
Gm20953,9,38937489,38940102,processed_pseudogene,-1,2613,chr9_38937489_38940102
Gm2098,Y,670179,695777,unprocessed_pseudogene,-1,25598,chrY_670179_695777
Gm21007,12,93716420,93716745,processed_pseudogene,1,325,chr12_93716420_93716745
Gm21009,5,19504455,19506123,processed_pseudogene,-1,1668,chr5_19504455_19506123
Gm2102,1,78216732,78217476,processed_pseudogene,-1,744,chr1_78216732_78217476
Gm21026,10,85730755,85732099,processed_pseudogene,-1,1344,chr10_85730755_85732099
Gm21027,10,86554947,86556182,processed_pseudogene,-1,1235,chr10_86554947_86556182
Gm21028,7,42578466,42578588,protein_coding,-1,122,chr7_42578466_42578588
Gm21038,12,87831002,87841162,processed_pseudogene,-1,10160,chr12_87831002_87841162
Gm21039,12,88280358,88282770,processed_pseudogene,-1,2412,chr12_88280358_88282770
Gm21040,5,11512247,11513378,processed_pseudogene,1,1131,chr5_11512247_11513378
Gm21041,9,39326728,39327887,processed_pseudogene,1,1159,chr9_39326728_39327887
Gm21046,18,70781887,70783895,processed_pseudogene,1,2008,chr18_70781887_70783895
Gm21050,16,56335586,56337378,processed_pseudogene,-1,1792,chr16_56335586_56337378
Gm21051,12,91870143,91871830,processed_pseudogene,-1,1687,chr12_91870143_91871830
Gm21055,18,14830668,14832016,processed_pseudogene,1,1348,chr18_14830668_14832016
Gm21056,12,101101677,101117214,transcribed_unprocessed_pseudogene,-1,15537,chr12_101101677_101117214
Gm21057,7,80062710,80075267,antisense,-1,12557,chr7_80062710_80075267
Gm2106,19,3253518,3255067,processed_pseudogene,-1,1549,chr19_3253518_3255067
Gm21063,14,14437740,14438708,processed_pseudogene,1,968,chr14_14437740_14438708
Gm21089,9,6594237,6594561,processed_pseudogene,1,324,chr9_6594237_6594561
Gm2109,9,83691475,83693223,lincRNA,1,1748,chr9_83691475_83693223
Gm21092,8,20567597,20582771,unprocessed_pseudogene,1,15174,chr8_20567597_20582771
Gm21093,4,42027873,42035425,unprocessed_pseudogene,-1,7552,chr4_42027873_42035425
Gm21112,8,20596464,20597041,processed_pseudogene,-1,577,chr8_20596464_20597041
Gm21119,8,20614919,20640703,protein_coding,1,25784,chr8_20614919_20640703
Gm21122,7,38779749,38786072,processed_pseudogene,-1,6323,chr7_38779749_38786072
Gm21123,7,110690163,110699734,lincRNA,-1,9571,chr7_110690163_110699734
Gm21149,5,15471703,15504507,protein_coding,-1,32804,chr5_15471703_15504507
Gm2115,7,84528954,84583531,protein_coding,1,54577,chr7_84528954_84583531
Gm21168,5,25956626,25957721,processed_pseudogene,1,1095,chr5_25956626_25957721
Gm21178,15,103827252,103949818,processed_pseudogene,1,122566,chr15_103827252_103949818
Gm21181,13,119917680,119918009,processed_pseudogene,-1,329,chr13_119917680_119918009
Gm21284,6,83568039,83588123,antisense,1,20084,chr6_83568039_83588123
Gm21317,Y,82225227,82251419,protein_coding,1,26192,chrY_82225227_82251419
Gm21319,12,87772425,87775755,protein_coding,-1,3330,chr12_87772425_87775755
Gm21321,10,7384111,7390783,processed_pseudogene,-1,6672,chr10_7384111_7390783
Gm21358,13,119864848,119873075,processed_pseudogene,-1,8227,chr13_119864848_119873075
Gm21378,13,120099087,120100332,processed_pseudogene,-1,1245,chr13_120099087_120100332
Gm21388,3,34826616,34879284,lincRNA,1,52668,chr3_34826616_34879284
Gm21399,8,129252998,129253594,processed_pseudogene,1,596,chr8_129252998_129253594
Gm2141,19,3730473,3731012,processed_pseudogene,-1,539,chr19_3730473_3731012
Gm21411,4,146891696,146909590,protein_coding,-1,17894,chr4_146891696_146909590
Gm2142,3,135121861,135122449,processed_pseudogene,1,588,chr3_135121861_135122449
Gm2147,1,6380394,6381032,processed_pseudogene,1,638,chr1_6380394_6381032
Gm21559,12,87765449,87766303,processed_pseudogene,-1,854,chr12_87765449_87766303
Gm2157,15,5301680,5302046,processed_pseudogene,-1,366,chr15_5301680_5302046
Gm21596,2,113919247,113920562,processed_pseudogene,-1,1315,chr2_113919247_113920562
Gm2163,4,42466972,42468868,unprocessed_pseudogene,1,1896,chr4_42466972_42468868
Gm2164,4,124528924,124657169,antisense,-1,128245,chr4_124528924_124657169
Gm21655,5,25919632,25926290,processed_transcript,-1,6658,chr5_25919632_25926290
Gm21663,5,25935791,25942381,protein_coding,-1,6590,chr5_25935791_25942381
Gm21671,5,25948253,25954417,protein_coding,-1,6164,chr5_25948253_25954417
Gm21680,5,25965961,25972663,protein_coding,-1,6702,chr5_25965961_25972663
Gm21698,5,25982030,25988650,protein_coding,-1,6620,chr5_25982030_25988650
Gm21759,5,8179636,8181463,processed_pseudogene,1,1827,chr5_8179636_8181463
Gm2178,14,26514554,26514910,processed_pseudogene,1,356,chr14_26514554_26514910
Gm21811,8,20136502,20151665,unprocessed_pseudogene,1,15163,chr8_20136502_20151665
Gm21885,11,94281873,94286253,protein_coding,1,4380,chr11_94281873_94286253
Gm2189,6,36639838,36640266,processed_pseudogene,-1,428,chr6_36639838_36640266
Gm21917,15,99931711,99953044,antisense,1,21333,chr15_99931711_99953044
Gm21926,17,3103175,3114795,transcribed_processed_pseudogene,-1,11620,chr17_3103175_3114795
Gm21939,12,87781143,87783915,processed_pseudogene,1,2772,chr12_87781143_87783915
Gm21963,13,62778782,62779111,processed_pseudogene,1,329,chr13_62778782_62779111
Gm2199,5,80900750,80901623,processed_pseudogene,-1,873,chr5_80900750_80901623
Gm21994,2,150254518,150255591,protein_coding,-1,1073,chr2_150254518_150255591
Gm21998,X,103003724,103005031,processed_pseudogene,-1,1307,chrX_103003724_103005031
Gm2203,15,45962526,45963459,processed_pseudogene,1,933,chr15_45962526_45963459
Gm2213,5,29807471,29808158,processed_pseudogene,-1,687,chr5_29807471_29808158
Gm22146,17,28446500,28456457,antisense,1,9957,chr17_28446500_28456457
Gm2221,8,43199968,43200385,processed_pseudogene,1,417,chr8_43199968_43200385
Gm2223,X,33505661,33507010,processed_pseudogene,1,1349,chrX_33505661_33507010
Gm2225,8,78486034,78486410,processed_pseudogene,-1,376,chr8_78486034_78486410
Gm2237,14,19563800,19585135,protein_coding,-1,21335,chr14_19563800_19585135
Gm2244,14,19532896,19549963,protein_coding,-1,17067,chr14_19532896_19549963
Gm22498,14,56837071,56837156,snoRNA,-1,85,chr14_56837071_56837156
Gm2253,8,78604294,78604707,processed_pseudogene,1,413,chr8_78604294_78604707
Gm2267,15,47520338,47522645,processed_pseudogene,1,2307,chr15_47520338_47522645
Gm2272,1,191407666,191408247,processed_pseudogene,1,581,chr1_191407666_191408247
Gm23011,3,133588406,133588537,snoRNA,-1,131,chr3_133588406_133588537
Gm2308,7,42125200,42126203,processed_pseudogene,-1,1003,chr7_42125200_42126203
Gm2316,Y,3766452,3767372,processed_pseudogene,1,920,chrY_3766452_3767372
Gm232,10,30010951,30017095,unprocessed_pseudogene,1,6144,chr10_30010951_30017095
Gm23428,9,66360641,66360742,snRNA,-1,101,chr9_66360641_66360742
Gm2343,1,163729569,163730610,processed_pseudogene,1,1041,chr1_163729569_163730610
Gm2345,3,50254855,50255443,processed_pseudogene,1,588,chr3_50254855_50255443
Gm2349,16,84647373,84647992,processed_pseudogene,1,619,chr16_84647373_84647992
Gm23711,4,130775741,130775823,snoRNA,1,82,chr4_130775741_130775823
Gm2381,7,42816829,42867234,protein_coding,-1,50405,chr7_42816829_42867234
Gm2383,1,12565577,12566383,processed_pseudogene,1,806,chr1_12565577_12566383
Gm2387,15,52089308,52089953,processed_pseudogene,1,645,chr15_52089308_52089953
Gm2389,1,85061154,85062642,unprocessed_pseudogene,1,1488,chr1_85061154_85062642
Gm2390,18,84712576,84713472,processed_pseudogene,1,896,chr18_84712576_84713472
Gm2395,12,54716796,54717219,processed_pseudogene,1,423,chr12_54716796_54717219
Gm2404,5,133919159,133920002,processed_pseudogene,-1,843,chr5_133919159_133920002
Gm24105,5,149247950,149248244,miRNA;misc_RNA,-1,294,chr5_149247950_149248244
Gm2412,12,54731716,54732141,processed_pseudogene,-1,425,chr12_54731716_54732141
Gm24148,1,86352008,86352087,snoRNA,-1,79,chr1_86352008_86352087
Gm2420,5,32720330,32736194,transcribed_unprocessed_pseudogene,1,15864,chr5_32720330_32736194
Gm2423,13,13232161,13232893,processed_pseudogene,-1,732,chr13_13232161_13232893
Gm2424,18,9909193,9910498,processed_pseudogene,1,1305,chr18_9909193_9910498
Gm2427,1,85501090,85514604,unprocessed_pseudogene,1,13514,chr1_85501090_85514604
Gm2429,3,12631260,12631845,processed_pseudogene,1,585,chr3_12631260_12631845
Gm24333,8,65093831,65093914,miRNA,-1,83,chr8_65093831_65093914
Gm24392,14,56416766,56416868,snRNA,1,102,chr14_56416766_56416868
Gm2445,13,98402095,98403083,processed_pseudogene,-1,988,chr13_98402095_98403083
Gm24463,9,89075336,89075407,snoRNA,1,71,chr9_89075336_89075407
Gm2447,3,52739716,52776656,lincRNA,1,36940,chr3_52739716_52776656
Gm24474,12,70650182,70693780,lincRNA,1,43598,chr12_70650182_70693780
Gm2449,9,119887449,119894863,bidirectional_promoter_lncRNA,-1,7414,chr9_119887449_119894863
Gm2451,3,139649379,139650377,processed_pseudogene,1,998,chr3_139649379_139650377
Gm24576,7,15946248,15946495,misc_RNA,1,247,chr7_15946248_15946495
Gm24595,X,94455010,94455119,snoRNA,-1,109,chrX_94455010_94455119
Gm2464,3,13470439,13471829,lincRNA,-1,1390,chr3_13470439_13471829
Gm2467,10,21289219,21290228,processed_pseudogene,1,1009,chr10_21289219_21290228
Gm2474,3,13749954,13750512,processed_pseudogene,1,558,chr3_13749954_13750512
Gm2477,16,84598878,84601206,processed_pseudogene,-1,2328,chr16_84598878_84601206
Gm2479,5,123007299,123015080,antisense,-1,7781,chr5_123007299_123015080
Gm2492,13,14220545,14221938,processed_pseudogene,-1,1393,chr13_14220545_14221938
Gm2495,9,92612512,92612977,processed_pseudogene,-1,465,chr9_92612512_92612977
Gm2516,8,50368112,50416088,lincRNA,1,47976,chr8_50368112_50416088
Gm2518,19,8776266,8776560,processed_pseudogene,1,294,chr19_8776266_8776560
Gm2531,18,10145453,10145965,pseudogene,-1,512,chr18_10145453_10145965
Gm2534,13,101348752,101349181,processed_pseudogene,1,429,chr13_101348752_101349181
Gm2539,10,22074237,22103313,transcribed_unprocessed_pseudogene,1,29076,chr10_22074237_22103313
Gm25404,3,55548446,55548552,snRNA,1,106,chr3_55548446_55548552
Gm2541,16,85553233,85553943,processed_pseudogene,-1,710,chr16_85553233_85553943
Gm25432,19,5435998,5436725,processed_pseudogene,1,727,chr19_5435998_5436725
Gm2546,7,89607706,89608696,processed_pseudogene,1,990,chr7_89607706_89608696
Gm25500,9,15312552,15312674,snoRNA,1,122,chr9_15312552_15312674
Gm2553,9,63801193,63801797,processed_pseudogene,-1,604,chr9_63801193_63801797
Gm2564,4,42629897,42631507,unprocessed_pseudogene,1,1610,chr4_42629897_42631507
Gm2573,15,12181147,12181464,processed_pseudogene,1,317,chr15_12181147_12181464
Gm2574,3,142962611,142963612,processed_pseudogene,1,1001,chr3_142962611_142963612
Gm2581,15,12198302,12198472,processed_pseudogene,-1,170,chr15_12198302_12198472
Gm2594,9,17501968,17502709,processed_pseudogene,-1,741,chr9_17501968_17502709
Gm26008,6,39265844,39265942,snRNA,-1,98,chr6_39265844_39265942
Gm2606,15,12574889,12575890,processed_pseudogene,1,1001,chr15_12574889_12575890
Gm2607,8,48070002,48070628,processed_pseudogene,-1,626,chr8_48070002_48070628
Gm2611,15,16599958,16600562,processed_pseudogene,-1,604,chr15_16599958_16600562
Gm2614,12,100744533,100744935,processed_pseudogene,-1,402,chr12_100744533_100744935
Gm2622,3,56828317,56828787,processed_pseudogene,-1,470,chr3_56828317_56828787
Gm2623,5,32838129,32838414,processed_pseudogene,1,285,chr5_32838129_32838414
Gm26232,3,96450446,96450611,snRNA,1,165,chr3_96450446_96450611
Gm2628,10,76198194,76198981,processed_pseudogene,-1,787,chr10_76198194_76198981
Gm2629,18,15194782,15214696,lincRNA,1,19914,chr18_15194782_15214696
Gm2638,15,17895690,17897697,processed_pseudogene,-1,2007,chr15_17895690_17897697
Gm2645,13,50207542,50208088,processed_pseudogene,-1,546,chr13_50207542_50208088
Gm2651,6,3207869,3208706,processed_pseudogene,1,837,chr6_3207869_3208706
Gm26510,17,70874349,70924996,lincRNA,-1,50647,chr17_70874349_70924996
Gm26511,9,21717616,21723450,lincRNA,-1,5834,chr9_21717616_21723450
Gm26512,12,90738201,90869235,bidirectional_promoter_lncRNA,1,131034,chr12_90738201_90869235
Gm26519,5,105401245,105406970,lincRNA,1,5725,chr5_105401245_105406970
Gm2654,13,50786144,50787735,processed_pseudogene,1,1591,chr13_50786144_50787735
Gm26544,3,116150479,116165821,lincRNA,1,15342,chr3_116150479_116165821
Gm26550,7,24631145,24637916,antisense,-1,6771,chr7_24631145_24637916
Gm26555,13,58281183,58299145,antisense,1,17962,chr13_58281183_58299145
Gm26559,13,99516629,99521760,bidirectional_promoter_lncRNA,1,5131,chr13_99516629_99521760
Gm26560,5,38317333,38320897,antisense,-1,3564,chr5_38317333_38320897
Gm26564,10,34230907,34233531,lincRNA,-1,2624,chr10_34230907_34233531
Gm26583,12,112946363,112950512,lincRNA,-1,4149,chr12_112946363_112950512
Gm26585,10,22452891,22453520,processed_pseudogene,-1,629,chr10_22452891_22453520
Gm26588,6,88716422,88725860,antisense,-1,9438,chr6_88716422_88725860
Gm26592,9,21034290,21037782,antisense,-1,3492,chr9_21034290_21037782
Gm266,12,111484609,111485823,protein_coding,-1,1214,chr12_111484609_111485823
Gm26604,7,29071603,29081142,antisense,1,9539,chr7_29071603_29081142
Gm26608,5,28019465,28071105,lincRNA,-1,51640,chr5_28019465_28071105
Gm26618,X,6027056,6092269,sense_overlapping,-1,65213,chrX_6027056_6092269
Gm26629,19,50677406,50778662,antisense,1,101256,chr19_50677406_50778662
Gm26632,8,33813203,33833094,antisense,1,19891,chr8_33813203_33833094
Gm26633,7,79018053,79053323,antisense,-1,35270,chr7_79018053_79053323
Gm26634,15,78862956,78868533,lincRNA,-1,5577,chr15_78862956_78868533
Gm26644,19,44685811,44695460,lincRNA,-1,9649,chr19_44685811_44695460
Gm26651,13,51973214,51976583,lincRNA,1,3369,chr13_51973214_51976583
Gm26653,6,136173061,136175664,antisense,1,2603,chr6_136173061_136175664
Gm26666,6,145047559,145050430,antisense,1,2871,chr6_145047559_145050430
Gm26671,3,57612697,57625824,lincRNA,-1,13127,chr3_57612697_57625824
Gm26679,14,120384859,120388985,antisense,-1,4126,chr14_120384859_120388985
Gm26682,18,5162839,5165731,lincRNA,-1,2892,chr18_5162839_5165731
Gm26684,15,54952070,54964642,bidirectional_promoter_lncRNA,1,12572,chr15_54952070_54964642
Gm26685,1,164503309,164514882,lincRNA,1,11573,chr1_164503309_164514882
Gm26691,3,133830668,134240641,antisense,-1,409973,chr3_133830668_134240641
Gm26705,7,99260481,99267218,lincRNA,-1,6737,chr7_99260481_99267218
Gm26708,7,84152140,84195115,bidirectional_promoter_lncRNA,1,42975,chr7_84152140_84195115
Gm26740,10,22187013,22302835,antisense,-1,115822,chr10_22187013_22302835
Gm26747,8,121421238,121428043,lincRNA,1,6805,chr8_121421238_121428043
Gm26748,6,99725771,99732553,antisense,1,6782,chr6_99725771_99732553
Gm26756,5,67427680,67437990,antisense,1,10310,chr5_67427680_67437990
Gm2676,8,4713207,4713812,processed_pseudogene,1,605,chr8_4713207_4713812
Gm26761,5,64695461,64698521,lincRNA,-1,3060,chr5_64695461_64698521
Gm26777,12,80509951,80518916,bidirectional_promoter_lncRNA,-1,8965,chr12_80509951_80518916
Gm26779,5,109886231,109891137,lincRNA,1,4906,chr5_109886231_109891137
Gm26782,14,50870324,50880603,antisense,1,10279,chr14_50870324_50880603
Gm26787,9,36767887,36782677,antisense,1,14790,chr9_36767887_36782677
Gm26793,7,144894560,144897461,antisense,-1,2901,chr7_144894560_144897461
Gm26820,3,134462087,134630765,lincRNA,-1,168678,chr3_134462087_134630765
Gm26839,12,99563796,99620038,bidirectional_promoter_lncRNA,1,56242,chr12_99563796_99620038
Gm26843,8,93646386,93687958,lincRNA,-1,41572,chr8_93646386_93687958
Gm26844,13,69141229,69143965,lincRNA,1,2736,chr13_69141229_69143965
Gm26868,9,56606693,56614473,lincRNA,1,7780,chr9_56606693_56614473
Gm26871,3,118430324,118530022,processed_transcript,1,99698,chr3_118430324_118530022
Gm26876,10,128645884,128649811,lincRNA,1,3927,chr10_128645884_128649811
Gm26885,17,29446919,29491925,antisense,-1,45006,chr17_29446919_29491925
Gm26901,1,7349406,7397869,lincRNA,-1,48463,chr1_7349406_7397869
Gm26907,9,81776695,81858891,antisense,-1,82196,chr9_81776695_81858891
Gm26910,18,67773712,67774857,bidirectional_promoter_lncRNA,-1,1145,chr18_67773712_67774857
Gm26911,6,101198569,101220141,antisense,1,21572,chr6_101198569_101220141
Gm26927,13,84339149,84340113,processed_pseudogene,-1,964,chr13_84339149_84340113
Gm2693,1,21178988,21187427,unprocessed_pseudogene,1,8439,chr1_21178988_21187427
Gm2694,8,87460469,87525554,lincRNA,1,65085,chr8_87460469_87525554
Gm26944,7,92639739,92647442,antisense,1,7703,chr7_92639739_92647442
Gm26947,10,60931991,60940942,antisense,1,8951,chr10_60931991_60940942
Gm26962,9,115195453,115196898,antisense,-1,1445,chr9_115195453_115196898
Gm26963,17,72699505,72700445,processed_pseudogene,-1,940,chr17_72699505_72700445
Gm26970,5,142283106,142284069,processed_pseudogene,1,963,chr5_142283106_142284069
Gm26973,12,56535343,56607476,antisense,1,72133,chr12_56535343_56607476
Gm26974,7,123958955,123968767,processed_transcript,-1,9812,chr7_123958955_123968767
Gm26976,10,118892911,118893818,processed_pseudogene,1,907,chr10_118892911_118893818
Gm26980,16,22236921,22237315,processed_pseudogene,1,394,chr16_22236921_22237315
Gm26988,10,102460198,102461142,processed_pseudogene,1,944,chr10_102460198_102461142
Gm26994,8,112554617,112569575,antisense,-1,14958,chr8_112554617_112569575
Gm26995,5,117935725,117939518,antisense,-1,3793,chr5_117935725_117939518
Gm27005,16,25726696,25727616,processed_pseudogene,1,920,chr16_25726696_25727616
Gm27008,3,106934382,107093894,antisense,-1,159512,chr3_106934382_107093894
Gm27017,14,61648950,61667312,lincRNA,1,18362,chr14_61648950_61667312
Gm27042,19,40589435,40594862,lincRNA,1,5427,chr19_40589435_40594862
Gm2707,7,47668095,47668808,unprocessed_pseudogene,-1,713,chr7_47668095_47668808
Gm2709,1,21372670,21373764,unprocessed_pseudogene,1,1094,chr1_21372670_21373764
Gm2716,8,88051511,88070810,unitary_pseudogene,-1,19299,chr8_88051511_88070810
Gm27167,8,86902453,86919422,lincRNA,1,16969,chr8_86902453_86919422
Gm27177,14,69582164,69683286,antisense,-1,101122,chr14_69582164_69683286
Gm27197,2,38347357,38348316,antisense,-1,959,chr2_38347357_38348316
Gm27198,14,118727794,118735145,lincRNA,-1,7351,chr14_118727794_118735145
Gm27199,5,120419659,120431767,antisense,-1,12108,chr5_120419659_120431767
Gm27204,9,72774063,72776225,lincRNA,-1,2162,chr9_72774063_72776225
Gm2721,12,105394860,105404618,lincRNA,-1,9758,chr12_105394860_105404618
Gm27219,9,36813133,36813874,processed_pseudogene,-1,741,chr9_36813133_36813874
Gm27227,9,80263306,80265450,antisense,-1,2144,chr9_80263306_80265450
Gm27230,9,72395974,72404510,processed_transcript,1,8536,chr9_72395974_72404510
Gm27242,15,66286917,66290243,lincRNA,1,3326,chr15_66286917_66290243
Gm27243,4,24430370,24430890,lincRNA,-1,520,chr4_24430370_24430890
Gm27252,7,63896533,63899698,processed_transcript,1,3165,chr7_63896533_63899698
Gm27254,9,72431127,72431643,processed_pseudogene,-1,516,chr9_72431127_72431643
Gm2726,13,107279615,107280191,processed_pseudogene,-1,576,chr13_107279615_107280191
Gm27321,X,103623551,103623755,misc_RNA,1,204,chrX_103623551_103623755
Gm2734,8,5993981,5994723,processed_pseudogene,-1,742,chr8_5993981_5994723
Gm2736,13,107348204,107348516,processed_pseudogene,1,312,chr13_107348204_107348516
Gm2754,12,62065039,62065627,processed_pseudogene,-1,588,chr12_62065039_62065627
Gm2756,3,59783289,59783688,processed_pseudogene,-1,399,chr3_59783289_59783688
Gm27572,13,108498384,108498638,misc_RNA,-1,254,chr13_108498384_108498638
Gm2762,13,53393657,53455630,lincRNA,1,61973,chr13_53393657_53455630
Gm2767,8,56560916,56561388,processed_pseudogene,1,472,chr8_56560916_56561388
Gm2774,9,123867809,123868973,processed_pseudogene,-1,1164,chr9_123867809_123868973
Gm27887,16,40367836,40367937,miRNA,-1,101,chr16_40367836_40367937
Gm2791,14,40449117,40449621,processed_pseudogene,1,504,chr14_40449117_40449621
Gm2792,17,6339604,6361848,unprocessed_pseudogene,-1,22244,chr17_6339604_6361848
Gm2796,6,13461462,13461957,processed_pseudogene,-1,495,chr6_13461462_13461957
Gm2803,15,24724160,24724793,processed_pseudogene,-1,633,chr15_24724160_24724793
Gm28042,2,120027493,120043033,protein_coding,1,15540,chr2_120027493_120043033
Gm2805,16,90089983,90090496,processed_pseudogene,1,513,chr16_90089983_90090496
Gm28050,5,106500894,106574718,lincRNA,-1,73824,chr5_106500894_106574718
Gm28068,15,75007303,75024410,lincRNA,1,17107,chr15_75007303_75024410
Gm28071,1,79957580,79958057,processed_pseudogene,1,477,chr1_79957580_79958057
Gm28077,7,37299265,37305225,lincRNA,1,5960,chr7_37299265_37305225
Gm2808,17,6511791,6528713,unprocessed_pseudogene,-1,16922,chr17_6511791_6528713
Gm2810,5,40328438,40329427,processed_pseudogene,1,989,chr5_40328438_40329427
Gm28111,9,106640928,106643564,antisense,1,2636,chr9_106640928_106643564
Gm2814,8,10898169,10900558,lincRNA,-1,2389,chr8_10898169_10900558
Gm28154,1,17615084,17641081,antisense,-1,25997,chr1_17615084_17641081
Gm28175,1,42261855,42304412,lincRNA,1,42557,chr1_42261855_42304412
Gm28178,1,52570014,52580291,lincRNA,-1,10277,chr1_52570014_52580291
Gm28209,1,119903130,119906897,lincRNA,1,3767,chr1_119903130_119906897
Gm2824,15,24981620,25027358,lincRNA,-1,45738,chr15_24981620_25027358
Gm28258,7,70372038,70388410,lincRNA,-1,16372,chr7_70372038_70388410
Gm2829,10,30179726,30180224,unprocessed_pseudogene,1,498,chr10_30179726_30180224
Gm2830,13,54499705,54500089,processed_pseudogene,-1,384,chr13_54499705_54500089
Gm2832,14,41278805,41288815,protein_coding,1,10010,chr14_41278805_41288815
Gm28321,1,50815375,50817701,lincRNA,1,2326,chr1_50815375_50817701
Gm28375,1,86929387,87057596,antisense,-1,128209,chr1_86929387_87057596
Gm28380,1,91611406,91624500,lincRNA,1,13094,chr1_91611406_91624500
Gm28392,1,145315156,145315548,processed_pseudogene,-1,392,chr1_145315156_145315548
Gm28410,1,78325628,78340106,antisense,-1,14478,chr1_78325628_78340106
Gm28441,1,133835189,133838372,lincRNA,1,3183,chr1_133835189_133838372
Gm28455,7,39489438,39498801,unprocessed_pseudogene,1,9363,chr7_39489438_39498801
Gm28497,1,69441056,69444084,lincRNA,1,3028,chr1_69441056_69444084
Gm28523,6,141246920,141250009,antisense,-1,3089,chr6_141246920_141250009
Gm28530,9,98301650,98302226,processed_pseudogene,1,576,chr9_98301650_98302226
Gm28578,19,45300455,45338435,lincRNA,-1,37980,chr19_45300455_45338435
Gm28590,1,122205145,122252180,lincRNA,1,47035,chr1_122205145_122252180
Gm28609,1,133050128,133068405,antisense,-1,18277,chr1_133050128_133068405
Gm28626,1,86303195,86304059,antisense,-1,864,chr1_86303195_86304059
Gm28643,2,45156925,45168467,lincRNA,1,11542,chr2_45156925_45168467
Gm28644,1,31041919,31043675,lincRNA,1,1756,chr1_31041919_31043675
Gm28650,1,52756719,52757129,processed_pseudogene,1,410,chr1_52756719_52757129
Gm28651,14,32685648,32689250,lincRNA,1,3602,chr14_32685648_32689250
Gm28685,5,10235871,10236971,processed_pseudogene,-1,1100,chr5_10235871_10236971
Gm2869,8,21100651,21103271,processed_pseudogene,1,2620,chr8_21100651_21103271
Gm28710,5,16791810,16882052,lincRNA;protein_coding,1,90242,chr5_16791810_16882052
Gm28729,9,96486001,96525264,protein_coding,-1,39263,chr9_96486001_96525264
Gm2875,8,91689753,91690112,processed_pseudogene,1,359,chr8_91689753_91690112
Gm28783,1,17124747,17128956,lincRNA,1,4209,chr1_17124747_17128956
Gm28784,1,17168403,17173103,lincRNA,1,4700,chr1_17168403_17173103
Gm28800,1,127959516,127967452,antisense,1,7936,chr1_127959516_127967452
Gm28802,1,58850085,58892792,unprocessed_pseudogene,-1,42707,chr1_58850085_58892792
Gm28818,1,71894068,71917125,lincRNA,-1,23057,chr1_71894068_71917125
Gm28836,1,21250359,21271593,antisense,-1,21234,chr1_21250359_21271593
Gm28857,1,130740162,130741327,antisense,-1,1165,chr1_130740162_130741327
Gm28874,4,132265708,132268841,lincRNA,1,3133,chr4_132265708_132268841
Gm28876,15,103096151,103102111,lincRNA,-1,5960,chr15_103096151_103102111
Gm28888,1,88459683,88465558,lincRNA,1,5875,chr1_88459683_88465558
Gm28905,10,9976627,10207981,lincRNA,1,231354,chr10_9976627_10207981
Gm28923,1,65438664,65438985,processed_pseudogene,-1,321,chr1_65438664_65438985
Gm28929,1,123756558,123757750,processed_pseudogene,1,1192,chr1_123756558_123757750
Gm2897,14,3049285,3076840,protein_coding,1,27555,chr14_3049285_3076840
Gm28979,9,101342194,101348017,lincRNA,1,5823,chr9_101342194_101348017
Gm28980,1,64454359,64454577,processed_pseudogene,-1,218,chr1_64454359_64454577
Gm29012,1,105116454,105127366,lincRNA,1,10912,chr1_105116454_105127366
Gm29050,17,5388763,5419652,antisense,1,30889,chr17_5388763_5419652
Gm29087,7,38500432,38537077,antisense,1,36645,chr7_38500432_38537077
Gm29138,1,55370016,55370363,processed_pseudogene,-1,347,chr1_55370016_55370363
Gm29152,1,64649935,64652756,lincRNA,1,2821,chr1_64649935_64652756
Gm29154,9,103888423,103960376,lincRNA,-1,71953,chr9_103888423_103960376
Gm29155,1,43741961,43743895,antisense,-1,1934,chr1_43741961_43743895
Gm29214,1,25614946,25615515,processed_pseudogene,-1,569,chr1_25614946_25615515
Gm29228,1,33482101,33482518,processed_pseudogene,1,417,chr1_33482101_33482518
Gm29241,9,97227800,97228895,processed_pseudogene,-1,1095,chr9_97227800_97228895
Gm29243,8,34216859,34226145,lincRNA,1,9286,chr8_34216859_34226145
Gm29257,1,133025801,133026439,processed_pseudogene,1,638,chr1_133025801_133026439
Gm2926,7,98455260,98455498,processed_pseudogene,1,238,chr7_98455260_98455498
Gm29260,1,41781808,41939560,lincRNA,1,157752,chr1_41781808_41939560
Gm29376,1,134519978,134524139,unprocessed_pseudogene,1,4161,chr1_134519978_134524139
Gm29383,1,128128410,128128889,processed_pseudogene,-1,479,chr1_128128410_128128889
Gm2939,3,151959185,151959662,processed_pseudogene,1,477,chr3_151959185_151959662
Gm29428,1,130195980,130196388,processed_pseudogene,1,408,chr1_130195980_130196388
Gm29443,7,16613824,16632643,antisense,1,18819,chr7_16613824_16632643
Gm29461,1,98173648,98190698,lincRNA,1,17050,chr1_98173648_98190698
Gm29478,9,91404474,91562818,lincRNA,1,158344,chr9_91404474_91562818
Gm29485,1,136523884,136524165,processed_pseudogene,1,281,chr1_136523884_136524165
Gm29486,1,136507409,136507780,processed_pseudogene,1,371,chr1_136507409_136507780
Gm2950,9,99220048,99220567,processed_pseudogene,-1,519,chr9_99220048_99220567
Gm29508,12,103312367,103314769,antisense,-1,2402,chr12_103312367_103314769
Gm29514,1,146419436,146495060,antisense,-1,75624,chr1_146419436_146495060
Gm29530,12,83063392,83098874,antisense,-1,35482,chr12_83063392_83098874
Gm29571,10,25536386,25673343,antisense,1,136957,chr10_25536386_25673343
Gm29590,13,37508940,37512074,lincRNA,1,3134,chr13_37508940_37512074
Gm29603,9,88597410,88597743,processed_pseudogene,1,333,chr9_88597410_88597743
Gm2961,8,62193441,62194212,processed_pseudogene,-1,771,chr8_62193441_62194212
Gm2962,1,170925309,170925644,processed_pseudogene,-1,335,chr1_170925309_170925644
Gm29630,1,132274716,132280411,lincRNA,-1,5695,chr1_132274716_132280411
Gm29638,7,12959299,12961887,lincRNA,1,2588,chr7_12959299_12961887
Gm29642,9,25152114,25175561,lincRNA,1,23447,chr9_25152114_25175561
Gm2965,3,38223451,38223793,processed_pseudogene,1,342,chr3_38223451_38223793
Gm29674,10,107199912,107205775,lincRNA,-1,5863,chr10_107199912_107205775
Gm29676,13,44249460,44280449,lincRNA,-1,30989,chr13_44249460_44280449
Gm29677,18,68559422,68566141,lincRNA,1,6719,chr18_68559422_68566141
Gm29680,13,90179217,90217142,lincRNA,-1,37925,chr13_90179217_90217142
Gm29681,5,131391600,131414718,lincRNA;lncRNA,-1,23118,chr5_131391600_131414718
Gm29682,8,104088916,104105873,antisense,-1,16957,chr8_104088916_104105873
Gm29683,7,70178868,70337852,lincRNA,-1,158984,chr7_70178868_70337852
Gm29684,10,95120582,95145825,lincRNA,-1,25243,chr10_95120582_95145825
Gm29686,16,51980376,52005495,processed_transcript,-1,25119,chr16_51980376_52005495
Gm29687,12,26091962,26210505,lincRNA,-1,118543,chr12_26091962_26210505
Gm29689,12,118757495,118758083,processed_pseudogene,-1,588,chr12_118757495_118758083
Gm29695,1,132191457,132209546,protein_coding,1,18089,chr1_132191457_132209546
Gm29697,15,38573996,38577707,processed_pseudogene,1,3711,chr15_38573996_38577707
Gm29704,3,89116724,89116976,processed_pseudogene,1,252,chr3_89116724_89116976
Gm29707,5,102070218,102071782,lincRNA,1,1564,chr5_102070218_102071782
Gm29711,17,9102678,9103132,processed_pseudogene,1,454,chr17_9102678_9103132
Gm29717,14,57384865,57385250,processed_pseudogene,-1,385,chr14_57384865_57385250
Gm29718,1,136793034,136793510,processed_pseudogene,1,476,chr1_136793034_136793510
Gm29719,17,6356813,6411834,processed_transcript;unprocessed_pseudogene,-1,55021,chr17_6356813_6411834
Gm29721,17,6535892,6582703,unprocessed_pseudogene,-1,46811,chr17_6535892_6582703
Gm29724,9,30954087,31031205,antisense,-1,77118,chr9_30954087_31031205
Gm29725,7,16647383,16647789,processed_pseudogene,-1,406,chr7_16647383_16647789
Gm29735,7,142156454,142157113,protein_coding,-1,659,chr7_142156454_142157113
Gm29736,3,116844579,116844963,processed_pseudogene,1,384,chr3_116844579_116844963
Gm29737,12,19408348,19408740,lincRNA,1,392,chr12_19408348_19408740
Gm29739,3,43764236,43764764,processed_pseudogene,-1,528,chr3_43764236_43764764
Gm29741,3,49643707,49644127,processed_pseudogene,1,420,chr3_49643707_49644127
Gm29748,17,40552598,40552855,processed_pseudogene,1,257,chr17_40552598_40552855
Gm2975,8,62539650,62540469,processed_pseudogene,1,819,chr8_62539650_62540469
Gm29753,15,15943431,15943915,processed_pseudogene,1,484,chr15_15943431_15943915
Gm29754,7,27067456,27067813,processed_pseudogene,1,357,chr7_27067456_27067813
Gm29755,5,11855234,11856181,processed_pseudogene,1,947,chr5_11855234_11856181
Gm29759,7,122837963,122838289,processed_pseudogene,1,326,chr7_122837963_122838289
Gm2976,9,22479934,22480446,processed_pseudogene,-1,512,chr9_22479934_22480446
Gm29761,9,20399922,20401860,processed_pseudogene,-1,1938,chr9_20399922_20401860
Gm29763,7,25792228,25792843,processed_pseudogene,-1,615,chr7_25792228_25792843
Gm29767,13,117050734,117051136,processed_pseudogene,1,402,chr13_117050734_117051136
Gm29770,17,53354512,53354821,processed_pseudogene,1,309,chr17_53354512_53354821
Gm29771,3,147096184,147128749,lincRNA,1,32565,chr3_147096184_147128749
Gm29773,8,123896273,123900620,antisense,1,4347,chr8_123896273_123900620
Gm29776,14,54692598,54698833,protein_coding,-1,6235,chr14_54692598_54698833
Gm29778,5,147325869,147326334,processed_pseudogene,-1,465,chr5_147325869_147326334
Gm29781,6,109125685,109126162,processed_pseudogene,1,477,chr6_109125685_109126162
Gm29783,10,70504880,70505248,processed_pseudogene,-1,368,chr10_70504880_70505248
Gm29785,9,12233994,12234376,processed_pseudogene,1,382,chr9_12233994_12234376
Gm29787,13,51205263,51206111,processed_pseudogene,-1,848,chr13_51205263_51206111
Gm29788,6,126792449,126810644,transcribed_unitary_pseudogene,-1,18195,chr6_126792449_126810644
Gm29793,5,147409920,147410379,processed_pseudogene,1,459,chr5_147409920_147410379
Gm29794,10,56100635,56102003,processed_pseudogene,-1,1368,chr10_56100635_56102003
Gm29797,2,181657034,181659467,protein_coding,1,2433,chr2_181657034_181659467
Gm29800,14,84126486,84126874,processed_pseudogene,-1,388,chr14_84126486_84126874
Gm29803,6,135134078,135134452,processed_pseudogene,-1,374,chr6_135134078_135134452
Gm29808,3,81000994,81001461,unprocessed_pseudogene,1,467,chr3_81000994_81001461
Gm2981,9,75061354,75062047,processed_pseudogene,-1,693,chr9_75061354_75062047
Gm29811,3,132842202,132878596,lincRNA,-1,36394,chr3_132842202_132878596
Gm29815,5,148613467,148613644,processed_pseudogene,-1,177,chr5_148613467_148613644
Gm29817,8,98878726,98878897,processed_pseudogene,-1,171,chr8_98878726_98878897
Gm29818,12,48632293,48632457,processed_pseudogene,1,164,chr12_48632293_48632457
Gm29819,17,26880456,26880608,processed_pseudogene,-1,152,chr17_26880456_26880608
Gm29825,9,114118088,114192640,lincRNA,1,74552,chr9_114118088_114192640
Gm29844,13,77169378,77169888,processed_pseudogene,1,510,chr13_77169378_77169888
Gm29848,6,67022177,67022471,processed_pseudogene,1,294,chr6_67022177_67022471
Gm29856,1,177458966,177461204,processed_transcript,1,2238,chr1_177458966_177461204
Gm29860,18,64799869,64806496,lincRNA,-1,6627,chr18_64799869_64806496
Gm29863,19,33070072,33102167,lincRNA,1,32095,chr19_33070072_33102167
Gm29865,3,131759805,132030743,lincRNA,1,270938,chr3_131759805_132030743
Gm29880,16,92202901,92207488,processed_transcript,-1,4587,chr16_92202901_92207488
Gm29904,15,61288441,61393822,lincRNA,1,105381,chr15_61288441_61393822
Gm2991,15,65928454,65928933,processed_pseudogene,-1,479,chr15_65928454_65928933
Gm29920,7,26099563,26100316,processed_pseudogene,-1,753,chr7_26099563_26100316
Gm29926,5,116811231,116813828,lincRNA,1,2597,chr5_116811231_116813828
Gm29961,9,43642082,43645157,lincRNA,-1,3075,chr9_43642082_43645157
Gm29966,18,65244287,65252621,lincRNA,1,8334,chr18_65244287_65252621
Gm29968,12,26235530,26252545,lincRNA,-1,17015,chr12_26235530_26252545
Gm29977,7,122249302,122250025,processed_pseudogene,-1,723,chr7_122249302_122250025
Gm2999,15,71794570,71795107,processed_pseudogene,1,537,chr15_71794570_71795107
Gm29992,18,14309209,14331676,lincRNA,-1,22467,chr18_14309209_14331676
Gm29994,18,37829008,37830200,antisense,-1,1192,chr18_37829008_37830200
Gm2a,11,55098115,55113029,protein_coding,1,14914,chr11_55098115_55113029
Gm30003,5,134747042,134822967,antisense,1,75925,chr5_134747042_134822967
Gm30008,14,65171115,65174959,lincRNA,-1,3844,chr14_65171115_65174959
Gm30015,9,43716841,43746100,processed_transcript,-1,29259,chr9_43716841_43746100
Gm30018,18,65526153,65531801,lincRNA,-1,5648,chr18_65526153_65531801
Gm3002,14,3810074,3966518,protein_coding,1,156444,chr14_3810074_3966518
Gm30023,3,94453169,94454057,processed_pseudogene,1,888,chr3_94453169_94454057
Gm30025,12,80435209,80435936,antisense,1,727,chr12_80435209_80435936
Gm30034,10,26493098,26498747,lincRNA,1,5649,chr10_26493098_26498747
Gm30042,19,10290926,10293421,antisense,1,2495,chr19_10290926_10293421
Gm30054,14,20364567,20378876,antisense,-1,14309,chr14_20364567_20378876
Gm30074,3,52172162,52179972,lincRNA,-1,7810,chr3_52172162_52179972
Gm30075,7,73202775,73238531,lincRNA,-1,35756,chr7_73202775_73238531
Gm30082,CHR_MG153_PATCH,4201778,4203240,bidirectional_promoter_lncRNA;lncRNA,1,1462,chrCHR_MG153_PATCH_4201778_4203240
Gm30085,15,93001824,93007017,lincRNA,1,5193,chr15_93001824_93007017
Gm30091,17,71612829,71615983,antisense,-1,3154,chr17_71612829_71615983
Gm30093,18,38023529,38061296,lincRNA,1,37767,chr18_38023529_38061296
Gm30094,18,65863333,65894755,antisense,-1,31422,chr18_65863333_65894755
Gm30097,3,82926665,83008488,lincRNA,-1,81823,chr3_82926665_83008488
Gm3010,5,47699845,47700292,processed_pseudogene,1,447,chr5_47699845_47700292
Gm30108,14,20794239,20796560,lincRNA,1,2321,chr14_20794239_20796560
Gm3012,14,3634512,3642943,protein_coding,1,8431,chr14_3634512_3642943
Gm30122,10,78248880,78264139,lincRNA,-1,15259,chr10_78248880_78264139
Gm30124,12,20990536,21040428,lincRNA,1,49892,chr12_20990536_21040428
Gm30127,13,35957545,35965008,antisense,-1,7463,chr13_35957545_35965008
Gm30155,13,93461846,93462184,processed_pseudogene,1,338,chr13_93461846_93462184
Gm30159,15,63067008,63143105,lincRNA,-1,76097,chr15_63067008_63143105
Gm30165,10,27646313,27698327,lincRNA,-1,52014,chr10_27646313_27698327
Gm30172,11,5274085,5275539,unitary_pseudogene,1,1454,chr11_5274085_5275539
Gm30173,3,52516964,52550219,lincRNA,1,33255,chr3_52516964_52550219
Gm30177,13,36727258,36729259,antisense,1,2001,chr13_36727258_36729259
Gm30196,7,60293204,60293363,processed_pseudogene,1,159,chr7_60293204_60293363
Gm30198,12,102447328,102467609,lincRNA,1,20281,chr12_102447328_102467609
Gm30232,10,78483595,78498353,transcribed_unprocessed_pseudogene,1,14758,chr10_78483595_78498353
Gm30246,14,76780827,76784212,lincRNA,1,3385,chr14_76780827_76784212
Gm30251,16,22528218,22528784,processed_pseudogene,1,566,chr16_22528218_22528784
Gm30262,10,111599177,111611338,lincRNA,1,12161,chr10_111599177_111611338
Gm30270,6,21852418,21853483,antisense,1,1065,chr6_21852418_21853483
Gm3028,9,23903900,23905018,processed_pseudogene,1,1118,chr9_23903900_23905018
Gm30280,1,189827230,189827491,processed_pseudogene,1,261,chr1_189827230_189827491
Gm30285,10,20292785,20293206,processed_pseudogene,1,421,chr10_20292785_20293206
Gm30292,3,52789004,52797785,lincRNA,-1,8781,chr3_52789004_52797785
Gm30301,5,52982037,52995753,lincRNA,1,13716,chr5_52982037_52995753
Gm30313,9,26519485,26549953,lincRNA,-1,30468,chr9_26519485_26549953
Gm3033,14,3846245,3856085,protein_coding,1,9840,chr14_3846245_3856085
Gm30332,6,138443973,138461615,antisense,1,17642,chr6_138443973_138461615
Gm30339,15,93734413,93738490,lincRNA,1,4077,chr15_93734413_93738490
Gm30340,3,17328694,17334425,lincRNA,-1,5731,chr3_17328694_17334425
Gm30341,3,18753077,18753365,processed_pseudogene,1,288,chr3_18753077_18753365
Gm30363,14,21449949,21473360,processed_transcript,-1,23411,chr14_21449949_21473360
Gm30371,16,8944913,8969900,lincRNA,1,24987,chr16_8944913_8969900
Gm30373,9,43924751,43970253,lincRNA,-1,45502,chr9_43924751_43970253
Gm30400,10,78747130,78767585,processed_transcript,1,20455,chr10_78747130_78767585
Gm30409,13,63134051,63134511,sense_intronic,1,460,chr13_63134051_63134511
Gm30411,13,106747070,106761579,lincRNA,-1,14509,chr13_106747070_106761579
Gm3043,14,3688783,3698000,protein_coding,1,9217,chr14_3688783_3698000
Gm3045,13,56426594,56433753,protein_coding,1,7159,chr13_56426594_56433753
Gm30484,3,133815919,133818518,lincRNA,-1,2599,chr3_133815919_133818518
Gm30489,13,36963239,36973329,antisense,1,10090,chr13_36963239_36973329
Gm30504,8,45110481,45196541,lincRNA,1,86060,chr8_45110481_45196541
Gm30505,16,22874983,22894386,antisense,-1,19403,chr16_22874983_22894386
Gm30517,3,121277524,121278295,processed_pseudogene,1,771,chr3_121277524_121278295
Gm30524,6,140955609,141044134,lincRNA,1,88525,chr6_140955609_141044134
Gm30531,17,21615500,21656484,transcribed_processed_pseudogene,1,40984,chr17_21615500_21656484
Gm30534,10,26966085,26966291,processed_pseudogene,1,206,chr10_26966085_26966291
Gm30541,19,53320598,53325743,processed_transcript,-1,5145,chr19_53320598_53325743
Gm3055,10,81742821,81771161,protein_coding,-1,28340,chr10_81742821_81771161
Gm30551,13,103591395,103707633,lincRNA,-1,116238,chr13_103591395_103707633
Gm30563,15,64396379,64433598,lincRNA,1,37219,chr15_64396379_64433598
Gm30564,15,93956722,93964708,lincRNA,-1,7986,chr15_93956722_93964708
Gm30570,10,4206426,4213114,lincRNA,-1,6688,chr10_4206426_4213114
Gm30584,14,78820981,78821197,processed_pseudogene,1,216,chr14_78820981_78821197
Gm30619,10,29029128,29035453,unprocessed_pseudogene,-1,6325,chr10_29029128_29035453
Gm30624,10,111725184,111843048,lincRNA,1,117864,chr10_111725184_111843048
Gm30645,7,10468733,10469693,processed_pseudogene,-1,960,chr7_10468733_10469693
Gm30646,7,30432544,30432723,processed_pseudogene,1,179,chr7_30432544_30432723
Gm30648,3,134199948,134213238,lincRNA,1,13290,chr3_134199948_134213238
Gm30652,5,5567328,5567757,processed_pseudogene,1,429,chr5_5567328_5567757
Gm30671,9,44610405,44610722,processed_pseudogene,-1,317,chr9_44610405_44610722
Gm30684,7,38050147,38061700,lincRNA,-1,11553,chr7_38050147_38061700
Gm30691,15,64627409,64633508,lincRNA,-1,6099,chr15_64627409_64633508
Gm30694,1,157118948,157134399,unitary_pseudogene,1,15451,chr1_157118948_157134399
Gm30708,5,33774912,33775223,processed_pseudogene,1,311,chr5_33774912_33775223
Gm30709,13,63621500,63627379,lincRNA,-1,5879,chr13_63621500_63627379
Gm30735,3,53725477,53733018,lincRNA,1,7541,chr3_53725477_53733018
Gm30747,13,108233089,108233555,processed_pseudogene,-1,466,chr13_108233089_108233555
Gm3076,3,154132340,154132790,processed_pseudogene,1,450,chr3_154132340_154132790
Gm30771,7,38059316,38076101,lincRNA,1,16785,chr7_38059316_38076101
Gm30784,6,141866358,141875220,lincRNA,1,8862,chr6_141866358_141875220
Gm30790,16,76751793,76779092,lincRNA,-1,27299,chr16_76751793_76779092
Gm30794,17,87454969,87460364,lincRNA,-1,5395,chr17_87454969_87460364
Gm30806,14,67169588,67209261,lincRNA,1,39673,chr14_67169588_67209261
Gm30835,5,7680108,7960346,lincRNA,-1,280238,chr5_7680108_7960346
Gm3086,12,69963409,69969736,transcribed_processed_pseudogene,1,6327,chr12_69963409_69969736
Gm30873,7,84338095,84347869,antisense,1,9774,chr7_84338095_84347869
Gm30881,16,93808540,93833019,antisense,-1,24479,chr16_93808540_93833019
Gm30893,13,14521486,14525016,antisense,1,3530,chr13_14521486_14525016
Gm30906,10,8176131,8193340,lincRNA,1,17209,chr10_8176131_8193340
Gm30928,7,126348372,126351619,lincRNA,-1,3247,chr7_126348372_126351619
Gm30929,15,66335133,66340714,lincRNA,-1,5581,chr15_66335133_66340714
Gm30931,8,46363251,46367204,lincRNA,1,3953,chr8_46363251_46367204
Gm30933,9,30385980,30426976,bidirectional_promoter_lncRNA,-1,40996,chr9_30385980_30426976
Gm30934,9,44920199,44921489,antisense,1,1290,chr9_44920199_44921489
Gm30938,17,87464640,87473742,lincRNA,-1,9102,chr17_87464640_87473742
Gm3095,14,3963547,3970207,protein_coding,1,6660,chr14_3963547_3970207
Gm30954,8,7468669,7580205,lincRNA,-1,111536,chr8_7468669_7580205
Gm3096,9,101053542,101053905,processed_pseudogene,1,363,chr9_101053542_101053905
Gm30961,18,39636406,39648356,lincRNA,1,11950,chr18_39636406_39648356
Gm30970,14,79106039,79106401,processed_pseudogene,-1,362,chr14_79106039_79106401
Gm30984,17,87529503,87530744,lincRNA,-1,1241,chr17_87529503_87530744
Gm31025,12,27995008,28010046,lincRNA,1,15038,chr12_27995008_28010046
Gm31036,8,95138310,95148386,antisense,1,10076,chr8_95138310_95148386
Gm31070,19,5439349,5439521,processed_pseudogene,-1,172,chr19_5439349_5439521
Gm31084,17,74055731,74080293,lincRNA,-1,24562,chr17_74055731_74080293
Gm31087,18,40242774,40258495,antisense,-1,15721,chr18_40242774_40258495
Gm31104,13,112138116,112139093,processed_pseudogene,1,977,chr13_112138116_112139093
Gm31105,8,80879940,80881169,antisense,1,1229,chr8_80879940_80881169
Gm31107,14,68044428,68051330,lincRNA,-1,6902,chr14_68044428_68051330
Gm31126,13,50267976,50276670,lincRNA,1,8694,chr13_50267976_50276670
Gm31135,8,8044577,8484730,lincRNA,-1,440153,chr8_8044577_8484730
Gm31138,9,3199894,3215230,lincRNA,1,15336,chr9_3199894_3215230
Gm31143,17,51534277,51534858,lincRNA,-1,581,chr17_51534277_51534858
Gm31152,7,12860884,12868583,lincRNA,-1,7699,chr7_12860884_12868583
Gm3116,1,102449353,102537656,unprocessed_pseudogene,1,88303,chr1_102449353_102537656
Gm31166,19,5512528,5550368,transcribed_processed_pseudogene,1,37840,chr19_5512528_5550368
Gm31172,8,46770553,46770985,antisense,-1,432,chr8_46770553_46770985
Gm31182,10,114875007,114885131,lincRNA,1,10124,chr10_114875007_114885131
Gm31205,18,40721504,40733873,lincRNA,1,12369,chr18_40721504_40733873
Gm3121,9,101281368,101281773,processed_pseudogene,-1,405,chr9_101281368_101281773
Gm31211,3,140627180,140627432,processed_pseudogene,-1,252,chr3_140627180_140627432
Gm31218,13,64449437,64508611,lincRNA,1,59174,chr13_64449437_64508611
Gm31219,13,76255947,76278968,antisense,1,23021,chr13_76255947_76278968
Gm31227,14,68461631,68496417,lincRNA,1,34786,chr14_68461631_68496417
Gm31243,3,135904344,136167184,antisense,1,262840,chr3_135904344_136167184
Gm31251,14,54979393,54991601,antisense,1,12208,chr14_54979393_54991601
Gm31256,1,159378404,159378909,processed_pseudogene,1,505,chr1_159378404_159378909
Gm31274,5,142622603,142622831,processed_pseudogene,-1,228,chr5_142622603_142622831
Gm31282,15,8482119,8500343,lincRNA,1,18224,chr15_8482119_8500343
Gm31294,18,69193336,69195744,lincRNA,-1,2408,chr18_69193336_69195744
Gm31300,19,34056140,34056475,processed_pseudogene,-1,335,chr19_34056140_34056475
Gm31305,3,97730339,97736166,antisense,1,5827,chr3_97730339_97736166
Gm31306,3,142898075,142898582,transcribed_processed_pseudogene,1,507,chr3_142898075_142898582
Gm31323,16,94488777,94522117,antisense,1,33340,chr16_94488777_94522117
Gm31328,17,74327589,74327744,processed_pseudogene,-1,155,chr17_74327589_74327744
Gm31333,12,29139167,29199768,lincRNA,1,60601,chr12_29139167_29199768
Gm31343,8,8377090,8391702,lincRNA,1,14612,chr8_8377090_8391702
Gm31356,19,55099502,55117815,antisense,1,18313,chr19_55099502_55117815
Gm31369,15,80431571,80438603,lincRNA,-1,7032,chr15_80431571_80438603
Gm31373,1,190992692,190994677,lincRNA,1,1985,chr1_190992692_190994677
Gm31374,9,46337931,46384755,lincRNA,1,46824,chr9_46337931_46384755
Gm3138,14,4249631,4258006,protein_coding,1,8375,chr14_4249631_4258006
Gm31406,1,193040973,193042405,lincRNA,-1,1432,chr1_193040973_193042405
Gm31408,9,31559609,31579634,lincRNA,1,20025,chr9_31559609_31579634
Gm31409,9,91922664,91961118,lincRNA,-1,38454,chr9_91922664_91961118
Gm3141,14,43147487,43149893,unprocessed_pseudogene,-1,2406,chr14_43147487_43149893
Gm3143,3,34699640,34716662,lincRNA,-1,17022,chr3_34699640_34716662
Gm31432,9,46532757,46543376,lincRNA,1,10619,chr9_46532757_46543376
Gm31447,12,69129836,69145076,lincRNA,1,15240,chr12_69129836_69145076
Gm31450,13,15931682,15934681,lincRNA,1,2999,chr13_15931682_15934681
Gm31452,13,107063693,107099252,lincRNA,1,35559,chr13_107063693_107099252
Gm31456,14,38317904,38337126,lincRNA,1,19222,chr14_38317904_38337126
Gm31458,15,28053099,28118452,lincRNA,-1,65353,chr15_28053099_28118452
Gm31462,15,81005407,81006410,antisense,-1,1003,chr15_81005407_81006410
Gm31479,7,45597140,45599569,lincRNA,1,2429,chr7_45597140_45599569
Gm3148,6,16237627,16238238,processed_pseudogene,1,611,chr6_16237627_16238238
Gm31497,9,31905993,31911198,antisense,1,5205,chr9_31905993_31911198
Gm31499,17,88168487,88170604,lincRNA,1,2117,chr17_88168487_88170604
Gm3150,15,72913357,72913560,processed_pseudogene,1,203,chr15_72913357_72913560
Gm31508,12,28910229,29041874,lincRNA,1,131645,chr12_28910229_29041874
Gm31510,7,79271688,79273035,bidirectional_promoter_lncRNA,-1,1347,chr7_79271688_79273035
Gm31513,12,84195969,84199580,antisense,1,3611,chr12_84195969_84199580
Gm31517,14,15015189,15065231,lincRNA,-1,50042,chr14_15015189_15065231
Gm31518,8,95593422,95621509,lincRNA,1,28087,chr8_95593422_95621509
Gm31520,6,66264155,66284845,transcribed_processed_pseudogene,1,20690,chr6_66264155_66284845
Gm31522,11,81983119,82019967,lincRNA,-1,36848,chr11_81983119_82019967
Gm31532,17,53699706,53700472,processed_pseudogene,1,766,chr17_53699706_53700472
Gm31557,9,46666273,46674844,lincRNA,1,8571,chr9_46666273_46674844
Gm31577,14,15304420,15321874,lincRNA,-1,17454,chr14_15304420_15321874
Gm31592,10,91888829,91953580,lincRNA,1,64751,chr10_91888829_91953580
Gm31597,7,45742049,45750257,antisense,1,8208,chr7_45742049_45750257
Gm3160,8,14136310,14136916,processed_pseudogene,1,606,chr8_14136310_14136916
Gm31600,13,37761748,37768147,lincRNA,1,6399,chr13_37761748_37768147
Gm31614,9,46830339,46837616,lincRNA,1,7277,chr9_46830339_46837616
Gm31615,17,88253483,88388699,lincRNA,-1,135216,chr17_88253483_88388699
Gm31630,13,92898286,92907126,processed_transcript,1,8840,chr13_92898286_92907126
Gm3164,14,4415448,4443839,protein_coding,1,28391,chr14_4415448_4443839
Gm31641,16,95183639,95355676,antisense,-1,172037,chr16_95183639_95355676
Gm31645,17,74519665,74528094,processed_transcript,-1,8429,chr17_74519665_74528094
Gm31651,3,116200408,116202713,lincRNA,1,2305,chr3_116200408_116202713
Gm31663,7,92979876,93006513,transcribed_unprocessed_pseudogene,1,26637,chr7_92979876_93006513
Gm31683,13,40907332,40917895,antisense,-1,10563,chr13_40907332_40917895
Gm31698,9,47085947,47227095,lincRNA,-1,141148,chr9_47085947_47227095
Gm31706,18,45044862,45129743,lincRNA,1,84881,chr18_45044862_45129743
Gm31711,13,16213569,16213764,processed_pseudogene,-1,195,chr13_16213569_16213764
Gm31718,8,126812640,126908215,lincRNA,-1,95575,chr8_126812640_126908215
Gm31727,8,26266977,26273555,lincRNA,1,6578,chr8_26266977_26273555
Gm31728,1,180256429,180274963,antisense,1,18534,chr1_180256429_180274963
Gm3173,14,4430992,4519452,protein_coding,1,88460,chr14_4430992_4519452
Gm31747,6,73586109,73608673,lincRNA,-1,22564,chr6_73586109_73608673
Gm31763,10,67005020,67041326,antisense,1,36306,chr10_67005020_67041326
Gm31786,8,47744712,47750134,lincRNA,-1,5422,chr8_47744712_47750134
Gm31805,8,95828598,95833675,lincRNA,-1,5077,chr8_95828598_95833675
Gm31812,1,52108121,52113751,lincRNA,-1,5630,chr1_52108121_52113751
Gm31816,9,47242326,47368649,lincRNA,-1,126323,chr9_47242326_47368649
Gm31834,13,38527403,38532920,antisense,1,5517,chr13_38527403_38532920
Gm31848,10,39936855,39939963,unprocessed_pseudogene,1,3108,chr10_39936855_39939963
Gm31849,10,55057193,55057567,processed_pseudogene,1,374,chr10_55057193_55057567
Gm31854,18,84097660,84102266,lincRNA,-1,4606,chr18_84097660_84102266
Gm31861,6,82242174,82242845,processed_pseudogene,1,671,chr6_82242174_82242845
Gm3188,19,13512555,13515138,processed_pseudogene,-1,2583,chr19_13512555_13515138
Gm31881,3,152106439,152107383,antisense,1,944,chr3_152106439_152107383
Gm31887,13,19162036,19193558,antisense,-1,31522,chr13_19162036_19193558
Gm3189,7,3956240,3957071,processed_pseudogene,-1,831,chr7_3956240_3957071
Gm31897,7,127287729,127290619,lincRNA,1,2890,chr7_127287729_127290619
Gm31904,10,10230736,10234850,lincRNA,-1,4114,chr10_10230736_10234850
Gm31907,18,45501590,45560130,transcribed_processed_pseudogene,-1,58540,chr18_45501590_45560130
Gm31908,18,72908890,72921090,lincRNA,-1,12200,chr18_72908890_72921090
Gm3191,12,106459150,106459495,processed_pseudogene,1,345,chr12_106459150_106459495
Gm31931,10,56829086,56829307,processed_pseudogene,-1,221,chr10_56829086_56829307
Gm31938,12,4524113,4529122,lincRNA,1,5009,chr12_4524113_4529122
Gm31946,13,78427248,78442524,lincRNA,1,15276,chr13_78427248_78442524
Gm31992,10,40164110,40169759,lincRNA,1,5649,chr10_40164110_40169759
Gm3200,7,100760805,100761806,processed_pseudogene,-1,1001,chr7_100760805_100761806
Gm32005,8,96309519,96361523,lincRNA,1,52004,chr8_96309519_96361523
Gm32014,9,8644073,8740988,lincRNA,-1,96915,chr9_8644073_8740988
Gm32017,9,70930488,70934430,processed_transcript,1,3942,chr9_70930488_70934430
Gm32025,10,71148160,71148466,processed_pseudogene,1,306,chr10_71148160_71148466
Gm32027,19,36215016,36264437,processed_transcript,-1,49421,chr19_36215016_36264437
Gm3203,5,6426844,6429232,processed_pseudogene,-1,2388,chr5_6426844_6429232
Gm32031,7,47008083,47009008,bidirectional_promoter_lncRNA,1,925,chr7_47008083_47009008
Gm32036,13,20445286,20473490,antisense,-1,28204,chr13_20445286_20473490
Gm32050,8,26626744,26627480,lincRNA,-1,736,chr8_26626744_26627480
Gm32051,5,105409367,105415670,lincRNA,1,6303,chr5_105409367_105415670
Gm32052,8,48002210,48009133,lincRNA,-1,6923,chr8_48002210_48009133
Gm32061,7,62337794,62423245,lincRNA,-1,85451,chr7_62337794_62423245
Gm32063,13,41236345,41241478,lincRNA,1,5133,chr13_41236345_41241478
Gm32067,13,78483354,78562570,lincRNA,1,79216,chr13_78483354_78562570
Gm32081,19,36182580,36221618,lincRNA,1,39038,chr19_36182580_36221618
Gm32090,13,107605284,107612849,lincRNA,-1,7565,chr13_107605284_107612849
Gm32098,8,26665893,26668306,lincRNA,-1,2413,chr8_26665893_26668306
Gm32122,8,96371727,96403862,lincRNA,-1,32135,chr8_96371727_96403862
Gm32123,14,25109384,25112926,lincRNA,1,3542,chr14_25109384_25112926
Gm3213,10,6367676,6368484,processed_pseudogene,1,808,chr10_6367676_6368484
Gm32151,12,70347462,70351706,bidirectional_promoter_lncRNA,1,4244,chr12_70347462_70351706
Gm32158,5,140546435,140546838,processed_pseudogene,1,403,chr5_140546435_140546838
Gm32172,10,13871280,13879208,lincRNA,1,7928,chr10_13871280_13879208
Gm32184,13,41543005,41559913,lincRNA,-1,16908,chr13_41543005_41559913
Gm3219,14,34345281,34345583,processed_pseudogene,1,302,chr14_34345281_34345583
Gm32200,1,191436340,191465048,lincRNA,-1,28708,chr1_191436340_191465048
Gm32219,12,70522598,70544587,lincRNA,1,21989,chr12_70522598_70544587
Gm3222,17,14709066,14710055,processed_pseudogene,1,989,chr17_14709066_14710055
Gm32220,12,52079014,52079311,processed_pseudogene,1,297,chr12_52079014_52079311
Gm32224,14,25127788,25135852,lincRNA,1,8064,chr14_25127788_25135852
Gm32243,13,39617668,39647247,lincRNA,-1,29579,chr13_39617668_39647247
Gm32250,1,194989062,194995345,lincRNA,-1,6283,chr1_194989062_194995345
Gm32256,19,16715799,16716261,processed_pseudogene,1,462,chr19_16715799_16716261
Gm3226,13,112593743,112595084,processed_pseudogene,-1,1341,chr13_112593743_112595084
Gm32281,9,95554497,95558913,lincRNA,1,4416,chr9_95554497_95558913
Gm32282,17,78199256,78200025,bidirectional_promoter_lncRNA,-1,769,chr17_78199256_78200025
Gm32296,12,85529598,85542280,lincRNA,1,12682,chr12_85529598_85542280
Gm32312,16,27317944,27326641,antisense,-1,8697,chr16_27317944_27326641
Gm32335,9,48896451,48905982,antisense,1,9531,chr9_48896451_48905982
Gm3234,12,107463269,107488583,lincRNA,-1,25314,chr12_107463269_107488583
Gm32340,3,45775933,45776191,processed_pseudogene,-1,258,chr3_45775933_45776191
Gm32341,19,16871092,16925014,lincRNA,1,53922,chr19_16871092_16925014
Gm32351,13,94701018,94702718,lincRNA,-1,1700,chr13_94701018_94702718
Gm32364,10,67575883,67586416,lincRNA;lncRNA,1,10533,chr10_67575883_67586416
Gm32376,13,108220468,108220841,processed_pseudogene,-1,373,chr13_108220468_108220841
Gm3239,14,4664192,4670850,protein_coding,1,6658,chr14_4664192_4670850
Gm32391,1,164462442,164463989,lincRNA,1,1547,chr1_164462442_164463989
Gm32401,13,41487130,41544567,antisense,1,57437,chr13_41487130_41544567
Gm32405,15,73994069,74000913,lincRNA,-1,6844,chr15_73994069_74000913
Gm32431,16,51051130,51053004,lincRNA,1,1874,chr16_51051130_51053004
Gm32432,16,96918732,96922160,antisense,1,3428,chr16_96918732_96922160
Gm32441,19,56656511,56664611,lincRNA,-1,8100,chr19_56656511_56664611
Gm32442,12,5808195,5984958,lincRNA,1,176763,chr12_5808195_5984958
Gm32460,1,191992710,191993092,processed_pseudogene,1,382,chr1_191992710_191993092
Gm32468,10,93084206,93093727,lincRNA,1,9521,chr10_93084206_93093727
Gm3248,14,5939225,5961745,protein_coding,-1,22520,chr14_5939225_5961745
Gm32486,7,139271004,139296865,lincRNA;lncRNA,-1,25861,chr7_139271004_139296865
Gm32492,19,56669118,56674371,processed_transcript,1,5253,chr19_56669118_56674371
Gm32507,8,64937959,64943988,lincRNA,1,6029,chr8_64937959_64943988
Gm32509,16,96723500,96773608,processed_transcript,1,50108,chr16_96723500_96773608
Gm32511,9,71163794,71208124,antisense,1,44330,chr9_71163794_71208124
Gm32514,2,90891773,90893198,unitary_pseudogene,-1,1425,chr2_90891773_90893198
Gm3252,14,4726775,4747493,protein_coding,1,20718,chr14_4726775_4747493
Gm32526,13,14594607,14595587,processed_pseudogene,1,980,chr13_14594607_14595587
Gm32536,6,124951321,124951765,processed_pseudogene,-1,444,chr6_124951321_124951765
Gm32548,18,73711328,73717593,lincRNA,1,6265,chr18_73711328_73717593
Gm32569,1,164803969,164899591,antisense,-1,95622,chr1_164803969_164899591
Gm32585,5,125238314,125272815,lincRNA,-1,34501,chr5_125238314_125272815
Gm32591,6,82823214,82841371,lincRNA,1,18157,chr6_82823214_82841371
Gm32592,6,98121796,98248611,antisense,1,126815,chr6_98121796_98248611
Gm32618,15,32778904,32796006,lincRNA,1,17102,chr15_32778904_32796006
Gm32629,19,20117385,20123828,lincRNA,-1,6443,chr19_20117385_20123828
Gm32633,7,64001885,64020959,lincRNA,1,19074,chr7_64001885_64020959
Gm3264,14,4855576,4875851,protein_coding,1,20275,chr14_4855576_4875851
Gm32647,7,94042691,94709171,lincRNA,1,666480,chr7_94042691_94709171
Gm32679,16,29829456,29834728,lincRNA,-1,5272,chr16_29829456_29834728
Gm32687,10,81863934,81881081,protein_coding,1,17147,chr10_81863934_81881081
Gm32710,9,10904345,10907818,antisense,1,3473,chr9_10904345_10907818
Gm32717,10,118238372,118240780,protein_coding,-1,2408,chr10_118238372_118240780
Gm32736,5,106095091,106103547,lincRNA,1,8456,chr5_106095091_106103547
Gm32743,9,103521787,103545977,antisense,1,24190,chr9_103521787_103545977
Gm32750,19,20922392,20947009,antisense,1,24617,chr19_20922392_20947009
Gm32764,15,33046021,33073523,lincRNA,-1,27502,chr15_33046021_33073523
Gm32766,7,118358170,118369717,unitary_pseudogene,-1,11547,chr7_118358170_118369717
Gm32772,7,17287678,17371627,lincRNA,-1,83949,chr7_17287678_17371627
Gm3278,14,4892416,4902431,protein_coding,1,10015,chr14_4892416_4902431
Gm32786,7,142095758,142125189,bidirectional_promoter_lncRNA,1,29431,chr7_142095758_142125189
Gm3279,6,55684571,55694574,lincRNA,1,10003,chr6_55684571_55694574
Gm32802,10,118258688,118261096,protein_coding,1,2408,chr10_118258688_118261096
Gm32815,14,86264144,86299734,processed_transcript,-1,35590,chr14_86264144_86299734
Gm32816,7,128462068,128475571,processed_transcript,1,13503,chr7_128462068_128475571
Gm32817,16,13462546,13467237,processed_transcript,1,4691,chr16_13462546_13467237
Gm32828,12,7524002,7859766,lincRNA,-1,335764,chr12_7524002_7859766
Gm3283,5,57229266,57230615,processed_pseudogene,1,1349,chr5_57229266_57230615
Gm32834,13,51378136,51418686,lincRNA,-1,40550,chr13_51378136_51418686
Gm32842,8,48270248,48270985,processed_pseudogene,-1,737,chr8_48270248_48270985
Gm32849,7,49085083,49086981,lincRNA,1,1898,chr7_49085083_49086981
Gm32856,8,129263641,129282844,lincRNA,1,19203,chr8_129263641_129282844
Gm32857,14,44226217,44315511,lincRNA,-1,89294,chr14_44226217_44315511
Gm32865,16,87125036,87128439,lincRNA,-1,3403,chr16_87125036_87128439
Gm32885,15,97157029,97167244,lincRNA,-1,10215,chr15_97157029_97167244
Gm32886,15,83257948,83258097,processed_pseudogene,-1,149,chr15_83257948_83258097
Gm32892,17,22873486,22874001,processed_pseudogene,1,515,chr17_22873486_22874001
Gm32899,12,31258651,31258857,processed_pseudogene,-1,206,chr12_31258651_31258857
Gm32913,14,86396382,86409099,lincRNA,-1,12717,chr14_86396382_86409099
Gm32914,6,145999536,146001763,lincRNA,-1,2227,chr6_145999536_146001763
Gm32916,7,120593151,120629769,lincRNA,1,36618,chr7_120593151_120629769
Gm32921,5,106321340,106323217,lincRNA,1,1877,chr5_106321340_106323217
Gm32926,10,18743469,18837979,antisense,1,94510,chr10_18743469_18837979
Gm32939,13,43530220,43531781,lincRNA,1,1561,chr13_43530220_43531781
Gm32950,3,28802804,28805336,lincRNA,-1,2532,chr3_28802804_28805336
Gm32983,7,67593659,67594163,processed_pseudogene,1,504,chr7_67593659_67594163
Gm33016,12,71337628,71342803,lincRNA,1,5175,chr12_71337628_71342803
Gm33022,14,19292162,19292529,unprocessed_pseudogene,-1,367,chr14_19292162_19292529
Gm33023,8,104630832,104636492,antisense,1,5660,chr8_104630832_104636492
Gm33027,7,129398102,129403090,lincRNA,-1,4988,chr7_129398102_129403090
Gm33035,10,69020740,69033888,lincRNA,-1,13148,chr10_69020740_69033888
Gm33037,12,8042721,8209165,antisense,-1,166444,chr12_8042721_8209165
Gm33045,13,110627288,110642730,lincRNA,1,15442,chr13_110627288_110642730
Gm33050,5,96456389,96457743,antisense,-1,1354,chr5_96456389_96457743
Gm33051,3,28807205,28813985,antisense,-1,6780,chr3_28807205_28813985
Gm33054,9,104001760,104002339,lincRNA,-1,579,chr9_104001760_104002339
Gm33056,10,19290989,19325817,lincRNA,1,34828,chr10_19290989_19325817
Gm3307,7,63606019,63606650,processed_pseudogene,1,631,chr7_63606019_63606650
Gm33080,7,127410820,127410991,processed_pseudogene,-1,171,chr7_127410820_127410991
Gm33091,10,95134290,95136874,lincRNA,-1,2584,chr10_95134290_95136874
Gm33103,8,68971145,69001683,lincRNA,-1,30538,chr8_68971145_69001683
Gm33111,12,32073286,32080850,lincRNA,-1,7564,chr12_32073286_32080850
Gm33148,7,142591744,142620804,lincRNA,1,29060,chr7_142591744_142620804
Gm3317,14,5164535,5169233,protein_coding,1,4698,chr14_5164535_5169233
Gm33175,8,12315004,12319480,lincRNA,-1,4476,chr8_12315004_12319480
Gm33178,8,69225536,69225792,processed_pseudogene,-1,256,chr8_69225536_69225792
Gm3318,10,3117805,3118987,processed_pseudogene,-1,1182,chr10_3117805_3118987
Gm33180,9,59499361,59512865,lincRNA,-1,13504,chr9_59499361_59512865
Gm33195,13,43864669,43868589,lincRNA,1,3920,chr13_43864669_43868589
Gm3320,17,16669156,16670186,processed_pseudogene,-1,1030,chr17_16669156_16670186
Gm33206,3,29773466,29893177,lincRNA,-1,119711,chr3_29773466_29893177
Gm3321,5,10875621,10876749,processed_pseudogene,1,1128,chr5_10875621_10876749
Gm33228,18,26007557,26215653,processed_transcript,1,208096,chr18_26007557_26215653
Gm33242,8,83489743,83490799,processed_pseudogene,-1,1056,chr8_83489743_83490799
Gm33248,7,129667405,129693400,sense_intronic,1,25995,chr7_129667405_129693400
Gm3325,13,62015605,62050986,transcribed_processed_pseudogene,1,35381,chr13_62015605_62050986
Gm33280,1,36132042,36138746,lincRNA,1,6704,chr1_36132042_36138746
Gm33301,15,40162581,40168076,lincRNA,1,5495,chr15_40162581_40168076
Gm33312,12,85662442,85662868,processed_pseudogene,1,426,chr12_85662442_85662868
Gm3333,13,62263566,62275253,transcribed_processed_pseudogene,1,11687,chr13_62263566_62275253
Gm33337,10,118714481,118715726,lincRNA,-1,1245,chr10_118714481_118715726
Gm33347,5,126724326,126727284,lincRNA,-1,2958,chr5_126724326_126727284
Gm3336,8,70718543,70722634,protein_coding,1,4091,chr8_70718543_70722634
Gm33370,5,96910341,96922175,lincRNA,-1,11834,chr5_96910341_96922175
Gm33373,17,80553464,80563942,antisense,1,10478,chr17_80553464_80563942
Gm33424,13,53016202,53018185,lincRNA,1,1983,chr13_53016202_53018185
Gm33432,15,84127304,84136259,lincRNA,1,8955,chr15_84127304_84136259
Gm33447,13,97376234,97380465,lincRNA,1,4231,chr13_97376234_97380465
Gm33460,9,118485559,118489099,antisense,-1,3540,chr9_118485559_118489099
Gm33466,3,157720404,157726408,lincRNA,-1,6004,chr3_157720404_157726408
Gm33467,12,108695486,108696446,antisense,1,960,chr12_108695486_108696446
Gm33474,5,107048836,107056042,lincRNA,1,7206,chr5_107048836_107056042
Gm33489,13,44010592,44018522,lincRNA,-1,7930,chr13_44010592_44018522
Gm33497,15,35200804,35273666,lincRNA,1,72862,chr15_35200804_35273666
Gm33508,17,24533862,24546531,antisense,1,12669,chr17_24533862_24546531
Gm33524,14,70018231,70057367,antisense,-1,39136,chr14_70018231_70057367
Gm33533,1,36739048,36744792,lincRNA,-1,5744,chr1_36739048_36744792
Gm33543,10,95823973,95842930,protein_coding,-1,18957,chr10_95823973_95842930
Gm33586,7,112983903,113010892,lincRNA,1,26989,chr7_112983903_113010892
Gm33594,2,57982192,57986017,lincRNA,-1,3825,chr2_57982192_57986017
Gm336,19,11090598,11092077,processed_pseudogene,-1,1479,chr19_11090598_11092077
Gm33609,5,97143026,97149848,lincRNA,1,6822,chr5_97143026_97149848
Gm3365,8,69554802,69585162,unprocessed_pseudogene,-1,30360,chr8_69554802_69585162
Gm33651,3,143576614,143589170,lincRNA,1,12556,chr3_143576614_143589170
Gm33666,15,100297171,100297451,processed_pseudogene,1,280,chr15_100297171_100297451
Gm33680,12,45466273,45546677,lincRNA,1,80404,chr12_45466273_45546677
Gm33682,12,108762032,108762970,lincRNA,-1,938,chr12_108762032_108762970
Gm33696,16,14892328,14991883,antisense,-1,99555,chr16_14892328_14991883
Gm33699,9,61032212,61059116,lincRNA,1,26904,chr9_61032212_61059116
Gm33707,3,60769887,60770455,processed_pseudogene,-1,568,chr3_60769887_60770455
Gm3372,5,60674317,60676108,processed_pseudogene,1,1791,chr5_60674317_60676108
Gm33727,17,25518585,25522565,lincRNA,1,3980,chr17_25518585_25522565
Gm3373,14,5718336,5741577,protein_coding,-1,23241,chr14_5718336_5741577
Gm33732,18,54768384,54823789,lincRNA,-1,55405,chr18_54768384_54823789
Gm3375,7,3181093,3181888,processed_pseudogene,1,795,chr7_3181093_3181888
Gm33756,19,59389784,59399207,lincRNA,1,9423,chr19_59389784_59399207
Gm33758,3,143603805,143624575,lincRNA,1,20770,chr3_143603805_143624575
Gm33785,12,72817712,72821823,lincRNA,1,4111,chr12_72817712_72821823
Gm3379,12,109894452,109895093,processed_pseudogene,-1,641,chr12_109894452_109895093
Gm33801,17,25537017,25538938,lincRNA,-1,1921,chr17_25537017_25538938
Gm3383,14,5607620,5807982,protein_coding,-1,200362,chr14_5607620_5807982
Gm33838,9,35301722,35307599,lincRNA,-1,5877,chr9_35301722_35307599
Gm33858,9,120068996,120070622,antisense,1,1626,chr9_120068996_120070622
Gm33866,3,102880780,102881068,processed_pseudogene,1,288,chr3_102880780_102881068
Gm33882,7,99090232,99090882,processed_pseudogene,1,650,chr7_99090232_99090882
Gm33929,12,73448318,73449215,lincRNA,1,897,chr12_73448318_73449215
Gm33936,15,36341217,36367117,processed_transcript,-1,25900,chr15_36341217_36367117
Gm33940,2,19428046,19430443,lincRNA,1,2397,chr2_19428046_19430443
Gm33952,3,102831590,102831997,processed_pseudogene,1,407,chr3_102831590_102831997
Gm33958,13,44363836,44391117,lincRNA,-1,27281,chr13_44363836_44391117
Gm33973,1,183563512,183564045,lincRNA,1,533,chr1_183563512_183564045
Gm33979,10,70714928,70738844,lincRNA,-1,23916,chr10_70714928_70738844
Gm33994,1,136576938,136579477,lincRNA,-1,2539,chr1_136576938_136579477
Gm34005,9,75964204,75964485,processed_pseudogene,1,281,chr9_75964204_75964485
Gm34006,10,42861382,42864699,antisense,-1,3317,chr10_42861382_42864699
Gm34016,12,73489915,73508670,lincRNA,-1,18755,chr12_73489915_73508670
Gm34030,8,57331692,57334585,lincRNA,-1,2893,chr8_57331692_57334585
Gm34035,17,3270681,3283270,lincRNA,-1,12589,chr17_3270681_3283270
Gm34045,10,119135164,119166385,lincRNA,-1,31221,chr10_119135164_119166385
Gm34066,1,54443404,54456763,protein_coding,-1,13359,chr1_54443404_54456763
Gm34069,9,14259041,14263803,lincRNA,-1,4762,chr9_14259041_14263803
Gm34081,12,109493529,109516740,lincRNA;lncRNA,-1,23211,chr12_109493529_109516740
Gm34086,5,124032361,124076299,lincRNA,1,43938,chr5_124032361_124076299
Gm34091,6,127411130,127411733,processed_pseudogene,1,603,chr6_127411130_127411733
Gm34113,10,84092266,84096249,lincRNA,1,3983,chr10_84092266_84096249
Gm34121,7,56038866,56049974,processed_transcript,-1,11108,chr7_56038866_56049974
Gm34139,3,122788221,122788514,transcribed_processed_pseudogene,-1,293,chr3_122788221_122788514
Gm34150,15,36375049,36376090,lincRNA,1,1041,chr15_36375049_36376090
Gm34152,15,98691863,98696191,lincRNA,-1,4328,chr15_98691863_98696191
Gm3417,17,14964242,14978790,protein_coding,-1,14548,chr17_14964242_14978790
Gm34184,10,84036560,84100697,lincRNA,-1,64137,chr10_84036560_84100697
Gm34237,12,11826607,11897726,lincRNA,1,71119,chr12_11826607_11897726
Gm3424,14,5821934,5830329,protein_coding,-1,8395,chr14_5821934_5830329
Gm34240,3,63439251,63457897,lincRNA,1,18646,chr3_63439251_63457897
Gm34248,5,146199985,146200458,processed_pseudogene,-1,473,chr5_146199985_146200458
Gm34256,16,31590196,31593220,lincRNA,-1,3024,chr16_31590196_31593220
Gm34266,17,40453694,40454366,processed_pseudogene,1,672,chr17_40453694_40454366
Gm34276,13,44537309,44568668,lincRNA,-1,31359,chr13_44537309_44568668
Gm34278,13,53681609,53700417,lincRNA,-1,18808,chr13_53681609_53700417
Gm3428,9,35847855,35850253,processed_transcript,-1,2398,chr9_35847855_35850253
Gm34280,7,99694297,99712777,antisense,1,18480,chr7_99694297_99712777
Gm34284,15,99068138,99074669,antisense,-1,6531,chr15_99068138_99074669
Gm34297,10,98537478,98569836,lincRNA,1,32358,chr10_98537478_98569836
Gm34304,12,49368729,49381885,lincRNA,-1,13156,chr12_49368729_49381885
Gm34307,13,59144257,59145828,lincRNA,-1,1571,chr13_59144257_59145828
Gm34333,5,146586645,146600102,lincRNA,-1,13457,chr5_146586645_146600102
Gm3434,9,36134246,36135630,lincRNA,-1,1384,chr9_36134246_36135630
Gm34342,1,184736977,184739520,lincRNA,1,2543,chr1_184736977_184739520
Gm3435,17,15010176,15022449,protein_coding,1,12273,chr17_15010176_15022449
Gm34350,7,67819250,67829618,lincRNA,1,10368,chr7_67819250_67829618
Gm34354,13,59145873,59204327,lincRNA,1,58454,chr13_59145873_59204327
Gm34358,6,55154459,55167210,lincRNA,1,12751,chr6_55154459_55167210
Gm3436,9,70852576,70853415,processed_pseudogene,1,839,chr9_70852576_70853415
Gm34376,10,71287729,71292483,lincRNA,1,4754,chr10_71287729_71292483
Gm34379,3,63905429,63905718,processed_pseudogene,1,289,chr3_63905429_63905718
Gm34388,13,97865841,97876662,lincRNA,-1,10821,chr13_97865841_97876662
Gm34391,6,135171199,135172105,processed_pseudogene,-1,906,chr6_135171199_135172105
Gm34408,12,37446746,37475031,antisense,-1,28285,chr12_37446746_37475031
Gm34417,14,101572528,101573014,processed_pseudogene,-1,486,chr14_101572528_101573014
Gm34418,11,117479875,117482597,lincRNA,-1,2722,chr11_117479875_117482597
Gm34419,8,35094545,35105029,lincRNA,1,10484,chr8_35094545_35105029
Gm34425,9,120869160,120873860,lincRNA,1,4700,chr9_120869160_120873860
Gm34432,19,25346414,25347203,processed_pseudogene,-1,789,chr19_25346414_25347203
Gm34455,17,26467560,26503200,lincRNA,-1,35640,chr17_26467560_26503200
Gm34466,13,45246632,45267711,lincRNA,-1,21079,chr13_45246632_45267711
Gm34471,13,113529039,113567767,lincRNA,-1,38728,chr13_113529039_113567767
Gm34510,17,14203728,14215929,antisense,1,12201,chr17_14203728_14215929
Gm34544,10,71527281,71678840,lincRNA,1,151559,chr10_71527281_71678840
Gm34552,12,74314201,74317162,lincRNA,-1,2961,chr12_74314201_74317162
Gm34557,13,53921313,53934788,lincRNA,-1,13475,chr13_53921313_53934788
Gm34558,13,59211622,59217172,lincRNA,-1,5550,chr13_59211622_59217172
Gm34562,15,51601772,51629635,lincRNA,-1,27863,chr15_51601772_51629635
Gm34567,17,14249851,14277755,lincRNA,1,27904,chr17_14249851_14277755
Gm34574,10,99216442,99228906,lincRNA,-1,12464,chr10_99216442_99228906
Gm34583,5,73380560,73391102,transcribed_processed_pseudogene,1,10542,chr5_73380560_73391102
Gm34585,13,88521190,88578168,lincRNA,1,56978,chr13_88521190_88578168
Gm34586,13,113672318,113686540,lincRNA,1,14222,chr13_113672318_113686540
Gm34589,14,102818164,102834758,processed_transcript,-1,16594,chr14_102818164_102834758
Gm34590,15,36938864,36949605,lincRNA,1,10741,chr15_36938864_36949605
Gm34597,8,35233303,35245479,lincRNA,-1,12176,chr8_35233303_35245479
Gm34599,3,34416495,34418162,lincRNA,1,1667,chr3_34416495_34418162
Gm34609,10,72026982,72111778,lincRNA,1,84796,chr10_72026982_72111778
Gm34623,8,60195802,60280346,lincRNA,1,84544,chr8_60195802_60280346
Gm34639,13,28889458,28898676,lincRNA,-1,9218,chr13_28889458_28898676
Gm34643,14,103012908,103024457,lincRNA,1,11549,chr14_103012908_103024457
Gm34648,5,77386599,77393683,antisense,1,7084,chr5_77386599_77393683
Gm34653,2,34833007,34839728,protein_coding,1,6721,chr2_34833007_34839728
Gm34654,9,77807036,77809793,lincRNA,-1,2757,chr9_77807036_77809793
Gm34655,9,121277775,121286000,bidirectional_promoter_lncRNA,1,8225,chr9_121277775_121286000
Gm34667,12,109990882,110023873,lincRNA,-1,32991,chr12_109990882_110023873
Gm34672,13,59235750,59255411,lincRNA,-1,19661,chr13_59235750_59255411
Gm34680,16,32550211,32553708,lincRNA,1,3497,chr16_32550211_32553708
Gm34684,17,9705342,9726361,lincRNA,-1,21019,chr17_9705342_9726361
Gm34721,13,59405486,59409301,lincRNA,-1,3815,chr13_59405486_59409301
Gm34727,1,38487519,38488047,processed_pseudogene,1,528,chr1_38487519_38488047
Gm34730,8,60616416,60632731,bidirectional_promoter_lncRNA,-1,16315,chr8_60616416_60632731
Gm34732,1,185082738,185085964,lincRNA,-1,3226,chr1_185082738_185085964
Gm34759,15,12068248,12085197,lincRNA,-1,16949,chr15_12068248_12085197
Gm34767,1,165734600,165735661,processed_pseudogene,-1,1061,chr1_165734600_165735661
Gm34768,2,11900082,11910310,unprocessed_pseudogene,1,10228,chr2_11900082_11910310
Gm34776,10,72940238,72949792,lincRNA,-1,9554,chr10_72940238_72949792
Gm34779,7,11866593,11866855,processed_pseudogene,1,262,chr7_11866593_11866855
Gm34783,7,70912518,70912820,processed_pseudogene,-1,302,chr7_70912518_70912820
Gm34788,13,59411618,59419254,lincRNA,-1,7636,chr13_59411618_59419254
Gm34794,15,52751427,52786267,lincRNA,-1,34840,chr15_52751427_52786267
Gm34799,17,9926593,9929767,lincRNA,-1,3174,chr17_9926593_9929767
Gm34804,18,5945183,5965965,lincRNA,1,20782,chr18_5945183_5965965
Gm34808,19,26483557,26484450,lincRNA,-1,893,chr19_26483557_26484450
Gm34829,9,77992599,78002261,lincRNA,1,9662,chr9_77992599_78002261
Gm34838,7,69354372,69396932,lincRNA,-1,42560,chr7_69354372_69396932
Gm34868,12,76287894,76306983,antisense,-1,19089,chr12_76287894_76306983
Gm3488,14,5501674,5522927,protein_coding,1,21253,chr14_5501674_5522927
Gm34882,1,185243713,185247889,antisense,-1,4176,chr1_185243713_185247889
Gm34885,9,37312136,37324436,antisense,1,12300,chr9_37312136_37324436
Gm3489,1,44839171,44839698,processed_pseudogene,1,527,chr1_44839171_44839698
Gm34907,14,103463919,103512619,lincRNA,1,48700,chr14_103463919_103512619
Gm34908,7,132361375,132365863,lincRNA,-1,4488,chr7_132361375_132365863
Gm34921,10,99267686,99270446,lincRNA,-1,2760,chr10_99267686_99270446
Gm34922,19,43645750,43652535,lincRNA,1,6785,chr19_43645750_43652535
Gm34934,14,46866576,46882757,lincRNA,-1,16181,chr14_46866576_46882757
Gm34939,15,99702664,99703976,antisense,-1,1312,chr15_99702664_99703976
Gm34961,13,59823266,59833236,lincRNA,1,9970,chr13_59823266_59833236
Gm34967,16,33824045,33824280,processed_pseudogene,-1,235,chr16_33824045_33824280
Gm34973,9,15381367,15387425,lincRNA,1,6058,chr9_15381367_15387425
Gm34983,10,99459689,99488610,lincRNA,1,28921,chr10_99459689_99488610
Gm3500,14,5365794,5389049,protein_coding,-1,23255,chr14_5365794_5389049
Gm35013,3,90758732,90759563,processed_pseudogene,1,831,chr3_90758732_90759563
Gm35019,15,37892995,37899716,lincRNA,-1,6721,chr15_37892995_37899716
Gm35021,8,35724175,35757517,processed_transcript,1,33342,chr8_35724175_35757517
Gm35025,CHR_MG117_PATCH,108823938,108825098,lncRNA;processed_transcript,-1,1160,chrCHR_MG117_PATCH_108823938_108825098
Gm35031,18,8180579,8192719,lincRNA,1,12140,chr18_8180579_8192719
Gm35035,10,99452654,99460230,lincRNA,-1,7576,chr10_99452654_99460230
Gm35037,7,3449873,3475020,lincRNA;lncRNA,1,25147,chr7_3449873_3475020
Gm35040,7,79536043,79560033,lincRNA,1,23990,chr7_79536043_79560033
Gm35065,3,123444328,123447447,antisense,-1,3119,chr3_123444328_123447447
Gm35066,3,144972124,144982560,macro_lncRNA,1,10436,chr3_144972124_144982560
Gm3507,17,15597928,15598448,processed_pseudogene,1,520,chr17_15597928_15598448
Gm35077,6,58457868,58521810,lincRNA,-1,63942,chr6_58457868_58521810
Gm3508,1,119241962,119242753,processed_pseudogene,-1,791,chr1_119241962_119242753
Gm35082,7,100675088,100677760,lincRNA,1,2672,chr7_100675088_100677760
Gm3510,5,15923755,15933406,lincRNA,-1,9651,chr5_15923755_15933406
Gm35101,10,99669514,99675623,lincRNA,1,6109,chr10_99669514_99675623
Gm3511,5,113767123,113767326,processed_pseudogene,1,203,chr5_113767123_113767326
Gm35110,13,46472669,46501984,bidirectional_promoter_lncRNA,-1,29315,chr13_46472669_46501984
Gm35135,12,52475739,52480609,lincRNA,-1,4870,chr12_52475739_52480609
Gm35147,7,132462012,132466661,lincRNA,-1,4649,chr7_132462012_132466661
Gm35161,13,68998793,69031550,antisense,1,32757,chr13_68998793_69031550
Gm35166,14,47502944,47508187,antisense,-1,5243,chr14_47502944_47508187
Gm35167,15,38184009,38202217,lincRNA,-1,18208,chr15_38184009_38202217
Gm35172,5,99508389,99511037,lincRNA,1,2648,chr5_99508389_99511037
Gm35177,9,40547360,40561393,lincRNA,1,14033,chr9_40547360_40561393
Gm35188,12,52496326,52581409,lincRNA,-1,85083,chr12_52496326_52581409
Gm35189,12,77039597,77042201,lincRNA,-1,2604,chr12_77039597_77042201
Gm3519,5,52441159,52443252,antisense,1,2093,chr5_52441159_52443252
Gm35190,13,3762282,3766722,lincRNA,-1,4440,chr13_3762282_3766722
Gm35206,10,99759506,99830562,antisense,1,71056,chr10_99759506_99830562
Gm35212,5,9779405,9780368,processed_pseudogene,1,963,chr5_9779405_9780368
Gm35229,17,83956248,83957523,lincRNA,1,1275,chr17_83956248_83957523
Gm35239,12,52607670,52628812,lincRNA,1,21142,chr12_52607670_52628812
Gm35248,15,38312293,38343139,lincRNA,1,30846,chr15_38312293_38343139
Gm35256,8,71026792,71126576,lincRNA,1,99784,chr8_71026792_71126576
Gm3526,14,5253907,5260580,protein_coding,-1,6673,chr14_5253907_5260580
Gm35262,9,79395203,79395469,processed_pseudogene,-1,266,chr9_79395203_79395469
Gm3527,5,18350348,18350807,processed_pseudogene,1,459,chr5_18350348_18350807
Gm35281,14,29786828,29852408,lincRNA,-1,65580,chr14_29786828_29852408
Gm35288,9,62298502,62336649,lincRNA,1,38147,chr9_62298502_62336649
Gm35290,17,28001065,28002362,antisense,-1,1297,chr17_28001065_28002362
Gm35299,3,67551329,67553425,lincRNA,-1,2096,chr3_67551329_67553425
Gm35309,7,118329486,118330121,lincRNA,1,635,chr7_118329486_118330121
Gm3531,1,97948901,97949389,processed_pseudogene,-1,488,chr1_97948901_97949389
Gm35315,5,110076136,110094420,protein_coding,-1,18284,chr5_110076136_110094420
Gm3532,14,5538496,5546373,protein_coding,1,7877,chr14_5538496_5546373
Gm35326,12,97869779,97872520,lincRNA,-1,2741,chr12_97869779_97872520
Gm35330,13,5539279,5724510,lincRNA,-1,185231,chr13_5539279_5724510
Gm35333,13,60422756,60434731,lincRNA,-1,11975,chr13_60422756_60434731
Gm35339,15,76354432,76365201,protein_coding,1,10769,chr15_76354432_76365201
Gm3534,14,48408618,48409618,processed_pseudogene,1,1000,chr14_48408618_48409618
Gm35360,14,47805235,47823104,lincRNA,1,17869,chr14_47805235_47823104
Gm35363,7,101525376,101538330,lincRNA,-1,12954,chr7_101525376_101538330
Gm35371,9,40667960,40669107,lincRNA,-1,1147,chr9_40667960_40669107
Gm35386,6,60586778,60591189,lincRNA,1,4411,chr6_60586778_60591189
Gm35394,5,99274095,99279284,lincRNA,1,5189,chr5_99274095_99279284
Gm35405,10,130535562,130535961,processed_pseudogene,-1,399,chr10_130535562_130535961
Gm35406,19,44453017,44459853,lincRNA,1,6836,chr19_44453017_44459853
Gm35419,14,62113120,62171126,lincRNA,-1,58006,chr14_62113120_62171126
Gm35438,19,27101951,27192009,lincRNA,-1,90058,chr19_27101951_27192009
Gm35439,3,92170221,92177907,lincRNA,1,7686,chr3_92170221_92177907
Gm3544,5,20588596,20588900,processed_pseudogene,1,304,chr5_20588596_20588900
Gm35453,8,15580279,15583962,lincRNA,-1,3683,chr8_15580279_15583962
Gm35455,17,15152159,15173058,lincRNA,1,20899,chr17_15152159_15173058
Gm35460,19,44614740,44646879,lincRNA,1,32139,chr19_44614740_44646879
Gm3547,17,20049043,20049287,processed_pseudogene,1,244,chr17_20049043_20049287
Gm3549,6,65169164,65169957,processed_pseudogene,1,793,chr6_65169164_65169957
Gm3550,18,34736359,34738014,protein_coding,1,1655,chr18_34736359_34738014
Gm35501,9,122686799,122693642,lincRNA,1,6843,chr9_122686799_122693642
Gm35507,3,106827307,106879361,lincRNA,-1,52054,chr3_106827307_106879361
Gm3551,1,119897461,119898124,processed_pseudogene,1,663,chr1_119897461_119898124
Gm35520,8,36188372,36202020,lincRNA,1,13648,chr8_36188372_36202020
Gm35548,9,82249931,82260208,lincRNA,-1,10277,chr9_82249931_82260208
Gm35549,9,122822776,122844035,protein_coding,-1,21259,chr9_122822776_122844035
Gm3555,1,98457768,98459162,processed_pseudogene,1,1394,chr1_98457768_98459162
Gm35550,17,65905532,65916482,lincRNA,1,10950,chr17_65905532_65916482
Gm35551,17,84020663,84026019,lincRNA,-1,5356,chr17_84020663_84026019
Gm35552,10,47016652,47102832,lincRNA,-1,86180,chr10_47016652_47102832
Gm35554,19,27344749,27373932,processed_transcript,1,29183,chr19_27344749_27373932
Gm35558,12,110596608,110597359,lincRNA,-1,751,chr12_110596608_110597359
Gm35569,15,100825679,100832391,lincRNA,-1,6712,chr15_100825679_100832391
Gm35570,5,87369803,87370483,processed_pseudogene,-1,680,chr5_87369803_87370483
Gm35572,8,71752026,71781322,lincRNA,-1,29296,chr8_71752026_71781322
Gm3558,14,7545151,7568566,protein_coding,-1,23415,chr14_7545151_7568566
Gm35585,3,127861599,127865261,lincRNA,1,3662,chr3_127861599_127865261
Gm35595,14,62541380,62541575,processed_pseudogene,-1,195,chr14_62541380_62541575
Gm35610,19,44739879,44743444,lincRNA,1,3565,chr19_44739879_44743444
Gm35611,7,35086836,35090842,lincRNA,1,4006,chr7_35086836_35090842
Gm35618,13,69680589,69697676,lincRNA,-1,17087,chr13_69680589_69697676
Gm35619,13,61917549,61918148,processed_pseudogene,1,599,chr13_61917549_61918148
Gm35638,12,13436447,13437098,processed_pseudogene,-1,651,chr12_13436447_13437098
Gm35648,5,147868074,147868548,processed_pseudogene,-1,474,chr5_147868074_147868548
Gm3565,12,111930429,111931037,processed_pseudogene,-1,608,chr12_111930429_111931037
Gm35657,9,41159424,41188862,lincRNA,1,29438,chr9_41159424_41188862
Gm35667,3,127970709,127972881,lincRNA,1,2172,chr3_127970709_127972881
Gm35696,10,121506623,121526101,lincRNA,1,19478,chr10_121506623_121526101
Gm3571,10,93778660,93779719,processed_pseudogene,1,1059,chr10_93778660_93779719
Gm35713,8,63933164,63933362,processed_pseudogene,1,198,chr8_63933164_63933362
Gm35715,9,110669329,110674954,antisense,-1,5625,chr9_110669329_110674954
Gm35721,10,76964653,77008569,lincRNA,-1,43916,chr10_76964653_77008569
Gm35722,10,100707535,100741635,lincRNA,-1,34100,chr10_100707535_100741635
Gm35725,12,13607789,13627646,lincRNA,-1,19857,chr12_13607789_13627646
Gm35732,13,31971086,31972329,antisense,1,1243,chr13_31971086_31972329
Gm35736,6,9146766,9147078,processed_pseudogene,1,312,chr6_9146766_9147078
Gm35755,12,38089902,38092463,processed_pseudogene,1,2561,chr12_38089902_38092463
Gm35781,19,28146096,28146303,processed_pseudogene,-1,207,chr19_28146096_28146303
Gm35823,14,31268757,31320941,antisense,1,52184,chr14_31268757_31320941
Gm35835,9,41680147,41737398,lincRNA,-1,57251,chr9_41680147_41737398
Gm35850,8,90709458,90740775,lincRNA,-1,31317,chr8_90709458_90740775
Gm35853,15,101322888,101405834,antisense,1,82946,chr15_101322888_101405834
Gm35857,8,72531031,72531208,processed_pseudogene,1,177,chr8_72531031_72531208
Gm35876,6,147028001,147028459,processed_pseudogene,1,458,chr6_147028001_147028459
Gm35890,12,13668853,13676084,lincRNA,1,7231,chr12_13668853_13676084
Gm35909,14,105518096,105523485,lincRNA,1,5389,chr14_105518096_105523485
Gm35933,15,76988024,76997054,lincRNA,1,9030,chr15_76988024_76997054
Gm35934,8,18889210,18902316,antisense,-1,13106,chr8_18889210_18902316
Gm35940,9,41805412,41838418,processed_transcript,1,33006,chr9_41805412_41838418
Gm35960,5,73396799,73397813,processed_pseudogene,-1,1014,chr5_73396799_73397813
Gm35963,8,90759463,90762596,lincRNA,-1,3133,chr8_90759463_90762596
Gm35974,16,3468460,3481051,lincRNA,1,12591,chr16_3468460_3481051
Gm35986,3,129527467,129532388,antisense,-1,4921,chr3_129527467_129532388
Gm35996,15,25101020,25128404,lincRNA,-1,27384,chr15_25101020_25128404
Gm36001,16,90548633,90550609,lincRNA,-1,1976,chr16_90548633_90550609
Gm36028,16,37850913,37861146,protein_coding,-1,10233,chr16_37850913_37861146
Gm36037,18,34982922,35109445,processed_transcript,1,126523,chr18_34982922_35109445
Gm3604,13,62368328,62383177,protein_coding,-1,14849,chr13_62368328_62383177
Gm36041,10,122386892,122435033,lincRNA,1,48141,chr10_122386892_122435033
Gm36101,13,48031773,48042471,lincRNA,1,10698,chr13_48031773_48042471
Gm36146,14,49722652,49744296,antisense,1,21644,chr14_49722652_49744296
Gm36159,7,24448354,24451327,lincRNA,1,2973,chr7_24448354_24451327
Gm36169,16,90667439,90677000,lincRNA,-1,9561,chr16_90667439_90677000
Gm3617,1,39314899,39315453,processed_pseudogene,1,554,chr1_39314899_39315453
Gm36186,5,148711466,148718397,lincRNA,1,6931,chr5_148711466_148718397
Gm36189,6,88882655,88883177,processed_pseudogene,1,522,chr6_88882655_88883177
Gm3619,10,95477343,95478117,processed_pseudogene,-1,774,chr10_95477343_95478117
Gm36198,9,21367396,21369184,antisense,-1,1788,chr9_21367396_21369184
Gm36199,17,29432835,29466267,lincRNA,1,33432,chr17_29432835_29466267
Gm36200,17,46067335,46084266,lincRNA,-1,16931,chr17_46067335_46084266
Gm36208,10,122792055,122792483,antisense,-1,428,chr10_122792055_122792483
Gm3621,19,28973039,28974077,processed_pseudogene,1,1038,chr19_28973039_28974077
Gm36210,7,4898450,4906516,protein_coding,-1,8066,chr7_4898450_4906516
Gm36229,10,53409882,53424272,lincRNA,1,14390,chr10_53409882_53424272
Gm36231,2,68820311,68845252,lincRNA,-1,24941,chr2_68820311_68845252
Gm36235,12,15980647,16015545,lincRNA,-1,34898,chr12_15980647_16015545
Gm36236,12,24974609,24975554,bidirectional_promoter_lncRNA,-1,945,chr12_24974609_24975554
Gm36241,5,149903197,149911114,processed_transcript,1,7917,chr5_149903197_149911114
Gm36243,8,91210570,91224667,antisense,1,14097,chr8_91210570_91224667
Gm36246,15,102350827,102355139,bidirectional_promoter_lncRNA,1,4312,chr15_102350827_102355139
Gm36251,9,113070983,113123029,lincRNA,-1,52046,chr9_113070983_113123029
Gm36262,12,54679311,54679809,processed_pseudogene,-1,498,chr12_54679311_54679809
Gm36278,9,83921709,83925022,lincRNA,-1,3313,chr9_83921709_83925022
Gm36279,17,84185756,84216056,antisense,1,30300,chr17_84185756_84216056
Gm36283,10,108417251,108453297,lincRNA,1,36046,chr10_108417251_108453297
Gm36287,12,25150915,25209377,lincRNA,1,58462,chr12_25150915_25209377
Gm3629,14,6583959,6590613,protein_coding,-1,6654,chr14_6583959_6590613
Gm36298,13,62639886,62643252,processed_pseudogene,-1,3366,chr13_62639886_62643252
Gm36315,18,35888769,35890337,lincRNA,-1,1568,chr18_35888769_35890337
Gm36328,6,134754246,134755192,antisense,1,946,chr6_134754246_134755192
Gm36346,13,48107617,48237251,lincRNA,-1,129634,chr13_48107617_48237251
Gm3635,8,112236613,112236966,processed_pseudogene,-1,353,chr8_112236613_112236966
Gm36355,6,115529131,115536900,lincRNA,-1,7769,chr6_115529131_115536900
Gm36356,7,135486029,135491315,lincRNA,1,5286,chr7_135486029_135491315
Gm3636,14,6735685,6742332,protein_coding,-1,6647,chr14_6735685_6742332
Gm36363,16,90836596,90850963,antisense,-1,14367,chr16_90836596_90850963
Gm36367,9,113287707,113311215,lincRNA,1,23508,chr9_113287707_113311215
Gm36368,18,62566410,62579152,protein_coding,-1,12742,chr18_62566410_62579152
Gm36371,7,6156516,6157618,bidirectional_promoter_lncRNA,1,1102,chr7_6156516_6157618
Gm36372,12,16204911,16221279,lincRNA,-1,16368,chr12_16204911_16221279
Gm36388,1,187616852,187651824,antisense,-1,34972,chr1_187616852_187651824
Gm3642,14,6832231,6840311,protein_coding,-1,8080,chr14_6832231_6840311
Gm36423,13,9684226,9689544,antisense,1,5318,chr13_9684226_9689544
Gm36445,13,65241753,65250154,lincRNA,1,8401,chr13_65241753_65250154
Gm36447,5,150822859,150866601,lincRNA,1,43742,chr5_150822859_150866601
Gm36485,9,113406169,113420060,lincRNA,-1,13891,chr9_113406169_113420060
Gm36486,17,29430798,29437448,processed_transcript,-1,6650,chr17_29430798_29437448
Gm36495,12,16844881,16850881,lincRNA,-1,6000,chr12_16844881_16850881
Gm3650,18,43472816,43475169,unprocessed_pseudogene,1,2353,chr18_43472816_43475169
Gm36500,13,34133860,34137654,lincRNA,1,3794,chr13_34133860_34137654
Gm36501,13,62151170,62151914,processed_pseudogene,1,744,chr13_62151170_62151914
Gm36525,13,10539738,10557707,lincRNA,-1,17969,chr13_10539738_10557707
Gm36529,13,70840451,70859609,antisense,1,19158,chr13_70840451_70859609
Gm36536,1,176430111,176527273,lincRNA,-1,97162,chr1_176430111_176527273
Gm36539,9,86981991,87006163,lincRNA,-1,24172,chr9_86981991_87006163
Gm36543,10,25701410,25707943,lincRNA,-1,6533,chr10_25701410_25707943
Gm36546,7,43670841,43671314,lincRNA,-1,473,chr7_43670841_43671314
Gm36550,13,48593501,48595843,antisense,1,2342,chr13_48593501_48595843
Gm36560,15,102797495,102819544,lincRNA,1,22049,chr15_102797495_102819544
Gm36584,7,82852498,82867074,lincRNA,-1,14576,chr7_82852498_82867074
Gm36602,19,46658967,46666126,lincRNA,-1,7159,chr19_46658967_46666126
Gm36607,13,70706233,70733207,antisense,1,26974,chr13_70706233_70733207
Gm36608,19,3689686,3708176,lincRNA,-1,18490,chr19_3689686_3708176
Gm36634,12,55497721,55499951,processed_transcript,1,2230,chr12_55497721_55499951
Gm36635,12,111703082,111705550,lincRNA,1,2468,chr12_111703082_111705550
Gm36644,15,78420496,78424193,lincRNA,-1,3697,chr15_78420496_78424193
Gm36660,12,80018415,80081434,lincRNA,-1,63019,chr12_80018415_80081434
Gm3667,14,6868502,6889962,protein_coding,-1,21460,chr14_6868502_6889962
Gm36677,15,59618590,59619055,lincRNA,1,465,chr15_59618590_59619055
Gm36684,17,13330748,13333842,lincRNA,1,3094,chr17_13330748_13333842
Gm36693,19,47198241,47202032,antisense,-1,3791,chr19_47198241_47202032
Gm36696,7,72110761,72113456,antisense,1,2695,chr7_72110761_72113456
Gm3671,9,75693653,75694659,processed_pseudogene,-1,1006,chr9_75693653_75694659
Gm36736,7,121314810,121393101,antisense,-1,78291,chr7_121314810_121393101
Gm36738,15,78574411,78581616,lincRNA,-1,7205,chr15_78574411_78581616
Gm36742,16,39187463,39188906,lincRNA,-1,1443,chr16_39187463_39188906
Gm36745,9,113636528,113642054,lincRNA,-1,5526,chr9_113636528_113642054
Gm3675,7,8035859,8055842,unprocessed_pseudogene,-1,19983,chr7_8035859_8055842
Gm36752,12,17436618,17446443,lincRNA,1,9825,chr12_17436618_17446443
Gm36756,12,100986623,101014822,antisense,1,28199,chr12_100986623_101014822
Gm3678,12,6498124,6498615,processed_pseudogene,-1,491,chr12_6498124_6498615
Gm36787,19,3713044,3719573,antisense,-1,6529,chr19_3713044_3719573
Gm36796,16,22244168,22244472,processed_pseudogene,1,304,chr16_22244168_22244472
Gm36804,18,64428353,64428669,processed_pseudogene,-1,316,chr18_64428353_64428669
Gm36816,6,66990031,67009260,antisense,-1,19229,chr6_66990031_67009260
Gm36823,3,38426552,38443874,lincRNA,-1,17322,chr3_38426552_38443874
Gm36839,13,34872512,34875432,lincRNA,-1,2920,chr13_34872512_34875432
Gm3685,14,7036535,7044970,protein_coding,-1,8435,chr14_7036535_7044970
Gm36855,9,43506551,43521004,lincRNA,-1,14453,chr9_43506551_43521004
Gm36858,18,36980057,36989575,unprocessed_pseudogene,1,9518,chr18_36980057_36989575
Gm36860,19,32974990,32980063,lincRNA,-1,5073,chr19_32974990_32980063
Gm36862,12,17553768,17578690,processed_transcript,1,24922,chr12_17553768_17578690
Gm36864,7,44236177,44243191,protein_coding,1,7014,chr7_44236177_44243191
Gm36888,3,147620811,147635647,lincRNA,-1,14836,chr3_147620811_147635647
Gm36899,15,27459835,27463449,lincRNA,-1,3614,chr15_27459835_27463449
Gm36903,16,39446749,39488234,lincRNA,1,41485,chr16_39446749_39488234
Gm36908,10,25615632,25621563,lincRNA,-1,5931,chr10_25615632_25621563
Gm36913,19,9924564,9928534,lincRNA,-1,3970,chr19_9924564_9928534
Gm3693,12,81228284,81243258,antisense,1,14974,chr12_81228284_81243258
Gm3695,12,81372213,81373221,processed_pseudogene,-1,1008,chr12_81372213_81373221
Gm3696,14,7083208,7100621,protein_coding,-1,17413,chr14_7083208_7100621
Gm3699,10,43456427,43456501,processed_pseudogene,-1,74,chr10_43456427_43456501
Gm3702,7,9965888,9966233,processed_pseudogene,-1,345,chr7_9965888_9966233
Gm3712,X,95319819,95321889,processed_pseudogene,-1,2070,chrX_95319819_95321889
Gm3716,5,64593857,64610700,lincRNA,-1,16843,chr5_64593857_64610700
Gm3724,5,24118316,24118664,processed_pseudogene,-1,348,chr5_24118316_24118664
Gm3728,19,20005989,20060758,lincRNA,-1,54769,chr19_20005989_20060758
Gm3734,18,46630807,46642970,lincRNA,1,12163,chr18_46630807_46642970
Gm3739,14,7293648,7315049,protein_coding,-1,21401,chr14_7293648_7315049
Gm3742,12,87633281,87643442,processed_pseudogene,-1,10161,chr12_87633281_87643442
Gm3744,18,46941807,46942176,processed_pseudogene,-1,369,chr18_46941807_46942176
Gm3745,3,87968186,87968606,processed_pseudogene,1,420,chr3_87968186_87968606
Gm3752,14,7466362,7483762,protein_coding,-1,17400,chr14_7466362_7483762
Gm3755,14,7440924,7450917,protein_coding,-1,9993,chr14_7440924_7450917
Gm3756,9,31935446,31936800,processed_pseudogene,-1,1354,chr9_31935446_31936800
Gm3764,3,88206813,88229959,lincRNA,1,23146,chr3_88206813_88229959
Gm3765,7,107198743,107200189,processed_pseudogene,-1,1446,chr7_107198743_107200189
Gm3772,13,70021959,70119949,lincRNA,1,97990,chr13_70021959_70119949
Gm3774,7,11112954,11113388,processed_pseudogene,-1,434,chr7_11112954_11113388
Gm3778,14,19016757,19024593,unprocessed_pseudogene,1,7836,chr14_19016757_19024593
Gm378,X,108405688,108406768,processed_pseudogene,1,1080,chrX_108405688_108406768
Gm3786,5,117294029,117294406,processed_pseudogene,-1,377,chr5_117294029_117294406
Gm3788,3,86672033,86672168,processed_pseudogene,-1,135,chr3_86672033_86672168
Gm3791,12,83875115,83875882,processed_pseudogene,-1,767,chr12_83875115_83875882
Gm3800,13,65313758,65314311,processed_pseudogene,1,553,chr13_65313758_65314311
Gm3809,1,186960508,186961513,processed_pseudogene,1,1005,chr1_186960508_186961513
Gm3810,11,27507625,27508100,processed_pseudogene,-1,475,chr11_27507625_27508100
Gm3815,18,51003104,51003605,processed_pseudogene,1,501,chr18_51003104_51003605
Gm3829,13,65579040,65579658,processed_pseudogene,-1,618,chr13_65579040_65579658
Gm3836,7,11970947,11972933,processed_pseudogene,1,1986,chr7_11970947_11972933
Gm3839,14,11280735,11356726,protein_coding,-1,75991,chr14_11280735_11356726
Gm3852,1,46011757,46012020,processed_pseudogene,-1,263,chr1_46011757_46012020
Gm3854,7,6343759,6355956,protein_coding,1,12197,chr7_6343759_6355956
Gm3861,15,90723648,90723996,processed_pseudogene,1,348,chr15_90723648_90723996
Gm3883,4,42456965,42461867,unprocessed_pseudogene,1,4902,chr4_42456965_42461867
Gm3888,15,92026359,92027598,processed_pseudogene,-1,1239,chr15_92026359_92027598
Gm3896,9,37015758,37020671,antisense,1,4913,chr9_37015758_37020671
Gm3912,7,7362898,7374624,transcribed_unprocessed_pseudogene,-1,11726,chr7_7362898_7374624
Gm3919,16,11036674,11037331,processed_pseudogene,-1,657,chr16_11036674_11037331
Gm3924,15,79045599,79051176,lincRNA,-1,5577,chr15_79045599_79051176
Gm3926,13,75523226,75524348,processed_pseudogene,-1,1122,chr13_75523226_75524348
Gm3928,X,103075919,103077225,processed_pseudogene,1,1306,chrX_103075919_103077225
Gm3940,1,52090635,52091066,processed_pseudogene,-1,431,chr1_52090635_52091066
Gm3946,17,26223711,26224554,processed_pseudogene,1,843,chr17_26223711_26224554
Gm3948,11,78292848,78293956,antisense,-1,1108,chr11_78292848_78293956
Gm3953,9,44663928,44664716,processed_pseudogene,-1,788,chr9_44663928_44664716
Gm3956,7,8667317,8693097,unprocessed_pseudogene,-1,25780,chr7_8667317_8693097
Gm3962,7,8738845,8754923,transcribed_unprocessed_pseudogene,-1,16078,chr7_8738845_8754923
Gm3963,13,78286637,78287084,processed_pseudogene,-1,447,chr13_78286637_78287084
Gm3978,7,7948362,7964378,unprocessed_pseudogene,-1,16016,chr7_7948362_7964378
Gm3985,8,32888505,32950026,lincRNA,-1,61521,chr8_32888505_32950026
Gm4012,12,20545201,20550720,unprocessed_pseudogene,1,5519,chr12_20545201_20550720
Gm4013,18,42274382,42275197,processed_transcript,-1,815,chr18_42274382_42275197
Gm4017,Y,1268548,1268885,processed_pseudogene,-1,337,chrY_1268548_1268885
Gm4034,1,148937897,148938376,processed_pseudogene,-1,479,chr1_148937897_148938376
Gm4035,13,37421833,37435149,lincRNA,-1,13316,chr13_37421833_37435149
Gm4036,12,21624760,21630450,unprocessed_pseudogene,-1,5690,chr12_21624760_21630450
Gm4042,9,50215079,50215715,processed_pseudogene,1,636,chr9_50215079_50215715
Gm4045,6,66746017,66746326,processed_pseudogene,1,309,chr6_66746017_66746326
Gm4052,13,72350221,72350671,processed_pseudogene,1,450,chr13_72350221_72350671
Gm4057,13,72472202,72472569,processed_pseudogene,-1,367,chr13_72472202_72472569
Gm4059,13,84973712,84974317,processed_pseudogene,-1,605,chr13_84973712_84974317
Gm4066,13,85025098,85025436,processed_pseudogene,-1,338,chr13_85025098_85025436
Gm4070,7,105895139,105953967,protein_coding,-1,58828,chr7_105895139_105953967
Gm4106,16,3161226,3162048,processed_pseudogene,-1,822,chr16_3161226_3162048
Gm4107,18,46357872,46427128,lincRNA,-1,69256,chr18_46357872_46427128
Gm4111,16,3304392,3305214,processed_pseudogene,1,822,chr16_3304392_3305214
Gm4116,16,3534391,3534825,processed_pseudogene,1,434,chr16_3534391_3534825
Gm4117,13,89739460,89887166,antisense,1,147706,chr13_89739460_89887166
Gm4118,14,61558798,61559661,processed_pseudogene,1,863,chr14_61558798_61559661
Gm4120,12,24302807,24308251,unprocessed_pseudogene,-1,5444,chr12_24302807_24308251
Gm4129,10,123196695,123199418,bidirectional_promoter_lncRNA,1,2723,chr10_123196695_123199418
Gm4130,13,91261449,91262418,processed_pseudogene,-1,969,chr13_91261449_91262418
Gm4131,14,62463414,62566921,protein_coding,-1,103507,chr14_62463414_62566921
Gm4149,13,75644896,75645171,processed_pseudogene,1,275,chr13_75644896_75645171
Gm4202,3,92689426,92690158,processed_pseudogene,1,732,chr3_92689426_92690158
Gm4204,1,135231995,135233225,processed_pseudogene,1,1230,chr1_135231995_135233225
Gm4208,1,62821355,62832370,lincRNA,-1,11015,chr1_62821355_62832370
Gm4211,13,80957665,80963730,lincRNA,-1,6065,chr13_80957665_80963730
Gm4217,15,84866317,84867318,processed_pseudogene,1,1001,chr15_84866317_84867318
Gm4221,18,54990265,55079414,antisense,1,89149,chr18_54990265_55079414
Gm4240,14,70302207,70302939,processed_pseudogene,1,732,chr14_70302207_70302939
Gm4242,19,61232424,61232926,processed_pseudogene,-1,502,chr19_61232424_61232926
Gm4246,17,36194596,36194811,processed_pseudogene,-1,215,chr17_36194596_36194811
Gm4248,3,106091034,106091349,processed_pseudogene,1,315,chr3_106091034_106091349
Gm4252,17,36248636,36248948,processed_pseudogene,-1,312,chr17_36248636_36248948
Gm4258,1,137898595,138000384,processed_transcript,1,101789,chr1_137898595_138000384
Gm4265,7,129962165,129978669,lincRNA,1,16504,chr7_129962165_129978669
Gm4266,14,73493093,73493924,processed_pseudogene,1,831,chr14_73493093_73493924
Gm4270,7,13094992,13095397,processed_pseudogene,1,405,chr7_13094992_13095397
Gm4285,14,75843379,75844964,antisense,-1,1585,chr14_75843379_75844964
Gm4287,6,90235689,90236273,processed_pseudogene,1,584,chr6_90235689_90236273
Gm4290,7,27046894,27047707,processed_pseudogene,1,813,chr7_27046894_27047707
Gm4291,14,76976249,76976887,processed_pseudogene,1,638,chr14_76976249_76976887
Gm4294,12,12023045,12023658,processed_pseudogene,1,613,chr12_12023045_12023658
Gm4312,10,100381647,100382560,protein_coding,-1,913,chr10_100381647_100382560
Gm4332,3,119709516,119709861,processed_pseudogene,1,345,chr3_119709516_119709861
Gm4335,15,93196595,93197598,processed_pseudogene,1,1003,chr15_93196595_93197598
Gm4342,8,123853829,123854195,processed_pseudogene,1,366,chr8_123853829_123854195
Gm4349,3,95427671,95431087,transcribed_unprocessed_pseudogene,1,3416,chr3_95427671_95431087
Gm4353,7,116083367,116084558,processed_pseudogene,-1,1191,chr7_116083367_116084558
Gm4356,17,28726083,28726700,protein_coding,1,617,chr17_28726083_28726700
Gm4366,7,116824510,116825851,processed_pseudogene,-1,1341,chr7_116824510_116825851
Gm4373,7,31652395,31652950,processed_pseudogene,1,555,chr7_31652395_31652950
Gm4374,6,73528815,73529238,processed_pseudogene,-1,423,chr6_73528815_73529238
Gm4383,15,97302352,97302974,processed_pseudogene,-1,622,chr15_97302352_97302974
Gm4419,12,21417323,21421064,antisense,1,3741,chr12_21417323_21421064
Gm4425,12,22115756,22156646,lincRNA,-1,40890,chr12_22115756_22156646
Gm4432,17,32242163,32242507,processed_pseudogene,1,344,chr17_32242163_32242507
Gm4450,3,98445675,98457126,protein_coding,-1,11451,chr3_98445675_98457126
Gm4459,7,139659688,139660155,processed_pseudogene,-1,467,chr7_139659688_139660155
Gm4462,16,20663754,20665056,processed_pseudogene,1,1302,chr16_20663754_20665056
Gm4471,17,55247703,55248636,processed_pseudogene,1,933,chr17_55247703_55248636
Gm4478,10,121343176,121343658,processed_pseudogene,1,482,chr10_121343176_121343658
Gm4479,14,56787517,56787687,processed_pseudogene,-1,170,chr14_56787517_56787687
Gm4482,6,122792584,122793325,processed_pseudogene,-1,741,chr6_122792584_122793325
Gm4486,14,112957368,112958203,processed_pseudogene,1,835,chr14_112957368_112958203
Gm4491,14,57112506,57115883,protein_coding,-1,3377,chr14_57112506_57115883
Gm4510,10,126185897,126186323,processed_pseudogene,-1,426,chr10_126185897_126186323
Gm4518,17,61780915,61781632,processed_pseudogene,-1,717,chr17_61780915_61781632
Gm4524,16,25956475,25960342,antisense,1,3867,chr16_25956475_25960342
Gm4525,3,104915910,104916163,processed_pseudogene,-1,253,chr3_104915910_104916163
Gm4529,14,121523544,121523748,processed_pseudogene,1,204,chr14_121523544_121523748
Gm4535,7,141406637,141407194,processed_pseudogene,1,557,chr7_141406637_141407194
Gm454,5,138202134,138207310,transcribed_unprocessed_pseudogene,-1,5176,chr5_138202134_138207310
Gm4540,3,106034664,106035092,processed_pseudogene,1,428,chr3_106034664_106035092
Gm4544,15,102657111,102660468,lincRNA,1,3357,chr15_102657111_102660468
Gm4553,7,142164696,142165739,protein_coding,-1,1043,chr7_142164696_142165739
Gm4556,10,128190529,128190883,processed_pseudogene,1,354,chr10_128190529_128190883
Gm4561,17,69925327,69925831,processed_pseudogene,-1,504,chr17_69925327_69925831
Gm4566,17,71333201,71341804,lincRNA,-1,8603,chr17_71333201_71341804
Gm4573,14,64921821,64922085,processed_pseudogene,1,264,chr14_64921821_64922085
Gm4575,6,91428883,91429884,processed_pseudogene,1,1001,chr6_91428883_91429884
Gm4587,7,132483658,132484294,processed_pseudogene,1,636,chr7_132483658_132484294
Gm4596,3,116528137,116528578,processed_pseudogene,-1,441,chr3_116528137_116528578
Gm4600,16,37696770,37697340,processed_pseudogene,-1,570,chr16_37696770_37697340
Gm4602,6,105531520,105531827,processed_pseudogene,1,307,chr6_105531520_105531827
Gm4605,6,109443601,109444225,processed_pseudogene,-1,624,chr6_109443601_109444225
Gm4607,7,25601326,25601902,processed_pseudogene,1,576,chr7_25601326_25601902
Gm4609,3,122230195,122231196,processed_pseudogene,-1,1001,chr3_122230195_122231196
Gm4610,3,122377097,122391811,antisense,-1,14714,chr3_122377097_122391811
Gm4613,7,25828602,25828877,processed_pseudogene,-1,275,chr7_25828602_25828877
Gm4617,3,124385667,124385997,processed_pseudogene,1,330,chr3_124385667_124385997
Gm4632,14,79178894,79199190,antisense,-1,20296,chr14_79178894_79199190
Gm4651,6,121064464,121069954,processed_transcript,1,5490,chr6_121064464_121069954
Gm4654,14,103370465,103371446,processed_pseudogene,-1,981,chr14_103370465_103371446
Gm4660,16,60397920,60398322,processed_pseudogene,-1,402,chr16_60397920_60398322
Gm4665,9,115180404,115186058,antisense,-1,5654,chr9_115180404_115186058
Gm4668,9,116189180,116194886,lincRNA,1,5706,chr9_116189180_116194886
Gm4673,7,30956909,30961619,antisense,1,4710,chr7_30956909_30961619
Gm4681,14,120089943,120195452,lincRNA,-1,105509,chr14_120089943_120195452
Gm4691,6,128202150,128203276,transcribed_processed_pseudogene,-1,1126,chr6_128202150_128203276
Gm4701,17,64876201,64876924,processed_pseudogene,1,723,chr17_64876201_64876924
Gm4705,17,66413631,66413984,processed_pseudogene,-1,353,chr17_66413631_66413984
Gm4708,17,74438285,74438639,processed_pseudogene,-1,354,chr17_74438285_74438639
Gm4710,17,75861023,75889039,lincRNA,1,28016,chr17_75861023_75889039
Gm4735,2,80837141,80838442,processed_pseudogene,1,1301,chr2_80837141_80838442
Gm4737,16,46152985,46155077,protein_coding,-1,2092,chr16_46152985_46155077
Gm4739,10,26107789,26108421,processed_pseudogene,1,632,chr10_26107789_26108421
Gm4740,15,38853385,38992007,processed_pseudogene,1,138622,chr15_38853385_38992007
Gm4742,14,52368918,52369688,processed_pseudogene,-1,770,chr14_52368918_52369688
Gm4746,X,90416967,90419372,processed_pseudogene,-1,2405,chrX_90416967_90419372
Gm4750,X,152432477,152434676,transcribed_processed_pseudogene,1,2199,chrX_152432477_152434676
Gm4754,5,41342123,41342931,processed_pseudogene,1,808,chr5_41342123_41342931
Gm4755,12,8764901,8771181,bidirectional_promoter_lncRNA,-1,6280,chr12_8764901_8771181
Gm4756,12,72576002,72649661,protein_coding,-1,73659,chr12_72576002_72649661
Gm4757,19,37870270,37871119,processed_pseudogene,1,849,chr19_37870270_37871119
Gm4759,7,106417848,106424469,unprocessed_pseudogene,-1,6621,chr7_106417848_106424469
Gm4760,X,143183508,143184537,processed_pseudogene,-1,1029,chrX_143183508_143184537
Gm4761,6,67414431,67415012,processed_pseudogene,-1,581,chr6_67414431_67415012
Gm4766,17,45163230,45164168,processed_pseudogene,-1,938,chr17_45163230_45164168
Gm4768,7,128997336,128998021,processed_pseudogene,-1,685,chr7_128997336_128998021
Gm4772,X,79902724,79903566,processed_pseudogene,-1,842,chrX_79902724_79903566
Gm4773,X,80061011,80061712,processed_pseudogene,-1,701,chrX_80061011_80061712
Gm4775,14,106100765,106101166,processed_pseudogene,-1,401,chr14_106100765_106101166
Gm4777,10,25053359,25054685,processed_pseudogene,1,1326,chr10_25053359_25054685
Gm4780,10,30372918,30375561,transcribed_processed_pseudogene,1,2643,chr10_30372918_30375561
Gm4782,6,50608637,50610682,processed_pseudogene,1,2045,chr6_50608637_50610682
Gm4784,X,109388744,109392165,processed_pseudogene,-1,3421,chrX_109388744_109392165
Gm4785,1,33108905,33109655,processed_pseudogene,-1,750,chr1_33108905_33109655
Gm4786,17,16557246,16558043,processed_pseudogene,1,797,chr17_16557246_16558043
Gm4787,12,81376991,81379464,protein_coding,-1,2473,chr12_81376991_81379464
Gm4788,1,139697623,139781243,protein_coding,-1,83620,chr1_139697623_139781243
Gm4789,X,23854819,23856034,processed_pseudogene,-1,1215,chrX_23854819_23856034
Gm4793,1,135584773,135599948,antisense,1,15175,chr1_135584773_135599948
Gm4795,10,45006110,45007117,processed_pseudogene,1,1007,chr10_45006110_45007117
Gm4796,10,65534654,65535277,processed_pseudogene,1,623,chr10_65534654_65535277
Gm4797,10,71595847,71597129,processed_pseudogene,-1,1282,chr10_71595847_71597129
Gm4798,10,71704290,71705988,processed_pseudogene,1,1698,chr10_71704290_71705988
Gm4799,10,82954344,82955000,processed_pseudogene,1,656,chr10_82954344_82955000
Gm4800,10,92542405,92543670,processed_pseudogene,-1,1265,chr10_92542405_92543670
Gm4803,12,11665771,11667049,processed_pseudogene,-1,1278,chr12_11665771_11667049
Gm4804,12,15606412,15729095,transcribed_processed_pseudogene,1,122683,chr12_15606412_15729095
Gm4806,12,64816815,64818504,processed_pseudogene,1,1689,chr12_64816815_64818504
Gm4810,13,64509490,64511096,processed_pseudogene,1,1606,chr13_64509490_64511096
Gm4811,13,64927942,64929161,processed_pseudogene,-1,1219,chr13_64927942_64929161
Gm4814,13,93073304,93074757,antisense,1,1453,chr13_93073304_93074757
Gm4815,13,98613501,98614494,processed_pseudogene,1,993,chr13_98613501_98614494
Gm4817,14,40294120,40295530,processed_pseudogene,-1,1410,chr14_40294120_40295530
Gm4819,14,56250069,56251077,processed_pseudogene,1,1008,chr14_56250069_56251077
Gm4821,14,78461292,78461818,processed_pseudogene,1,526,chr14_78461292_78461818
Gm4822,14,112481367,112481845,processed_pseudogene,1,478,chr14_112481367_112481845
Gm4823,15,3745892,3746875,processed_pseudogene,-1,983,chr15_3745892_3746875
Gm4824,15,25840120,25840611,processed_pseudogene,-1,491,chr15_25840120_25840611
Gm4825,15,85510812,85511219,processed_pseudogene,1,407,chr15_85510812_85511219
Gm4828,17,4880626,4881115,processed_pseudogene,1,489,chr17_4880626_4881115
Gm4829,17,3101143,3101736,processed_pseudogene,-1,593,chr17_3101143_3101736
Gm4832,17,88125512,88131113,transcribed_processed_pseudogene,1,5601,chr17_88125512_88131113
Gm4833,18,8051203,8051992,processed_pseudogene,1,789,chr18_8051203_8051992
Gm4834,18,9628862,9632479,processed_pseudogene,1,3617,chr18_9628862_9632479
Gm4835,18,15988368,15989339,processed_pseudogene,1,971,chr18_15988368_15989339
Gm4837,18,21492516,21494099,processed_pseudogene,-1,1583,chr18_21492516_21494099
Gm4839,18,45146504,45147126,processed_pseudogene,-1,622,chr18_45146504_45147126
Gm4840,18,46355158,46356967,processed_pseudogene,-1,1809,chr18_46355158_46356967
Gm4841,18,60268305,60273272,protein_coding,-1,4967,chr18_60268305_60273272
Gm4842,18,69256288,69257122,processed_pseudogene,1,834,chr18_69256288_69257122
Gm4845,1,141256596,141257157,processed_pseudogene,-1,561,chr1_141256596_141257157
Gm4849,1,19330939,19333184,processed_pseudogene,1,2245,chr1_19330939_19333184
Gm4852,1,47365644,47366372,processed_pseudogene,-1,728,chr1_47365644_47366372
Gm4853,X,38396935,38397328,processed_pseudogene,1,393,chrX_38396935_38397328
Gm4854,1,115219190,115219763,processed_pseudogene,-1,573,chr1_115219190_115219763
Gm4855,3,26380445,26382411,processed_pseudogene,1,1966,chr3_26380445_26382411
Gm4857,3,81556041,81556825,processed_pseudogene,-1,784,chr3_81556041_81556825
Gm4859,3,112302372,112303158,processed_pseudogene,1,786,chr3_112302372_112303158
Gm4863,3,140116655,140118035,processed_pseudogene,-1,1380,chr3_140116655_140118035
Gm4864,12,77623549,77625009,processed_pseudogene,-1,1460,chr12_77623549_77625009
Gm4865,5,27999998,28001306,processed_pseudogene,-1,1308,chr5_27999998_28001306
Gm4866,5,83863163,83863751,unprocessed_pseudogene,1,588,chr5_83863163_83863751
Gm4868,5,125847952,125848740,processed_pseudogene,-1,788,chr5_125847952_125848740
Gm4874,6,81840674,81841364,processed_pseudogene,-1,690,chr6_81840674_81841364
Gm4875,6,117997207,117997992,processed_pseudogene,1,785,chr6_117997207_117997992
Gm4876,6,17065010,17171833,antisense,-1,106823,chr6_17065010_17171833
Gm4877,6,42519516,42520313,processed_pseudogene,-1,797,chr6_42519516_42520313
Gm4879,7,13178903,13180174,processed_pseudogene,1,1271,chr7_13178903_13180174
Gm4880,7,18509861,18511630,processed_pseudogene,-1,1769,chr7_18509861_18511630
Gm4887,7,104821204,104822256,processed_pseudogene,1,1052,chr7_104821204_104822256
Gm4890,8,79295123,79308961,bidirectional_promoter_lncRNA,1,13838,chr8_79295123_79308961
Gm4891,8,80933677,80934588,processed_pseudogene,1,911,chr8_80933677_80934588
Gm4895,10,22153280,22154416,processed_pseudogene,-1,1136,chr10_22153280_22154416
Gm4899,8,81197630,81198348,processed_pseudogene,-1,718,chr8_81197630_81198348
Gm4900,13,3138485,3140112,processed_pseudogene,-1,1627,chr13_3138485_3140112
Gm4908,X,47471808,47472812,processed_pseudogene,1,1004,chrX_47471808_47472812
Gm4910,X,68315952,68316317,processed_pseudogene,-1,365,chrX_68315952_68316317
Gm4913,X,119966284,119967573,processed_pseudogene,1,1289,chrX_119966284_119967573
Gm4914,X,114948913,114949371,processed_pseudogene,1,458,chrX_114948913_114949371
Gm4915,X,114021997,114023565,processed_pseudogene,1,1568,chrX_114021997_114023565
Gm4917,X,136338065,136338714,processed_pseudogene,1,649,chrX_136338065_136338714
Gm4918,X,146095376,146096459,processed_pseudogene,1,1083,chrX_146095376_146096459
Gm4919,X,151761943,151762658,processed_pseudogene,-1,715,chrX_151761943_151762658
Gm4921,10,6525883,6526874,processed_pseudogene,-1,991,chr10_6525883_6526874
Gm4922,10,18779725,18786793,protein_coding,-1,7068,chr10_18779725_18786793
Gm4924,10,82354255,82422882,protein_coding,1,68627,chr10_82354255_82422882
Gm4925,10,88729541,88731101,transcribed_processed_pseudogene,-1,1560,chr10_88729541_88731101
Gm4926,11,46636516,46645006,lincRNA,-1,8490,chr11_46636516_46645006
Gm4927,12,6281019,6282336,processed_pseudogene,-1,1317,chr12_6281019_6282336
Gm4928,12,10723657,10724506,processed_pseudogene,-1,849,chr12_10723657_10724506
Gm4929,12,13752674,13753665,processed_pseudogene,-1,991,chr12_13752674_13753665
Gm4935,13,64673863,64675060,processed_pseudogene,1,1197,chr13_64673863_64675060
Gm4936,13,82378785,82379643,processed_pseudogene,-1,858,chr13_82378785_82379643
Gm4938,13,104918780,104919176,processed_pseudogene,1,396,chr13_104918780_104919176
Gm4939,14,18543808,18545132,processed_pseudogene,-1,1324,chr14_18543808_18545132
Gm4940,15,13452316,13453112,processed_pseudogene,1,796,chr15_13452316_13453112
Gm4945,17,47042587,47043039,processed_pseudogene,-1,452,chr17_47042587_47043039
Gm4946,17,54507415,54508222,processed_pseudogene,1,807,chr17_54507415_54508222
Gm4948,17,73870431,73871350,processed_pseudogene,-1,919,chr17_73870431_73871350
Gm4949,18,38359441,38360538,processed_pseudogene,-1,1097,chr18_38359441_38360538
Gm4950,18,51865267,51865881,processed_pseudogene,-1,614,chr18_51865267_51865881
Gm4951,18,60212080,60247820,protein_coding,1,35740,chr18_60212080_60247820
Gm4952,19,12599974,12628251,protein_coding,1,28277,chr19_12599974_12628251
Gm4953,1,159168160,159168642,processed_pseudogene,-1,482,chr1_159168160_159168642
Gm4954,1,166762145,166770485,processed_pseudogene,1,8340,chr1_166762145_166770485
Gm4959,5,10558353,10559396,processed_pseudogene,1,1043,chr5_10558353_10559396
Gm4960,5,7399362,7400362,processed_pseudogene,-1,1000,chr5_7399362_7400362
Gm4961,5,30092940,30097686,lincRNA,1,4746,chr5_30092940_30097686
Gm4962,5,50679716,50682692,transcribed_processed_pseudogene,1,2976,chr5_50679716_50682692
Gm4963,5,137993047,137993424,processed_pseudogene,-1,377,chr5_137993047_137993424
Gm4968,6,127233762,127234619,processed_pseudogene,1,857,chr6_127233762_127234619
Gm4969,7,19099046,19118368,protein_coding,-1,19322,chr7_19099046_19118368
Gm4971,7,73685494,73686601,processed_pseudogene,-1,1107,chr7_73685494_73686601
Gm4972,7,105412720,105413973,processed_pseudogene,-1,1253,chr7_105412720_105413973
Gm4973,7,125547269,125548602,processed_pseudogene,1,1333,chr7_125547269_125548602
Gm4974,7,139887477,139888351,processed_pseudogene,-1,874,chr7_139887477_139888351
Gm4977,9,17732670,17733931,processed_pseudogene,1,1261,chr9_17732670_17733931
Gm4978,9,69450235,69451035,processed_pseudogene,-1,800,chr9_69450235_69451035
Gm4981,10,58234848,58261198,protein_coding,-1,26350,chr10_58234848_58261198
Gm4984,X,12652303,12652662,processed_pseudogene,1,359,chrX_12652303_12652662
Gm4986,X,40137008,40137556,processed_pseudogene,-1,548,chrX_40137008_40137556
Gm4987,X,46455887,46456294,processed_pseudogene,-1,407,chrX_46455887_46456294
Gm4988,X,61288188,61292484,transcribed_unprocessed_pseudogene,1,4296,chrX_61288188_61292484
Gm4989,X,74566958,74567706,processed_pseudogene,1,748,chrX_74566958_74567706
Gm4991,X,109910221,109911772,processed_pseudogene,1,1551,chrX_109910221_109911772
Gm4992,X,121913227,121913994,processed_pseudogene,1,767,chrX_121913227_121913994
Gm4993,X,120957711,120958884,processed_pseudogene,1,1173,chrX_120957711_120958884
Gm4994,X,131847887,131850073,processed_pseudogene,-1,2186,chrX_131847887_131850073
Gm4996,X,146932685,146934254,processed_pseudogene,1,1569,chrX_146932685_146934254
Gm5,5,150499747,150502304,lincRNA,-1,2557,chr5_150499747_150502304
Gm5037,7,95912769,95913386,processed_pseudogene,-1,617,chr7_95912769_95913386
Gm5039,12,88320122,88324026,protein_coding,-1,3904,chr12_88320122_88324026
Gm5040,10,51238829,51239628,processed_pseudogene,1,799,chr10_51238829_51239628
Gm5042,13,78273469,78273952,processed_pseudogene,-1,483,chr13_78273469_78273952
Gm5043,15,8914484,8915303,processed_pseudogene,1,819,chr15_8914484_8915303
Gm5046,15,65015154,65015764,processed_pseudogene,1,610,chr15_65015154_65015764
Gm5047,18,4743076,4743876,processed_pseudogene,1,800,chr18_4743076_4743876
Gm5049,1,161746056,161747645,processed_pseudogene,1,1589,chr1_161746056_161747645
Gm5050,5,136211012,136211786,processed_pseudogene,-1,774,chr5_136211012_136211786
Gm5051,6,140420171,140420655,processed_pseudogene,1,484,chr6_140420171_140420655
Gm5054,7,142305842,142306294,processed_pseudogene,-1,452,chr7_142305842_142306294
Gm5055,9,40487720,40488300,processed_pseudogene,1,580,chr9_40487720_40488300
Gm5060,X,154226501,154227099,processed_pseudogene,-1,598,chrX_154226501_154227099
Gm5063,16,44800674,44801649,processed_pseudogene,-1,975,chr16_44800674_44801649
Gm5064,18,28187110,28188817,processed_pseudogene,-1,1707,chr18_28187110_28188817
Gm5065,7,5350537,5360682,protein_coding,1,10145,chr7_5350537_5360682
Gm5066,9,88280369,88281190,processed_pseudogene,-1,821,chr9_88280369_88281190
Gm5067,5,26007027,26008035,processed_pseudogene,1,1008,chr5_26007027_26008035
Gm5069,1,180326970,180330550,transcribed_processed_pseudogene,-1,3580,chr1_180326970_180330550
Gm5070,3,95410346,95411207,processed_pseudogene,-1,861,chr3_95410346_95411207
Gm5075,3,107868022,107868643,processed_pseudogene,-1,621,chr3_107868022_107868643
Gm5080,10,71799105,71799847,processed_pseudogene,-1,742,chr10_71799105_71799847
Gm5083,13,44121167,44125179,lincRNA,1,4012,chr13_44121167_44125179
Gm5084,13,60205471,60216023,lincRNA,1,10552,chr13_60205471_60216023
Gm5086,13,97559971,97583996,lincRNA,1,24025,chr13_97559971_97583996
Gm5087,14,13157388,13284638,processed_transcript,-1,127250,chr14_13157388_13284638
Gm5089,14,122365239,122451115,antisense;processed_transcript,-1,85876,chr14_122365239_122451115
Gm5093,17,46439578,46440097,processed_pseudogene,-1,519,chr17_46439578_46440097
Gm5096,18,87756286,87758151,protein_coding,1,1865,chr18_87756286_87758151
Gm5100,1,39597417,39598005,processed_pseudogene,-1,588,chr1_39597417_39598005
Gm5103,3,51378024,51386324,lincRNA,1,8300,chr3_51378024_51386324
Gm5105,3,138048761,138067388,protein_coding,-1,18627,chr3_138048761_138067388
Gm5106,5,8773577,8798523,antisense,-1,24946,chr5_8773577_8798523
Gm5108,5,67941669,67977070,protein_coding,1,35401,chr5_67941669_67977070
Gm5111,6,48589445,48590584,processed_transcript,1,1139,chr6_48589445_48590584
Gm5113,7,30169875,30182324,transcribed_unprocessed_pseudogene,1,12449,chr7_30169875_30182324
Gm5117,8,31737208,31739760,processed_pseudogene,-1,2552,chr8_31737208_31739760
Gm5118,8,87093307,87100987,lincRNA,1,7680,chr8_87093307_87100987
Gm5120,9,26960146,26962559,processed_pseudogene,-1,2413,chr9_26960146_26962559
Gm5121,9,57334128,57334754,processed_pseudogene,1,626,chr9_57334128_57334754
Gm5122,9,61013481,61019797,lincRNA,1,6316,chr9_61013481_61019797
Gm5124,X,21360865,21364622,transcribed_processed_pseudogene,1,3757,chrX_21360865_21364622
Gm5129,5,29735334,29735936,antisense,-1,602,chr5_29735334_29735936
Gm5130,7,10745268,10746226,processed_pseudogene,1,958,chr7_10745268_10746226
Gm5131,8,97163793,97165030,processed_pseudogene,1,1237,chr8_97163793_97165030
Gm5134,10,75954514,76009591,protein_coding,1,55077,chr10_75954514_76009591
Gm5135,X,41923255,41923827,processed_pseudogene,-1,572,chrX_41923255_41923827
Gm5136,10,108698764,108700160,protein_coding,-1,1396,chr10_108698764_108700160
Gm5138,6,83874379,83875380,processed_pseudogene,-1,1001,chr6_83874379_83875380
Gm5139,3,64163390,64163638,processed_pseudogene,1,248,chr3_64163390_64163638
Gm5141,13,62772200,62785808,protein_coding,-1,13608,chr13_62772200_62785808
Gm5144,15,11906519,11907464,bidirectional_promoter_lncRNA,1,945,chr15_11906519_11907464
Gm5145,17,20570369,20571198,processed_pseudogene,1,829,chr17_20570369_20571198
Gm5147,1,55120080,55120873,processed_pseudogene,-1,793,chr1_55120080_55120873
Gm5148,3,37714190,37724490,protein_coding,-1,10300,chr3_37714190_37724490
Gm5149,3,149304829,149345840,lincRNA,1,41011,chr3_149304829_149345840
Gm5150,3,15946870,16032686,protein_coding,-1,85816,chr3_15946870_16032686
Gm5159,8,104701705,104708257,transcribed_unprocessed_pseudogene,-1,6552,chr8_104701705_104708257
Gm5160,18,14424868,14425303,processed_pseudogene,1,435,chr18_14424868_14425303
Gm5161,9,101448501,101449353,processed_pseudogene,-1,852,chr9_101448501_101449353
Gm5171,10,30780857,30782271,processed_pseudogene,-1,1414,chr10_30780857_30782271
Gm5173,10,81727923,81728872,processed_pseudogene,1,949,chr10_81727923_81728872
Gm5174,10,86655958,86657380,processed_pseudogene,1,1422,chr10_86655958_86657380
Gm5175,10,102819320,102838659,transcribed_processed_pseudogene,1,19339,chr10_102819320_102838659
Gm5176,10,111500739,111501965,transcribed_processed_pseudogene,1,1226,chr10_111500739_111501965
Gm5177,10,10605945,10616313,transcribed_processed_pseudogene,1,10368,chr10_10605945_10616313
Gm5178,10,16424173,16425070,processed_pseudogene,-1,897,chr10_16424173_16425070
Gm5181,10,130120239,130121209,processed_pseudogene,1,970,chr10_130120239_130121209
Gm5182,12,10152142,10158233,processed_pseudogene,1,6091,chr12_10152142_10158233
Gm5184,12,56189414,56191115,processed_pseudogene,1,1701,chr12_56189414_56191115
Gm5185,12,63072526,63073144,processed_pseudogene,-1,618,chr12_63072526_63073144
Gm5186,12,97564149,97565068,processed_pseudogene,-1,919,chr12_97564149_97565068
Gm5189,12,112751271,112751531,processed_pseudogene,-1,260,chr12_112751271_112751531
Gm5191,13,8128133,8129368,processed_pseudogene,1,1235,chr13_8128133_8129368
Gm5194,13,33596035,33596776,processed_pseudogene,-1,741,chr13_33596035_33596776
Gm5195,13,39757308,39757967,processed_pseudogene,1,659,chr13_39757308_39757967
Gm5197,13,80098222,80099418,processed_pseudogene,-1,1196,chr13_80098222_80099418
Gm5203,14,37722117,37722937,processed_pseudogene,1,820,chr14_37722117_37722937
Gm5205,14,40557238,40558240,processed_pseudogene,1,1002,chr14_40557238_40558240
Gm5206,14,45546408,45558330,transcribed_processed_pseudogene,-1,11922,chr14_45546408_45558330
Gm5207,14,95419786,95421363,processed_pseudogene,1,1577,chr14_95419786_95421363
Gm5209,14,113902027,113902746,processed_pseudogene,1,719,chr14_113902027_113902746
Gm5210,15,8917798,8929171,processed_pseudogene,-1,11373,chr15_8917798_8929171
Gm5212,15,30012294,30013065,processed_pseudogene,1,771,chr15_30012294_30013065
Gm5213,15,38238109,38238659,processed_pseudogene,1,550,chr15_38238109_38238659
Gm5215,15,54311961,54312365,processed_pseudogene,-1,404,chr15_54311961_54312365
Gm5216,15,70063061,70064669,processed_pseudogene,-1,1608,chr15_70063061_70064669
Gm5217,15,71309834,71311311,processed_pseudogene,1,1477,chr15_71309834_71311311
Gm5221,16,65793371,65794337,processed_pseudogene,1,966,chr16_65793371_65794337
Gm5223,17,16781621,16782887,processed_pseudogene,1,1266,chr17_16781621_16782887
Gm5224,17,22734963,22735380,processed_pseudogene,1,417,chr17_22734963_22735380
Gm5225,17,24023774,24024281,processed_pseudogene,1,507,chr17_24023774_24024281
Gm5229,17,78177590,78177947,processed_pseudogene,-1,357,chr17_78177590_78177947
Gm5230,17,79257410,79258049,processed_pseudogene,-1,639,chr17_79257410_79258049
Gm5231,17,85541625,85542703,processed_pseudogene,-1,1078,chr17_85541625_85542703
Gm5232,17,17500343,17500944,processed_pseudogene,1,601,chr17_17500343_17500944
Gm5234,18,87231932,87233793,processed_pseudogene,1,1861,chr18_87231932_87233793
Gm5236,18,47729767,47731112,processed_pseudogene,1,1345,chr18_47729767_47731112
Gm5237,18,48068322,48070022,processed_pseudogene,-1,1700,chr18_48068322_48070022
Gm5239,18,35536583,35536947,processed_pseudogene,1,364,chr18_35536583_35536947
Gm5240,18,13130675,13131561,processed_pseudogene,-1,886,chr18_13130675_13131561
Gm5242,19,5131740,5132972,processed_pseudogene,-1,1232,chr19_5131740_5132972
Gm5244,19,12846682,12847424,protein_coding,1,742,chr19_12846682_12847424
Gm5246,19,44851009,44851979,processed_pseudogene,1,970,chr19_44851009_44851979
Gm5248,19,35051962,35052677,processed_pseudogene,-1,715,chr19_35051962_35052677
Gm5249,19,25493837,25494563,processed_pseudogene,1,726,chr19_25493837_25494563
Gm5251,1,17394958,17395429,processed_pseudogene,1,471,chr1_17394958_17395429
Gm5252,1,18708428,18709336,processed_pseudogene,1,908,chr1_18708428_18709336
Gm5253,1,51317528,51318552,processed_pseudogene,-1,1024,chr1_51317528_51318552
Gm5254,1,57291425,57292401,processed_pseudogene,-1,976,chr1_57291425_57292401
Gm5256,1,71714048,71714924,processed_pseudogene,-1,876,chr1_71714048_71714924
Gm5257,1,75636390,75637179,processed_pseudogene,1,789,chr1_75636390_75637179
Gm5258,1,86323267,86323593,processed_pseudogene,1,326,chr1_86323267_86323593
Gm5259,1,89256182,89256981,processed_pseudogene,-1,799,chr1_89256182_89256981
Gm5260,1,104513001,104514068,processed_pseudogene,1,1067,chr1_104513001_104514068
Gm5262,1,145183894,145184889,processed_pseudogene,1,995,chr1_145183894_145184889
Gm5263,1,146420436,146421036,processed_pseudogene,1,600,chr1_146420436_146421036
Gm5264,1,95255963,95256810,processed_pseudogene,-1,847,chr1_95255963_95256810
Gm5265,1,169453528,169453869,processed_pseudogene,-1,341,chr1_169453528_169453869
Gm5266,1,34367371,34369003,processed_pseudogene,1,1632,chr1_34367371_34369003
Gm5267,1,42103289,42104333,processed_pseudogene,1,1044,chr1_42103289_42104333
Gm5268,1,45178067,45179006,processed_pseudogene,1,939,chr1_45178067_45179006
Gm527,12,64917906,64924592,protein_coding,1,6686,chr12_64917906_64924592
Gm5270,2,161254456,161255457,processed_pseudogene,-1,1001,chr2_161254456_161255457
Gm5272,3,6450607,6451588,processed_pseudogene,-1,981,chr3_6450607_6451588
Gm5274,3,47084732,47085734,processed_pseudogene,-1,1002,chr3_47084732_47085734
Gm5276,3,57362388,57363434,processed_pseudogene,1,1046,chr3_57362388_57363434
Gm5277,3,78891867,78892422,processed_pseudogene,-1,555,chr3_78891867_78892422
Gm5278,3,93433215,93433766,processed_pseudogene,-1,551,chr3_93433215_93433766
Gm5281,3,136049555,136051688,processed_pseudogene,-1,2133,chr3_136049555_136051688
Gm5283,3,17230642,17230975,processed_pseudogene,-1,333,chr3_17230642_17230975
Gm5284,3,90722611,90723513,processed_pseudogene,-1,902,chr3_90722611_90723513
Gm5288,5,11927622,11928740,processed_pseudogene,1,1118,chr5_11927622_11928740
Gm5291,5,39401347,39402245,processed_pseudogene,-1,898,chr5_39401347_39402245
Gm5292,5,43943903,43944482,processed_pseudogene,-1,579,chr5_43943903_43944482
Gm5297,5,72626858,72628028,transcribed_processed_pseudogene,-1,1170,chr5_72626858_72628028
Gm5298,5,41853310,41854201,processed_pseudogene,-1,891,chr5_41853310_41854201
Gm5300,6,13055595,13056597,processed_pseudogene,-1,1002,chr6_13055595_13056597
Gm5302,6,25046503,25047298,processed_pseudogene,-1,795,chr6_25046503_25047298
Gm5303,6,28361914,28363165,processed_pseudogene,-1,1251,chr6_28361914_28363165
Gm5311,6,79048116,79048824,processed_pseudogene,1,708,chr6_79048116_79048824
Gm5312,6,83841682,83842228,processed_pseudogene,1,546,chr6_83841682_83842228
Gm5313,6,93137004,93137990,processed_pseudogene,-1,986,chr6_93137004_93137990
Gm5314,6,99770657,99771122,processed_pseudogene,1,465,chr6_99770657_99771122
Gm5315,6,105063257,105065153,processed_pseudogene,-1,1896,chr6_105063257_105065153
Gm5317,6,123886396,123887242,processed_pseudogene,1,846,chr6_123886396_123887242
Gm5319,7,4176363,4177235,processed_pseudogene,-1,872,chr7_4176363_4177235
Gm5320,7,4909038,4910556,processed_pseudogene,1,1518,chr7_4909038_4910556
Gm5321,7,6019022,6019468,processed_pseudogene,1,446,chr7_6019022_6019468
Gm5322,7,18038476,18039174,processed_pseudogene,1,698,chr7_18038476_18039174
Gm5327,7,32545759,32546767,processed_pseudogene,1,1008,chr7_32545759_32546767
Gm5335,7,72989154,72990153,processed_pseudogene,-1,999,chr7_72989154_72990153
Gm5338,7,111386694,111387332,processed_pseudogene,-1,638,chr7_111386694_111387332
Gm5339,7,102568476,102569735,processed_pseudogene,-1,1259,chr7_102568476_102569735
Gm5340,7,3283159,3285474,processed_pseudogene,-1,2315,chr7_3283159_3285474
Gm5341,7,90107480,90107968,processed_pseudogene,-1,488,chr7_90107480_90107968
Gm5342,7,69209884,69210886,processed_pseudogene,1,1002,chr7_69209884_69210886
Gm5345,8,40853828,40855027,processed_pseudogene,-1,1199,chr8_40853828_40855027
Gm5350,8,63778051,63779052,processed_pseudogene,1,1001,chr8_63778051_63779052
Gm5353,8,76862256,76863048,processed_pseudogene,-1,792,chr8_76862256_76863048
Gm5354,8,81308177,81309149,processed_pseudogene,-1,972,chr8_81308177_81309149
Gm5356,8,89186946,89187560,processed_pseudogene,-1,614,chr8_89186946_89187560
Gm5357,8,116489186,116491109,processed_pseudogene,1,1923,chr8_116489186_116491109
Gm5358,8,127040348,127040700,processed_pseudogene,-1,352,chr8_127040348_127040700
Gm536,16,31617735,31638979,lincRNA,1,21244,chr16_31617735_31638979
Gm5362,9,3494379,3497463,processed_pseudogene,-1,3084,chr9_3494379_3497463
Gm5364,9,43683053,43683941,processed_pseudogene,1,888,chr9_43683053_43683941
Gm5366,9,75374611,75375948,processed_pseudogene,-1,1337,chr9_75374611_75375948
Gm5368,9,88145969,88146557,processed_pseudogene,1,588,chr9_88145969_88146557
Gm5370,9,94407553,94408126,processed_pseudogene,-1,573,chr9_94407553_94408126
Gm5371,9,97209044,97210880,processed_pseudogene,-1,1836,chr9_97209044_97210880
Gm5373,8,71824641,71857281,transcribed_unprocessed_pseudogene,-1,32640,chr8_71824641_71857281
Gm5374,13,13275135,13276085,transcribed_processed_pseudogene,1,950,chr13_13275135_13276085
Gm5380,X,13302285,13304420,processed_pseudogene,1,2135,chrX_13302285_13304420
Gm5381,X,13927287,13929511,processed_pseudogene,-1,2224,chrX_13927287_13929511
Gm5384,X,19893657,19894119,processed_pseudogene,1,462,chrX_19893657_19894119
Gm5385,X,41248575,41250133,processed_pseudogene,1,1558,chrX_41248575_41250133
Gm5386,X,45546931,45549380,processed_pseudogene,-1,2449,chrX_45546931_45549380
Gm5387,X,51043963,51044819,processed_pseudogene,1,856,chrX_51043963_51044819
Gm5388,X,51218877,51219993,processed_pseudogene,-1,1116,chrX_51218877_51219993
Gm5389,X,57659732,57660907,processed_pseudogene,1,1175,chrX_57659732_57660907
Gm5390,X,62135099,62136328,processed_pseudogene,-1,1229,chrX_62135099_62136328
Gm5391,X,68319638,68320250,processed_pseudogene,-1,612,chrX_68319638_68320250
Gm5392,X,107354879,107357447,processed_pseudogene,-1,2568,chrX_107354879_107357447
Gm5395,X,151655188,151656102,processed_pseudogene,1,914,chrX_151655188_151656102
Gm5396,X,153112923,153113454,processed_pseudogene,-1,531,chrX_153112923_153113454
Gm5397,X,76196108,76198742,unprocessed_pseudogene,1,2634,chrX_76196108_76198742
Gm5398,X,77289832,77290815,processed_pseudogene,-1,983,chrX_77289832_77290815
Gm5400,X,94311894,94312836,processed_pseudogene,1,942,chrX_94311894_94312836
Gm5402,X,94671503,94673120,processed_pseudogene,-1,1617,chrX_94671503_94673120
Gm5403,X,128058531,128061325,processed_pseudogene,-1,2794,chrX_128058531_128061325
Gm5405,16,32591301,32591909,processed_pseudogene,-1,608,chr16_32591301_32591909
Gm5406,16,45411580,45412345,processed_pseudogene,1,765,chr16_45411580_45412345
Gm5415,1,32543686,32547294,protein_coding,-1,3608,chr1_32543686_32547294
Gm5417,15,83405626,83406063,processed_pseudogene,-1,437,chr15_83405626_83406063
Gm5418,7,17618499,17619026,processed_pseudogene,1,527,chr7_17618499_17619026
Gm5419,X,161272237,161272840,processed_pseudogene,-1,603,chrX_161272237_161272840
Gm5421,10,22343439,22345792,processed_pseudogene,1,2353,chr10_22343439_22345792
Gm5422,10,31248023,31251043,transcribed_processed_pseudogene,1,3020,chr10_31248023_31251043
Gm5424,10,62071123,62072362,processed_pseudogene,1,1239,chr10_62071123_62072362
Gm5425,10,84308886,84309344,processed_pseudogene,1,458,chr10_84308886_84309344
Gm5426,10,96136603,96136914,protein_coding,1,311,chr10_96136603_96136914
Gm5430,17,25326612,25327526,processed_pseudogene,-1,914,chr17_25326612_25327526
Gm5434,12,36090379,36091829,transcribed_processed_pseudogene,1,1450,chr12_36090379_36091829
Gm5435,12,82495388,82496537,processed_pseudogene,-1,1149,chr12_82495388_82496537
Gm5436,12,84258331,84258973,processed_pseudogene,-1,642,chr12_84258331_84258973
Gm5441,12,117234521,117337022,antisense,-1,102501,chr12_117234521_117337022
Gm5442,12,88085311,88087404,processed_pseudogene,1,2093,chr12_88085311_88087404
Gm5445,13,12378158,12378637,processed_pseudogene,1,479,chr13_12378158_12378637
Gm5446,13,19995021,19995804,processed_pseudogene,-1,783,chr13_19995021_19995804
Gm5449,13,53525703,53526059,processed_pseudogene,1,356,chr13_53525703_53526059
Gm5452,13,83832340,83833336,processed_pseudogene,1,996,chr13_83832340_83833336
Gm5454,13,103356252,103357704,processed_pseudogene,1,1452,chr13_103356252_103357704
Gm5455,13,110304777,110305491,processed_pseudogene,-1,714,chr13_110304777_110305491
Gm5456,14,7241442,7242285,processed_pseudogene,1,843,chr14_7241442_7242285
Gm5457,14,12867553,12867885,processed_pseudogene,1,332,chr14_12867553_12867885
Gm5458,14,19594139,19602581,protein_coding,-1,8442,chr14_19594139_19602581
Gm5460,14,34016758,34048193,protein_coding,1,31435,chr14_34016758_34048193
Gm5461,14,61324852,61325810,processed_pseudogene,-1,958,chr14_61324852_61325810
Gm5464,14,66868850,66871723,lincRNA,1,2873,chr14_66868850_66871723
Gm5466,2,181896823,181898712,processed_pseudogene,1,1889,chr2_181896823_181898712
Gm5468,15,25414192,25414873,lincRNA,1,681,chr15_25414192_25414873
Gm5469,15,41922076,41923151,processed_pseudogene,1,1075,chr15_41922076_41923151
Gm5470,15,42031319,42032742,processed_pseudogene,-1,1423,chr15_42031319_42032742
Gm5471,15,44971797,44972133,processed_pseudogene,-1,336,chr15_44971797_44972133
Gm5472,15,45978360,45980037,processed_pseudogene,-1,1677,chr15_45978360_45980037
Gm5473,15,63631697,63632338,processed_pseudogene,1,641,chr15_63631697_63632338
Gm5475,15,100422147,100428150,protein_coding,1,6003,chr15_100422147_100428150
Gm5479,17,3056687,3057121,processed_pseudogene,1,434,chr17_3056687_3057121
Gm5481,16,16275603,16275947,processed_pseudogene,1,344,chr16_16275603_16275947
Gm5487,16,53983928,53986084,processed_pseudogene,1,2156,chr16_53983928_53986084
Gm5491,17,8384053,8384660,processed_pseudogene,-1,607,chr17_8384053_8384660
Gm5492,17,20661558,20662067,processed_pseudogene,1,509,chr17_20661558_20662067
Gm5497,17,63570903,63571248,processed_pseudogene,1,345,chr17_63570903_63571248
Gm5499,17,87078271,87079155,processed_pseudogene,1,884,chr17_87078271_87079155
Gm550,19,6094419,6098241,protein_coding,1,3822,chr19_6094419_6098241
Gm5500,18,8415129,8416047,processed_pseudogene,1,918,chr18_8415129_8416047
Gm5503,18,33384398,33384955,processed_pseudogene,-1,557,chr18_33384398_33384955
Gm5504,18,42200743,42201347,processed_pseudogene,1,604,chr18_42200743_42201347
Gm5507,18,53984321,53985328,processed_pseudogene,1,1007,chr18_53984321_53985328
Gm5509,18,79934332,79935561,processed_pseudogene,1,1229,chr18_79934332_79935561
Gm5510,19,6152715,6153200,processed_pseudogene,1,485,chr19_6152715_6153200
Gm5511,19,11438031,11438832,processed_pseudogene,1,801,chr19_11438031_11438832
Gm5512,19,12905320,12906841,transcribed_unprocessed_pseudogene,1,1521,chr19_12905320_12906841
Gm5513,19,14959549,14960766,processed_pseudogene,-1,1217,chr19_14959549_14960766
Gm5517,19,28033464,28033941,processed_pseudogene,1,477,chr19_28033464_28033941
Gm5518,19,29160118,29160762,processed_pseudogene,1,644,chr19_29160118_29160762
Gm5519,19,33822908,33825068,processed_pseudogene,1,2160,chr19_33822908_33825068
Gm5521,19,61167249,61168049,processed_pseudogene,1,800,chr19_61167249_61168049
Gm5523,1,13785883,13786879,processed_pseudogene,-1,996,chr1_13785883_13786879
Gm5524,1,27884046,27902396,lincRNA,1,18350,chr1_27884046_27902396
Gm5525,1,29484604,29485915,processed_pseudogene,-1,1311,chr1_29484604_29485915
Gm5526,1,45857332,45857754,processed_pseudogene,-1,422,chr1_45857332_45857754
Gm5527,1,52584518,52585159,processed_pseudogene,1,641,chr1_52584518_52585159
Gm5528,1,72004288,72004767,processed_pseudogene,1,479,chr1_72004288_72004767
Gm5529,1,79922536,79923426,processed_pseudogene,-1,890,chr1_79922536_79923426
Gm553,1,52522902,52582679,lincRNA,1,59777,chr1_52522902_52582679
Gm5530,1,81741985,81742969,processed_pseudogene,-1,984,chr1_81741985_81742969
Gm5532,1,155520173,155527143,lincRNA,-1,6970,chr1_155520173_155527143
Gm5535,2,144098815,144207990,lincRNA,-1,109175,chr2_144098815_144207990
Gm5537,3,58102996,58104247,processed_pseudogene,-1,1251,chr3_58102996_58104247
Gm5539,3,59767275,59768240,processed_pseudogene,1,965,chr3_59767275_59768240
Gm5540,3,65393337,65395184,processed_pseudogene,1,1847,chr3_65393337_65395184
Gm5544,3,97930173,97967018,lincRNA,1,36845,chr3_97930173_97967018
Gm5546,3,104350635,104366613,lincRNA,-1,15978,chr3_104350635_104366613
Gm5550,3,157816720,157817795,processed_pseudogene,-1,1075,chr3_157816720_157817795
Gm5551,5,27860449,27861138,processed_pseudogene,1,689,chr5_27860449_27861138
Gm5554,5,42963404,42964609,processed_pseudogene,-1,1205,chr5_42963404_42964609
Gm5555,5,49552158,49553268,processed_pseudogene,1,1110,chr5_49552158_49553268
Gm5558,5,91806579,91807073,processed_pseudogene,-1,494,chr5_91806579_91807073
Gm5559,5,95861714,95862715,processed_pseudogene,1,1001,chr5_95861714_95862715
Gm5560,5,97264828,97265719,processed_pseudogene,1,891,chr5_97264828_97265719
Gm5561,1,179520378,179520857,processed_pseudogene,-1,479,chr1_179520378_179520857
Gm5564,5,138504813,138505779,processed_pseudogene,1,966,chr5_138504813_138505779
Gm5566,5,149660765,149661223,processed_pseudogene,-1,458,chr5_149660765_149661223
Gm5570,6,60031967,60150045,lincRNA,1,118078,chr6_60031967_60150045
Gm5575,5,24209327,24209724,processed_pseudogene,-1,397,chr5_24209327_24209724
Gm5576,6,78215878,78217113,processed_pseudogene,1,1235,chr6_78215878_78217113
Gm5577,6,87980883,88005471,antisense,1,24588,chr6_87980883_88005471
Gm5578,6,112605544,112606779,processed_pseudogene,1,1235,chr6_112605544_112606779
Gm5582,6,131253528,131254049,processed_pseudogene,-1,521,chr6_131253528_131254049
Gm5586,7,16719116,16719910,processed_pseudogene,-1,794,chr7_16719116_16719910
Gm5587,7,25419153,25419826,processed_pseudogene,-1,673,chr7_25419153_25419826
Gm5590,7,39445830,39449221,transcribed_processed_pseudogene,-1,3391,chr7_39445830_39449221
Gm5596,7,57878806,57881226,processed_pseudogene,-1,2420,chr7_57878806_57881226
Gm5597,7,76244746,76245938,processed_pseudogene,-1,1192,chr7_76244746_76245938
Gm5599,7,112972096,112972883,processed_pseudogene,-1,787,chr7_112972096_112972883
Gm5602,7,130861285,130866330,antisense,-1,5045,chr7_130861285_130866330
Gm5605,8,5117361,5118665,processed_pseudogene,1,1304,chr8_5117361_5118665
Gm5609,8,39455910,39457176,processed_pseudogene,1,1266,chr8_39455910_39457176
Gm5611,9,17030045,17030896,processed_pseudogene,1,851,chr9_17030045_17030896
Gm5612,9,18427543,18427917,processed_pseudogene,1,374,chr9_18427543_18427917
Gm5614,9,35281518,35281835,processed_pseudogene,-1,317,chr9_35281518_35281835
Gm5616,9,48450400,48450783,processed_pseudogene,1,383,chr9_48450400_48450783
Gm5617,9,48495442,48495972,protein_coding,1,530,chr9_48495442_48495972
Gm5619,9,85781868,85782627,processed_pseudogene,-1,759,chr9_85781868_85782627
Gm5620,9,91097149,91098496,processed_pseudogene,1,1347,chr9_91097149_91098496
Gm5621,9,105560122,105560761,processed_pseudogene,-1,639,chr9_105560122_105560761
Gm5622,14,51552790,51662953,protein_coding,1,110163,chr14_51552790_51662953
Gm5628,13,17949908,17950956,processed_pseudogene,1,1048,chr13_17949908_17950956
Gm5630,14,19350748,19351647,processed_pseudogene,-1,899,chr14_19350748_19351647
Gm5637,X,60045111,60046229,processed_pseudogene,-1,1118,chrX_60045111_60046229
Gm5638,X,68629428,68630685,processed_pseudogene,1,1257,chrX_68629428_68630685
Gm5641,3,54481438,54482925,transcribed_processed_pseudogene,1,1487,chr3_54481438_54482925
Gm5643,X,142297565,142298530,processed_pseudogene,1,965,chrX_142297565_142298530
Gm5644,X,145601837,145602301,processed_pseudogene,-1,464,chrX_145601837_145602301
Gm5650,7,138062006,138062603,processed_pseudogene,1,597,chr7_138062006_138062603
Gm5652,12,5589617,5590624,processed_pseudogene,-1,1007,chr12_5589617_5590624
Gm5654,12,79939165,79939639,processed_pseudogene,-1,474,chr12_79939165_79939639
Gm5655,12,88359357,88360257,processed_pseudogene,-1,900,chr12_88359357_88360257
Gm5656,12,103699528,103704619,unprocessed_pseudogene,-1,5091,chr12_103699528_103704619
Gm5666,13,85572976,85573578,processed_pseudogene,-1,602,chr13_85572976_85573578
Gm5667,13,88547216,88548270,processed_pseudogene,1,1054,chr13_88547216_88548270
Gm567,3,137289639,137300708,lincRNA,1,11069,chr3_137289639_137300708
Gm5671,14,105043450,105044354,processed_pseudogene,1,904,chr14_105043450_105044354
Gm5673,15,56782642,56783428,processed_pseudogene,-1,786,chr15_56782642_56783428
Gm5674,16,57768778,57769248,processed_pseudogene,-1,470,chr16_57768778_57769248
Gm5678,16,93628097,93630451,protein_coding,1,2354,chr16_93628097_93630451
Gm5679,17,3097018,3098165,processed_pseudogene,1,1147,chr17_3097018_3098165
Gm5682,17,36210276,36211184,unprocessed_pseudogene,-1,908,chr17_36210276_36211184
Gm5684,17,54002372,54003332,processed_pseudogene,1,960,chr17_54002372_54003332
Gm5686,18,10262207,10263285,processed_pseudogene,1,1078,chr18_10262207_10263285
Gm5687,18,12898427,12899066,processed_pseudogene,1,639,chr18_12898427_12899066
Gm5688,18,20499315,20500587,processed_pseudogene,1,1272,chr18_20499315_20500587
Gm5690,18,74240890,74241524,processed_pseudogene,1,634,chr18_74240890_74241524
Gm5691,18,86914648,86915568,processed_pseudogene,1,920,chr18_86914648_86915568
Gm5693,19,40282277,40282697,processed_pseudogene,1,420,chr19_40282277_40282697
Gm5694,1,7035915,7037217,processed_pseudogene,1,1302,chr1_7035915_7037217
Gm5696,1,22030064,22030615,processed_pseudogene,-1,551,chr1_22030064_22030615
Gm5697,1,28800240,28802721,processed_pseudogene,-1,2481,chr1_28800240_28802721
Gm5702,1,108376970,108379438,processed_pseudogene,-1,2468,chr1_108376970_108379438
Gm5703,1,148975522,148979494,processed_pseudogene,1,3972,chr1_148975522_148979494
Gm5706,1,182392543,182393535,processed_pseudogene,-1,992,chr1_182392543_182393535
Gm5708,3,34183307,34184192,processed_pseudogene,1,885,chr3_34183307_34184192
Gm5710,3,121180103,121181097,processed_pseudogene,-1,994,chr3_121180103_121181097
Gm5714,5,6748892,6749457,processed_pseudogene,-1,565,chr5_6748892_6749457
Gm5717,5,87162279,87175290,unprocessed_pseudogene,-1,13011,chr5_87162279_87175290
Gm572,4,148643317,148671572,protein_coding,1,28255,chr4_148643317_148671572
Gm5723,6,95250301,95254515,processed_pseudogene,1,4214,chr6_95250301_95254515
Gm5732,7,33402819,33403825,processed_pseudogene,1,1006,chr7_33402819_33403825
Gm5735,7,101061309,101061475,processed_pseudogene,-1,166,chr7_101061309_101061475
Gm5737,7,120812365,120831193,protein_coding,1,18828,chr7_120812365_120831193
Gm5738,7,128016442,128017220,processed_pseudogene,-1,778,chr7_128016442_128017220
Gm5741,8,85067568,85067982,protein_coding,-1,414,chr8_85067568_85067982
Gm5742,8,100060116,100060620,processed_pseudogene,1,504,chr8_100060116_100060620
Gm5743,8,104984464,104996811,transcribed_unprocessed_pseudogene,1,12347,chr8_104984464_104996811
Gm5745,9,73175429,73175741,processed_pseudogene,-1,312,chr9_73175429_73175741
Gm5746,9,77097191,77099390,processed_pseudogene,1,2199,chr9_77097191_77099390
Gm5749,8,40748003,40749092,processed_pseudogene,-1,1089,chr8_40748003_40749092
Gm5750,10,61959624,61960424,processed_pseudogene,1,800,chr10_61959624_61960424
Gm5751,X,8874253,8880750,protein_coding,1,6497,chrX_8874253_8880750
Gm5754,X,10011788,10012679,processed_pseudogene,1,891,chrX_10011788_10012679
Gm5757,X,77292661,77293188,processed_pseudogene,1,527,chrX_77292661_77293188
Gm5760,X,99081401,99082402,processed_pseudogene,-1,1001,chrX_99081401_99082402
Gm5761,X,137103889,137104722,processed_pseudogene,-1,833,chrX_137103889_137104722
Gm5763,X,142631483,142634015,processed_pseudogene,-1,2532,chrX_142631483_142634015
Gm5764,X,158833435,158834319,processed_pseudogene,1,884,chrX_158833435_158834319
Gm5766,16,4229230,4231206,transcribed_processed_pseudogene,1,1976,chr16_4229230_4231206
Gm5767,16,8680770,8683911,protein_coding,1,3141,chr16_8680770_8683911
Gm5768,16,16852315,16853857,processed_pseudogene,1,1542,chr16_16852315_16853857
Gm5776,7,54412158,54412478,processed_pseudogene,-1,320,chr7_54412158_54412478
Gm5777,10,57782354,57782801,processed_pseudogene,1,447,chr10_57782354_57782801
Gm5778,10,73201695,73202766,processed_pseudogene,1,1071,chr10_73201695_73202766
Gm5779,10,75344472,75353033,transcribed_processed_pseudogene,1,8561,chr10_75344472_75353033
Gm5780,10,90132984,90134817,processed_pseudogene,-1,1833,chr10_90132984_90134817
Gm5781,10,116972766,116973208,processed_pseudogene,-1,442,chr10_116972766_116973208
Gm5784,12,19387809,19433081,lincRNA,1,45272,chr12_19387809_19433081
Gm5786,12,59081019,59081900,processed_pseudogene,1,881,chr12_59081019_59081900
Gm5787,8,36372596,36373633,processed_pseudogene,-1,1037,chr8_36372596_36373633
Gm5790,13,47009533,47010945,processed_pseudogene,-1,1412,chr13_47009533_47010945
Gm5791,13,64624272,64624760,processed_pseudogene,-1,488,chr13_64624272_64624760
Gm5793,X,76538909,76539538,unprocessed_pseudogene,-1,629,chrX_76538909_76539538
Gm5796,14,4023941,4041370,protein_coding,1,17429,chr14_4023941_4041370
Gm5801,14,56010536,56011315,processed_pseudogene,-1,779,chr14_56010536_56011315
Gm5802,14,62540493,62541193,processed_pseudogene,-1,700,chr14_62540493_62541193
Gm5808,15,99555542,99556192,processed_pseudogene,-1,650,chr15_99555542_99556192
Gm5809,16,22230391,22230919,processed_pseudogene,1,528,chr16_22230391_22230919
Gm5814,17,47410362,47410737,processed_pseudogene,1,375,chr17_47410362_47410737
Gm5815,17,58593614,58594840,processed_pseudogene,1,1226,chr17_58593614_58594840
Gm5820,18,38892458,38971276,lincRNA,1,78818,chr18_38892458_38971276
Gm5821,18,54766132,54766380,processed_pseudogene,1,248,chr18_54766132_54766380
Gm5822,19,28862330,28863707,processed_pseudogene,-1,1377,chr19_28862330_28863707
Gm5823,18,79959006,79959539,processed_pseudogene,1,533,chr18_79959006_79959539
Gm5824,18,85847280,85848729,processed_pseudogene,-1,1449,chr18_85847280_85848729
Gm5826,18,87474188,87474671,processed_pseudogene,-1,483,chr18_87474188_87474671
Gm5827,19,40191038,40194370,processed_pseudogene,1,3332,chr19_40191038_40194370
Gm5828,1,16768279,16770138,processed_pseudogene,-1,1859,chr1_16768279_16770138
Gm5829,1,71709705,71710055,processed_pseudogene,-1,350,chr1_71709705_71710055
Gm5830,1,78967637,78968079,processed_pseudogene,-1,442,chr1_78967637_78968079
Gm5832,1,88022381,88023962,processed_pseudogene,1,1581,chr1_88022381_88023962
Gm5833,1,138640095,138682077,lincRNA,-1,41982,chr1_138640095_138682077
Gm5835,1,143093347,143094616,processed_pseudogene,-1,1269,chr1_143093347_143094616
Gm5836,17,25705049,25705822,processed_pseudogene,1,773,chr17_25705049_25705822
Gm5839,18,48626704,48627710,processed_pseudogene,1,1006,chr18_48626704_48627710
Gm5841,3,8327531,8329707,processed_pseudogene,1,2176,chr3_8327531_8329707
Gm5842,3,22080494,22081115,processed_pseudogene,-1,621,chr3_22080494_22081115
Gm5843,3,14722416,14729626,unprocessed_pseudogene,1,7210,chr3_14722416_14729626
Gm5844,3,18008806,18010996,processed_pseudogene,1,2190,chr3_18008806_18010996
Gm5845,3,33621608,33622403,processed_pseudogene,1,795,chr3_33621608_33622403
Gm5846,3,49381333,49382746,processed_pseudogene,-1,1413,chr3_49381333_49382746
Gm5847,3,65613589,65615183,processed_pseudogene,1,1594,chr3_65613589_65615183
Gm5852,3,93727026,93728046,unprocessed_pseudogene,-1,1020,chr3_93727026_93728046
Gm5853,3,98579767,98580398,processed_pseudogene,-1,631,chr3_98579767_98580398
Gm5854,14,101981991,101982763,processed_pseudogene,-1,772,chr14_101981991_101982763
Gm5855,3,130929366,130930670,processed_pseudogene,-1,1304,chr3_130929366_130930670
Gm5860,4,82065431,82102808,lincRNA,1,37377,chr4_82065431_82102808
Gm5863,X,120160710,120161717,processed_pseudogene,1,1007,chrX_120160710_120161717
Gm5864,5,32420003,32420972,processed_pseudogene,1,969,chr5_32420003_32420972
Gm5865,5,44405957,44406593,processed_pseudogene,-1,636,chr5_44405957_44406593
Gm5866,5,52582074,52583046,processed_pseudogene,1,972,chr5_52582074_52583046
Gm5867,5,69461152,69461743,processed_pseudogene,1,591,chr5_69461152_69461743
Gm5869,5,86997159,86998415,processed_pseudogene,1,1256,chr5_86997159_86998415
Gm5870,5,104989050,104989331,processed_pseudogene,-1,281,chr5_104989050_104989331
Gm5871,5,109016198,109016915,processed_pseudogene,-1,717,chr5_109016198_109016915
Gm5873,6,6735427,6736492,processed_pseudogene,-1,1065,chr6_6735427_6736492
Gm5874,6,18824552,18825059,processed_pseudogene,1,507,chr6_18824552_18825059
Gm5876,6,65995637,65996330,processed_pseudogene,1,693,chr6_65995637_65996330
Gm5878,6,85111416,85126125,lincRNA,-1,14709,chr6_85111416_85126125
Gm5879,6,87764996,87766204,processed_pseudogene,-1,1208,chr6_87764996_87766204
Gm5881,6,96033003,96033369,processed_pseudogene,-1,366,chr6_96033003_96033369
Gm5883,6,123218953,123219447,processed_pseudogene,-1,494,chr6_123218953_123219447
Gm5884,6,128644913,128646391,processed_pseudogene,1,1478,chr6_128644913_128646391
Gm5896,7,41191113,41192136,processed_pseudogene,1,1023,chr7_41191113_41192136
Gm5898,7,63542479,63544549,processed_pseudogene,1,2070,chr7_63542479_63544549
Gm5899,7,94197210,94197479,processed_pseudogene,1,269,chr7_94197210_94197479
Gm5900,7,104949915,104950289,processed_pseudogene,-1,374,chr7_104949915_104950289
Gm5903,7,130352038,130354362,processed_pseudogene,-1,2324,chr7_130352038_130354362
Gm5904,7,136657209,136658073,processed_pseudogene,1,864,chr7_136657209_136658073
Gm5905,7,141177885,141178464,processed_pseudogene,-1,579,chr7_141177885_141178464
Gm5909,8,80110806,80112086,processed_pseudogene,-1,1280,chr8_80110806_80112086
Gm5910,8,83477471,83479216,processed_pseudogene,-1,1745,chr8_83477471_83479216
Gm5912,8,95577471,95578908,processed_pseudogene,1,1437,chr8_95577471_95578908
Gm5913,8,97427712,97429110,processed_pseudogene,-1,1398,chr8_97427712_97429110
Gm5914,8,105624336,105637485,lincRNA,-1,13149,chr8_105624336_105637485
Gm5916,9,36119934,36128779,protein_coding,-1,8845,chr9_36119934_36128779
Gm5917,9,55518569,55519289,processed_pseudogene,1,720,chr9_55518569_55519289
Gm5920,9,98873064,98873916,processed_pseudogene,-1,852,chr9_98873064_98873916
Gm5921,9,115437700,115438581,processed_pseudogene,-1,881,chr9_115437700_115438581
Gm5922,9,120133463,120136329,lincRNA,-1,2866,chr9_120133463_120136329
Gm5931,X,10660522,10660998,processed_pseudogene,1,476,chrX_10660522_10660998
Gm5937,X,77456586,77457228,processed_pseudogene,1,642,chrX_77456586_77457228
Gm5939,X,78855408,78858281,processed_pseudogene,-1,2873,chrX_78855408_78858281
Gm5940,X,80456742,80457809,processed_pseudogene,1,1067,chrX_80456742_80457809
Gm5943,X,114989150,114989608,processed_pseudogene,1,458,chrX_114989150_114989608
Gm5944,X,115458894,115459894,processed_pseudogene,-1,1000,chrX_115458894_115459894
Gm5946,X,150220716,150226021,transcribed_processed_pseudogene,-1,5305,chrX_150220716_150226021
Gm5950,10,44589928,44592573,processed_pseudogene,1,2645,chr10_44589928_44592573
Gm5951,10,78543276,78543779,processed_pseudogene,1,503,chr10_78543276_78543779
Gm5958,14,99835518,99835814,processed_pseudogene,-1,296,chr14_99835518_99835814
Gm5960,15,75071112,75074638,unprocessed_pseudogene,1,3526,chr15_75071112_75074638
Gm5964,16,44848374,44849796,processed_pseudogene,-1,1422,chr16_44848374_44849796
Gm5966,17,17920269,17921312,processed_pseudogene;unprocessed_pseudogene,1,1043,chr17_17920269_17921312
Gm5967,17,37947192,37947685,processed_pseudogene,1,493,chr17_37947192_37947685
Gm5969,18,32140730,32141852,processed_pseudogene,1,1122,chr18_32140730_32141852
Gm5971,18,86925964,86926918,processed_pseudogene,-1,954,chr18_86925964_86926918
Gm5973,1,40863737,40864232,processed_pseudogene,-1,495,chr1_40863737_40864232
Gm5974,1,48313866,48314851,processed_pseudogene,-1,985,chr1_48313866_48314851
Gm5976,1,52503234,52504229,processed_pseudogene,-1,995,chr1_52503234_52504229
Gm5977,12,21042959,21048327,transcribed_unprocessed_pseudogene,1,5368,chr12_21042959_21048327
Gm5979,3,88474584,88475154,unprocessed_pseudogene,1,570,chr3_88474584_88475154
Gm5981,3,122632785,122633271,processed_pseudogene,-1,486,chr3_122632785_122633271
Gm5982,3,130846462,130846973,processed_pseudogene,-1,511,chr3_130846462_130846973
Gm5983,3,157410017,157410786,processed_pseudogene,1,769,chr3_157410017_157410786
Gm5987,5,106215651,106216801,processed_pseudogene,1,1150,chr5_106215651_106216801
Gm5990,6,43766565,43767310,processed_pseudogene,-1,745,chr6_43766565_43767310
Gm5995,6,76121627,76122899,processed_pseudogene,1,1272,chr6_76121627_76122899
Gm5996,7,11248404,11249121,processed_pseudogene,-1,717,chr7_11248404_11249121
Gm5997,7,18375547,18377523,processed_pseudogene,-1,1976,chr7_18375547_18377523
Gm6004,7,42750414,42751858,processed_pseudogene,1,1444,chr7_42750414_42751858
Gm6007,7,108269529,108270351,processed_pseudogene,1,822,chr7_108269529_108270351
Gm6008,7,116803626,116804499,processed_pseudogene,-1,873,chr7_116803626_116804499
Gm6011,8,43722269,43724064,processed_pseudogene,-1,1795,chr8_43722269_43724064
Gm6012,8,57520157,57520886,processed_pseudogene,-1,729,chr8_57520157_57520886
Gm6013,8,95674696,95675394,processed_pseudogene,-1,698,chr8_95674696_95675394
Gm6015,9,5861647,5865418,processed_pseudogene,1,3771,chr9_5861647_5865418
Gm6018,9,71598835,71600140,processed_pseudogene,-1,1305,chr9_71598835_71600140
Gm6020,19,61183890,61183955,protein_coding,1,65,chr19_61183890_61183955
Gm6023,X,36213524,36214129,processed_pseudogene,-1,605,chrX_36213524_36214129
Gm6028,1,111880735,111881308,processed_pseudogene,-1,573,chr1_111880735_111881308
Gm6029,16,30139459,30139829,processed_pseudogene,1,370,chr16_30139459_30139829
Gm6030,16,45205100,45205489,processed_pseudogene,1,389,chr16_45205100_45205489
Gm6031,16,15426151,15427204,processed_pseudogene,1,1053,chr16_15426151_15427204
Gm6032,16,84513051,84514188,processed_pseudogene,-1,1137,chr16_84513051_84514188
Gm6034,17,36042961,36058645,protein_coding,1,15684,chr17_36042961_36058645
Gm6035,13,115528556,115529772,processed_pseudogene,-1,1216,chr13_115528556_115529772
Gm6039,X,75233063,75234312,processed_pseudogene,1,1249,chrX_75233063_75234312
Gm6043,14,29217639,29218130,processed_pseudogene,1,491,chr14_29217639_29218130
Gm6044,5,64320256,64320754,processed_pseudogene,1,498,chr5_64320256_64320754
Gm6047,14,51825720,51826293,transcribed_processed_pseudogene,1,573,chr14_51825720_51826293
Gm6051,5,76060412,76060763,processed_pseudogene,-1,351,chr5_76060412_76060763
Gm6052,18,34046826,34047291,processed_pseudogene,1,465,chr18_34046826_34047291
Gm6054,5,147408982,147409359,processed_pseudogene,1,377,chr5_147408982_147409359
Gm6055,14,48079375,48079752,processed_pseudogene,-1,377,chr14_48079375_48079752
Gm6056,13,51338921,51339707,processed_pseudogene,1,786,chr13_51338921_51339707
Gm6057,3,138604318,138604984,processed_pseudogene,-1,666,chr3_138604318_138604984
Gm6058,1,157383931,157384329,processed_pseudogene,-1,398,chr1_157383931_157384329
Gm6059,3,142184412,142184751,processed_pseudogene,-1,339,chr3_142184412_142184751
Gm6060,1,15760122,15760668,processed_pseudogene,-1,546,chr1_15760122_15760668
Gm6061,3,122256728,122257219,transcribed_processed_pseudogene,1,491,chr3_122256728_122257219
Gm6062,X,70978281,70978911,processed_pseudogene,1,630,chrX_70978281_70978911
Gm6063,6,71641612,71642096,processed_pseudogene,-1,484,chr6_71641612_71642096
Gm6064,6,107093662,107094115,processed_pseudogene,-1,453,chr6_107093662_107094115
Gm6065,7,17792574,17793065,processed_pseudogene,1,491,chr7_17792574_17793065
Gm6066,14,60441979,60442453,processed_pseudogene,1,474,chr14_60441979_60442453
Gm6067,X,142405951,142406441,processed_pseudogene,-1,490,chrX_142405951_142406441
Gm6068,12,60547743,60548238,processed_pseudogene,-1,495,chr12_60547743_60548238
Gm6069,3,41485733,41486195,processed_pseudogene,1,462,chr3_41485733_41486195
Gm6070,8,4465589,4466007,processed_pseudogene,1,418,chr8_4465589_4466007
Gm6071,X,22305800,22306274,processed_pseudogene,-1,474,chrX_22305800_22306274
Gm6072,6,78496946,78497441,processed_pseudogene,-1,495,chr6_78496946_78497441
Gm6074,3,147192468,147192918,processed_pseudogene,-1,450,chr3_147192468_147192918
Gm6075,1,17429043,17429528,processed_pseudogene,-1,485,chr1_17429043_17429528
Gm6076,14,62514848,62515295,processed_pseudogene,-1,447,chr14_62514848_62515295
Gm6077,3,134365606,134366104,processed_pseudogene,-1,498,chr3_134365606_134366104
Gm6079,X,7686951,7687354,processed_pseudogene,1,403,chrX_7686951_7687354
Gm6083,5,29538153,29538509,processed_pseudogene,1,356,chr5_29538153_29538509
Gm6085,1,4687934,4689403,processed_pseudogene,-1,1469,chr1_4687934_4689403
Gm6087,14,119278424,119279086,processed_pseudogene,1,662,chr14_119278424_119279086
Gm6088,X,140797396,140799934,processed_pseudogene,1,2538,chrX_140797396_140799934
Gm6089,5,26070537,26071474,processed_pseudogene,1,937,chr5_26070537_26071474
Gm6091,8,126476248,126476412,processed_pseudogene,-1,164,chr8_126476248_126476412
Gm6093,13,33562486,33569317,lincRNA,-1,6831,chr13_33562486_33569317
Gm6100,8,34307285,34307687,processed_pseudogene,-1,402,chr8_34307285_34307687
Gm6101,1,4256234,4260519,processed_pseudogene,-1,4285,chr1_4256234_4260519
Gm6104,1,4880049,4880651,processed_pseudogene,-1,602,chr1_4880049_4880651
Gm6108,7,130766953,130767319,processed_pseudogene,1,366,chr7_130766953_130767319
Gm6109,13,93448488,93448835,processed_pseudogene,1,347,chr13_93448488_93448835
Gm6112,7,82966589,82967217,processed_pseudogene,-1,628,chr7_82966589_82967217
Gm6114,13,101013019,101013986,processed_pseudogene,-1,967,chr13_101013019_101013986
Gm6119,1,4692219,4693424,processed_pseudogene,-1,1205,chr1_4692219_4693424
Gm6123,1,4771131,4772199,processed_pseudogene,1,1068,chr1_4771131_4772199
Gm6125,12,44619191,44622662,processed_pseudogene,-1,3471,chr12_44619191_44622662
Gm6128,14,20856014,20856421,processed_pseudogene,-1,407,chr14_20856014_20856421
Gm6129,13,34393724,34394524,processed_pseudogene,-1,800,chr13_34393724_34394524
Gm6133,18,78349754,78350701,protein_coding,1,947,chr18_78349754_78350701
Gm6134,6,112976213,112976383,processed_pseudogene,1,170,chr6_112976213_112976383
Gm6136,1,86908793,86909683,processed_pseudogene,-1,890,chr1_86908793_86909683
Gm6140,3,4890266,4891231,processed_pseudogene,-1,965,chr3_4890266_4891231
Gm6141,3,19584791,19585538,processed_pseudogene,1,747,chr3_19584791_19585538
Gm6142,16,4320356,4320680,processed_pseudogene,-1,324,chr16_4320356_4320680
Gm6149,17,58579030,58579967,processed_pseudogene,-1,937,chr17_58579030_58579967
Gm6150,10,9683908,9691906,transcribed_processed_pseudogene,1,7998,chr10_9683908_9691906
Gm6153,1,87543635,87544692,processed_pseudogene,-1,1057,chr1_87543635_87544692
Gm6155,7,84834539,84834879,processed_pseudogene,-1,340,chr7_84834539_84834879
Gm6158,14,24069734,24070637,processed_pseudogene,1,903,chr14_24069734_24070637
Gm6159,1,78783136,78784859,processed_pseudogene,-1,1723,chr1_78783136_78784859
Gm6161,1,9574548,9575649,processed_pseudogene,1,1101,chr1_9574548_9575649
Gm6162,3,6164895,6167824,processed_pseudogene,-1,2929,chr3_6164895_6167824
Gm6166,9,57483963,57484371,processed_pseudogene,1,408,chr9_57483963_57484371
Gm6169,13,97098208,97099237,protein_coding,-1,1029,chr13_97098208_97099237
Gm6170,1,128520073,128521460,processed_pseudogene,-1,1387,chr1_128520073_128521460
Gm6173,18,90017821,90019079,processed_pseudogene,-1,1258,chr18_90017821_90019079
Gm6177,1,160893120,160893584,processed_pseudogene,1,464,chr1_160893120_160893584
Gm6180,8,42246911,42247408,processed_pseudogene,1,497,chr8_42246911_42247408
Gm6181,7,52755465,52755728,processed_pseudogene,1,263,chr7_52755465_52755728
Gm6182,2,176201042,176203572,unprocessed_pseudogene,1,2530,chr2_176201042_176203572
Gm6184,X,101518985,101520245,processed_pseudogene,1,1260,chrX_101518985_101520245
Gm6185,1,161176936,161237307,transcribed_unprocessed_pseudogene,1,60371,chr1_161176936_161237307
Gm6187,1,9396773,9398687,processed_pseudogene,-1,1914,chr1_9396773_9398687
Gm6189,1,80383104,80385185,processed_pseudogene,-1,2081,chr1_80383104_80385185
Gm6190,12,88353313,88354686,processed_pseudogene,-1,1373,chr12_88353313_88354686
Gm6192,19,7959743,7961107,processed_pseudogene,-1,1364,chr19_7959743_7961107
Gm6195,1,9802197,9802553,processed_pseudogene,-1,356,chr1_9802197_9802553
Gm6197,3,25731243,25731696,processed_pseudogene,1,453,chr3_25731243_25731696
Gm6198,1,81554157,81557483,processed_pseudogene,-1,3326,chr1_81554157_81557483
Gm6201,14,105199326,105201099,processed_pseudogene,-1,1773,chr14_105199326_105201099
Gm6203,8,37371824,37373165,processed_pseudogene,-1,1341,chr8_37371824_37373165
Gm6204,3,53692422,53692878,processed_pseudogene,-1,456,chr3_53692422_53692878
Gm6206,X,103163110,103165407,processed_pseudogene,-1,2297,chrX_103163110_103165407
Gm6207,X,135119961,135122984,transcribed_unprocessed_pseudogene,-1,3023,chrX_135119961_135122984
Gm6209,3,50516399,50607223,processed_transcript,-1,90824,chr3_50516399_50607223
Gm6210,6,75296118,75298059,processed_pseudogene,-1,1941,chr6_75296118_75298059
Gm6211,13,103159795,103164069,transcribed_processed_pseudogene,-1,4274,chr13_103159795_103164069
Gm6212,14,119644012,119644231,processed_pseudogene,1,219,chr14_119644012_119644231
Gm6213,8,39297980,39368268,lincRNA,1,70288,chr8_39297980_39368268
Gm6214,3,140839097,140839637,processed_pseudogene,-1,540,chr3_140839097_140839637
Gm6215,X,135349021,135352023,transcribed_processed_pseudogene,1,3002,chrX_135349021_135352023
Gm6216,1,12655867,12656553,processed_pseudogene,1,686,chr1_12655867_12656553
Gm6218,12,54622590,54623217,processed_pseudogene,1,627,chr12_54622590_54623217
Gm6221,X,135409856,135412955,unprocessed_pseudogene,1,3099,chrX_135409856_135412955
Gm6222,X,103762917,103763545,transcribed_processed_pseudogene,-1,628,chrX_103762917_103763545
Gm6225,18,3336680,3366863,processed_transcript,1,30183,chr18_3336680_3366863
Gm6226,7,58836793,58837938,processed_pseudogene,-1,1145,chr7_58836793_58837938
Gm6227,6,117472998,117473418,processed_pseudogene,-1,420,chr6_117472998_117473418
Gm6228,X,135549210,135552221,transcribed_unprocessed_pseudogene,1,3011,chrX_135549210_135552221
Gm6235,18,3446814,3447222,processed_pseudogene,1,408,chr18_3446814_3447222
Gm6238,X,104382042,104382506,processed_pseudogene,-1,464,chrX_104382042_104382506
Gm6240,7,88781926,88782398,processed_pseudogene,-1,472,chr7_88781926_88782398
Gm6244,1,83212044,83212884,processed_pseudogene,-1,840,chr1_83212044_83212884
Gm6245,13,40778040,40778807,processed_pseudogene,1,767,chr13_40778040_40778807
Gm6248,18,4052351,4052536,processed_pseudogene,-1,185,chr18_4052351_4052536
Gm6252,19,9216381,9216960,processed_pseudogene,1,579,chr19_9216381_9216960
Gm6254,14,122117938,122119009,processed_pseudogene,1,1071,chr14_122117938_122119009
Gm6257,9,63443166,63444075,processed_pseudogene,-1,909,chr9_63443166_63444075
Gm6260,3,143670892,143712210,lincRNA,-1,41318,chr3_143670892_143712210
Gm6261,6,79541208,79541967,processed_pseudogene,1,759,chr6_79541208_79541967
Gm6263,13,74018793,74020134,processed_pseudogene,-1,1341,chr13_74018793_74020134
Gm6266,6,146782469,146783274,processed_pseudogene,1,805,chr6_146782469_146783274
Gm6275,X,136929786,136930907,processed_pseudogene,1,1121,chrX_136929786_136930907
Gm6276,17,75165207,75165785,processed_pseudogene,1,578,chr17_75165207_75165785
Gm6277,18,11820671,11840869,antisense,-1,20198,chr18_11820671_11840869
Gm6278,16,85644252,85645023,processed_pseudogene,1,771,chr16_85644252_85645023
Gm6284,8,43158754,43163944,processed_pseudogene,1,5190,chr8_43158754_43163944
Gm6285,X,104947785,104948282,processed_pseudogene,1,497,chrX_104947785_104948282
Gm6286,1,166945597,166946358,processed_pseudogene,-1,761,chr1_166945597_166946358
Gm6288,6,147438362,147476046,antisense,-1,37684,chr6_147438362_147476046
Gm6290,7,54604244,54611198,processed_pseudogene,-1,6954,chr7_54604244_54611198
Gm6292,X,105140849,105141943,processed_pseudogene,1,1094,chrX_105140849_105141943
Gm6296,13,74767919,74768861,processed_pseudogene,-1,942,chr13_74767919_74768861
Gm6300,3,14363117,14377587,unprocessed_pseudogene,1,14470,chr3_14363117_14377587
Gm6303,8,43729479,43729949,processed_pseudogene,-1,470,chr8_43729479_43729949
Gm6305,16,11190254,11191265,processed_pseudogene,-1,1011,chr16_11190254_11191265
Gm6308,6,124297863,124298175,processed_pseudogene,1,312,chr6_124297863_124298175
Gm6311,13,75954136,75955013,processed_pseudogene,1,877,chr13_75954136_75955013
Gm6313,6,148606786,148614309,lincRNA,-1,7523,chr6_148606786_148614309
Gm6316,12,69920472,69921491,processed_pseudogene,-1,1019,chr12_69920472_69921491
Gm6317,13,78372987,78379128,processed_pseudogene,-1,6141,chr13_78372987_78379128
Gm6321,3,15891466,15918804,processed_pseudogene,-1,27338,chr3_15891466_15918804
Gm6322,X,139676087,139677489,processed_pseudogene,-1,1402,chrX_139676087_139677489
Gm6331,10,71162928,71163377,processed_pseudogene,1,449,chr10_71162928_71163377
Gm6332,16,12950781,12951463,processed_pseudogene,-1,682,chr16_12950781_12951463
Gm6333,10,126893113,126893908,processed_pseudogene,1,795,chr10_126893113_126893908
Gm6334,8,4778042,4778269,processed_pseudogene,1,227,chr8_4778042_4778269
Gm6335,X,112162554,112163747,processed_pseudogene,1,1193,chrX_112162554_112163747
Gm6336,10,128676158,128676649,processed_pseudogene,-1,491,chr10_128676158_128676649
Gm6341,7,101154645,101155055,processed_pseudogene,-1,410,chr7_101154645_101155055
Gm6342,6,83844330,83845095,processed_pseudogene,-1,765,chr6_83844330_83845095
Gm6343,13,113761386,113762128,processed_pseudogene,-1,742,chr13_113761386_113762128
Gm6344,13,55085777,55086259,processed_pseudogene,1,482,chr13_55085777_55086259
Gm6350,3,17269456,17270794,processed_pseudogene,1,1338,chr3_17269456_17270794
Gm6352,6,47045156,47046289,processed_pseudogene,1,1133,chr6_47045156_47046289
Gm6353,12,62365255,62366305,processed_pseudogene,1,1050,chr12_62365255_62366305
Gm6361,15,31446383,31446817,processed_pseudogene,-1,434,chr15_31446383_31446817
Gm6363,16,94242274,94243347,processed_pseudogene,-1,1073,chr16_94242274_94243347
Gm6365,19,11877615,11878358,processed_pseudogene,-1,743,chr19_11877615_11878358
Gm6366,5,89499152,89499977,processed_pseudogene,-1,825,chr5_89499152_89499977
Gm6368,X,141980175,141982321,processed_pseudogene,1,2146,chrX_141980175_141982321
Gm6374,1,83314513,83315300,processed_pseudogene,1,787,chr1_83314513_83315300
Gm6375,6,133761445,133763062,processed_pseudogene,-1,1617,chr6_133761445_133763062
Gm6376,7,140385765,140386344,processed_pseudogene,-1,579,chr7_140385765_140386344
Gm6377,X,109196756,109200439,protein_coding,1,3683,chrX_109196756_109200439
Gm6378,18,21076668,21077109,processed_pseudogene,-1,441,chr18_21076668_21077109
Gm6382,X,142210884,142211825,processed_pseudogene,1,941,chrX_142210884_142211825
Gm6386,19,7975840,7978039,processed_pseudogene,1,2199,chr19_7975840_7978039
Gm6390,10,29781411,29781999,processed_pseudogene,1,588,chr10_29781411_29781999
Gm6392,15,60468124,60469477,processed_pseudogene,1,1353,chr15_60468124_60469477
Gm6394,3,57717813,57718289,processed_pseudogene,-1,476,chr3_57717813_57718289
Gm6397,1,143683230,143684298,processed_pseudogene,1,1068,chr1_143683230_143684298
Gm6402,17,30395620,30396033,processed_pseudogene,-1,413,chr17_30395620_30396033
Gm6407,10,73690257,73690805,processed_pseudogene,-1,548,chr10_73690257_73690805
Gm6408,5,146481965,146484704,protein_coding,1,2739,chr5_146481965_146484704
Gm6409,18,88831859,88832477,processed_pseudogene,-1,618,chr18_88831859_88832477
Gm6410,8,4678462,4688494,lincRNA,1,10032,chr8_4678462_4688494
Gm6411,13,83761132,83762335,processed_pseudogene,-1,1203,chr13_83761132_83762335
Gm6416,13,117130027,117135884,lincRNA,1,5857,chr13_117130027_117135884
Gm6418,X,112459033,112462903,processed_pseudogene,-1,3870,chrX_112459033_112462903
Gm6419,10,74862988,74863416,processed_pseudogene,-1,428,chr10_74862988_74863416
Gm6421,13,117358212,117358620,processed_pseudogene,-1,408,chr13_117358212_117358620
Gm6423,6,124251531,124252464,processed_pseudogene,1,933,chr6_124251531_124252464
Gm6425,19,8588407,8589196,processed_pseudogene,-1,789,chr19_8588407_8589196
Gm6426,8,5527689,5528542,processed_pseudogene,1,853,chr8_5527689_5528542
Gm6430,1,97024681,97025928,processed_pseudogene,1,1247,chr1_97024681_97025928
Gm6436,13,61710587,61711371,processed_pseudogene,-1,784,chr13_61710587_61711371
Gm6438,16,16968609,16969068,processed_pseudogene,1,459,chr16_16968609_16969068
Gm6439,3,150515220,150516081,processed_pseudogene,-1,861,chr3_150515220_150516081
Gm6440,16,17137328,17137681,processed_pseudogene,1,353,chr16_17137328_17137681
Gm6441,X,145264831,145265526,processed_pseudogene,-1,695,chrX_145264831_145265526
Gm6443,6,47977003,47977876,processed_pseudogene,-1,873,chr6_47977003_47977876
Gm6444,5,123066242,123066699,processed_pseudogene,1,457,chr5_123066242_123066699
Gm6445,19,9607104,9608376,unprocessed_pseudogene,1,1272,chr19_9607104_9608376
Gm6446,X,145833317,145834134,processed_pseudogene,1,817,chrX_145833317_145834134
Gm6447,X,145994291,145995125,processed_pseudogene,1,834,chrX_145994291_145995125
Gm6450,5,93003831,93004404,processed_pseudogene,1,573,chr5_93003831_93004404
Gm6451,X,151413668,151414384,processed_pseudogene,-1,716,chrX_151413668_151414384
Gm6452,17,32731010,32731806,processed_pseudogene,1,796,chr17_32731010_32731806
Gm6457,18,14570147,14570638,processed_pseudogene,1,491,chr18_14570147_14570638
Gm6458,8,51879563,51880197,processed_pseudogene,1,634,chr8_51879563_51880197
Gm6461,X,115443399,115444031,processed_pseudogene,-1,632,chrX_115443399_115444031
Gm6462,1,28938036,28938339,processed_pseudogene,1,303,chr1_28938036_28938339
Gm6463,8,52278506,52279471,processed_pseudogene,-1,965,chr8_52278506_52279471
Gm6467,16,21896506,21897116,pseudogene,1,610,chr16_21896506_21897116
Gm6473,1,30769687,30771815,unprocessed_pseudogene,1,2128,chr1_30769687_30771815
Gm6474,13,61687282,61687980,processed_pseudogene,-1,698,chr13_61687282_61687980
Gm6475,17,3312250,3314185,processed_pseudogene,-1,1935,chr17_3312250_3314185
Gm6477,10,39198538,39199301,processed_pseudogene,1,763,chr10_39198538_39199301
Gm6478,13,62035422,62036163,processed_pseudogene,1,741,chr13_62035422_62036163
Gm648,X,56543874,56549606,protein_coding,-1,5732,chrX_56543874_56549606
Gm6480,X,47724528,47726413,processed_pseudogene,1,1885,chrX_47724528_47726413
Gm6483,8,19682449,19697736,unprocessed_pseudogene,1,15287,chr8_19682449_19697736
Gm6485,3,104752727,104753165,transcribed_processed_pseudogene,-1,438,chr3_104752727_104753165
Gm6489,1,31286945,31287640,processed_pseudogene,1,695,chr1_31286945_31287640
Gm6493,16,23014208,23017038,processed_pseudogene,-1,2830,chr16_23014208_23017038
Gm6494,10,58757270,58759567,processed_pseudogene,1,2297,chr10_58757270_58759567
Gm6496,17,76936640,76937041,processed_pseudogene,1,401,chr17_76936640_76937041
Gm6498,14,48227201,48228206,transcribed_processed_pseudogene,1,1005,chr14_48227201_48228206
Gm6500,X,117886441,117886891,processed_pseudogene,-1,450,chrX_117886441_117886891
Gm6501,19,11121510,11122425,processed_pseudogene,1,915,chr19_11121510_11122425
Gm6503,8,56713049,56715273,processed_pseudogene,1,2224,chr8_56713049_56715273
Gm6505,3,28764713,28765360,processed_pseudogene,-1,647,chr3_28764713_28765360
Gm6510,3,156060891,156062063,processed_pseudogene,1,1172,chr3_156060891_156062063
Gm6517,5,66890366,66890876,processed_pseudogene,1,510,chr5_66890366_66890876
Gm6520,3,157888465,157888874,processed_pseudogene,-1,409,chr3_157888465_157888874
Gm6524,8,11693042,11694484,processed_pseudogene,-1,1442,chr8_11693042_11694484
Gm6525,3,84174104,84175132,protein_coding,1,1028,chr3_84174104_84175132
Gm6532,14,44265044,44265602,unprocessed_pseudogene,1,558,chr14_44265044_44265602
Gm6533,15,23489891,23490498,processed_pseudogene,1,607,chr15_23489891_23490498
Gm6542,18,36609958,36610729,processed_pseudogene,1,771,chr18_36609958_36610729
Gm6543,5,21598740,21599547,processed_pseudogene,1,807,chr5_21598740_21599547
Gm6545,19,12528755,12530540,processed_pseudogene,-1,1785,chr19_12528755_12530540
Gm6546,3,66029540,66031519,processed_pseudogene,-1,1979,chr3_66029540_66031519
Gm6548,17,78850792,78851956,processed_pseudogene,-1,1164,chr17_78850792_78851956
Gm6550,1,145164951,145165943,processed_pseudogene,-1,992,chr1_145164951_145165943
Gm6551,16,20928969,20929853,unprocessed_pseudogene,1,884,chr16_20928969_20929853
Gm6552,17,79933512,79934572,processed_pseudogene,-1,1060,chr17_79933512_79934572
Gm6554,13,50000347,50002258,processed_pseudogene,-1,1911,chr13_50000347_50002258
Gm6555,3,66882350,66883138,processed_pseudogene,1,788,chr3_66882350_66883138
Gm6557,16,21062213,21063094,unprocessed_pseudogene,-1,881,chr16_21062213_21063094
Gm6559,6,51379710,51392791,lincRNA,1,13081,chr6_51379710_51392791
Gm6560,5,22724578,22726168,processed_pseudogene,-1,1590,chr5_22724578_22726168
Gm6562,13,16045641,16046104,processed_pseudogene,1,463,chr13_16045641_16046104
Gm6563,19,23675848,23676480,processed_pseudogene,1,632,chr19_23675848_23676480
Gm6564,5,22931395,22932013,processed_pseudogene,-1,618,chr5_22931395_22932013
Gm6565,6,100604683,100605120,processed_pseudogene,1,437,chr6_100604683_100605120
Gm6566,12,87149475,87155486,antisense,-1,6011,chr12_87149475_87155486
Gm6567,7,73097749,73102068,lincRNA,-1,4319,chr7_73097749_73102068
Gm6568,X,157540866,157541562,processed_pseudogene,1,696,chrX_157540866_157541562
Gm6576,15,27025328,27026210,processed_pseudogene,1,882,chr15_27025328_27026210
Gm6578,6,12099518,12109583,transcribed_processed_pseudogene,-1,10065,chr6_12099518_12109583
Gm6579,7,29798712,29799796,unprocessed_pseudogene,-1,1084,chr7_29798712_29799796
Gm6580,14,46027428,46028784,processed_pseudogene,1,1356,chr14_46027428_46028784
Gm6581,9,22092513,22092772,processed_pseudogene,1,259,chr9_22092513_22092772
Gm6583,5,112353801,112356033,protein_coding,-1,2232,chr5_112353801_112356033
Gm6588,5,112449426,112451738,protein_coding,1,2312,chr5_112449426_112451738
Gm6592,X,8843994,8849607,protein_coding,1,5613,chrX_8843994_8849607
Gm6594,17,82539260,82539545,processed_pseudogene,1,285,chr17_82539260_82539545
Gm6599,16,95754300,95754707,processed_pseudogene,1,407,chr16_95754300_95754707
Gm6602,3,111881903,112082001,lincRNA,1,200098,chr3_111881903_112082001
Gm6606,1,181067596,181076640,unprocessed_pseudogene,1,9044,chr1_181067596_181076640
Gm6607,9,22330173,22330500,processed_pseudogene,-1,327,chr9_22330173_22330500
Gm6610,15,74924444,74925296,processed_pseudogene,1,852,chr15_74924444_74925296
Gm6611,16,32923218,32924489,processed_pseudogene,1,1271,chr16_32923218_32924489
Gm6612,15,80952505,80952899,processed_pseudogene,1,394,chr15_80952505_80952899
Gm6615,5,57460160,57460790,processed_pseudogene,1,630,chr5_57460160_57460790
Gm6616,14,47569526,47569774,processed_pseudogene,1,248,chr14_47569526_47569774
Gm6618,17,12356482,12357608,processed_pseudogene,1,1126,chr17_12356482_12357608
Gm6621,1,38907945,38908716,processed_pseudogene,1,771,chr1_38907945_38908716
Gm6623,17,36179114,36179657,processed_pseudogene,1,543,chr17_36179114_36179657
Gm6625,8,89146787,89147058,processed_pseudogene,-1,271,chr8_89146787_89147058
Gm6627,10,52341272,52343657,processed_pseudogene,-1,2385,chr10_52341272_52343657
Gm6630,16,23179556,23180009,processed_pseudogene,1,453,chr16_23179556_23180009
Gm6631,3,70413319,70413877,processed_pseudogene,1,558,chr3_70413319_70413877
Gm6632,5,59053599,59054552,processed_pseudogene,1,953,chr5_59053599_59054552
Gm6637,6,122295664,122296045,processed_pseudogene,1,381,chr6_122295664_122296045
Gm6639,3,35597152,35666163,lincRNA,-1,69011,chr3_35597152_35666163
Gm6640,16,23717169,23718755,processed_pseudogene,-1,1586,chr16_23717169_23718755
Gm6641,5,13080828,13082142,processed_pseudogene,1,1314,chr5_13080828_13082142
Gm6643,18,28432889,28435355,processed_pseudogene,1,2466,chr18_28432889_28435355
Gm6644,1,55444074,55445024,processed_pseudogene,-1,950,chr1_55444074_55445024
Gm6645,X,154971207,154974721,processed_pseudogene,-1,3514,chrX_154971207_154974721
Gm6651,1,106439600,106439870,processed_pseudogene,1,270,chr1_106439600_106439870
Gm6652,1,153619604,153620673,processed_pseudogene,-1,1069,chr1_153619604_153620673
Gm6654,6,146647241,146647588,processed_pseudogene,-1,347,chr6_146647241_146647588
Gm6655,6,19119469,19120777,processed_pseudogene,1,1308,chr6_19119469_19120777
Gm6657,12,78194242,78209029,protein_coding,1,14787,chr12_78194242_78209029
Gm6659,17,36157988,36158534,processed_pseudogene,1,546,chr17_36157988_36158534
Gm6663,18,45070322,45071294,processed_pseudogene,-1,972,chr18_45070322_45071294
Gm6665,18,31819862,31820519,processed_pseudogene,-1,657,chr18_31819862_31820519
Gm6669,7,31817113,31818109,processed_pseudogene,1,996,chr7_31817113_31818109
Gm6677,3,78006459,78006899,processed_pseudogene,1,440,chr3_78006459_78006899
Gm6679,1,108770135,108772003,processed_pseudogene,1,1868,chr1_108770135_108772003
Gm6680,3,78134630,78135579,processed_pseudogene,1,949,chr3_78134630_78135579
Gm6681,6,99839708,99840314,processed_pseudogene,-1,606,chr6_99839708_99840314
Gm6682,12,4782170,4783515,processed_pseudogene,1,1345,chr12_4782170_4783515
Gm6684,19,20586073,20586757,processed_pseudogene,-1,684,chr19_20586073_20586757
Gm6685,11,28339128,28339814,processed_pseudogene,-1,686,chr11_28339128_28339814
Gm6689,8,21091366,21091846,processed_pseudogene,1,480,chr8_21091366_21091846
Gm6693,1,110600021,110600833,processed_pseudogene,1,812,chr1_110600021_110600833
Gm6695,6,58091076,58092247,processed_pseudogene,1,1171,chr6_58091076_58092247
Gm6702,7,108019016,108019486,processed_pseudogene,1,470,chr7_108019016_108019486
Gm6704,15,36629645,36629869,processed_pseudogene,-1,224,chr15_36629645_36629869
Gm6705,17,16847395,16848079,processed_pseudogene,1,684,chr17_16847395_16848079
Gm6710,2,175869219,175881248,protein_coding,1,12029,chr2_175869219_175881248
Gm6712,17,17294443,17319511,lincRNA,1,25068,chr17_17294443_17319511
Gm6713,10,85709327,85710772,processed_pseudogene,-1,1445,chr10_85709327_85710772
Gm6717,1,112137868,112138705,processed_pseudogene,1,837,chr1_112137868_112138705
Gm6721,10,85807809,85809253,processed_pseudogene,1,1444,chr10_85807809_85809253
Gm6722,12,83620680,83621069,processed_pseudogene,-1,389,chr12_83620680_83621069
Gm6723,15,78554408,78554848,processed_pseudogene,-1,440,chr15_78554408_78554848
Gm6724,18,34970469,34970735,processed_pseudogene,-1,266,chr18_34970469_34970735
Gm6728,6,136486122,136487186,processed_pseudogene,-1,1064,chr6_136486122_136487186
Gm6729,10,86526299,86541334,lincRNA;processed_pseudogene,-1,15035,chr10_86526299_86541334
Gm6733,11,72833461,72835380,processed_pseudogene,1,1919,chr11_72833461_72835380
Gm6734,14,14371648,14372248,processed_pseudogene,1,600,chr14_14371648_14372248
Gm6736,12,13455023,13455970,processed_pseudogene,-1,947,chr12_13455023_13455970
Gm6741,17,91236811,91237557,processed_pseudogene,1,746,chr17_91236811_91237557
Gm6745,5,24009887,24010412,processed_pseudogene,-1,525,chr5_24009887_24010412
Gm6746,15,90561347,90561829,processed_pseudogene,1,482,chr15_90561347_90561829
Gm6750,12,116507616,116507883,processed_pseudogene,-1,267,chr12_116507616_116507883
Gm6751,17,92372015,92373116,processed_pseudogene,-1,1101,chr17_92372015_92373116
Gm6756,18,36920396,36922015,processed_pseudogene,1,1619,chr18_36920396_36922015
Gm6757,1,49399024,49400729,processed_pseudogene,-1,1705,chr1_49399024_49400729
Gm6758,X,74135133,74136187,processed_pseudogene,-1,1054,chrX_74135133_74136187
Gm6764,17,93331463,93332937,processed_pseudogene,1,1474,chr17_93331463_93332937
Gm6767,16,51362452,51363832,processed_pseudogene,-1,1380,chr16_51362452_51363832
Gm6771,17,41345997,41346997,processed_pseudogene,1,1000,chr17_41345997_41346997
Gm6773,14,18099183,18100060,processed_pseudogene,-1,877,chr14_18099183_18100060
Gm6776,19,43280798,43281697,processed_pseudogene,1,899,chr19_43280798_43281697
Gm6781,14,18531363,18532604,processed_pseudogene,1,1241,chr14_18531363_18532604
Gm6783,X,66969223,66970659,processed_pseudogene,-1,1436,chrX_66969223_66970659
Gm6786,6,66527014,66528928,processed_pseudogene,1,1914,chr6_66527014_66528928
Gm6787,X,8097087,8106701,processed_transcript,1,9614,chrX_8097087_8106701
Gm6788,19,28763161,28763430,processed_pseudogene,-1,269,chr19_28763161_28763430
Gm6789,18,63543751,63545135,processed_pseudogene,-1,1384,chr18_63543751_63545135
Gm6793,8,112013953,112015008,processed_pseudogene,-1,1055,chr8_112013953_112015008
Gm6794,6,66711691,66712147,processed_pseudogene,1,456,chr6_66711691_66712147
Gm6801,1,53390415,53392585,unprocessed_pseudogene,1,2170,chr1_53390415_53392585
Gm6807,19,45450308,45451195,processed_pseudogene,-1,887,chr19_45450308_45451195
Gm6808,10,112089667,112090473,processed_pseudogene,-1,806,chr10_112089667_112090473
Gm6813,19,45877647,45878126,processed_pseudogene,-1,479,chr19_45877647_45878126
Gm6815,16,36194849,36198129,transcribed_unprocessed_pseudogene,-1,3280,chr16_36194849_36198129
Gm6822,1,55160747,55161053,processed_pseudogene,-1,306,chr1_55160747_55161053
Gm6823,X,70420716,70422554,processed_pseudogene,-1,1838,chrX_70420716_70422554
Gm6828,7,7096843,7098028,processed_pseudogene,-1,1185,chr7_7096843_7098028
Gm6829,X,9327749,9328108,processed_pseudogene,-1,359,chrX_9327749_9328108
Gm6838,12,22320382,22326042,unprocessed_pseudogene,-1,5660,chr12_22320382_22326042
Gm6847,15,85008139,85009000,processed_pseudogene,1,861,chr15_85008139_85009000
Gm6852,14,55349784,55350690,processed_pseudogene,-1,906,chr14_55349784_55350690
Gm6855,7,4638536,4639325,processed_pseudogene,1,789,chr7_4638536_4639325
Gm6859,10,96768625,96769828,processed_pseudogene,-1,1203,chr10_96768625_96769828
Gm6863,12,96922423,96923058,processed_pseudogene,-1,635,chr12_96922423_96923058
Gm6867,12,11760447,11760871,processed_pseudogene,-1,424,chr12_11760447_11760871
Gm6872,7,41668608,41669307,processed_pseudogene,-1,699,chr7_41668608_41669307
Gm6877,8,33191196,33192296,processed_pseudogene,-1,1100,chr8_33191196_33192296
Gm6883,18,47414465,47415361,processed_pseudogene,-1,896,chr18_47414465_47415361
Gm6884,10,24045592,24046206,processed_pseudogene,1,614,chr10_24045592_24046206
Gm6885,9,41164374,41164745,processed_pseudogene,1,371,chr9_41164374_41164745
Gm6888,13,64998934,65000335,processed_pseudogene,1,1401,chr13_64998934_65000335
Gm6893,10,24567077,24568134,processed_pseudogene,-1,1057,chr10_24567077_24568134
Gm6900,7,10656479,10656820,processed_pseudogene,-1,341,chr7_10656479_10656820
Gm6903,16,45533124,45534489,processed_pseudogene,-1,1365,chr16_45533124_45534489
Gm6905,7,123010112,123010622,processed_pseudogene,1,510,chr7_123010112_123010622
Gm6906,10,25836687,25837255,processed_pseudogene,1,568,chr10_25836687_25837255
Gm6909,7,11182400,11188803,unprocessed_pseudogene,1,6403,chr7_11182400_11188803
Gm6912,16,47074198,47076035,processed_pseudogene,1,1837,chr16_47074198_47076035
Gm6914,16,47620504,47621691,processed_pseudogene,1,1187,chr16_47620504_47621691
Gm6916,7,128314784,128340805,transcribed_processed_pseudogene,1,26021,chr7_128314784_128340805
Gm6921,8,127561435,127561869,processed_pseudogene,1,434,chr8_127561435_127561869
Gm6929,7,11845253,11845720,processed_pseudogene,-1,467,chr7_11845253_11845720
Gm6931,16,49424806,49425814,processed_pseudogene,1,1008,chr16_49424806_49425814
Gm6937,19,42159669,42160711,processed_pseudogene,1,1042,chr19_42159669_42160711
Gm6938,X,21312210,21334727,lincRNA,-1,22517,chrX_21312210_21334727
Gm6939,7,126687459,126690034,transcribed_unprocessed_pseudogene,-1,2575,chr7_126687459_126690034
Gm6942,18,55841665,55843018,processed_pseudogene,1,1353,chr18_55841665_55843018
Gm6943,12,19525993,19563094,unprocessed_pseudogene,1,37101,chr12_19525993_19563094
Gm6944,18,55972286,55973291,processed_pseudogene,1,1005,chr18_55972286_55973291
Gm6946,7,12742686,12743672,processed_pseudogene,1,986,chr7_12742686_12743672
Gm6947,1,71493737,71493814,processed_pseudogene,-1,77,chr1_71493737_71493814
Gm6951,19,44252517,44261446,unprocessed_pseudogene,1,8929,chr19_44252517_44261446
Gm6954,X,80666313,80666537,processed_pseudogene,1,224,chrX_80666313_80666537
Gm6960,18,60426292,60426934,pseudogene,1,642,chr18_60426292_60426934
Gm6961,15,95747247,95751591,lincRNA,-1,4344,chr15_95747247_95751591
Gm6967,19,46674273,46675279,processed_pseudogene,-1,1006,chr19_46674273_46675279
Gm6969,12,24638669,24639010,processed_pseudogene,-1,341,chr12_24638669_24639010
Gm6974,18,64080765,64081420,processed_pseudogene,-1,655,chr18_64080765_64081420
Gm6975,19,49709393,49710124,processed_pseudogene,-1,731,chr19_49709393_49710124
Gm6977,X,90744546,90745062,processed_pseudogene,-1,516,chrX_90744546_90745062
Gm6978,18,64611725,64613099,transcribed_processed_pseudogene,-1,1374,chr18_64611725_64613099
Gm6980,9,51913477,51931661,lincRNA,-1,18184,chr9_51913477_51931661
Gm6981,9,52002274,52003281,processed_pseudogene,-1,1007,chr9_52002274_52003281
Gm6983,10,44852614,44853241,processed_pseudogene,1,627,chr10_44852614_44853241
Gm6985,X,93638614,93638884,processed_pseudogene,1,270,chrX_93638614_93638884
Gm6986,14,74297545,74298775,processed_pseudogene,1,1230,chr14_74297545_74298775
Gm6987,X,94023860,94024626,processed_pseudogene,1,766,chrX_94023860_94024626
Gm6988,12,110315990,110316364,processed_pseudogene,1,374,chr12_110315990_110316364
Gm6989,12,29316915,29317568,processed_pseudogene,-1,653,chr12_29316915_29317568
Gm6992,12,31018218,31019824,processed_pseudogene,1,1606,chr12_31018218_31019824
Gm6994,14,77479483,77506868,antisense,-1,27385,chr14_77479483_77506868
Gm6995,18,72426526,72427108,processed_pseudogene,-1,582,chr18_72426526_72427108
Gm6997,14,78965949,78966568,processed_pseudogene,-1,619,chr14_78965949_78966568
Gm7001,10,57290889,57292353,processed_pseudogene,1,1464,chr10_57290889_57292353
Gm7002,12,35772951,35775115,processed_pseudogene,1,2164,chr12_35772951_35775115
Gm7004,14,84757626,84759083,processed_pseudogene,-1,1457,chr14_84757626_84759083
Gm7008,12,40222758,40229184,antisense,1,6426,chr12_40222758_40229184
Gm7027,7,101573460,101574321,processed_pseudogene,-1,861,chr7_101573460_101574321
Gm7034,10,74820722,74821366,processed_pseudogene,1,644,chr10_74820722_74821366
Gm7039,6,133113928,133114273,processed_pseudogene,-1,345,chr6_133113928_133114273
Gm7041,5,151281123,151281646,processed_pseudogene,1,523,chr5_151281123_151281646
Gm7043,17,3461800,3462332,processed_pseudogene,-1,532,chr17_3461800_3462332
Gm7045,13,62670299,62670903,processed_pseudogene,-1,604,chr13_62670299_62670903
Gm7046,13,13895807,13910408,processed_pseudogene,-1,14601,chr13_13895807_13910408
Gm7047,5,17493223,17494285,processed_pseudogene,1,1062,chr5_17493223_17494285
Gm7048,5,88231350,88233240,processed_pseudogene,1,1890,chr5_88231350_88233240
Gm7049,13,62813076,62814787,processed_pseudogene,1,1711,chr13_62813076_62814787
Gm7052,17,22039028,22040539,unprocessed_pseudogene,-1,1511,chr17_22039028_22040539
Gm7054,13,106475936,106476755,processed_pseudogene,1,819,chr13_106475936_106476755
Gm7059,17,32852205,32853020,processed_pseudogene,-1,815,chr17_32852205_32853020
Gm7063,1,45519774,45520754,processed_pseudogene,-1,980,chr1_45519774_45520754
Gm7065,13,64703158,64703631,processed_pseudogene,1,473,chr13_64703158_64703631
Gm7067,7,100197100,100198348,processed_pseudogene,-1,1248,chr7_100197100_100198348
Gm7069,8,76293972,76294979,processed_pseudogene,1,1007,chr8_76293972_76294979
Gm7072,17,22285871,22314837,protein_coding,-1,28966,chr17_22285871_22314837
Gm7074,19,5324014,5325823,processed_pseudogene,1,1809,chr19_5324014_5325823
Gm7075,10,63421365,63421789,protein_coding,-1,424,chr10_63421365_63421789
Gm7079,X,8047229,8047399,processed_pseudogene,1,170,chrX_8047229_8047399
Gm7082,8,40016714,40018248,processed_pseudogene,1,1534,chr8_40016714_40018248
Gm7084,14,18242422,18243253,processed_pseudogene,1,831,chr14_18242422_18243253
Gm7085,16,15452004,15452762,processed_pseudogene,1,758,chr16_15452004_15452762
Gm7086,15,60742858,60746535,transcribed_unprocessed_pseudogene,1,3677,chr15_60742858_60746535
Gm7091,X,140821938,140822523,processed_pseudogene,-1,585,chrX_140821938_140822523
Gm7093,12,18332873,18339043,unprocessed_pseudogene,1,6170,chr12_18332873_18339043
Gm7099,12,9429547,9430100,processed_pseudogene,1,553,chr12_9429547_9430100
Gm7102,19,61174686,61176309,protein_coding,-1,1623,chr19_61174686_61176309
Gm7103,3,8214332,8216183,processed_pseudogene,1,1851,chr3_8214332_8216183
Gm7104,12,88284538,88287069,processed_pseudogene,-1,2531,chr12_88284538_88287069
Gm7105,19,8256224,8257587,processed_pseudogene,-1,1363,chr19_8256224_8257587
Gm7106,14,51314461,51314928,processed_pseudogene,1,467,chr14_51314461_51314928
Gm7107,14,51358603,51359964,processed_pseudogene,1,1361,chr14_51358603_51359964
Gm7108,X,89802319,89806126,processed_pseudogene,-1,3807,chrX_89802319_89806126
Gm7114,1,33100907,33102695,processed_pseudogene,1,1788,chr1_33100907_33102695
Gm7115,3,83799968,83832219,unprocessed_pseudogene,1,32251,chr3_83799968_83832219
Gm7118,5,108145226,108146907,processed_pseudogene,-1,1681,chr5_108145226_108146907
Gm7123,X,142412755,142412967,processed_pseudogene,1,212,chrX_142412755_142412967
Gm7125,15,68792320,68883576,lincRNA,1,91256,chr15_68792320_68883576
Gm7126,12,13788557,13790252,processed_pseudogene,-1,1695,chr12_13788557_13790252
Gm7128,8,15877664,15878196,processed_pseudogene,1,532,chr8_15877664_15878196
Gm7129,X,13326023,13327019,processed_pseudogene,-1,996,chrX_13326023_13327019
Gm7132,3,14973569,14974552,processed_pseudogene,-1,983,chr3_14973569_14974552
Gm7133,1,97162860,97310664,unprocessed_pseudogene,1,147804,chr1_97162860_97310664
Gm7135,1,97346475,97573015,transcribed_unprocessed_pseudogene,1,226540,chr1_97346475_97573015
Gm7143,12,102866631,102867489,processed_pseudogene,-1,858,chr12_102866631_102867489
Gm715,X,60546265,60548849,processed_pseudogene,1,2584,chrX_60546265_60548849
Gm7150,X,153403090,153404070,processed_pseudogene,-1,980,chrX_153403090_153404070
Gm7155,X,75971453,75973123,processed_pseudogene,-1,1670,chrX_75971453_75973123
Gm7156,18,10197676,10198174,processed_pseudogene,-1,498,chr18_10197676_10198174
Gm7158,X,152544253,152545155,processed_pseudogene,-1,902,chrX_152544253_152545155
Gm7160,1,105979350,105990282,lincRNA,-1,10932,chr1_105979350_105990282
Gm7162,17,12819819,12820842,processed_pseudogene,-1,1023,chr17_12819819_12820842
Gm7172,12,51133551,51134702,processed_pseudogene,-1,1151,chr12_51133551_51134702
Gm7177,17,15535065,15536704,processed_pseudogene,-1,1639,chr17_15535065_15536704
Gm7180,7,81222362,81222874,processed_pseudogene,-1,512,chr7_81222362_81222874
Gm7181,5,42499981,42500414,processed_pseudogene,-1,433,chr5_42499981_42500414
Gm7182,1,5276106,5277337,processed_pseudogene,-1,1231,chr1_5276106_5277337
Gm7183,9,113530229,113531233,processed_pseudogene,1,1004,chr9_113530229_113531233
Gm7189,X,40000782,40001210,processed_pseudogene,-1,428,chrX_40000782_40001210
Gm7190,X,40007137,40008588,processed_pseudogene,-1,1451,chrX_40007137_40008588
Gm7191,8,97565603,97566592,processed_pseudogene,-1,989,chr8_97565603_97566592
Gm7192,8,98223527,98224663,processed_pseudogene,-1,1136,chr8_98223527_98224663
Gm7198,10,15520331,15521404,processed_pseudogene,-1,1073,chr10_15520331_15521404
Gm7199,X,163477652,163479136,processed_pseudogene,1,1484,chrX_163477652_163479136
Gm7200,1,118249863,118251025,processed_pseudogene,1,1162,chr1_118249863_118251025
Gm7201,13,40830797,40838656,processed_pseudogene,-1,7859,chr13_40830797_40838656
Gm7204,16,48218605,48219201,processed_pseudogene,1,596,chr16_48218605_48219201
Gm7210,7,11586435,11594194,unprocessed_pseudogene,-1,7759,chr7_11586435_11594194
Gm7211,7,42878596,42880005,processed_pseudogene,1,1409,chr7_42878596_42880005
Gm7213,10,19262034,19262983,processed_pseudogene,1,949,chr10_19262034_19262983
Gm7217,17,20379063,20379671,processed_pseudogene,1,608,chr17_20379063_20379671
Gm7222,X,134828140,134829045,processed_pseudogene,-1,905,chrX_134828140_134829045
Gm7224,7,42047948,42050212,unprocessed_pseudogene,-1,2264,chr7_42047948_42050212
Gm7229,9,120521813,120522819,unprocessed_pseudogene,1,1006,chr9_120521813_120522819
Gm7232,14,92602458,92604397,processed_pseudogene,-1,1939,chr14_92602458_92604397
Gm7233,14,43179867,43187988,protein_coding,1,8121,chr14_43179867_43187988
Gm7237,19,33409131,33420642,unprocessed_pseudogene,-1,11511,chr19_33409131_33420642
Gm7238,7,44299915,44300887,processed_pseudogene,-1,972,chr7_44299915_44300887
Gm7239,12,40883755,40884614,processed_pseudogene,-1,859,chr12_40883755_40884614
Gm7240,13,61804257,61861675,transcribed_processed_pseudogene,1,57418,chr13_61804257_61861675
Gm7241,1,132284453,132284809,processed_pseudogene,1,356,chr1_132284453_132284809
Gm7244,9,31274821,31275275,processed_pseudogene,1,454,chr9_31274821_31275275
Gm7251,13,49804944,49805952,processed_pseudogene,-1,1008,chr13_49804944_49805952
Gm7252,12,36539357,36539812,processed_pseudogene,1,455,chr12_36539357_36539812
Gm7253,17,63627617,63627954,processed_pseudogene,-1,337,chr17_63627617_63627954
Gm7258,7,128595979,128596278,processed_pseudogene,-1,299,chr7_128595979_128596278
Gm7266,1,144312032,144312436,processed_pseudogene,-1,404,chr1_144312032_144312436
Gm7269,10,112008922,112049286,unprocessed_pseudogene,-1,40364,chr10_112008922_112049286
Gm7270,3,68846079,68847406,processed_pseudogene,1,1327,chr3_68846079_68847406
Gm7271,5,76484040,76516649,protein_coding,1,32609,chr5_76484040_76516649
Gm7274,18,9543831,9545889,processed_pseudogene,1,2058,chr18_9543831_9545889
Gm7276,18,77184269,77186363,bidirectional_promoter_lncRNA,-1,2094,chr18_77184269_77186363
Gm7278,1,152729159,152730559,processed_pseudogene,-1,1400,chr1_152729159_152730559
Gm7284,5,136997386,136999294,unprocessed_pseudogene,1,1908,chr5_136997386_136999294
Gm7285,5,137601593,137602172,processed_pseudogene,1,579,chr5_137601593_137602172
Gm7286,9,45835929,45836935,processed_pseudogene,-1,1006,chr9_45835929_45836935
Gm7287,7,17138871,17139472,processed_pseudogene,-1,601,chr7_17138871_17139472
Gm7289,18,84658932,84659844,processed_pseudogene,-1,912,chr18_84658932_84659844
Gm7290,7,142757236,142757852,processed_pseudogene,-1,616,chr7_142757236_142757852
Gm7291,5,143157161,143157542,processed_pseudogene,-1,381,chr5_143157161_143157542
Gm7293,9,51622745,51623751,processed_pseudogene,1,1006,chr9_51622745_51623751
Gm7299,1,170630921,170631501,processed_pseudogene,1,580,chr1_170630921_170631501
Gm7307,16,90163180,90163570,processed_pseudogene,1,390,chr16_90163180_90163570
Gm7308,6,127282063,127282509,processed_pseudogene,-1,446,chr6_127282063_127282509
Gm7313,14,109566618,109567087,processed_pseudogene,1,469,chr14_109566618_109567087
Gm7318,15,78820810,78821402,processed_pseudogene,1,592,chr15_78820810_78821402
Gm7319,8,37154715,37155808,processed_pseudogene,1,1093,chr8_37154715_37155808
Gm7324,14,43697828,43715378,protein_coding,1,17550,chr14_43697828_43715378
Gm7326,17,34017040,34017294,processed_pseudogene,1,254,chr17_34017040_34017294
Gm7327,X,61785381,61786032,processed_pseudogene,1,651,chrX_61785381_61786032
Gm7328,8,56952829,56955053,processed_pseudogene,1,2224,chr8_56952829_56955053
Gm7329,1,65095227,65095436,processed_pseudogene,1,209,chr1_65095227_65095436
Gm7331,X,162566857,162567243,processed_pseudogene,1,386,chrX_162566857_162567243
Gm7332,5,9260935,9261388,processed_pseudogene,-1,453,chr5_9260935_9261388
Gm7333,10,31209273,31210332,processed_pseudogene,1,1059,chr10_31209273_31210332
Gm7334,17,50698688,50699443,processed_pseudogene,1,755,chr17_50698688_50699443
Gm7335,17,37713552,37713924,processed_pseudogene,-1,372,chr17_37713552_37713924
Gm7336,7,51746647,51747878,processed_pseudogene,1,1231,chr7_51746647_51747878
Gm7337,5,87850359,87853013,transcribed_processed_pseudogene,1,2654,chr5_87850359_87853013
Gm7340,X,111571699,111574450,processed_pseudogene,1,2751,chrX_111571699_111574450
Gm7341,1,3531795,3532720,processed_pseudogene,1,925,chr1_3531795_3532720
Gm7343,3,15941773,15969082,processed_pseudogene,-1,27309,chr3_15941773_15969082
Gm7347,5,26051883,26058581,protein_coding,-1,6698,chr5_26051883_26058581
Gm7351,8,55973640,55974219,processed_pseudogene,-1,579,chr8_55973640_55974219
Gm7353,7,3109020,3111963,processed_pseudogene,-1,2943,chr7_3109020_3111963
Gm7357,1,4522905,4526737,processed_pseudogene,1,3832,chr1_4522905_4526737
Gm7361,5,26257691,26264308,protein_coding,1,6617,chr5_26257691_26264308
Gm7363,7,3983787,3984185,processed_pseudogene,-1,398,chr7_3983787_3984185
Gm7366,16,65914961,65915591,processed_pseudogene,1,630,chr16_65914961_65915591
Gm7367,7,60155609,60156100,processed_pseudogene,1,491,chr7_60155609_60156100
Gm7368,9,54691136,54691502,processed_pseudogene,-1,366,chr9_54691136_54691502
Gm7369,1,4610471,4611406,processed_pseudogene,1,935,chr1_4610471_4611406
Gm7370,12,44202405,44203171,processed_pseudogene,-1,766,chr12_44202405_44203171
Gm7378,18,4010256,4011157,processed_pseudogene,1,901,chr18_4010256_4011157
Gm7380,7,139774714,139775179,processed_pseudogene,1,465,chr7_139774714_139775179
Gm7381,8,3842096,3842395,processed_pseudogene,-1,299,chr8_3842096_3842395
Gm7382,15,40537321,40538425,processed_pseudogene,1,1104,chr15_40537321_40538425
Gm7384,6,141138047,141138576,processed_pseudogene,1,529,chr6_141138047_141138576
Gm7389,8,3994626,3997509,processed_pseudogene,1,2883,chr8_3994626_3997509
Gm7390,9,4977959,4979174,processed_pseudogene,1,1215,chr9_4977959_4979174
Gm7392,12,47812905,47813249,processed_pseudogene,1,344,chr12_47812905_47813249
Gm7397,8,4018992,4021471,unprocessed_pseudogene,1,2479,chr8_4018992_4021471
Gm7399,10,59806557,59807414,processed_pseudogene,1,857,chr10_59806557_59807414
Gm7400,18,4293099,4294482,processed_pseudogene,-1,1383,chr18_4293099_4294482
Gm7405,X,113225541,113227320,processed_pseudogene,-1,1779,chrX_113225541_113227320
Gm7407,8,4039854,4040421,processed_pseudogene,-1,567,chr8_4039854_4040421
Gm7411,18,4484469,4485501,processed_pseudogene,1,1032,chr18_4484469_4485501
Gm7413,10,59871221,59871682,processed_pseudogene,-1,461,chr10_59871221_59871682
Gm7416,X,114052511,114054304,processed_pseudogene,-1,1793,chrX_114052511_114054304
Gm7418,8,94835717,94836517,processed_pseudogene,1,800,chr8_94835717_94836517
Gm7419,8,56453515,56454439,processed_pseudogene,1,924,chr8_56453515_56454439
Gm7420,5,29217724,29218565,transcribed_processed_pseudogene,1,841,chr5_29217724_29218565
Gm7422,12,46478688,46479327,processed_pseudogene,-1,639,chr12_46478688_46479327
Gm7423,17,15321432,15321882,processed_pseudogene,-1,450,chr17_15321432_15321882
Gm7424,6,83600807,83601708,processed_pseudogene,-1,901,chr6_83600807_83601708
Gm7426,13,13418766,13419169,processed_pseudogene,-1,403,chr13_13418766_13419169
Gm7429,X,114980970,114981317,processed_pseudogene,-1,347,chrX_114980970_114981317
Gm7430,1,159209135,159211141,unprocessed_pseudogene,-1,2006,chr1_159209135_159211141
Gm7432,8,61380509,61381387,processed_pseudogene,-1,878,chr8_61380509_61381387
Gm7434,8,4391726,4392133,processed_pseudogene,1,407,chr8_4391726_4392133
Gm7435,9,55938252,55952409,transcribed_processed_pseudogene,1,14157,chr9_55938252_55952409
Gm7436,9,105545437,105545827,processed_pseudogene,-1,390,chr9_105545437_105545827
Gm7439,9,56021340,56022174,processed_pseudogene,1,834,chr9_56021340_56022174
Gm7441,13,13842242,13844250,processed_pseudogene,1,2008,chr13_13842242_13844250
Gm7442,3,19768873,19769255,processed_pseudogene,1,382,chr3_19768873_19769255
Gm7443,6,83792602,83792979,processed_pseudogene,-1,377,chr6_83792602_83792979
Gm7444,9,56027742,56030169,processed_pseudogene,1,2427,chr9_56027742_56030169
Gm7446,13,13890760,13891999,processed_pseudogene,-1,1239,chr13_13890760_13891999
Gm7447,18,80162752,80163514,processed_pseudogene,1,762,chr18_80162752_80163514
Gm7449,1,6910560,6911222,processed_pseudogene,1,662,chr1_6910560_6911222
Gm7450,17,15575999,15577151,processed_pseudogene,-1,1152,chr17_15575999_15577151
Gm7451,8,4641466,4642857,processed_pseudogene,1,1391,chr8_4641466_4642857
Gm7452,6,36956802,36959888,transcribed_processed_pseudogene,1,3086,chr6_36956802_36959888
Gm7456,12,49140256,49141266,processed_pseudogene,1,1010,chr12_49140256_49141266
Gm7457,6,142814231,142833494,processed_transcript,1,19263,chr6_142814231_142833494
Gm7459,15,44281980,44283775,processed_pseudogene,1,1795,chr15_44281980_44283775
Gm7463,6,37541414,37541960,processed_pseudogene,1,546,chr6_37541414_37541960
Gm7464,18,6557130,6557796,processed_pseudogene,1,666,chr18_6557130_6557796
Gm7466,18,6760516,6760959,processed_pseudogene,-1,443,chr18_6760516_6760959
Gm7467,5,76304876,76305527,antisense,1,651,chr5_76304876_76305527
Gm7468,6,142970662,142971313,processed_pseudogene,-1,651,chr6_142970662_142971313
Gm7470,1,7597379,7599473,processed_pseudogene,1,2094,chr1_7597379_7599473
Gm7473,14,22775018,22775244,processed_pseudogene,-1,226,chr14_22775018_22775244
Gm7476,12,49776115,49776775,processed_pseudogene,-1,660,chr12_49776115_49776775
Gm7477,17,16726453,16727116,processed_pseudogene,1,663,chr17_16726453_16727116
Gm7478,5,117058812,117059392,processed_pseudogene,1,580,chr5_117058812_117059392
Gm7481,12,49840757,49841751,processed_pseudogene,-1,994,chr12_49840757_49841751
Gm7482,7,63810826,63811330,processed_pseudogene,-1,504,chr7_63810826_63811330
Gm7485,X,118697795,118698903,processed_pseudogene,-1,1108,chrX_118697795_118698903
Gm7488,3,21049565,21050248,processed_pseudogene,1,683,chr3_21049565_21050248
Gm7489,15,53884906,53886597,protein_coding,1,1691,chr15_53884906_53886597
Gm7492,6,37865840,37866564,processed_pseudogene,-1,724,chr6_37865840_37866564
Gm7496,1,161821865,161823068,processed_pseudogene,1,1203,chr1_161821865_161823068
Gm7497,18,9748732,9749724,processed_pseudogene,1,992,chr18_9748732_9749724
Gm7498,6,84031588,84032671,processed_pseudogene,1,1083,chr6_84031588_84032671
Gm7499,8,59092611,59093423,processed_pseudogene,-1,812,chr8_59092611_59093423
Gm7502,18,7932782,7933514,processed_pseudogene,1,732,chr18_7932782_7933514
Gm7504,6,38284526,38284949,processed_pseudogene,1,423,chr6_38284526_38284949
Gm7506,8,7001941,7002755,processed_pseudogene,-1,814,chr8_7001941_7002755
Gm7507,6,84812240,84813247,processed_pseudogene,1,1007,chr6_84812240_84813247
Gm7508,15,47421915,47422423,processed_pseudogene,1,508,chr15_47421915_47422423
Gm7512,1,9450579,9451748,processed_pseudogene,1,1169,chr1_9450579_9451748
Gm7513,17,17648821,17649883,processed_pseudogene,1,1062,chr17_17648821_17649883
Gm7514,7,140992580,140993513,processed_pseudogene,-1,933,chr7_140992580_140993513
Gm7516,1,81797241,81797946,processed_pseudogene,1,705,chr1_81797241_81797946
Gm7517,15,48888353,48890024,processed_pseudogene,1,1671,chr15_48888353_48890024
Gm7523,18,8967744,8968796,processed_pseudogene,1,1052,chr18_8967744_8968796
Gm7525,10,12846088,12846541,processed_pseudogene,1,453,chr10_12846088_12846541
Gm7527,18,9495621,9496509,processed_pseudogene,1,888,chr18_9495621_9496509
Gm7529,9,10734640,10736536,processed_pseudogene,1,1896,chr9_10734640_10736536
Gm7530,10,63412999,63413603,processed_pseudogene,1,604,chr10_63412999_63413603
Gm7532,18,9538258,9539766,processed_pseudogene,1,1508,chr18_9538258_9539766
Gm7536,3,24333068,24333511,processed_pseudogene,1,443,chr3_24333068_24333511
Gm7537,13,16638077,16639490,processed_pseudogene,-1,1413,chr13_16638077_16639490
Gm7539,1,83015393,83016022,processed_pseudogene,1,629,chr1_83015393_83016022
Gm7541,16,8623186,8623720,processed_pseudogene,-1,534,chr16_8623186_8623720
Gm7542,6,85938439,85939215,processed_pseudogene,1,776,chr6_85938439_85939215
Gm7543,15,52259123,52259694,processed_pseudogene,1,571,chr15_52259123_52259694
Gm7545,6,86284887,86285894,processed_pseudogene,1,1007,chr6_86284887_86285894
Gm7551,7,65784859,65785932,processed_pseudogene,1,1073,chr7_65784859_65785932
Gm7553,1,83003482,83004907,processed_pseudogene,-1,1425,chr1_83003482_83004907
Gm7554,6,39828200,39828773,processed_pseudogene,-1,573,chr6_39828200_39828773
Gm7556,6,39843212,39844295,processed_pseudogene,-1,1083,chr6_39843212_39844295
Gm7557,12,54429534,54430398,processed_pseudogene,-1,864,chr12_54429534_54430398
Gm7558,3,27046789,27047953,processed_pseudogene,-1,1164,chr3_27046789_27047953
Gm7560,1,12120960,12121832,processed_pseudogene,1,872,chr1_12120960_12121832
Gm7561,8,62546946,62547831,processed_pseudogene,-1,885,chr8_62546946_62547831
Gm7565,14,26565766,26566388,processed_pseudogene,1,622,chr14_26565766_26566388
Gm7570,9,12819525,12820222,processed_pseudogene,1,697,chr9_12819525_12820222
Gm7571,6,147173481,147175116,processed_pseudogene,1,1635,chr6_147173481_147175116
Gm7572,16,10044965,10045730,processed_pseudogene,1,765,chr16_10044965_10045730
Gm7575,18,10928884,10931510,processed_pseudogene,1,2626,chr18_10928884_10931510
Gm7577,15,54764532,54765513,processed_pseudogene,-1,981,chr15_54764532_54765513
Gm7584,10,17817379,17818318,processed_pseudogene,1,939,chr10_17817379_17818318
Gm7587,7,6533491,6534511,processed_pseudogene,-1,1020,chr7_6533491_6534511
Gm7588,9,13868706,13869276,processed_pseudogene,1,570,chr9_13868706_13869276
Gm7589,9,59145677,59146210,processed_pseudogene,-1,533,chr9_59145677_59146210
Gm7591,14,27210397,27211249,processed_pseudogene,1,852,chr14_27210397_27211249
Gm7593,1,13407012,13407655,processed_pseudogene,-1,643,chr1_13407012_13407655
Gm7594,10,68691503,68692373,processed_pseudogene,-1,870,chr10_68691503_68692373
Gm7595,15,55973605,55974505,processed_pseudogene,1,900,chr15_55973605_55974505
Gm7598,X,38476461,38482486,lincRNA,1,6025,chrX_38476461_38482486
Gm7599,18,12742464,12743259,processed_pseudogene,-1,795,chr18_12742464_12743259
Gm7600,8,11683459,11684243,processed_pseudogene,-1,784,chr8_11683459_11684243
Gm7604,14,27551191,27552158,processed_pseudogene,-1,967,chr14_27551191_27552158
Gm7609,1,85199613,85213786,protein_coding,1,14173,chr1_85199613_85213786
Gm7613,9,59766717,59767203,processed_pseudogene,-1,486,chr9_59766717_59767203
Gm7614,13,20748498,20748825,processed_pseudogene,1,327,chr13_20748498_20748825
Gm7616,9,59951285,59959044,antisense,1,7759,chr9_59951285_59959044
Gm7618,6,148900968,148901138,processed_pseudogene,-1,170,chr6_148900968_148901138
Gm7619,8,65131033,65132314,processed_pseudogene,-1,1281,chr8_65131033_65132314
Gm7621,14,30402002,30402988,processed_pseudogene,1,986,chr14_30402002_30402988
Gm7622,13,61665941,61667140,processed_pseudogene,1,1199,chr13_61665941_61667140
Gm7626,1,166043339,166043691,processed_pseudogene,-1,352,chr1_166043339_166043691
Gm7627,7,69605842,69606840,processed_pseudogene,-1,998,chr7_69605842_69606840
Gm7631,5,86976820,86991777,unprocessed_pseudogene,1,14957,chr5_86976820_86991777
Gm7633,14,29902950,29907588,transcribed_processed_pseudogene,1,4638,chr14_29902950_29907588
Gm7634,1,16053335,16053887,processed_pseudogene,1,552,chr1_16053335_16053887
Gm7639,8,67053650,67054133,processed_pseudogene,-1,483,chr8_67053650_67054133
Gm7642,9,15644283,15646091,processed_pseudogene,1,1808,chr9_15644283_15646091
Gm7645,2,181292148,181292935,processed_pseudogene,1,787,chr2_181292148_181292935
Gm7648,7,7585300,7596549,unprocessed_pseudogene,-1,11249,chr7_7585300_7596549
Gm765,6,98235708,98342754,protein_coding,-1,107046,chr6_98235708_98342754
Gm7653,9,62789904,62790411,processed_pseudogene,1,507,chr9_62789904_62790411
Gm7654,1,16662980,16663662,processed_pseudogene,-1,682,chr1_16662980_16663662
Gm7656,7,70490848,70491851,processed_pseudogene,1,1003,chr7_70490848_70491851
Gm7658,1,21511933,21513056,processed_pseudogene,-1,1123,chr1_21511933_21513056
Gm7662,18,88657992,88658614,processed_pseudogene,-1,622,chr18_88657992_88658614
Gm7664,13,62528216,62528960,processed_pseudogene,-1,744,chr13_62528216_62528960
Gm7665,18,16274648,16274944,processed_pseudogene,-1,296,chr18_16274648_16274944
Gm7666,15,6653923,6654741,transcribed_processed_pseudogene,1,818,chr15_6653923_6654741
Gm7667,16,88682104,88682728,processed_pseudogene,-1,624,chr16_88682104_88682728
Gm7669,8,13745876,13747478,processed_pseudogene,-1,1602,chr8_13745876_13747478
Gm7670,18,16839317,16839957,processed_pseudogene,-1,640,chr18_16839317_16839957
Gm7672,10,22046114,22046985,processed_pseudogene,-1,871,chr10_22046114_22046985
Gm7674,18,90321891,90322880,processed_pseudogene,-1,989,chr18_90321891_90322880
Gm7676,8,13896311,13896629,processed_pseudogene,1,318,chr8_13896311_13896629
Gm7678,10,22124496,22125438,processed_pseudogene,1,942,chr10_22124496_22125438
Gm7680,9,18022224,18023571,processed_pseudogene,1,1347,chr9_18022224_18023571
Gm7684,8,69239202,69240030,processed_pseudogene,-1,828,chr8_69239202_69240030
Gm7688,8,69329218,69329554,processed_pseudogene,1,336,chr8_69329218_69329554
Gm7690,1,17947041,17948439,processed_pseudogene,1,1398,chr1_17947041_17948439
Gm7691,15,59238489,59239002,processed_pseudogene,1,513,chr15_59238489_59239002
Gm7692,9,18289452,18289860,processed_pseudogene,-1,408,chr9_18289452_18289860
Gm7693,7,72712634,72713621,processed_pseudogene,-1,987,chr7_72712634_72713621
Gm7694,1,170298199,170306332,protein_coding,-1,8133,chr1_170298199_170306332
Gm7695,13,63945881,63946521,processed_pseudogene,-1,640,chr13_63945881_63946521
Gm7697,8,69481346,69522976,protein_coding,-1,41630,chr8_69481346_69522976
Gm7700,X,44862880,44863849,processed_pseudogene,1,969,chrX_44862880_44863849
Gm7701,18,24257378,24258856,processed_pseudogene,1,1478,chr18_24257378_24258856
Gm7707,14,32266593,32267748,processed_pseudogene,-1,1155,chr14_32266593_32267748
Gm7708,15,59929618,59930290,processed_pseudogene,-1,672,chr15_59929618_59930290
Gm7709,5,88062516,88064373,processed_pseudogene,1,1857,chr5_88062516_88064373
Gm7712,13,64454413,64458923,transcribed_processed_pseudogene,-1,4510,chr13_64454413_64458923
Gm7713,15,59993886,59994892,processed_pseudogene,-1,1006,chr15_59993886_59994892
Gm7719,12,59291964,59292938,processed_pseudogene,1,974,chr12_59291964_59292938
Gm7720,18,19549778,19554960,transcribed_processed_pseudogene,-1,5182,chr18_19549778_19554960
Gm7721,5,88427813,88428358,processed_pseudogene,1,545,chr5_88427813_88428358
Gm7722,X,46535855,46536625,unprocessed_pseudogene,-1,770,chrX_46535855_46536625
Gm7727,12,59645496,59646166,processed_pseudogene,-1,670,chr12_59645496_59646166
Gm7729,18,27598644,27599756,unprocessed_pseudogene,1,1112,chr18_27598644_27599756
Gm773,X,56189827,56212881,protein_coding,-1,23054,chrX_56189827_56212881
Gm7730,8,70010549,70011002,processed_pseudogene,-1,453,chr8_70010549_70011002
Gm7733,3,35536882,35537800,processed_pseudogene,-1,918,chr3_35536882_35537800
Gm7734,14,32897719,32898729,processed_pseudogene,1,1010,chr14_32897719_32898729
Gm7739,12,60526518,60528077,processed_pseudogene,1,1559,chr12_60526518_60528077
Gm7741,3,35863877,35864865,processed_pseudogene,1,988,chr3_35863877_35864865
Gm7745,12,61302553,61354674,transcribed_processed_pseudogene,-1,52121,chr12_61302553_61354674
Gm7748,16,15609107,15609515,processed_pseudogene,1,408,chr16_15609107_15609515
Gm7751,9,19364855,19365563,processed_pseudogene,1,708,chr9_19364855_19365563
Gm7753,12,61888923,61890604,processed_pseudogene,-1,1681,chr12_61888923_61890604
Gm7754,12,62161957,62170247,processed_pseudogene,1,8290,chr12_62161957_62170247
Gm7760,8,19711128,19711705,processed_pseudogene,-1,577,chr8_19711128_19711705
Gm7762,13,65336222,65348597,lincRNA,-1,12375,chr13_65336222_65348597
Gm7763,12,62882277,62883282,processed_pseudogene,-1,1005,chr12_62882277_62883282
Gm7765,16,16365184,16366157,processed_pseudogene,-1,973,chr16_16365184_16366157
Gm7768,13,65368150,65368746,processed_pseudogene,-1,596,chr13_65368150_65368746
Gm7769,9,19690619,19691551,processed_pseudogene,1,932,chr9_19690619_19691551
Gm7773,17,23642237,23643144,processed_pseudogene,1,907,chr17_23642237_23643144
Gm7774,5,126025941,126026473,processed_pseudogene,-1,532,chr5_126025941_126026473
Gm7775,10,77137100,77137952,processed_pseudogene,1,852,chr10_77137100_77137952
Gm7776,1,91171429,91172148,processed_pseudogene,-1,719,chr1_91171429_91172148
Gm7778,14,34139448,34139815,processed_pseudogene,1,367,chr14_34139448_34139815
Gm7780,9,114647630,114648035,processed_pseudogene,-1,405,chr9_114647630_114648035
Gm7781,X,130524637,130525424,processed_pseudogene,1,787,chrX_130524637_130525424
Gm7783,6,43856124,43856904,processed_pseudogene,-1,780,chr6_43856124_43856904
Gm7784,1,23479539,23480527,processed_pseudogene,1,988,chr1_23479539_23480527
Gm7787,9,67748077,67748764,processed_pseudogene,-1,687,chr9_67748077_67748764
Gm7788,18,23216669,23217611,processed_pseudogene,1,942,chr18_23216669_23217611
Gm7791,10,25251500,25252038,processed_pseudogene,1,538,chr10_25251500_25252038
Gm7798,19,3248804,3250214,processed_pseudogene,1,1410,chr19_3248804_3250214
Gm7803,X,50325518,50326532,processed_pseudogene,-1,1014,chrX_50325518_50326532
Gm7804,1,172458569,172474969,transcribed_processed_pseudogene,1,16400,chr1_172458569_172474969
Gm7807,8,20381081,20381658,processed_pseudogene,1,577,chr8_20381081_20381658
Gm7808,9,19927896,19928282,processed_pseudogene,-1,386,chr9_19927896_19928282
Gm7814,15,65195339,65195778,processed_pseudogene,1,439,chr15_65195339_65195778
Gm7815,3,38438962,38439793,processed_pseudogene,-1,831,chr3_38438962_38439793
Gm7816,5,39798214,39799407,processed_pseudogene,1,1193,chr5_39798214_39799407
Gm7818,17,22067264,22069888,processed_pseudogene,-1,2624,chr17_22067264_22069888
Gm7820,X,132888108,132889159,processed_pseudogene,-1,1051,chrX_132888108_132889159
Gm7823,X,133093940,133095562,processed_pseudogene,-1,1622,chrX_133093940_133095562
Gm7824,3,38558137,38558668,processed_pseudogene,-1,531,chr3_38558137_38558668
Gm7825,6,94417829,94418244,processed_pseudogene,1,415,chr6_94417829_94418244
Gm7832,5,91760696,91761575,processed_pseudogene,-1,879,chr5_91760696_91761575
Gm7833,6,94820530,94821519,processed_pseudogene,1,989,chr6_94820530_94821519
Gm7834,X,51212511,51212947,processed_pseudogene,-1,436,chrX_51212511_51212947
Gm7838,6,95925741,95926929,processed_pseudogene,-1,1188,chr6_95925741_95926929
Gm7841,X,134052787,134054415,processed_pseudogene,-1,1628,chrX_134052787_134054415
Gm7842,10,78628922,78630300,processed_pseudogene,-1,1378,chr10_78628922_78630300
Gm7846,1,28580499,28580772,processed_pseudogene,-1,273,chr1_28580499_28580772
Gm7847,18,25823581,25824357,processed_pseudogene,-1,776,chr18_25823581_25824357
Gm7854,5,43151686,43235355,antisense,-1,83669,chr5_43151686_43235355
Gm7855,X,134625058,134625744,processed_pseudogene,-1,686,chrX_134625058_134625744
Gm7856,16,91513141,91514633,processed_pseudogene,-1,1492,chr16_91513141_91514633
Gm7858,1,29930094,29930715,processed_pseudogene,1,621,chr1_29930094_29930715
Gm7859,15,68715009,68715763,processed_pseudogene,-1,754,chr15_68715009_68715763
Gm7860,16,91539182,91540060,processed_pseudogene,-1,878,chr16_91539182_91540060
Gm7863,9,72128587,72129391,processed_pseudogene,1,804,chr9_72128587_72129391
Gm7868,12,69123101,69123780,processed_pseudogene,1,679,chr12_69123101_69123780
Gm7869,8,21708029,21709350,processed_pseudogene,1,1321,chr8_21708029_21709350
Gm7870,9,72209555,72210170,processed_pseudogene,1,615,chr9_72209555_72210170
Gm7879,5,43913144,43913917,protein_coding,1,773,chr5_43913144_43913917
Gm7880,6,48381190,48382060,processed_pseudogene,-1,870,chr6_48381190_48382060
Gm7887,6,48524554,48525090,processed_pseudogene,-1,536,chr6_48524554_48525090
Gm7889,1,93975353,93985816,unprocessed_pseudogene,1,10463,chr1_93975353_93985816
Gm7890,6,49080462,49081062,processed_pseudogene,-1,600,chr6_49080462_49081062
Gm7893,1,31164549,31164773,processed_pseudogene,1,224,chr1_31164549_31164773
Gm7895,1,94468715,94469887,processed_pseudogene,-1,1172,chr1_94468715_94469887
Gm7898,17,23515454,23515784,processed_pseudogene,1,330,chr17_23515454_23515784
Gm7899,3,41976152,41978048,processed_pseudogene,-1,1896,chr3_41976152_41978048
Gm7901,8,75711600,75713196,processed_pseudogene,-1,1596,chr8_75711600_75713196
Gm7902,5,133841573,133842519,processed_pseudogene,-1,946,chr5_133841573_133842519
Gm7904,9,21607863,21608327,processed_pseudogene,-1,464,chr9_21607863_21608327
Gm7905,X,135470455,135473530,unprocessed_pseudogene,1,3075,chrX_135470455_135473530
Gm7908,15,73407489,73408239,processed_pseudogene,-1,750,chr15_73407489_73408239
Gm7909,10,31574400,31575013,processed_pseudogene,-1,613,chr10_31574400_31575013
Gm7910,1,31736057,31736891,processed_pseudogene,1,834,chr1_31736057_31736891
Gm7911,13,66875090,66875710,processed_pseudogene,-1,620,chr13_66875090_66875710
Gm7912,17,23619236,23620900,processed_pseudogene,-1,1664,chr17_23619236_23620900
Gm7924,6,102071466,102072250,processed_pseudogene,1,784,chr6_102071466_102072250
Gm7926,18,30419686,30420060,processed_pseudogene,-1,374,chr18_30419686_30420060
Gm7927,X,55845759,55846638,processed_pseudogene,-1,879,chrX_55845759_55846638
Gm7928,13,67460000,67460700,processed_pseudogene,1,700,chr13_67460000_67460700
Gm7931,5,46414344,46414614,processed_pseudogene,1,270,chr5_46414344_46414614
Gm7932,6,48860329,48866083,lincRNA,1,5754,chr6_48860329_48866083
Gm7933,1,33371331,33373585,processed_pseudogene,1,2254,chr1_33371331_33373585
Gm7935,15,74080234,74081511,processed_pseudogene,-1,1277,chr15_74080234_74081511
Gm7936,18,30495004,30495373,processed_pseudogene,-1,369,chr18_30495004_30495373
Gm7940,10,33972801,33973569,processed_pseudogene,-1,768,chr10_33972801_33973569
Gm7941,18,31349183,31350204,processed_pseudogene,-1,1021,chr18_31349183_31350204
Gm7946,6,103550893,103551850,processed_pseudogene,-1,957,chr6_103550893_103551850
Gm7947,17,9321902,9323795,processed_pseudogene,-1,1893,chr17_9321902_9323795
Gm7948,8,73871693,73872536,processed_pseudogene,1,843,chr8_73871693_73872536
Gm7952,1,98263523,98264506,processed_pseudogene,1,983,chr1_98263523_98264506
Gm7959,12,71268744,71270357,processed_pseudogene,-1,1613,chr12_71268744_71270357
Gm7962,15,3217391,3219698,processed_pseudogene,-1,2307,chr15_3217391_3219698
Gm7964,7,83755904,83757281,processed_pseudogene,1,1377,chr7_83755904_83757281
Gm7965,7,13150477,13151581,processed_pseudogene,-1,1104,chr7_13150477_13151581
Gm7967,1,98589517,98607384,lincRNA,1,17867,chr1_98589517_98607384
Gm7972,9,75468616,75486681,transcribed_unprocessed_pseudogene,1,18065,chr9_75468616_75486681
Gm7973,X,136340181,136340668,processed_pseudogene,1,487,chrX_136340181_136340668
Gm7977,3,48026013,48026760,processed_pseudogene,-1,747,chr3_48026013_48026760
Gm7979,13,68856533,68857557,processed_pseudogene,1,1024,chr13_68856533_68857557
Gm7982,5,95742014,95746617,protein_coding,1,4603,chr5_95742014_95746617
Gm7984,8,75398511,75399048,processed_pseudogene,1,537,chr8_75398511_75399048
Gm7985,12,71846311,71847291,processed_pseudogene,-1,980,chr12_71846311_71847291
Gm7986,12,72048709,72049259,processed_pseudogene,-1,550,chr12_72048709_72049259
Gm7988,5,49900006,49902302,processed_pseudogene,-1,2296,chr5_49900006_49902302
Gm7990,8,76395132,76395724,processed_pseudogene,-1,592,chr8_76395132_76395724
Gm7993,5,95974240,95975623,processed_pseudogene,1,1383,chr5_95974240_95975623
Gm7995,14,42310210,42325394,protein_coding,1,15184,chr14_42310210_42325394
Gm7997,8,80770691,80771670,processed_pseudogene,1,979,chr8_80770691_80771670
Gm8000,15,74986591,74988460,unprocessed_pseudogene,-1,1869,chr15_74986591_74988460
Gm8009,1,34970065,34970500,processed_pseudogene,1,435,chr1_34970065_34970500
Gm8010,1,178143301,178144272,unprocessed_pseudogene,1,971,chr1_178143301_178144272
Gm8013,5,96921272,96934867,lincRNA,1,13595,chr5_96921272_96934867
Gm8018,7,84879555,84882525,unprocessed_pseudogene,1,2970,chr7_84879555_84882525
Gm8019,X,137099516,137100102,processed_pseudogene,1,586,chrX_137099516_137100102
Gm8023,1,178266204,178267106,processed_pseudogene,1,902,chr1_178266204_178267106
Gm8031,9,25228444,25229069,processed_pseudogene,-1,625,chr9_25228444_25229069
Gm8034,19,6044691,6044822,processed_pseudogene,-1,131,chr19_6044691_6044822
Gm8036,X,137203615,137206763,processed_pseudogene,-1,3148,chrX_137203615_137206763
Gm8038,6,50619841,50621884,processed_pseudogene,-1,2043,chr6_50619841_50621884
Gm8041,5,98075303,98075918,processed_pseudogene,-1,615,chr5_98075303_98075918
Gm8043,15,5866235,5867093,processed_pseudogene,1,858,chr15_5866235_5867093
Gm8048,5,98153181,98154176,processed_pseudogene,1,995,chr5_98153181_98154176
Gm8049,9,25450462,25452243,processed_pseudogene,1,1781,chr9_25450462_25452243
Gm805,12,86169341,86195102,lincRNA,1,25761,chr12_86169341_86195102
Gm8050,14,6712183,6720251,protein_coding,-1,8068,chr14_6712183_6720251
Gm8054,8,78869386,78869868,processed_pseudogene,-1,482,chr8_78869386_78869868
Gm8055,10,40011866,40012873,processed_pseudogene,1,1007,chr10_40011866_40012873
Gm8058,9,78068851,78069437,processed_pseudogene,1,586,chr9_78068851_78069437
Gm8061,X,139358468,139359257,processed_pseudogene,1,789,chrX_139358468_139359257
Gm8069,5,54651968,54652121,processed_pseudogene,-1,153,chr5_54651968_54652121
Gm807,13,99100706,99107580,lincRNA,1,6874,chr13_99100706_99107580
Gm8079,8,79549774,79550748,processed_pseudogene,-1,974,chr8_79549774_79550748
Gm8083,6,112992122,112992596,processed_pseudogene,1,474,chr6_112992122_112992596
Gm8091,5,100220440,100355119,unprocessed_pseudogene,-1,134679,chr5_100220440_100355119
Gm8093,9,78427507,78430805,transcribed_processed_pseudogene,1,3298,chr9_78427507_78430805
Gm8096,8,28083330,28084920,processed_pseudogene,-1,1590,chr8_28083330_28084920
Gm8099,5,137928275,137929016,processed_pseudogene,1,741,chr5_137928275_137929016
Gm8100,8,28185840,28186827,processed_pseudogene,1,987,chr8_28185840_28186827
Gm8101,1,180721614,180722091,processed_pseudogene,1,477,chr1_180721614_180722091
Gm8106,9,27611600,27612122,processed_pseudogene,1,522,chr9_27611600_27612122
Gm8108,14,4110526,4132784,protein_coding,1,22258,chr14_4110526_4132784
Gm8109,3,54021164,54021909,processed_pseudogene,1,745,chr3_54021164_54021909
Gm8112,10,81693721,81694185,processed_pseudogene,-1,464,chr10_81693721_81694185
Gm8115,5,57261272,57262007,processed_pseudogene,1,735,chr5_57261272_57262007
Gm8116,9,78820638,78821838,processed_pseudogene,-1,1200,chr9_78820638_78821838
Gm8118,16,22685350,22686194,processed_pseudogene,-1,844,chr16_22685350_22686194
Gm8121,5,57608569,57609067,processed_pseudogene,1,498,chr5_57608569_57609067
Gm8126,14,43258649,43266799,protein_coding,1,8150,chr14_43258649_43266799
Gm8129,6,52346730,52346942,processed_pseudogene,-1,212,chr6_52346730_52346942
Gm8130,16,23050282,23050851,processed_pseudogene,1,569,chr16_23050282_23050851
Gm8132,6,114168884,114169523,processed_pseudogene,-1,639,chr6_114168884_114169523
Gm8134,16,23092943,23094465,processed_pseudogene,1,1522,chr16_23092943_23094465
Gm8139,15,9250522,9261332,unprocessed_pseudogene,-1,10810,chr15_9250522_9261332
Gm8141,1,109833024,109834746,processed_pseudogene,1,1722,chr1_109833024_109834746
Gm8146,1,181282046,181283892,processed_pseudogene,1,1846,chr1_181282046_181283892
Gm8151,9,81016088,81016958,processed_pseudogene,-1,870,chr9_81016088_81016958
Gm8153,10,81887013,81887964,processed_pseudogene,1,951,chr10_81887013_81887964
Gm8155,10,3139447,3141058,processed_pseudogene,-1,1611,chr10_3139447_3141058
Gm8157,19,7727185,7727664,processed_pseudogene,-1,479,chr19_7727185_7727664
Gm8162,9,31434043,31434707,processed_pseudogene,-1,664,chr9_31434043_31434707
Gm8163,X,60724635,60727448,processed_pseudogene,-1,2813,chrX_60724635_60727448
Gm8167,8,82577767,82578724,processed_pseudogene,1,957,chr8_82577767_82578724
Gm8168,8,31279867,31280814,processed_pseudogene,-1,947,chr8_31279867_31280814
Gm8170,10,82020551,82021495,processed_pseudogene,1,944,chr10_82020551_82021495
Gm8171,9,31782984,31783703,processed_pseudogene,1,719,chr9_31782984_31783703
Gm8172,X,69605496,69606245,processed_pseudogene,-1,749,chrX_69605496_69606245
Gm8173,1,111804934,111807775,processed_pseudogene,-1,2841,chr1_111804934_111807775
Gm8174,15,10560524,10561524,processed_pseudogene,-1,1000,chr15_10560524_10561524
Gm8177,3,57135496,57136831,processed_pseudogene,-1,1335,chr3_57135496_57136831
Gm8178,4,147378929,147379574,processed_pseudogene,1,645,chr4_147378929_147379574
Gm8181,18,43171159,43171824,processed_pseudogene,1,665,chr18_43171159_43171824
Gm8182,5,60821659,60822427,processed_pseudogene,-1,768,chr5_60821659_60822427
Gm8184,19,8272512,8274705,processed_pseudogene,1,2193,chr19_8272512_8274705
Gm8185,13,76935163,76935831,processed_pseudogene,1,668,chr13_76935163_76935831
Gm8186,17,26098991,26099221,processed_pseudogene,-1,230,chr17_26098991_26099221
Gm8188,10,82430704,82432393,processed_pseudogene,1,1689,chr10_82430704_82432393
Gm8190,5,108154245,108154830,processed_pseudogene,-1,585,chr5_108154245_108154830
Gm8192,11,32774682,32775639,processed_pseudogene,-1,957,chr11_32774682_32775639
Gm8194,14,44021600,44022458,processed_pseudogene,-1,858,chr14_44021600_44022458
Gm8199,X,144232759,144233581,processed_pseudogene,-1,822,chrX_144232759_144233581
Gm8202,X,144236903,144237212,processed_pseudogene,-1,309,chrX_144236903_144237212
Gm8203,6,116173737,116174123,processed_pseudogene,1,386,chr6_116173737_116174123
Gm8209,7,16693817,16694369,processed_pseudogene,-1,552,chr7_16693817_16694369
Gm8210,1,43189156,43189638,processed_pseudogene,1,482,chr1_43189156_43189638
Gm8213,6,116195418,116195858,processed_pseudogene,-1,440,chr6_116195418_116195858
Gm8216,X,144847683,144848283,processed_pseudogene,1,600,chrX_144847683_144848283
Gm8219,12,77819582,77819823,processed_pseudogene,1,241,chr12_77819582_77819823
Gm8221,15,77621834,77626637,unprocessed_pseudogene,1,4803,chr15_77621834_77626637
Gm8222,19,16490522,16491064,processed_pseudogene,-1,542,chr19_16490522_16491064
Gm8225,17,26542760,26543715,processed_pseudogene,1,955,chr17_26542760_26543715
Gm8226,9,84423984,84424781,processed_pseudogene,1,797,chr9_84423984_84424781
Gm8227,13,74381629,74382199,processed_pseudogene,-1,570,chr13_74381629_74382199
Gm8228,9,84973053,84976515,processed_pseudogene,-1,3462,chr9_84973053_84976515
Gm8231,13,34865795,34866577,processed_pseudogene,-1,782,chr13_34865795_34866577
Gm8234,3,58652053,58653159,processed_pseudogene,1,1106,chr3_58652053_58653159
Gm8238,15,13418422,13418856,processed_pseudogene,-1,434,chr15_13418422_13418856
Gm8241,1,43898294,43899109,processed_pseudogene,1,815,chr1_43898294_43899109
Gm8245,13,34940643,34941629,processed_pseudogene,1,986,chr13_34940643_34941629
Gm8253,16,28950923,28951355,processed_pseudogene,-1,432,chr16_28950923_28951355
Gm8254,8,34321853,34322824,processed_pseudogene,-1,971,chr8_34321853_34322824
Gm8258,5,104775779,104777227,processed_pseudogene,1,1448,chr5_104775779_104777227
Gm826,2,160311393,160334162,protein_coding,-1,22769,chr2_160311393_160334162
Gm8261,X,146599751,146600958,processed_pseudogene,-1,1207,chrX_146599751_146600958
Gm8268,8,34507207,34507664,processed_pseudogene,1,457,chr8_34507207_34507664
Gm8275,12,79979428,79979851,processed_pseudogene,-1,423,chr12_79979428_79979851
Gm8276,3,59431537,59433348,processed_pseudogene,1,1811,chr3_59431537_59433348
Gm8277,13,36558466,36559065,processed_pseudogene,-1,599,chr13_36558466_36559065
Gm8278,13,75515897,75518414,processed_pseudogene,-1,2517,chr13_75515897_75518414
Gm8281,14,5071040,5093318,protein_coding,1,22278,chr14_5071040_5093318
Gm8282,9,87127334,87127816,processed_pseudogene,1,482,chr9_87127334_87127816
Gm8285,7,93564937,93565695,processed_pseudogene,-1,758,chr7_93564937_93565695
Gm8288,13,75802706,75803298,processed_pseudogene,1,592,chr13_75802706_75803298
Gm8290,10,82008379,82008855,processed_pseudogene,1,476,chr10_82008379_82008855
Gm8291,8,35052123,35053383,processed_pseudogene,-1,1260,chr8_35052123_35053383
Gm8292,1,55335401,55335796,processed_pseudogene,1,395,chr1_55335401_55335796
Gm8296,1,45513532,45514055,processed_pseudogene,-1,523,chr1_45513532_45514055
Gm8300,12,87514316,87518266,protein_coding,1,3950,chr12_87514316_87518266
Gm8302,18,38771496,38772347,processed_pseudogene,-1,851,chr18_38771496_38772347
Gm8304,1,45602026,45602753,processed_pseudogene,1,727,chr1_45602026_45602753
Gm8309,7,95461991,95463438,processed_pseudogene,1,1447,chr7_95461991_95463438
Gm831,4,131487197,131505527,lincRNA,1,18330,chr4_131487197_131505527
Gm8314,7,18454742,18456688,processed_pseudogene,-1,1946,chr7_18454742_18456688
Gm8317,14,45858076,45858546,processed_pseudogene,-1,470,chr14_45858076_45858546
Gm8318,15,18163881,18164752,processed_pseudogene,1,871,chr15_18163881_18164752
Gm8319,7,96202896,96203536,processed_pseudogene,-1,640,chr7_96202896_96203536
Gm8321,1,119157586,119158565,processed_pseudogene,1,979,chr1_119157586_119158565
Gm8325,3,60877014,60877587,transcribed_processed_pseudogene,1,573,chr3_60877014_60877587
Gm8326,1,46414502,46416932,processed_pseudogene,1,2430,chr1_46414502_46416932
Gm8328,15,19066151,19066569,processed_pseudogene,-1,418,chr15_19066151_19066569
Gm8330,10,13890646,13891653,processed_pseudogene,-1,1007,chr10_13890646_13891653
Gm8332,12,88249666,88250100,protein_coding,-1,434,chr12_88249666_88250100
Gm8337,1,47657693,47659630,processed_pseudogene,1,1937,chr1_47657693_47659630
Gm8338,1,119817763,119818125,processed_pseudogene,1,362,chr1_119817763_119818125
Gm8341,15,19454755,19456352,processed_pseudogene,-1,1597,chr15_19454755_19456352
Gm8342,8,37094703,37095459,processed_pseudogene,1,756,chr8_37094703_37095459
Gm8343,9,37685941,37686934,processed_pseudogene,1,993,chr9_37685941_37686934
Gm8345,13,78953088,78954792,processed_pseudogene,-1,1704,chr13_78953088_78954792
Gm8349,3,61461859,61462861,processed_pseudogene,-1,1002,chr3_61461859_61462861
Gm8352,13,40496188,40497473,processed_pseudogene,1,1285,chr13_40496188_40497473
Gm8353,14,47419758,47420189,processed_pseudogene,-1,431,chr14_47419758_47420189
Gm8355,10,14745362,14747302,processed_pseudogene,-1,1940,chr10_14745362_14747302
Gm8357,1,48881713,48882723,processed_pseudogene,1,1010,chr1_48881713_48882723
Gm8358,12,82543636,82544190,processed_pseudogene,1,554,chr12_82543636_82544190
Gm8363,17,5481123,5482964,processed_pseudogene,-1,1841,chr17_5481123_5482964
Gm8365,5,106738117,106738764,processed_pseudogene,-1,647,chr5_106738117_106738764
Gm8367,1,49236252,49237244,processed_pseudogene,1,992,chr1_49236252_49237244
Gm8369,19,11485938,11512577,protein_coding,1,26639,chr19_11485938_11512577
Gm8371,13,80161328,80161879,processed_pseudogene,1,551,chr13_80161328_80161879
Gm8375,15,80229127,80229923,processed_pseudogene,-1,796,chr15_80229127_80229923
Gm8376,17,5939087,5939729,processed_pseudogene,1,642,chr17_5939087_5939729
Gm8384,1,50056782,50058490,processed_pseudogene,1,1708,chr1_50056782_50058490
Gm8387,16,32326181,32326695,processed_pseudogene,-1,514,chr16_32326181_32326695
Gm8388,3,63173106,63173861,processed_pseudogene,-1,755,chr3_63173106_63173861
Gm8390,18,44061598,44062204,processed_pseudogene,1,606,chr18_44061598_44062204
Gm8391,1,50177566,50178291,processed_pseudogene,-1,725,chr1_50177566_50178291
Gm8392,1,122190221,122191055,processed_pseudogene,1,834,chr1_122190221_122191055
Gm8396,14,7801208,7802030,processed_pseudogene,1,822,chr14_7801208_7802030
Gm8399,13,81064684,81065800,processed_pseudogene,1,1116,chr13_81064684_81065800
Gm8401,X,70517777,70519515,processed_pseudogene,1,1738,chrX_70517777_70519515
Gm8407,1,191001425,191001851,processed_pseudogene,-1,426,chr1_191001425_191001851
Gm8408,15,24203884,24205570,processed_pseudogene,-1,1686,chr15_24203884_24205570
Gm8410,X,70770867,70771471,processed_pseudogene,1,604,chrX_70770867_70771471
Gm8417,14,49802785,49826516,transcribed_unprocessed_pseudogene,1,23731,chr14_49802785_49826516
Gm8419,1,51938254,51938665,processed_pseudogene,-1,411,chr1_51938254_51938665
Gm8420,1,51940664,51941261,processed_pseudogene,-1,597,chr1_51940664_51941261
Gm8423,8,40712681,40713287,processed_pseudogene,-1,606,chr8_40712681_40713287
Gm8428,6,8377596,8379379,processed_pseudogene,-1,1783,chr6_8377596_8379379
Gm8430,6,122456904,122457374,processed_pseudogene,1,470,chr6_122456904_122457374
Gm8435,10,88641379,88642170,processed_pseudogene,1,791,chr10_88641379_88642170
Gm8436,8,40789057,40790136,processed_pseudogene,-1,1079,chr8_40789057_40790136
Gm8439,4,120588745,120609673,protein_coding,1,20928,chr4_120588745_120609673
Gm8444,15,81843346,81843713,processed_pseudogene,-1,367,chr15_81843346_81843713
Gm8446,Y,1946919,1973442,unprocessed_pseudogene,1,26523,chrY_1946919_1973442
Gm8447,13,83997547,83998439,processed_pseudogene,-1,892,chr13_83997547_83998439
Gm8449,9,95410669,95411656,processed_pseudogene,-1,987,chr9_95410669_95411656
Gm8451,1,127282662,127283108,processed_pseudogene,-1,446,chr1_127282662_127283108
Gm8454,5,146017031,146017841,processed_pseudogene,-1,810,chr5_146017031_146017841
Gm8459,6,122566715,122567474,processed_pseudogene,-1,759,chr6_122566715_122567474
Gm8463,7,100524016,100524628,processed_pseudogene,1,612,chr7_100524016_100524628
Gm8468,18,47116552,47117374,processed_pseudogene,1,822,chr18_47116552_47117374
Gm8472,15,28123259,28123621,processed_pseudogene,-1,362,chr15_28123259_28123621
Gm8473,5,109236544,109238428,processed_pseudogene,1,1884,chr5_109236544_109238428
Gm8479,6,65328105,65329174,transcribed_processed_pseudogene,1,1069,chr6_65328105_65329174
Gm8483,14,14447661,14448944,processed_pseudogene,-1,1283,chr14_14447661_14448944
Gm8484,15,28718667,28720086,processed_pseudogene,-1,1419,chr15_28718667_28720086
Gm8486,7,20618446,20637932,unprocessed_pseudogene,1,19486,chr7_20618446_20637932
Gm8488,5,109527460,109529470,processed_pseudogene,-1,2010,chr5_109527460_109529470
Gm8492,17,9320395,9321381,processed_pseudogene,-1,986,chr17_9320395_9321381
Gm8493,5,109551892,109554156,unprocessed_pseudogene,-1,2264,chr5_109551892_109554156
Gm8494,5,146574888,146576120,processed_pseudogene,1,1232,chr5_146574888_146576120
Gm8495,9,96537161,96537854,processed_pseudogene,1,693,chr9_96537161_96537854
Gm8497,17,32586504,32594207,processed_pseudogene,1,7703,chr17_32586504_32594207
Gm8504,12,86650573,86651662,processed_pseudogene,1,1089,chr12_86650573_86651662
Gm8512,10,92223004,92223474,processed_pseudogene,-1,470,chr10_92223004_92223474
Gm8513,13,45186534,45187536,processed_pseudogene,-1,1002,chr13_45186534_45187536
Gm8514,14,15910518,15912163,processed_pseudogene,1,1645,chr14_15910518_15912163
Gm8515,3,67607206,67607781,processed_pseudogene,-1,575,chr3_67607206_67607781
Gm8517,14,16171397,16172608,processed_pseudogene,1,1211,chr14_16171397_16172608
Gm8518,14,50978447,50978936,processed_pseudogene,-1,489,chr14_50978447_50978936
Gm8520,9,96813467,96814334,processed_pseudogene,-1,867,chr9_96813467_96814334
Gm8522,X,75271010,75272938,processed_pseudogene,-1,1928,chrX_75271010_75272938
Gm8523,7,101945962,101946513,processed_pseudogene,-1,551,chr7_101945962_101946513
Gm8525,Y,3948853,3949713,processed_pseudogene,-1,860,chrY_3948853_3949713
Gm8526,13,88478580,88479054,processed_pseudogene,1,474,chr13_88478580_88479054
Gm8529,18,50220071,50220815,processed_pseudogene,-1,744,chr18_50220071_50220815
Gm8534,X,153656606,153657371,processed_pseudogene,1,765,chrX_153656606_153657371
Gm8538,16,36735587,36737110,processed_pseudogene,1,1523,chr16_36735587_36737110
Gm8543,9,39074102,39075735,processed_pseudogene,1,1633,chr9_39074102_39075735
Gm8545,X,74006702,74007502,processed_pseudogene,1,800,chrX_74006702_74007502
Gm8550,1,65028080,65028732,processed_pseudogene,1,652,chr1_65028080_65028732
Gm8556,7,102520346,102521009,processed_pseudogene,-1,663,chr7_102520346_102521009
Gm8565,3,69566451,69567464,processed_pseudogene,-1,1013,chr3_69566451_69567464
Gm8566,6,67205619,67206083,processed_pseudogene,1,464,chr6_67205619_67206083
Gm8569,X,154436056,154436702,processed_pseudogene,1,646,chrX_154436056_154436702
Gm8572,18,52952549,52953101,processed_pseudogene,1,552,chr18_52952549_52953101
Gm8574,6,67384418,67385341,processed_pseudogene,-1,923,chr6_67384418_67385341
Gm8575,8,46279672,46280192,processed_pseudogene,1,520,chr8_46279672_46280192
Gm8580,10,93665383,93665846,processed_pseudogene,-1,463,chr10_93665383_93665846
Gm8582,14,19127800,19132109,unprocessed_pseudogene,1,4309,chr14_19127800_19132109
Gm8587,12,88089134,88089976,processed_pseudogene,1,842,chr12_88089134_88089976
Gm8588,13,48312670,48314251,processed_pseudogene,1,1581,chr13_48312670_48314251
Gm8594,18,54030699,54031308,processed_pseudogene,-1,609,chr18_54030699_54031308
Gm8596,1,133529479,133530270,processed_pseudogene,1,791,chr1_133529479_133530270
Gm8597,17,13394025,13404191,transcribed_unprocessed_pseudogene,-1,10166,chr17_13394025_13404191
Gm8601,10,96476479,96477387,processed_pseudogene,1,908,chr10_96476479_96477387
Gm8602,6,4359028,4359634,processed_pseudogene,1,606,chr6_4359028_4359634
Gm8604,3,71859185,71860149,processed_pseudogene,1,964,chr3_71859185_71860149
Gm8606,X,155504037,155504924,processed_pseudogene,-1,887,chrX_155504037_155504924
Gm8609,16,39934002,39934999,processed_pseudogene,1,997,chr16_39934002_39934999
Gm8613,10,97199195,97200370,processed_pseudogene,-1,1175,chr10_97199195_97200370
Gm8614,18,55837972,55838949,processed_pseudogene,-1,977,chr18_55837972_55838949
Gm8615,5,149155108,149156209,transcribed_processed_pseudogene,-1,1101,chr5_149155108_149156209
Gm8616,13,3352952,3353988,processed_pseudogene,1,1036,chr13_3352952_3353988
Gm8618,1,134109368,134109799,processed_pseudogene,1,431,chr1_134109368_134109799
Gm8623,8,47632329,47632764,processed_pseudogene,-1,435,chr8_47632329_47632764
Gm8624,11,117420637,117421717,transcribed_processed_pseudogene,-1,1080,chr11_117420637_117421717
Gm8634,12,88302813,88305189,processed_pseudogene,1,2376,chr12_88302813_88305189
Gm8641,9,99946564,99947389,processed_pseudogene,-1,825,chr9_99946564_99947389
Gm8642,18,56518240,56519380,processed_pseudogene,1,1140,chr18_56518240_56519380
Gm8649,6,6329762,6329994,processed_pseudogene,-1,232,chr6_6329762_6329994
Gm8652,6,6351304,6352267,processed_pseudogene,-1,963,chr6_6351304_6352267
Gm8655,12,88334624,88335475,processed_pseudogene,1,851,chr12_88334624_88335475
Gm8659,X,158150096,158151179,processed_pseudogene,1,1083,chrX_158150096_158151179
Gm8661,9,100624974,100625965,processed_pseudogene,-1,991,chr9_100624974_100625965
Gm8662,X,158248797,158249370,processed_pseudogene,1,573,chrX_158248797_158249370
Gm8663,19,37388407,37400401,processed_pseudogene,1,11994,chr19_37388407_37400401
Gm8667,7,104222333,104222781,processed_pseudogene,-1,448,chr7_104222333_104222781
Gm8668,15,37421248,37422694,processed_pseudogene,1,1446,chr15_37421248_37422694
Gm867,10,75937723,75940672,protein_coding,-1,2949,chr10_75937723_75940672
Gm8670,16,48749400,48750448,processed_pseudogene,-1,1048,chr16_48749400_48750448
Gm8675,5,151007446,151009301,processed_pseudogene,-1,1855,chr5_151007446_151009301
Gm8682,X,160036321,160036818,processed_pseudogene,1,497,chrX_160036321_160036818
Gm8684,3,78085833,78087396,processed_pseudogene,-1,1563,chr3_78085833_78087396
Gm8685,7,22607553,22627043,unprocessed_pseudogene,1,19490,chr7_22607553_22627043
Gm8686,6,7835272,7835659,processed_pseudogene,-1,387,chr6_7835272_7835659
Gm8692,X,75987178,75987615,processed_pseudogene,-1,437,chrX_75987178_75987615
Gm8696,17,34954328,34954712,processed_pseudogene,-1,384,chr17_34954328_34954712
Gm8697,18,59774229,59774471,processed_pseudogene,-1,242,chr18_59774229_59774471
Gm8702,15,88980021,88980414,processed_pseudogene,-1,393,chr15_88980021_88980414
Gm8705,15,38243364,38244248,processed_pseudogene,-1,884,chr15_38243364_38244248
Gm8707,9,41651893,41655282,transcribed_processed_pseudogene,1,3389,chr9_41651893_41655282
Gm8709,10,26673601,26674612,processed_pseudogene,-1,1011,chr10_26673601_26674612
Gm8712,13,96376930,96377630,processed_pseudogene,1,700,chr13_96376930_96377630
Gm8717,19,38703511,38704324,processed_pseudogene,-1,813,chr19_38703511_38704324
Gm8719,6,128472855,128473388,processed_pseudogene,-1,533,chr6_128472855_128473388
Gm8722,X,77757378,77758146,processed_pseudogene,-1,768,chrX_77757378_77758146
Gm8724,6,128530918,128531400,processed_pseudogene,-1,482,chr6_128530918_128531400
Gm8725,13,7307802,7309134,processed_pseudogene,1,1332,chr13_7307802_7309134
Gm8728,7,23166873,23186354,unprocessed_pseudogene,1,19481,chr7_23166873_23186354
Gm8730,8,102864845,102865798,processed_pseudogene,-1,953,chr8_102864845_102865798
Gm8734,8,55080404,55081715,processed_pseudogene,-1,1311,chr8_55080404_55081715
Gm8737,X,162697612,162698253,processed_pseudogene,1,641,chrX_162697612_162698253
Gm8738,11,103879915,103880243,processed_pseudogene,-1,328,chr11_103879915_103880243
Gm8739,13,50343583,50491741,antisense,-1,148158,chr13_50343583_50491741
Gm8741,17,35335909,35336292,processed_pseudogene,1,383,chr17_35335909_35336292
Gm8744,6,10882429,10888600,processed_pseudogene,1,6171,chr6_10882429_10888600
Gm8745,7,23526174,23526955,processed_pseudogene,1,781,chr7_23526174_23526955
Gm8748,8,104071149,104071735,processed_pseudogene,1,586,chr8_104071149_104071735
Gm8750,17,35400799,35403727,processed_pseudogene,1,2928,chr17_35400799_35403727
Gm8752,17,35445856,35448926,processed_pseudogene,1,3070,chr17_35445856_35448926
Gm8754,X,78390705,78391224,processed_pseudogene,1,519,chrX_78390705_78391224
Gm8755,18,61433502,61434201,processed_pseudogene,-1,699,chr18_61433502_61434201
Gm8756,13,97458149,97459077,processed_pseudogene,-1,928,chr13_97458149_97459077
Gm8761,X,78655785,78656739,processed_pseudogene,-1,954,chrX_78655785_78656739
Gm8767,10,30084265,30085334,processed_pseudogene,-1,1069,chr10_30084265_30085334
Gm8770,X,78785747,78786855,processed_pseudogene,1,1108,chrX_78785747_78786855
Gm8773,5,5573799,5576203,protein_coding,1,2404,chr5_5573799_5576203
Gm8774,6,128883852,128884543,processed_pseudogene,1,691,chr6_128883852_128884543
Gm8775,3,4211718,4213044,processed_pseudogene,1,1326,chr3_4211718_4213044
Gm8778,6,128976866,128977972,processed_pseudogene,-1,1106,chr6_128976866_128977972
Gm8783,19,40622460,40622981,processed_pseudogene,1,521,chr19_40622460_40622981
Gm8784,13,9223537,9224971,processed_pseudogene,1,1434,chr13_9223537_9224971
Gm8793,10,31639158,31640460,processed_pseudogene,1,1302,chr10_31639158_31640460
Gm8796,10,106065857,106066792,processed_pseudogene,1,935,chr10_106065857_106066792
Gm8797,3,5750806,5751295,protein_coding,1,489,chr3_5750806_5751295
Gm8801,17,35947246,35952297,unprocessed_pseudogene,1,5051,chr17_35947246_35952297
Gm8802,5,7857108,7857847,processed_pseudogene,1,739,chr5_7857108_7857847
Gm8804,8,105110624,105111421,processed_pseudogene,1,797,chr8_105110624_105111421
Gm8806,X,80533745,80535151,processed_pseudogene,-1,1406,chrX_80533745_80535151
Gm8807,18,75182193,75182814,processed_pseudogene,-1,621,chr18_75182193_75182814
Gm8810,17,36066108,36067753,unprocessed_pseudogene,-1,1645,chr17_36066108_36067753
Gm8812,1,66062965,66063376,processed_pseudogene,1,411,chr1_66062965_66063376
Gm8813,3,84552858,84553452,processed_pseudogene,-1,594,chr3_84552858_84553452
Gm8814,X,167028902,167029436,processed_pseudogene,-1,534,chrX_167028902_167029436
Gm8816,6,130567639,130568801,processed_pseudogene,1,1162,chr6_130567639_130568801
Gm8818,1,153305432,153306478,processed_pseudogene,1,1046,chr1_153305432_153306478
Gm8823,3,7192778,7193210,processed_pseudogene,-1,432,chr3_7192778_7193210
Gm8824,16,50111073,50112062,processed_pseudogene,1,989,chr16_50111073_50112062
Gm8825,19,25795810,25796807,processed_pseudogene,-1,997,chr19_25795810_25796807
Gm8826,3,7454521,7455539,processed_pseudogene,1,1018,chr3_7454521_7455539
Gm8834,10,34898256,34898820,processed_pseudogene,1,564,chr10_34898256_34898820
Gm8838,8,105503406,105503946,processed_pseudogene,1,540,chr8_105503406_105503946
Gm8839,X,86270712,86272356,processed_pseudogene,1,1644,chrX_86270712_86272356
Gm884,11,103534577,103621140,protein_coding,-1,86563,chr11_103534577_103621140
Gm8840,1,69130914,69131299,processed_pseudogene,-1,385,chr1_69130914_69131299
Gm8843,15,95715193,95716294,processed_pseudogene,1,1101,chr15_95715193_95716294
Gm8844,X,86316083,86318696,processed_pseudogene,1,2613,chrX_86316083_86318696
Gm8847,13,100559402,100560032,processed_pseudogene,-1,630,chr13_100559402_100560032
Gm8849,15,95775754,95776233,processed_pseudogene,1,479,chr15_95775754_95776233
Gm8855,X,87672992,87673869,processed_pseudogene,-1,877,chrX_87672992_87673869
Gm8856,1,144952928,144954071,processed_pseudogene,1,1143,chr1_144952928_144954071
Gm8863,9,46713233,46714158,processed_pseudogene,-1,925,chr9_46713233_46714158
Gm8864,X,88572051,88573060,processed_pseudogene,-1,1009,chrX_88572051_88573060
Gm8869,3,87022937,87023883,processed_pseudogene,-1,946,chr3_87022937_87023883
Gm8870,1,71155246,71156020,processed_pseudogene,-1,774,chr1_71155246_71156020
Gm8873,10,111156216,111157654,processed_pseudogene,1,1438,chr10_111156216_111157654
Gm8877,17,36701629,36703209,unprocessed_pseudogene,-1,1580,chr17_36701629_36703209
Gm8878,17,36759857,36762423,processed_pseudogene,-1,2566,chr17_36759857_36762423
Gm8885,1,72087857,72088454,processed_pseudogene,1,597,chr1_72087857_72088454
Gm8887,18,67907628,67908924,processed_pseudogene,1,1296,chr18_67907628_67908924
Gm8894,14,55420124,55420789,processed_pseudogene,-1,665,chr14_55420124_55420789
Gm8899,10,39662089,39663420,processed_pseudogene,1,1331,chr10_39662089_39663420
Gm8900,16,55940339,55940711,processed_pseudogene,-1,372,chr16_55940339_55940711
Gm8902,7,26245899,26247958,processed_pseudogene,1,2059,chr7_26245899_26247958
Gm8907,9,50186043,50187045,processed_pseudogene,-1,1002,chr9_50186043_50187045
Gm8909,17,36164443,36168537,protein_coding,-1,4094,chr17_36164443_36168537
Gm8911,10,39911149,39911800,processed_pseudogene,1,651,chr10_39911149_39911800
Gm8913,7,105060234,105060874,processed_pseudogene,1,640,chr7_105060234_105060874
Gm8918,12,104228917,104230003,processed_pseudogene,-1,1086,chr12_104228917_104230003
Gm8919,3,11658497,11659510,processed_pseudogene,-1,1013,chr3_11658497_11659510
Gm8921,6,133092181,133092829,processed_pseudogene,1,648,chr6_133092181_133092829
Gm8925,5,12478866,12479628,processed_pseudogene,-1,762,chr5_12478866_12479628
Gm8927,6,22703436,22704416,processed_pseudogene,1,980,chr6_22703436_22704416
Gm8930,6,22733733,22734500,processed_pseudogene,1,767,chr6_22733733_22734500
Gm8934,18,70647149,70648037,processed_pseudogene,-1,888,chr18_70647149_70648037
Gm8935,3,12855836,12858633,transcribed_processed_pseudogene,1,2797,chr3_12855836_12858633
Gm8939,3,12892451,12893414,processed_pseudogene,-1,963,chr3_12892451_12893414
Gm8941,1,151136507,151137780,processed_pseudogene,1,1273,chr1_151136507_151137780
Gm8942,10,115269978,115270377,processed_pseudogene,1,399,chr10_115269978_115270377
Gm8948,10,40333951,40334320,processed_pseudogene,1,369,chr10_40333951_40334320
Gm8952,6,72073052,72074153,processed_pseudogene,-1,1101,chr6_72073052_72074153
Gm8955,3,14428492,14435009,processed_pseudogene,-1,6517,chr3_14428492_14435009
Gm8957,3,14511084,14512095,processed_pseudogene,-1,1011,chr3_14511084_14512095
Gm8959,9,51656891,51657461,processed_pseudogene,1,570,chr9_51656891_51657461
Gm8960,10,115599026,115600328,processed_pseudogene,-1,1302,chr10_115599026_115600328
Gm8963,14,56181827,56182507,processed_pseudogene,1,680,chr14_56181827_56182507
Gm8971,14,57363385,57363733,processed_pseudogene,1,348,chr14_57363385_57363733
Gm8973,15,99006057,99006369,processed_pseudogene,1,312,chr15_99006057_99006369
Gm8976,1,152949395,152950097,processed_pseudogene,-1,702,chr1_152949395_152950097
Gm8980,19,33674073,33688481,unprocessed_pseudogene,-1,14408,chr19_33674073_33688481
Gm8982,7,106123174,106124730,processed_pseudogene,1,1556,chr7_106123174_106124730
Gm8983,14,56865413,56866355,processed_pseudogene,1,942,chr14_56865413_56866355
Gm8984,5,16508165,16509183,processed_pseudogene,-1,1018,chr5_16508165_16509183
Gm8986,18,74400608,74401047,processed_pseudogene,1,439,chr18_74400608_74401047
Gm8990,13,108309202,108310750,processed_pseudogene,-1,1548,chr13_108309202_108310750
Gm8995,7,106504239,106511671,transcribed_unprocessed_pseudogene,-1,7432,chr7_106504239_106511671
Gm8996,14,57217233,57217642,processed_pseudogene,1,409,chr14_57217233_57217642
Gm9001,6,75782358,75782756,processed_pseudogene,-1,398,chr6_75782358_75782756
Gm9002,10,117429618,117430116,processed_pseudogene,1,498,chr10_117429618_117430116
Gm9003,X,94422678,94423295,processed_pseudogene,-1,617,chrX_94422678_94423295
Gm9008,6,76495432,76497784,protein_coding,-1,2352,chr6_76495432_76497784
Gm9012,14,58049229,58049823,processed_pseudogene,-1,594,chr14_58049229_58049823
Gm9013,14,60039610,60040491,processed_pseudogene,-1,881,chr14_60039610_60040491
Gm9022,14,58878833,58880228,transcribed_processed_pseudogene,-1,1395,chr14_58878833_58880228
Gm9023,3,91010083,91017184,unprocessed_pseudogene,-1,7101,chr3_91010083_91017184
Gm9028,18,76223970,76224183,processed_pseudogene,-1,213,chr18_76223970_76224183
Gm9029,10,118243800,118246209,processed_pseudogene,-1,2409,chr10_118243800_118246209
Gm9030,10,118253259,118255668,processed_pseudogene,1,2409,chr10_118253259_118255668
Gm9034,10,43821231,43822235,processed_pseudogene,1,1004,chr10_43821231_43822235
Gm9038,6,138859521,138860124,processed_pseudogene,-1,603,chr6_138859521_138860124
Gm9042,19,36404447,36406110,processed_pseudogene,1,1663,chr19_36404447_36406110
Gm9051,X,96224308,96225727,processed_pseudogene,-1,1419,chrX_96224308_96225727
Gm9061,16,64911273,64912278,processed_pseudogene,1,1005,chr16_64911273_64912278
Gm9062,X,97826379,97827105,processed_pseudogene,1,726,chrX_97826379_97827105
Gm9063,12,110319592,110320173,processed_pseudogene,-1,581,chr12_110319592_110320173
Gm9064,7,110425037,110425602,processed_pseudogene,1,565,chr7_110425037_110425602
Gm9066,19,37722787,37723423,processed_pseudogene,-1,636,chr19_37722787_37723423
Gm9067,19,37784266,37785584,processed_pseudogene,1,1318,chr19_37784266_37785584
Gm9068,10,47325218,47325672,processed_pseudogene,-1,454,chr10_47325218_47325672
Gm9077,12,3171874,3201049,unprocessed_pseudogene,1,29175,chr12_3171874_3201049
Gm9081,10,122169373,122170363,processed_pseudogene,1,990,chr10_122169373_122170363
Gm9088,12,3931533,3932040,processed_pseudogene,-1,507,chr12_3931533_3932040
Gm9095,X,101787766,101788646,processed_pseudogene,1,880,chrX_101787766_101788646
Gm9098,13,118568775,118569782,processed_pseudogene,-1,1007,chr13_118568775_118569782
Gm9102,10,125512531,125512995,processed_pseudogene,1,464,chr10_125512531_125512995
Gm9104,17,45465788,45466270,processed_pseudogene,1,482,chr17_45465788_45466270
Gm9105,7,109387478,109388875,processed_pseudogene,-1,1397,chr7_109387478_109388875
Gm9108,15,103586944,103588368,processed_pseudogene,-1,1424,chr15_103586944_103588368
Gm9109,X,102655659,102657063,processed_pseudogene,1,1404,chrX_102655659_102657063
Gm9111,10,126809592,126810300,processed_pseudogene,-1,708,chr10_126809592_126810300
Gm9114,7,31744189,31745185,processed_pseudogene,1,996,chr7_31744189_31745185
Gm9115,X,102724402,102725749,processed_pseudogene,-1,1347,chrX_102724402_102725749
Gm9116,3,93909825,93910842,unprocessed_pseudogene,1,1017,chr3_93909825_93910842
Gm9118,10,56497341,56498094,processed_pseudogene,1,753,chr10_56497341_56498094
Gm9120,7,31879045,31880038,processed_pseudogene,1,993,chr7_31879045_31880038
Gm9127,7,32059024,32060008,processed_pseudogene,1,984,chr7_32059024_32060008
Gm9129,10,57386423,57391155,processed_pseudogene,1,4732,chr10_57386423_57391155
Gm9130,14,66797856,66798378,processed_pseudogene,-1,522,chr14_66797856_66798378
Gm9135,7,32171714,32172703,processed_pseudogene,1,989,chr7_32171714_32172703
Gm9139,12,7417425,7418124,processed_pseudogene,-1,699,chr12_7417425_7418124
Gm9142,7,32358928,32359882,processed_pseudogene,1,954,chr7_32358928_32359882
Gm9146,7,32473252,32474257,processed_pseudogene,1,1005,chr7_32473252_32474257
Gm9149,7,32604815,32605821,processed_pseudogene,1,1006,chr7_32604815_32605821
Gm9157,X,103529483,103529707,transcribed_processed_pseudogene,1,224,chrX_103529483_103529707
Gm9158,12,19096320,19099220,unprocessed_pseudogene,1,2900,chr12_19096320_19099220
Gm9159,X,103597771,103598336,processed_pseudogene,1,565,chrX_103597771_103598336
Gm9162,7,33137119,33138109,processed_pseudogene,1,990,chr7_33137119_33138109
Gm9164,X,103887599,103888612,processed_pseudogene,-1,1013,chrX_103887599_103888612
Gm9165,7,120504658,120513772,processed_pseudogene,1,9114,chr7_120504658_120513772
Gm9167,7,33312140,33313101,processed_pseudogene,1,961,chr7_33312140_33313101
Gm9169,3,95144371,95144906,processed_pseudogene,1,535,chr3_95144371_95144906
Gm9172,8,124765261,124766214,processed_pseudogene,1,953,chr8_124765261_124766214
Gm9174,14,70360187,70360441,processed_pseudogene,1,254,chr14_70360187_70360441
Gm9176,10,128549694,128550813,processed_pseudogene,-1,1119,chr10_128549694_128550813
Gm9182,10,128615401,128616039,processed_pseudogene,1,638,chr10_128615401_128616039
Gm9191,17,50212751,50214206,processed_pseudogene,-1,1455,chr17_50212751_50214206
Gm9192,14,71819567,71820551,processed_pseudogene,-1,984,chr14_71819567_71820551
Gm9194,12,13790264,13791710,processed_pseudogene,-1,1446,chr12_13790264_13791710
Gm9198,14,72978626,72979904,processed_pseudogene,-1,1278,chr14_72978626_72979904
Gm9200,X,106641381,106642734,processed_pseudogene,-1,1353,chrX_106641381_106642734
Gm9202,12,14930107,14930543,processed_pseudogene,1,436,chr12_14930107_14930543
Gm9204,8,128633936,128634882,processed_pseudogene,1,946,chr8_128633936_128634882
Gm9207,3,96454835,96455949,processed_pseudogene,-1,1114,chr3_96454835_96455949
Gm9210,17,53196451,53198567,processed_pseudogene,1,2116,chr17_53196451_53198567
Gm9211,7,36234292,36235266,processed_pseudogene,1,974,chr7_36234292_36235266
Gm9212,14,74717712,74718830,processed_pseudogene,1,1118,chr14_74717712_74718830
Gm9214,17,53359927,53361889,processed_pseudogene,1,1962,chr17_53359927_53361889
Gm9231,12,18364462,18365470,processed_pseudogene,1,1008,chr12_18364462_18365470
Gm9234,7,121015142,121015633,processed_pseudogene,-1,491,chr7_121015142_121015633
Gm9237,12,18681374,18684265,unprocessed_pseudogene,1,2891,chr12_18681374_18684265
Gm9240,7,121223253,121223994,processed_pseudogene,-1,741,chr7_121223253_121223994
Gm9242,16,97490047,97491120,processed_pseudogene,1,1073,chr16_97490047_97491120
Gm9246,7,41335384,41338873,processed_pseudogene,1,3489,chr7_41335384_41338873
Gm9247,14,93194698,93195696,processed_pseudogene,-1,998,chr14_93194698_93195696
Gm9252,7,41666517,41668118,processed_pseudogene,-1,1601,chr7_41666517_41668118
Gm9255,12,19329058,19334616,unprocessed_pseudogene,1,5558,chr12_19329058_19334616
Gm9257,12,19606929,19623085,unprocessed_pseudogene,1,16156,chr12_19606929_19623085
Gm9259,12,19824891,19830372,unprocessed_pseudogene,-1,5481,chr12_19824891_19830372
Gm9264,14,85479026,85479533,processed_pseudogene,1,507,chr14_85479026_85479533
Gm9265,12,20111164,20144845,unprocessed_pseudogene,1,33681,chr12_20111164_20144845
Gm9266,7,42951724,42952207,processed_pseudogene,1,483,chr7_42951724_42952207
Gm9267,12,118602677,118603080,processed_pseudogene,1,403,chr12_118602677_118603080
Gm9269,12,20275039,20278028,unprocessed_pseudogene,1,2989,chr12_20275039_20278028
Gm9273,3,104417613,104418327,processed_pseudogene,-1,714,chr3_104417613_104418327
Gm9274,14,88349372,88350355,processed_pseudogene,-1,983,chr14_88349372_88350355
Gm9276,19,59087571,59088954,processed_pseudogene,1,1383,chr19_59087571_59088954
Gm9278,7,43506951,43507503,processed_pseudogene,1,552,chr7_43506951_43507503
Gm9279,12,119609918,119611523,processed_pseudogene,1,1605,chr12_119609918_119611523
Gm9280,12,119876653,119877169,unprocessed_pseudogene,1,516,chr12_119876653_119877169
Gm9284,17,58803053,58803626,processed_pseudogene,-1,573,chr17_58803053_58803626
Gm9287,14,96967825,96969754,processed_pseudogene,1,1929,chr14_96967825_96969754
Gm9288,17,65427478,65429044,processed_pseudogene,1,1566,chr17_65427478_65429044
Gm9290,14,97665672,97666291,processed_pseudogene,-1,619,chr14_97665672_97666291
Gm9292,12,23112535,23115584,unprocessed_pseudogene,-1,3049,chr12_23112535_23115584
Gm9293,12,23090769,23093393,unprocessed_pseudogene,-1,2624,chr12_23090769_23093393
Gm9294,7,42953600,42954388,processed_pseudogene,-1,788,chr7_42953600_42954388
Gm9298,14,99629756,99630666,processed_pseudogene,-1,910,chr14_99629756_99630666
Gm9299,7,128041251,128042390,processed_pseudogene,-1,1139,chr7_128041251_128042390
Gm9300,17,63701836,63702490,processed_pseudogene,-1,654,chr17_63701836_63702490
Gm9305,12,23711590,23714509,unprocessed_pseudogene,-1,2919,chr12_23711590_23714509
Gm9308,14,123698141,123698588,processed_pseudogene,-1,447,chr14_123698141_123698588
Gm9311,17,73190258,73191685,processed_pseudogene,-1,1427,chr17_73190258_73191685
Gm9314,3,111321330,111322857,processed_pseudogene,-1,1527,chr3_111321330_111322857
Gm9315,12,24382254,24383161,processed_pseudogene,-1,907,chr12_24382254_24383161
Gm9316,17,74211958,74214082,processed_pseudogene,1,2124,chr17_74211958_74214082
Gm9317,3,112330911,112331772,processed_pseudogene,-1,861,chr3_112330911_112331772
Gm9318,12,24776246,24776683,processed_pseudogene,-1,437,chr12_24776246_24776683
Gm9319,17,69554230,69554761,processed_pseudogene,1,531,chr17_69554230_69554761
Gm9320,17,70853767,70876312,transcribed_processed_pseudogene,1,22545,chr17_70853767_70876312
Gm9332,3,116998857,116999586,processed_pseudogene,-1,729,chr3_116998857_116999586
Gm9333,7,134660335,134661657,processed_pseudogene,1,1322,chr7_134660335_134661657
Gm9334,14,107525474,107526244,processed_pseudogene,-1,770,chr14_107525474_107526244
Gm9335,14,107748450,107749760,processed_pseudogene,1,1310,chr14_107748450_107749760
Gm9341,7,135952798,135953783,processed_pseudogene,1,985,chr7_135952798_135953783
Gm9347,7,136810909,136812515,processed_pseudogene,1,1606,chr7_136810909_136812515
Gm9349,17,74329533,74329888,processed_pseudogene,-1,355,chr17_74329533_74329888
Gm9351,17,74332008,74332529,processed_pseudogene,-1,521,chr17_74332008_74332529
Gm9353,3,121250134,121250737,processed_pseudogene,-1,603,chr3_121250134_121250737
Gm9354,7,51458060,51458527,processed_pseudogene,1,467,chr7_51458060_51458527
Gm9357,7,52022237,52029158,processed_pseudogene,-1,6921,chr7_52022237_52029158
Gm9358,7,138914388,138915314,processed_pseudogene,1,926,chr7_138914388_138915314
Gm9359,12,31418848,31420068,processed_pseudogene,1,1220,chr12_31418848_31420068
Gm9360,17,75661240,75662226,processed_pseudogene,1,986,chr17_75661240_75662226
Gm9361,3,122183498,122185004,processed_pseudogene,-1,1506,chr3_122183498_122185004
Gm9367,7,55462069,55462614,processed_pseudogene,1,545,chr7_55462069_55462614
Gm9369,3,123509942,123510674,processed_pseudogene,-1,732,chr3_123509942_123510674
Gm9370,12,33846454,33847062,processed_pseudogene,1,608,chr12_33846454_33847062
Gm9372,3,124292076,124292505,transcribed_processed_pseudogene,1,429,chr3_124292076_124292505
Gm9373,7,58951578,58952176,processed_pseudogene,1,598,chr7_58951578_58952176
Gm9377,7,59109920,59110542,processed_pseudogene,1,622,chr7_59109920_59110542
Gm9379,3,124588512,124589157,processed_pseudogene,-1,645,chr3_124588512_124589157
Gm9381,3,125042262,125043273,processed_pseudogene,-1,1011,chr3_125042262_125043273
Gm9385,9,116040593,116041064,processed_pseudogene,-1,471,chr9_116040593_116041064
Gm9387,3,128953779,128955098,processed_pseudogene,-1,1319,chr3_128953779_128955098
Gm9390,17,82355393,82356084,processed_pseudogene,1,691,chr17_82355393_82356084
Gm9391,14,120827158,120827546,processed_pseudogene,1,388,chr14_120827158_120827546
Gm9392,7,46820864,46821417,processed_pseudogene,-1,553,chr7_46820864_46821417
Gm9396,3,130068412,130068978,processed_pseudogene,1,566,chr3_130068412_130068978
Gm9397,3,130140380,130142042,processed_pseudogene,1,1662,chr3_130140380_130142042
Gm9399,14,122494613,122495251,processed_pseudogene,-1,638,chr14_122494613_122495251
Gm9400,17,84852538,84853451,unprocessed_pseudogene,1,913,chr17_84852538_84853451
Gm9402,3,132655395,132655782,processed_pseudogene,-1,387,chr3_132655395_132655782
Gm9403,3,132842396,132844576,processed_pseudogene,1,2180,chr3_132842396_132844576
Gm9407,17,88856233,88856622,processed_pseudogene,-1,389,chr17_88856233_88856622
Gm9408,3,136331486,136332990,processed_pseudogene,1,1504,chr3_136331486_136332990
Gm9410,17,91106255,91107296,processed_pseudogene,1,1041,chr17_91106255_91107296
Gm9411,17,91125107,91126194,processed_pseudogene,1,1087,chr17_91125107_91126194
Gm9415,3,138601132,138602452,processed_pseudogene,1,1320,chr3_138601132_138602452
Gm9416,17,94608185,94608497,processed_pseudogene,1,312,chr17_94608185_94608497
Gm9419,3,144727884,144728450,processed_pseudogene,1,566,chr3_144727884_144728450
Gm9423,3,158960446,158961442,processed_pseudogene,1,996,chr3_158960446_158961442
Gm9434,X,13377866,13378678,processed_pseudogene,-1,812,chrX_13377866_13378678
Gm9435,X,14955098,14955974,processed_pseudogene,-1,876,chrX_14955098_14955974
Gm9436,X,17674430,17676284,processed_pseudogene,-1,1854,chrX_17674430_17676284
Gm9439,X,21504054,21505466,processed_pseudogene,1,1412,chrX_21504054_21505466
Gm9442,3,51402844,51403162,processed_pseudogene,-1,318,chr3_51402844_51403162
Gm9443,1,25011941,25012756,processed_pseudogene,1,815,chr1_25011941_25012756
Gm9449,7,107951346,107952356,processed_pseudogene,-1,1010,chr7_107951346_107952356
Gm9451,9,106121296,106121899,processed_pseudogene,-1,603,chr9_106121296_106121899
Gm9457,8,4812817,4813434,processed_pseudogene,-1,617,chr8_4812817_4813434
Gm9465,13,98713074,98716510,lincRNA,-1,3436,chr13_98713074_98716510
Gm9472,12,35818739,35819264,processed_pseudogene,-1,525,chr12_35818739_35819264
Gm9474,18,14922055,14924111,processed_pseudogene,-1,2056,chr18_14922055_14924111
Gm9480,3,146696219,146696834,processed_pseudogene,1,615,chr3_146696219_146696834
Gm9487,9,115405149,115405620,processed_pseudogene,1,471,chr9_115405149_115405620
Gm9495,8,69427980,69453565,protein_coding,-1,25585,chr8_69427980_69453565
Gm9496,1,45971182,45976975,processed_pseudogene,1,5793,chr1_45971182_45976975
Gm9497,5,143456903,143457440,processed_pseudogene,1,537,chr5_143456903_143457440
Gm9499,1,97001820,97002783,processed_pseudogene,-1,963,chr1_97001820_97002783
Gm9506,4,149096383,149096702,processed_pseudogene,1,319,chr4_149096383_149096702
Gm9509,15,37171058,37172404,processed_pseudogene,-1,1346,chr15_37171058_37172404
Gm9512,13,15118632,15119128,processed_pseudogene,1,496,chr13_15118632_15119128
Gm9514,17,22184764,22186108,processed_pseudogene,-1,1344,chr17_22184764_22186108
Gm9516,X,103336830,103337253,processed_pseudogene,1,423,chrX_103336830_103337253
Gm9520,8,82160623,82165639,processed_pseudogene,1,5016,chr8_82160623_82165639
Gm9521,7,18229777,18231292,processed_pseudogene,1,1515,chr7_18229777_18231292
Gm9522,15,39180511,39181436,processed_pseudogene,1,925,chr15_39180511_39181436
Gm9523,5,22693561,22694719,processed_pseudogene,-1,1158,chr5_22693561_22694719
Gm9525,16,22535028,22535297,processed_pseudogene,-1,269,chr16_22535028_22535297
Gm9529,19,60966673,60967252,processed_pseudogene,-1,579,chr19_60966673_60967252
Gm9530,1,155063447,155083266,lincRNA,-1,19819,chr1_155063447_155083266
Gm9531,9,81677598,81678677,transcribed_processed_pseudogene,1,1079,chr9_81677598_81678677
Gm9536,16,20820381,20820703,processed_pseudogene,1,322,chr16_20820381_20820703
Gm9540,9,87394250,87394727,processed_pseudogene,1,477,chr9_87394250_87394727
Gm9544,12,74346341,74348822,processed_pseudogene,1,2481,chr12_74346341_74348822
Gm9547,14,56162131,56162801,processed_pseudogene,-1,670,chr14_56162131_56162801
Gm9556,16,32726666,32727605,processed_pseudogene,1,939,chr16_32726666_32727605
Gm9560,10,130140042,130149977,processed_pseudogene,1,9935,chr10_130140042_130149977
Gm9563,19,32439941,32441024,processed_pseudogene,-1,1083,chr19_32439941_32441024
Gm9568,15,75854819,75856228,processed_pseudogene,-1,1409,chr15_75854819_75856228
Gm9570,14,66967182,66969867,processed_pseudogene,1,2685,chr14_66967182_66969867
Gm9573,17,35617923,35626637,protein_coding,-1,8714,chr17_35617923_35626637
Gm9574,17,36137188,36139105,unprocessed_pseudogene,-1,1917,chr17_36137188_36139105
Gm9575,16,50665008,50666346,processed_pseudogene,-1,1338,chr16_50665008_50666346
Gm9577,17,37840310,37842929,processed_pseudogene,-1,2619,chr17_37840310_37842929
Gm9578,14,80341733,80342485,processed_pseudogene,-1,752,chr14_80341733_80342485
Gm9585,10,118232128,118233531,processed_pseudogene,-1,1403,chr10_118232128_118233531
Gm9586,17,49164711,49165758,processed_pseudogene,-1,1047,chr17_49164711_49165758
Gm9598,17,69570406,69571181,processed_pseudogene,1,775,chr17_69570406_69571181
Gm960,19,4625734,4698668,protein_coding,-1,72934,chr19_4625734_4698668
Gm9604,7,11443992,11444424,processed_pseudogene,1,432,chr7_11443992_11444424
Gm9616,13,3298887,3299667,processed_pseudogene,1,780,chr13_3298887_3299667
Gm9618,19,53134472,53135325,processed_pseudogene,-1,853,chr19_53134472_53135325
Gm9619,8,91688374,91689135,processed_pseudogene,-1,761,chr8_91688374_91689135
Gm9621,9,93391368,93392370,processed_pseudogene,-1,1002,chr9_93391368_93392370
Gm9625,13,67810246,67811200,processed_pseudogene,1,954,chr13_67810246_67811200
Gm9632,3,117176019,117176661,processed_pseudogene,1,642,chr3_117176019_117176661
Gm9633,13,118047320,118047944,processed_pseudogene,1,624,chr13_118047320_118047944
Gm9634,13,77553610,77554373,processed_pseudogene,-1,763,chr13_77553610_77554373
Gm9643,15,34012652,34013022,processed_pseudogene,1,370,chr15_34012652_34013022
Gm9644,8,75274482,75275664,processed_pseudogene,-1,1182,chr8_75274482_75275664
Gm9645,3,57765864,57766655,processed_pseudogene,-1,791,chr3_57765864_57766655
Gm9655,8,82747616,82757987,processed_pseudogene,1,10371,chr8_82747616_82757987
Gm9658,15,43217150,43218161,processed_pseudogene,-1,1011,chr15_43217150_43218161
Gm9661,12,109827003,109828124,processed_pseudogene,1,1121,chr12_109827003_109828124
Gm9662,9,6070313,6074278,processed_pseudogene,1,3965,chr9_6070313_6074278
Gm9665,17,93316720,93317261,processed_pseudogene,-1,541,chr17_93316720_93317261
Gm9673,X,105032586,105033366,processed_pseudogene,1,780,chrX_105032586_105033366
Gm9678,3,98581153,98588290,unprocessed_pseudogene,-1,7137,chr3_98581153_98588290
Gm9682,3,152071246,152071801,processed_pseudogene,-1,555,chr3_152071246_152071801
Gm9697,16,21079670,21080666,processed_pseudogene,1,996,chr16_21079670_21080666
Gm9700,3,62067540,62069794,processed_pseudogene,-1,2254,chr3_62067540_62069794
Gm9701,3,62923807,62924233,processed_pseudogene,-1,426,chr3_62923807_62924233
Gm9703,17,27530067,27530412,processed_pseudogene,1,345,chr17_27530067_27530412
Gm9706,17,46407004,46407484,processed_pseudogene,-1,480,chr17_46407004_46407484
Gm9710,5,145265879,145266377,processed_pseudogene,-1,498,chr5_145265879_145266377
Gm9711,7,144791996,144792322,processed_pseudogene,1,326,chr7_144791996_144792322
Gm9712,7,45933850,45934160,processed_pseudogene,1,310,chr7_45933850_45934160
Gm9722,1,185878084,185878885,processed_pseudogene,-1,801,chr1_185878084_185878885
Gm9723,3,43250387,43250843,processed_pseudogene,1,456,chr3_43250387_43250843
Gm9726,12,93927993,93928670,processed_pseudogene,-1,677,chr12_93927993_93928670
Gm9727,5,107478526,107479080,processed_pseudogene,-1,554,chr5_107478526_107479080
Gm973,1,59516264,59636417,protein_coding,1,120153,chr1_59516264_59636417
Gm9730,X,73578239,73584123,unitary_pseudogene,-1,5884,chrX_73578239_73584123
Gm9731,8,27296055,27296801,processed_pseudogene,1,746,chr8_27296055_27296801
Gm9742,13,8013696,8038218,transcribed_processed_pseudogene,-1,24522,chr13_8013696_8038218
Gm9745,13,8941575,8948231,protein_coding,-1,6656,chr13_8941575_8948231
Gm9755,8,67514235,67515590,processed_pseudogene,-1,1355,chr8_67514235_67515590
Gm9761,3,116560935,116561426,processed_pseudogene,-1,491,chr3_116560935_116561426
Gm9762,3,78966356,78966799,processed_pseudogene,-1,443,chr3_78966356_78966799
Gm9767,10,26078255,26079447,antisense,1,1192,chr10_26078255_26079447
Gm9771,3,98189966,98191102,processed_pseudogene,-1,1136,chr3_98189966_98191102
Gm9772,17,22005994,22007599,processed_pseudogene,-1,1605,chr17_22005994_22007599
Gm9774,3,92428032,92429423,protein_coding,-1,1391,chr3_92428032_92429423
Gm9776,13,94355839,94358923,bidirectional_promoter_lncRNA,-1,3084,chr13_94355839_94358923
Gm9785,X,103525316,103526330,transcribed_processed_pseudogene,-1,1014,chrX_103525316_103526330
Gm9790,3,85915783,85916070,processed_pseudogene,1,287,chr3_85915783_85916070
Gm9791,3,34005017,34005463,processed_pseudogene,-1,446,chr3_34005017_34005463
Gm9794,6,66875321,66875743,processed_pseudogene,-1,422,chr6_66875321_66875743
Gm9795,10,56656194,56656886,processed_pseudogene,1,692,chr10_56656194_56656886
Gm9797,10,11609223,11609835,transcribed_processed_pseudogene,1,612,chr10_11609223_11609835
Gm9801,7,62094506,62209479,lincRNA,-1,114973,chr7_62094506_62209479
Gm9803,10,43524084,43524646,protein_coding,1,562,chr10_43524084_43524646
Gm9816,16,62717037,62718450,processed_pseudogene,1,1413,chr16_62717037_62718450
Gm9824,10,29030128,29030688,processed_pseudogene,1,560,chr10_29030128_29030688
Gm9826,1,7177739,7179037,processed_pseudogene,1,1298,chr1_7177739_7179037
Gm9830,9,44464243,44464599,processed_pseudogene,1,356,chr9_44464243_44464599
Gm9833,3,10088110,10092565,protein_coding,1,4455,chr3_10088110_10092565
Gm9843,16,76403251,76403652,processed_pseudogene,-1,401,chr16_76403251_76403652
Gm9844,7,24862213,24862697,protein_coding,1,484,chr7_24862213_24862697
Gm9845,3,39358306,39358903,processed_pseudogene,-1,597,chr3_39358306_39358903
Gm9847,12,14494561,14495159,processed_pseudogene,1,598,chr12_14494561_14495159
Gm9866,12,27050950,27160633,lincRNA,-1,109683,chr12_27050950_27160633
Gm9871,6,101774249,101801982,lincRNA,1,27733,chr6_101774249_101801982
Gm9892,8,52196065,52197056,processed_pseudogene,-1,991,chr8_52196065_52197056
Gm9894,13,67762714,67773451,unprocessed_pseudogene,-1,10737,chr13_67762714_67773451
Gm9895,19,29067347,29069503,lincRNA,1,2156,chr19_29067347_29069503
Gm9899,5,30573987,30588619,processed_transcript,-1,14632,chr5_30573987_30588619
Gm9903,5,33629925,33632092,protein_coding,1,2167,chr5_33629925_33632092
Gm9918,15,102270563,102274121,protein_coding,1,3558,chr15_102270563_102274121
Gm9919,CHR_MG4264_PATCH,58278469,58278765,protein_coding,-1,296,chrCHR_MG4264_PATCH_58278469_58278765
Gm9920,15,55099917,55113677,processed_transcript,-1,13760,chr15_55099917_55113677
Gm9923,10,72309321,72311156,processed_pseudogene,1,1835,chr10_72309321_72311156
Gm9925,18,74065102,74065584,protein_coding,1,482,chr18_74065102_74065584
Gm9926,18,66504178,66511745,lincRNA,1,7567,chr18_66504178_66511745
Gm9936,5,114855025,114859383,antisense,-1,4358,chr5_114855025_114859383
Gm9946,6,117559697,117572329,lincRNA,1,12632,chr6_117559697_117572329
Gm9949,18,62180126,62184405,lincRNA,1,4279,chr18_62180126_62184405
Gm9958,5,90366620,90368488,bidirectional_promoter_lncRNA,1,1868,chr5_90366620_90368488
Gm9959,17,80728131,80728522,pseudogene,1,391,chr17_80728131_80728522
Gm9961,16,11901363,11930600,lincRNA,1,29237,chr16_11901363_11930600
Gm9962,7,57387272,57409941,antisense,1,22669,chr7_57387272_57409941
Gm9999,7,46983580,46987803,protein_coding,1,4223,chr7_46983580_46987803
Gmcl1,6,86691768,86733383,protein_coding,-1,41615,chr6_86691768_86733383
Gmds,13,31819579,32338740,protein_coding,-1,519161,chr13_31819579_32338740
Gmeb1,4,132221025,132261602,protein_coding,-1,40577,chr4_132221025_132261602
Gmeb2,2,181251449,181288035,protein_coding,-1,36586,chr2_181251449_181288035
Gmfb,14,46808149,46822242,protein_coding,-1,14093,chr14_46808149_46822242
Gmfg,7,28437447,28448233,protein_coding,1,10786,chr7_28437447_28448233
Gmip,8,69808679,69821870,protein_coding,1,13191,chr8_69808679_69821870
Gmnc,16,26913553,26991652,protein_coding,-1,78099,chr16_26913553_26991652
Gmnn,13,24751845,24761923,protein_coding,-1,10078,chr13_24751845_24761923
Gmppa,1,75435930,75443179,protein_coding,1,7249,chr1_75435930_75443179
Gmppb,9,108049242,108052801,protein_coding,1,3559,chr9_108049242_108052801
Gmpr,13,45507444,45553800,protein_coding,1,46356,chr13_45507444_45553800
Gmpr2,14,55671941,55679200,protein_coding,1,7259,chr14_55671941_55679200
Gmps,3,63976106,64022579,protein_coding,1,46473,chr3_63976106_64022579
Gna11,10,81528724,81545190,protein_coding,-1,16466,chr10_81528724_81545190
Gna12,5,140758408,140830431,protein_coding,-1,72023,chr5_140758408_140830431
Gna13,11,109362831,109401369,protein_coding,1,38538,chr11_109362831_109401369
Gna14,19,16435762,16610820,protein_coding,1,175058,chr19_16435762_16610820
Gna15,10,81502306,81524225,protein_coding,-1,21919,chr10_81502306_81524225
Gnai1,5,18265135,18360355,protein_coding,-1,95220,chr5_18265135_18360355
Gnai2,9,107614125,107635367,protein_coding,-1,21242,chr9_107614125_107635367
Gnai3,3,108107280,108146146,protein_coding,-1,38866,chr3_108107280_108146146
Gnal,18,67088216,67226792,protein_coding,1,138576,chr18_67088216_67226792
Gnao1,8,93809966,93969388,protein_coding,1,159422,chr8_93809966_93969388
Gnaq,19,16132831,16387463,protein_coding,1,254632,chr19_16132831_16387463
Gnas,2,174284320,174346744,protein_coding,1,62424,chr2_174284320_174346744
Gnat1,9,107674474,107679712,protein_coding,-1,5238,chr9_107674474_107679712
Gnat2,3,108092789,108101432,protein_coding,1,8643,chr3_108092789_108101432
Gnaz,10,74967177,75016907,protein_coding,1,49730,chr10_74967177_75016907
Gnb1,4,155491361,155559269,protein_coding,1,67908,chr4_155491361_155559269
Gnb1-ps2,14,96700273,96700609,processed_pseudogene,-1,336,chr14_96700273_96700609
Gnb1-ps3,8,94760288,94761237,processed_pseudogene,1,949,chr8_94760288_94761237
Gnb1l,16,18498713,18566679,protein_coding,1,67966,chr16_18498713_18566679
Gnb2,5,137528127,137533510,protein_coding,-1,5383,chr5_137528127_137533510
Gnb3,6,124834240,124840275,protein_coding,-1,6035,chr6_124834240_124840275
Gnb4,3,32580332,32616585,protein_coding,-1,36253,chr3_32580332_32616585
Gnb5,9,75306288,75345876,protein_coding,1,39588,chr9_75306288_75345876
Gne,4,44034075,44084177,protein_coding,-1,50102,chr4_44034075_44084177
Gng10,4,59035088,59041903,protein_coding,1,6815,chr4_59035088_59041903
Gng11,6,4003904,4008445,protein_coding,1,4541,chr6_4003904_4008445
Gng12,6,66896397,67021350,protein_coding,1,124953,chr6_66896397_67021350
Gng13,17,25717171,25719406,protein_coding,1,2235,chr17_25717171_25719406
Gng2,14,19872559,19977627,protein_coding,-1,105068,chr14_19872559_19977627
Gng2-ps1,4,26501443,26501659,processed_pseudogene,-1,216,chr4_26501443_26501659
Gng3,19,8836933,8839194,protein_coding,-1,2261,chr19_8836933_8839194
Gng4,13,13784059,13827896,protein_coding,1,43837,chr13_13784059_13827896
Gng5,3,146499807,146505572,protein_coding,1,5765,chr3_146499807_146505572
Gng7,10,80948624,81014945,protein_coding,-1,66321,chr10_80948624_81014945
Gng8,7,16891786,16895436,protein_coding,1,3650,chr7_16891786_16895436
Gngt1,6,3993792,3997436,protein_coding,1,3644,chr6_3993792_3997436
Gngt2,11,95837216,95845734,protein_coding,1,8518,chr11_95837216_95845734
Gnl1,17,35979851,35989462,protein_coding,1,9611,chr17_35979851_35989462
Gnl2,4,125016585,125055380,protein_coding,1,38795,chr4_125016585_125055380
Gnl3,14,31012433,31019152,protein_coding,-1,6719,chr14_31012433_31019152
Gnl3l,X,150983141,151017322,protein_coding,-1,34181,chrX_150983141_151017322
Gnmt,17,46725664,46729168,protein_coding,-1,3504,chr17_46725664_46729168
Gnpat,8,124863033,124890057,protein_coding,1,27024,chr8_124863033_124890057
Gnpda1,18,38327535,38339003,protein_coding,-1,11468,chr18_38327535_38339003
Gnpda2,5,69573108,69592340,protein_coding,-1,19232,chr5_69573108_69592340
Gnpnat1,14,45376334,45404913,protein_coding,-1,28579,chr14_45376334_45404913
Gnptab,10,88379132,88447329,protein_coding,1,68197,chr10_88379132_88447329
Gnptg,17,25233331,25240124,protein_coding,-1,6793,chr17_25233331_25240124
Gnrh1,14,67745181,67749439,protein_coding,1,4258,chr14_67745181_67749439
Gns,10,121365090,121397249,protein_coding,1,32159,chr10_121365090_121397249
Golga1,2,39016155,39065541,protein_coding,-1,49386,chr2_39016155_39065541
Golga2,2,32287384,32307921,protein_coding,1,20537,chr2_32287384_32307921
Golga3,5,110176701,110226470,protein_coding,1,49769,chr5_110176701_110226470
Golga4,9,118506267,118582519,protein_coding,1,76252,chr9_118506267_118582519
Golga5,12,102469135,102497907,protein_coding,1,28772,chr12_102469135_102497907
Golga7,8,23241346,23257074,protein_coding,-1,15728,chr8_23241346_23257074
Golga7b,19,42247574,42270348,protein_coding,1,22774,chr19_42247574_42270348
Golgb1,16,36875140,36933085,protein_coding,1,57945,chr16_36875140_36933085
Golim4,3,75875084,75956949,protein_coding,-1,81865,chr3_75875084_75956949
Golm1,13,59634626,59675811,protein_coding,-1,41185,chr13_59634626_59675811
Golph3,15,12321450,12351591,protein_coding,1,30141,chr15_12321450_12351591
Golph3l,3,95588934,95619247,protein_coding,1,30313,chr3_95588934_95619247
Golt1a,1,133309800,133323026,protein_coding,1,13226,chr1_133309800_133323026
Golt1b,6,142387221,142403858,protein_coding,1,16637,chr6_142387221_142403858
Gon4l,3,88835231,88910103,protein_coding,1,74872,chr3_88835231_88910103
Gopc,10,52335850,52382124,protein_coding,-1,46274,chr10_52335850_52382124
Gorab,1,163384908,163403669,protein_coding,-1,18761,chr1_163384908_163403669
Gorasp1,9,119925257,119937565,protein_coding,-1,12308,chr9_119925257_119937565
Gorasp2,2,70661576,70712636,protein_coding,1,51060,chr2_70661576_70712636
Gosr1,11,76726602,76763579,protein_coding,-1,36977,chr11_76726602_76763579
Gosr2,11,103676849,103697898,protein_coding,-1,21049,chr11_103676849_103697898
Got1,19,43499752,43524605,protein_coding,-1,24853,chr19_43499752_43524605
Got1l1,8,27197459,27223828,protein_coding,-1,26369,chr8_27197459_27223828
Got2,8,95864134,95888547,protein_coding,-1,24413,chr8_95864134_95888547
Got2-ps1,5,138364260,138365552,processed_pseudogene,-1,1292,chr5_138364260_138365552
Gp1ba,11,70639122,70642036,protein_coding,1,2914,chr11_70639122_70642036
Gp1bb,16,18620317,18622403,protein_coding,-1,2086,chr16_18620317_18622403
Gp5,16,30307685,30310779,protein_coding,-1,3094,chr16_30307685_30310779
Gp6,7,4363965,4397744,protein_coding,-1,33779,chr7_4363965_4397744
Gp9,6,87778072,87779768,protein_coding,1,1696,chr6_87778072_87779768
Gpaa1,15,76331231,76334907,protein_coding,1,3676,chr15_76331231_76334907
Gpalpp1,14,76086236,76110760,protein_coding,-1,24524,chr14_76086236_76110760
Gpam,19,55067268,55127238,protein_coding,-1,59970,chr19_55067268_55127238
Gpank1,17,35121455,35124814,protein_coding,1,3359,chr17_35121455_35124814
Gpat2,2,127425199,127436092,protein_coding,1,10893,chr2_127425199_127436092
Gpatch1,7,35276536,35318440,protein_coding,-1,41904,chr7_35276536_35318440
Gpatch11,17,78835567,78848308,protein_coding,1,12741,chr17_78835567_78848308
Gpatch2,1,187215508,187351704,protein_coding,1,136196,chr1_187215508_187351704
Gpatch2l,12,86241858,86291784,protein_coding,1,49926,chr12_86241858_86291784
Gpatch3,4,133574745,133584243,protein_coding,1,9498,chr4_133574745_133584243
Gpatch4,3,88043108,88055993,protein_coding,1,12885,chr3_88043108_88055993
Gpatch8,11,102475915,102556392,protein_coding,-1,80477,chr11_102475915_102556392
Gpbar1,1,74278550,74279624,protein_coding,1,1074,chr1_74278550_74279624
Gpbp1,13,111425680,111490111,protein_coding,-1,64431,chr13_111425680_111490111
Gpbp1l1,4,116557658,116593882,protein_coding,1,36224,chr4_116557658_116593882
Gpc1,1,92831645,92860779,protein_coding,1,29134,chr1_92831645_92860779
Gpc2,5,138273655,138280005,protein_coding,-1,6350,chr5_138273655_138280005
Gpc3,X,52272426,52613950,protein_coding,-1,341524,chrX_52272426_52613950
Gpc4,X,52053021,52165252,protein_coding,-1,112231,chrX_52053021_52165252
Gpc5,14,115092215,116525179,protein_coding,1,1432964,chr14_115092215_116525179
Gpc6,14,116925315,117976544,protein_coding,1,1051229,chr14_116925315_117976544
Gpcpd1,2,132529082,132587729,protein_coding,-1,58647,chr2_132529082_132587729
Gpd1,15,99717515,99725005,protein_coding,1,7490,chr15_99717515_99725005
Gpd1l,9,114899341,114933987,protein_coding,-1,34646,chr9_114899341_114933987
Gpd2,2,57237635,57370719,protein_coding,1,133084,chr2_57237635_57370719
Gper1,5,139423151,139427800,protein_coding,1,4649,chr5_139423151_139427800
Gphb5,12,75411722,75416781,protein_coding,-1,5059,chr12_75411722_75416781
Gphn,12,78226379,78684772,protein_coding,1,458393,chr12_78226379_78684772
Gpi1,7,34201330,34230336,protein_coding,-1,29006,chr7_34201330_34230336
Gpkow,X,7697131,7710262,protein_coding,1,13131,chrX_7697131_7710262
Gpld1,13,24943152,24992501,protein_coding,1,49349,chr13_24943152_24992501
Gpm6a,8,54954843,55060871,protein_coding,1,106028,chr8_54954843_55060871
Gpm6b,X,166238911,166388988,protein_coding,1,150077,chrX_166238911_166388988
Gpn1,5,31494741,31512904,protein_coding,1,18163,chr5_31494741_31512904
Gpn2,4,133584362,133591735,protein_coding,1,7373,chr4_133584362_133591735
Gpn3,5,122371876,122382902,protein_coding,1,11026,chr5_122371876_122382902
Gpnmb,6,49036546,49070929,protein_coding,1,34383,chr6_49036546_49070929
Gpr1,1,63182691,63214543,protein_coding,-1,31852,chr1_63182691_63214543
Gpr101,X,57496668,57503757,protein_coding,-1,7089,chrX_57496668_57503757
Gpr107,2,31152316,31218775,protein_coding,1,66459,chr2_31152316_31218775
Gpr108,17,57234635,57248446,protein_coding,-1,13811,chr17_57234635_57248446
Gpr119,X,48667979,48674478,protein_coding,-1,6499,chrX_48667979_48674478
Gpr12,5,146582398,146585239,protein_coding,-1,2841,chr5_146582398_146585239
Gpr135,12,72067976,72071125,protein_coding,-1,3149,chr12_72067976_72071125
Gpr137,19,6938057,6942480,protein_coding,-1,4423,chr19_6938057_6942480
Gpr137b,13,13357620,13394014,protein_coding,-1,36394,chr13_13357620_13394014
Gpr137b-ps,13,12615057,12650388,transcribed_unprocessed_pseudogene,-1,35331,chr13_12615057_12650388
Gpr137c,14,45219717,45282725,protein_coding,1,63008,chr14_45219717_45282725
Gpr139,7,119140747,119184603,protein_coding,-1,43856,chr7_119140747_119184603
Gpr142,11,114798924,114806745,protein_coding,1,7821,chr11_114798924_114806745
Gpr146,5,139377697,139396415,protein_coding,1,18718,chr5_139377697_139396415
Gpr149,3,62529077,62605140,protein_coding,-1,76063,chr3_62529077_62605140
Gpr15,16,58717433,58719070,protein_coding,-1,1637,chr16_58717433_58719070
Gpr150,13,76054851,76056996,protein_coding,-1,2145,chr13_76054851_76056996
Gpr151,18,42577881,42579652,protein_coding,-1,1771,chr18_42577881_42579652
Gpr152,19,4139786,4145740,protein_coding,1,5954,chr19_4139786_4145740
Gpr153,4,152274232,152285337,protein_coding,1,11105,chr4_152274232_152285337
Gpr155,2,73341506,73386572,protein_coding,-1,45066,chr2_73341506_73386572
Gpr156,16,37916496,38007530,protein_coding,1,91034,chr16_37916496_38007530
Gpr157,4,150087365,150105927,protein_coding,1,18562,chr4_150087365_150105927
Gpr158,2,21367542,21830547,protein_coding,1,463005,chr2_21367542_21830547
Gpr160,3,30855950,30897192,protein_coding,1,41242,chr3_30855950_30897192
Gpr161,1,165295789,165326745,protein_coding,1,30956,chr1_165295789_165326745
Gpr162,6,124858444,124863983,protein_coding,-1,5539,chr6_124858444_124863983
Gpr165,X,96713441,96719388,protein_coding,1,5947,chrX_96713441_96719388
Gpr17,18,31942997,31949636,protein_coding,-1,6639,chr18_31942997_31949636
Gpr171,3,59096448,59101821,protein_coding,-1,5373,chr3_59096448_59101821
Gpr173,X,152343598,152368704,protein_coding,-1,25106,chrX_152343598_152368704
Gpr174,X,107255878,107296769,protein_coding,1,40891,chrX_107255878_107296769
Gpr176,2,118277110,118373419,protein_coding,-1,96309,chr2_118277110_118373419
Gpr179,11,97332109,97352077,protein_coding,-1,19968,chr11_97332109_97352077
Gpr18,14,121911253,121915781,protein_coding,-1,4528,chr14_121911253_121915781
Gpr180,14,118137158,118163261,protein_coding,1,26103,chr14_118137158_118163261
Gpr182,10,127747276,127751732,protein_coding,-1,4456,chr10_127747276_127751732
Gpr183,14,121952551,121965195,protein_coding,-1,12644,chr14_121952551_121965195
Gpr19,6,134869093,134898578,protein_coding,-1,29485,chr6_134869093_134898578
Gpr21,2,37516332,37520603,protein_coding,1,4271,chr2_37516332_37520603
Gpr22,12,31706867,31713947,protein_coding,-1,7080,chr12_31706867_31713947
Gpr25,1,136259797,136260873,protein_coding,-1,1076,chr1_136259797_136260873
Gpr26,7,131966460,131994405,protein_coding,1,27945,chr7_131966460_131994405
Gpr27,6,99692679,99695066,protein_coding,1,2387,chr6_99692679_99695066
Gpr3,4,133209340,133212536,protein_coding,-1,3196,chr4_133209340_133212536
Gpr34,X,13632089,13640858,protein_coding,1,8769,chrX_13632089_13640858
Gpr35,1,92950865,92986391,protein_coding,1,35526,chr1_92950865_92986391
Gpr37,6,25665878,25690729,protein_coding,-1,24851,chr6_25665878_25690729
Gpr37l1,1,135160234,135167681,protein_coding,-1,7447,chr1_135160234_135167681
Gpr39,1,125676995,125873862,protein_coding,1,196867,chr1_125676995_125873862
Gpr4,7,19212538,19224174,protein_coding,1,11636,chr7_19212538_19224174
Gpr45,1,42952872,43035456,protein_coding,1,82584,chr1_42952872_43035456
Gpr50,X,71663667,71669257,protein_coding,1,5590,chrX_71663667_71669257
Gpr52,1,160576338,160577974,protein_coding,-1,1636,chr1_160576338_160577974
Gpr55,1,85938318,85961007,protein_coding,-1,22689,chr1_85938318_85961007
Gpr6,10,41069977,41072285,protein_coding,-1,2308,chr10_41069977_41072285
Gpr61,3,108148321,108154882,protein_coding,-1,6561,chr3_108148321_108154882
Gpr62,9,106463962,106465938,protein_coding,-1,1976,chr9_106463962_106465938
Gpr63,4,24966407,25009233,protein_coding,1,42826,chr4_24966407_25009233
Gpr65,12,98268635,98276644,protein_coding,1,8009,chr12_98268635_98276644
Gpr68,12,100876682,100908198,protein_coding,-1,31516,chr12_100876682_100908198
Gpr75,11,30885358,30893729,protein_coding,1,8371,chr11_30885358_30893729
Gpr82,X,13661363,13667433,protein_coding,1,6070,chrX_13661363_13667433
Gpr83,9,14860210,14870789,protein_coding,1,10579,chr9_14860210_14870789
Gpr84,15,103308235,103310612,protein_coding,-1,2377,chr15_103308235_103310612
Gpr85,6,13834458,13839942,protein_coding,-1,5484,chr6_13834458_13839942
Gpr87,3,59178923,59195104,protein_coding,-1,16181,chr3_59178923_59195104
Gpr88,3,116249654,116253503,protein_coding,-1,3849,chr3_116249654_116253503
Gpr89,3,96868281,96905346,protein_coding,-1,37065,chr3_96868281_96905346
Gprasp1,X,135742733,135803474,protein_coding,1,60741,chrX_135742733_135803474
Gprasp2,X,135839034,135844730,protein_coding,1,5696,chrX_135839034_135844730
Gprc5b,7,118972047,118995211,protein_coding,-1,23164,chr7_118972047_118995211
Gprc5c,11,114851152,114872617,protein_coding,1,21465,chr11_114851152_114872617
Gprc5d,6,135105991,135118283,protein_coding,-1,12292,chr6_135105991_135118283
Gprin1,13,54736671,54749874,protein_coding,-1,13203,chr13_54736671_54749874
Gprin2,14,34185688,34201653,protein_coding,-1,15965,chr14_34185688_34201653
Gprin3,6,59347226,59426294,protein_coding,-1,79068,chr6_59347226_59426294
Gps1,11,120784272,120789102,protein_coding,1,4830,chr11_120784272_120789102
Gps2,11,69913888,69916591,protein_coding,1,2703,chr11_69913888_69916591
Gpsm1,2,26315515,26348237,protein_coding,1,32722,chr2_26315515_26348237
Gpsm2,3,108678638,108722309,protein_coding,-1,43671,chr3_108678638_108722309
Gpsm3,17,34589806,34591754,protein_coding,1,1948,chr17_34589806_34591754
Gpt,15,76695716,76699686,protein_coding,1,3970,chr15_76695716_76699686
Gpt2,8,85492576,85527560,protein_coding,1,34984,chr8_85492576_85527560
Gpx1,9,108338903,108340343,protein_coding,1,1440,chr9_108338903_108340343
Gpx2,12,76792333,76795554,protein_coding,-1,3221,chr12_76792333_76795554
Gpx2-ps1,7,100264675,100265245,processed_pseudogene,1,570,chr7_100264675_100265245
Gpx3,11,54902453,54910377,protein_coding,1,7924,chr11_54902453_54910377
Gpx4,10,80047166,80056439,protein_coding,1,9273,chr10_80047166_80056439
Gpx7,4,108400390,108406961,protein_coding,-1,6571,chr4_108400390_108406961
Gpx8,13,113042753,113046410,protein_coding,-1,3657,chr13_113042753_113046410
Gramd1a,7,31130127,31155896,protein_coding,-1,25769,chr7_31130127_31155896
Gramd1b,9,40293233,40531383,protein_coding,-1,238150,chr9_40293233_40531383
Gramd1c,16,43980350,44063345,protein_coding,-1,82995,chr16_43980350_44063345
Gramd2,9,59680144,59718874,protein_coding,1,38730,chr9_59680144_59718874
Gramd3,18,56400337,56503792,protein_coding,1,103455,chr18_56400337_56503792
Gramd4,15,86057695,86137634,protein_coding,1,79939,chr15_86057695_86137634
Grap,11,61653265,61672784,protein_coding,1,19519,chr11_61653265_61672784
Grap2,15,80572594,80652854,protein_coding,1,80260,chr15_80572594_80652854
Grasp,15,101224188,101232756,protein_coding,1,8568,chr15_101224188_101232756
Grb10,11,11930508,12038683,protein_coding,-1,108175,chr11_11930508_12038683
Grb14,2,64912476,65024987,protein_coding,-1,112511,chr2_64912476_65024987
Grb2,11,115644045,115708597,protein_coding,-1,64552,chr11_115644045_115708597
Grb7,11,98446394,98455373,protein_coding,1,8979,chr11_98446394_98455373
Grcc10,6,124739183,124741374,protein_coding,-1,2191,chr6_124739183_124741374
Greb1,12,16670615,16800886,protein_coding,-1,130271,chr12_16670615_16800886
Greb1l,18,10325177,10562940,protein_coding,1,237763,chr18_10325177_10562940
Grem1,2,113746164,113758646,protein_coding,-1,12482,chr2_113746164_113758646
Grem2,1,174833785,174921819,protein_coding,-1,88034,chr1_174833785_174921819
Grhl1,12,24572283,24617391,protein_coding,1,45108,chr12_24572283_24617391
Grhl2,15,37233036,37363569,protein_coding,1,130533,chr15_37233036_37363569
Grhl3,4,135541888,135573630,protein_coding,-1,31742,chr4_135541888_135573630
Grhpr,4,44981395,44990734,protein_coding,1,9339,chr4_44981395_44990734
Gria1,11,57011387,57330244,protein_coding,1,318857,chr11_57011387_57330244
Gria2,3,80681450,80802835,protein_coding,-1,121385,chr3_80681450_80802835
Gria3,X,41400854,41678601,protein_coding,1,277747,chrX_41400854_41678601
Gria4,9,4417896,4796234,protein_coding,-1,378338,chr9_4417896_4796234
Grid1,14,34820108,35583379,protein_coding,1,763271,chr14_34820108_35583379
Grid2,6,63255876,64704323,protein_coding,1,1448447,chr6_63255876_64704323
Grid2ip,5,143357338,143392152,protein_coding,1,34814,chr5_143357338_143392152
Grifin,5,140563119,140565071,protein_coding,-1,1952,chr5_140563119_140565071
Grik1,16,87895900,88290265,protein_coding,-1,394365,chr16_87895900_88290265
Grik2,10,49094833,49788766,protein_coding,-1,693933,chr10_49094833_49788766
Grik3,4,125490700,125714173,protein_coding,1,223473,chr4_125490700_125714173
Grik4,9,42518135,42944493,protein_coding,-1,426358,chr9_42518135_42944493
Grik5,7,25009849,25072346,protein_coding,-1,62497,chr7_25009849_25072346
Grin1,2,25291181,25319187,protein_coding,-1,28006,chr2_25291181_25319187
Grin1os,2,25291220,25298925,antisense,1,7705,chr2_25291220_25298925
Grin2a,16,9567898,9995560,protein_coding,-1,427662,chr16_9567898_9995560
Grin2b,6,135713233,136173511,protein_coding,-1,460278,chr6_135713233_136173511
Grin2c,11,115249169,115267243,protein_coding,-1,18074,chr11_115249169_115267243
Grin2d,7,45831883,45878378,protein_coding,-1,46495,chr7_45831883_45878378
Grin3a,4,49661611,49845744,protein_coding,-1,184133,chr4_49661611_49845744
Grin3b,10,79970715,79977190,protein_coding,1,6475,chr10_79970715_79977190
Grina,15,76246764,76249904,protein_coding,1,3140,chr15_76246764_76249904
Grip1,10,119453830,120087261,protein_coding,1,633431,chr10_119453830_120087261
Grip1os1,10,119825204,119852390,antisense,-1,27186,chr10_119825204_119852390
Grip1os2,10,119746063,119761699,antisense,-1,15636,chr10_119746063_119761699
Grip2,6,91761509,91827250,protein_coding,-1,65741,chr6_91761509_91827250
Gripap1,X,7789765,7820567,protein_coding,1,30802,chrX_7789765_7820567
Grk4,5,34660379,34755305,protein_coding,1,94926,chr5_34660379_34755305
Grk5,19,60889749,61095968,protein_coding,1,206219,chr19_60889749_61095968
Grk6,13,55445072,55460927,protein_coding,1,15855,chr13_55445072_55460927
Grm1,10,10686059,11082356,protein_coding,-1,396297,chr10_10686059_11082356
Grm2,9,106643095,106656082,protein_coding,-1,12987,chr9_106643095_106656082
Grm3,5,9485541,9725170,protein_coding,-1,239629,chr5_9485541_9725170
Grm4,17,27422387,27521403,protein_coding,-1,99016,chr17_27422387_27521403
Grm5,7,87584168,88134907,protein_coding,1,550739,chr7_87584168_88134907
Grm6,11,50850685,50866208,protein_coding,1,15523,chr11_50850685_50866208
Grm7,6,110645581,111567230,protein_coding,1,921649,chr6_110645581_111567230
Grm8,6,27275119,28135178,protein_coding,-1,860059,chr6_27275119_28135178
Grn,11,102430315,102437048,protein_coding,1,6733,chr11_102430315_102437048
Grp,18,65872820,65886596,protein_coding,1,13776,chr18_65872820_65886596
Grpel1,5,36464998,36474080,protein_coding,1,9082,chr5_36464998_36474080
Grpel2,18,61712424,61726325,protein_coding,-1,13901,chr18_61712424_61726325
Grpr,X,163513904,163549677,protein_coding,-1,35773,chrX_163513904_163549677
Grrp1,4,134251110,134254106,protein_coding,-1,2996,chr4_134251110_134254106
Grsf1,5,88659448,88676171,protein_coding,-1,16723,chr5_88659448_88676171
Grtp1,8,13172022,13200620,protein_coding,-1,28598,chr8_13172022_13200620
Grwd1,7,45825223,45830944,protein_coding,-1,5721,chr7_45825223_45830944
Grxcr2,18,41985323,41999049,protein_coding,-1,13726,chr18_41985323_41999049
Gsap,5,21186255,21315132,protein_coding,1,128877,chr5_21186255_21315132
Gsc2,16,17913107,17915059,protein_coding,-1,1952,chr16_17913107_17915059
Gsdma,11,98664351,98677708,protein_coding,1,13357,chr11_98664351_98677708
Gsdma2,11,98646759,98657964,protein_coding,1,11205,chr11_98646759_98657964
Gsdmcl-ps,15,63914448,63925666,transcribed_unprocessed_pseudogene,1,11218,chr15_63914448_63925666
Gsdmd,15,75862327,75867408,protein_coding,1,5081,chr15_75862327_75867408
Gse1,8,120228456,120581390,protein_coding,1,352934,chr8_120228456_120581390
Gsg1,6,135237326,135254351,protein_coding,-1,17025,chr6_135237326_135254351
Gsg1l,7,125878420,126082411,protein_coding,-1,203991,chr7_125878420_126082411
Gsk3a,7,25228258,25237851,protein_coding,-1,9593,chr7_25228258_25237851
Gsk3b,16,38089001,38246084,protein_coding,1,157083,chr16_38089001_38246084
Gskip,12,105684829,105703023,protein_coding,1,18194,chr12_105684829_105703023
Gsn,2,35256380,35307892,protein_coding,1,51512,chr2_35256380_35307892
Gspt1,16,11219292,11254325,protein_coding,-1,35033,chr16_11219292_11254325
Gspt2,X,94636069,94643244,protein_coding,1,7175,chrX_94636069_94643244
Gsr,8,33652523,33698163,protein_coding,1,45640,chr8_33652523_33698163
Gss,2,155563181,155592810,protein_coding,-1,29629,chr2_155563181_155592810
Gsta3,1,21240589,21265661,protein_coding,1,25072,chr1_21240589_21265661
Gsta4,9,78182774,78209349,protein_coding,1,26575,chr9_78182774_78209349
Gstcd,3,132981752,133092033,protein_coding,-1,110281,chr3_132981752_133092033
Gstk1,6,42245935,42250447,protein_coding,1,4512,chr6_42245935_42250447
Gstm1,3,108012255,108017973,protein_coding,-1,5718,chr3_108012255_108017973
Gstm2,3,107981702,107986453,protein_coding,-1,4751,chr3_107981702_107986453
Gstm2-ps1,5,116632908,116633564,processed_pseudogene,-1,656,chr5_116632908_116633564
Gstm3,3,107963696,107969283,protein_coding,-1,5587,chr3_107963696_107969283
Gstm4,3,108040408,108044894,protein_coding,-1,4486,chr3_108040408_108044894
Gstm5,3,107895821,107898686,protein_coding,1,2865,chr3_107895821_107898686
Gstm6,3,107938847,107943749,protein_coding,-1,4902,chr3_107938847_107943749
Gstm7,3,107926334,107931817,protein_coding,-1,5483,chr3_107926334_107931817
Gsto1,19,47854970,47864790,protein_coding,1,9820,chr19_47854970_47864790
Gsto2,19,47865534,47886324,protein_coding,1,20790,chr19_47865534_47886324
Gstp1,19,4035407,4037985,protein_coding,-1,2578,chr19_4035407_4037985
Gstp2,19,4040285,4046023,protein_coding,-1,5738,chr19_4040285_4046023
Gstt1,10,75783813,75798584,protein_coding,-1,14771,chr10_75783813_75798584
Gstt2,10,75831114,75837424,protein_coding,-1,6310,chr10_75831114_75837424
Gstt3,10,75774115,75781414,protein_coding,-1,7299,chr10_75774115_75781414
Gstz1,12,87147165,87164723,protein_coding,1,17558,chr12_87147165_87164723
Gsx1,5,147188696,147190947,protein_coding,1,2251,chr5_147188696_147190947
Gsx2,5,75075601,75077893,protein_coding,1,2292,chr5_75075601_75077893
Gt(ROSA)26Sor,6,113067428,113077333,antisense,-1,9905,chr6_113067428_113077333
Gtdc1,2,44564412,44927657,protein_coding,-1,363245,chr2_44564412_44927657
Gtf2a1,12,91555262,91590487,protein_coding,-1,35225,chr12_91555262_91590487
Gtf2a1l,17,88668660,88715152,protein_coding,1,46492,chr17_88668660_88715152
Gtf2a2,9,70012550,70022866,protein_coding,1,10316,chr9_70012550_70022866
Gtf2b,3,142765045,142783606,protein_coding,1,18561,chr3_142765045_142783606
Gtf2e1,16,37509790,37539789,protein_coding,-1,29999,chr16_37509790_37539789
Gtf2e2,8,33731833,33777173,protein_coding,1,45340,chr8_33731833_33777173
Gtf2f1,17,57003405,57011288,protein_coding,-1,7883,chr17_57003405_57011288
Gtf2f2,14,75896937,76010865,protein_coding,-1,113928,chr14_75896937_76010865
Gtf2h1,7,46796103,46823800,protein_coding,1,27697,chr7_46796103_46823800
Gtf2h2,13,100460218,100492579,protein_coding,-1,32361,chr13_100460218_100492579
Gtf2h3,5,124579140,124597680,protein_coding,1,18540,chr5_124579140_124597680
Gtf2h4,17,35667730,35673739,protein_coding,-1,6009,chr17_35667730_35673739
Gtf2h5,17,6079786,6086517,protein_coding,1,6731,chr17_6079786_6086517
Gtf2i,5,134237834,134314760,protein_coding,-1,76926,chr5_134237834_134314760
Gtf2ird1,5,134357656,134456716,protein_coding,-1,99060,chr5_134357656_134456716
Gtf2ird2,5,134184019,134224355,protein_coding,1,40336,chr5_134184019_134224355
Gtf3a,5,146948657,146955614,protein_coding,1,6957,chr5_146948657_146955614
Gtf3c1,7,125640954,125707780,protein_coding,-1,66826,chr7_125640954_125707780
Gtf3c2,5,31156005,31180144,protein_coding,-1,24139,chr5_31156005_31180144
Gtf3c3,1,54396004,54438971,protein_coding,-1,42967,chr1_54396004_54438971
Gtf3c4,2,28822299,28840360,protein_coding,-1,18061,chr2_28822299_28840360
Gtf3c5,2,28566311,28583751,protein_coding,-1,17440,chr2_28566311_28583751
Gtf3c6,10,40247703,40258108,protein_coding,-1,10405,chr10_40247703_40258108
Gtpbp1,15,79690845,79721479,protein_coding,1,30634,chr15_79690845_79721479
Gtpbp10,5,5537454,5559538,protein_coding,-1,22084,chr5_5537454_5559538
Gtpbp2,17,46161032,46169370,protein_coding,1,8338,chr17_46161032_46169370
Gtpbp3,8,71488103,71499583,protein_coding,1,11480,chr8_71488103_71499583
Gtpbp4,13,8966331,8996083,protein_coding,-1,29752,chr13_8966331_8996083
Gtpbp6,5,110103975,110108197,protein_coding,-1,4222,chr5_110103975_110108197
Gtpbp8,16,44736768,44746363,protein_coding,-1,9595,chr16_44736768_44746363
Gtse1,15,85859745,85876573,protein_coding,1,16828,chr15_85859745_85876573
Gtsf1,15,103402405,103430470,protein_coding,-1,28065,chr15_103402405_103430470
Guca1a,17,47394557,47400584,protein_coding,-1,6027,chr17_47394557_47400584
Guca1b,17,47385392,47392967,protein_coding,1,7575,chr17_47385392_47392967
Guca2a,4,119637704,119639471,protein_coding,1,1767,chr4_119637704_119639471
Guca2b,4,119656607,119658954,protein_coding,-1,2347,chr4_119656607_119658954
Gucd1,10,75351111,75517972,protein_coding,-1,166861,chr10_75351111_75517972
Gucy1a2,9,3532778,3894736,protein_coding,1,361958,chr9_3532778_3894736
Gucy1b2,14,62392676,62456289,protein_coding,-1,63613,chr14_62392676_62456289
Gucy2c,6,136697284,136781765,protein_coding,-1,84481,chr6_136697284_136781765
Gucy2e,11,69218117,69237036,protein_coding,-1,18919,chr11_69218117_69237036
Gucy2f,X,142081160,142196931,protein_coding,-1,115771,chrX_142081160_142196931
Gucy2g,19,55198099,55241236,protein_coding,-1,43137,chr19_55198099_55241236
Guf1,5,69556923,69575973,protein_coding,1,19050,chr5_69556923_69575973
Guk1,11,59183875,59192212,protein_coding,-1,8337,chr11_59183875_59192212
Gulp1,1,44551511,44796838,protein_coding,1,245327,chr1_44551511_44796838
Gusb,5,129989011,130003049,protein_coding,-1,14038,chr5_129989011_130003049
Gvin1,7,106156556,106215326,protein_coding,-1,58770,chr7_106156556_106215326
Gxylt1,15,93239742,93275179,protein_coding,-1,35437,chr15_93239742_93275179
Gxylt2,6,100704734,100810913,protein_coding,1,106179,chr6_100704734_100810913
Gyg,3,20122084,20155317,protein_coding,-1,33233,chr3_20122084_20155317
Gykl1,18,52693690,52695550,protein_coding,1,1860,chr18_52693690_52695550
Gypc,18,32528322,32560034,protein_coding,-1,31712,chr18_32528322_32560034
Gys1,7,45434844,45456619,protein_coding,1,21775,chr7_45434844_45456619
Gys2,6,142422613,142473109,protein_coding,-1,50496,chr6_142422613_142473109
Gzf1,2,148681023,148692949,protein_coding,1,11926,chr2_148681023_148692949
Gzmk,13,113171608,113225908,protein_coding,-1,54300,chr13_113171608_113225908
Gzmm,10,79689020,79695261,protein_coding,1,6241,chr10_79689020_79695261
H13,2,152669461,152708670,protein_coding,1,39209,chr2_152669461_152708670
H1f0,15,79028450,79030504,protein_coding,1,2054,chr15_79028450_79030504
H2-Aa,17,34282744,34287823,protein_coding,-1,5079,chr17_34282744_34287823
H2-Ab1,17,34257689,34269419,protein_coding,1,11730,chr17_34257689_34269419
H2-Bl,17,36080115,36084223,polymorphic_pseudogene,-1,4108,chr17_36080115_36084223
H2-D1,17,35262730,35267499,protein_coding,1,4769,chr17_35262730_35267499
H2-DMa,17,34119541,34139101,protein_coding,1,19560,chr17_34119541_34139101
H2-DMb1,17,34153072,34160230,protein_coding,1,7158,chr17_34153072_34160230
H2-DMb2,17,34143307,34151555,protein_coding,1,8248,chr17_34143307_34151555
H2-Eb1,17,34305867,34316674,protein_coding,1,10807,chr17_34305867_34316674
H2-Eb2,17,34325665,34341412,protein_coding,1,15747,chr17_34325665_34341412
H2-K1,17,33996017,34000347,protein_coding,-1,4330,chr17_33996017_34000347
H2-K2,17,33974659,33978827,transcribed_unprocessed_pseudogene,-1,4168,chr17_33974659_33978827
H2-Ke6,17,34026033,34028060,protein_coding,-1,2027,chr17_34026033_34028060
H2-M10.1,17,36322858,36326155,protein_coding,-1,3297,chr17_36322858_36326155
H2-M10.2,17,36284227,36286490,protein_coding,-1,2263,chr17_36284227_36286490
H2-M10.5,17,36772910,36776234,protein_coding,1,3324,chr17_36772910_36776234
H2-M11,17,36547075,36549250,protein_coding,1,2175,chr17_36547075_36549250
H2-M2,17,37480851,37483552,protein_coding,-1,2701,chr17_37480851_37483552
H2-M3,17,37270220,37274484,protein_coding,1,4264,chr17_37270220_37274484
H2-M5,17,36984061,36989537,protein_coding,-1,5476,chr17_36984061_36989537
H2-M6-ps,17,36969195,36971396,unprocessed_pseudogene,-1,2201,chr17_36969195_36971396
H2-Oa,17,34092340,34095234,protein_coding,1,2894,chr17_34092340_34095234
H2-Ob,17,34238903,34254414,protein_coding,1,15511,chr17_34238903_34254414
H2-Pa,17,34084601,34085823,unprocessed_pseudogene,1,1222,chr17_34084601_34085823
H2-Q1,17,35320405,35325099,protein_coding,1,4694,chr17_35320405_35325099
H2-Q10,17,35470089,35474563,protein_coding,1,4474,chr17_35470089_35474563
H2-Q2,17,35342242,35346762,protein_coding,1,4520,chr17_35342242_35346762
H2-Q3,17,35358989,35359972,unprocessed_pseudogene,1,983,chr17_35358989_35359972
H2-Q4,17,35379617,35385290,protein_coding,1,5673,chr17_35379617_35385290
H2-Q5,17,35394126,35397800,polymorphic_pseudogene,1,3674,chr17_35394126_35397800
H2-Q6,17,35424850,35430055,protein_coding,1,5205,chr17_35424850_35430055
H2-Q7,17,35439155,35443773,protein_coding,1,4618,chr17_35439155_35443773
H2-T10,17,36115876,36121465,polymorphic_pseudogene,-1,5589,chr17_36115876_36121465
H2-T22,17,36037128,36042747,protein_coding,-1,5619,chr17_36037128_36042747
H2-T23,17,36029773,36032855,protein_coding,-1,3082,chr17_36029773_36032855
H2-T24,17,36005695,36020560,protein_coding,-1,14865,chr17_36005695_36020560
H2-T3,17,36185572,36190287,protein_coding,-1,4715,chr17_36185572_36190287
H3f3a,1,180800832,180813943,protein_coding,-1,13111,chr1_180800832_180813943
H3f3a-ps1,X,101824515,101824924,processed_pseudogene,1,409,chrX_101824515_101824924
H3f3a-ps2,16,91114189,91114599,processed_pseudogene,-1,410,chr16_91114189_91114599
H3f3b,11,116021912,116027962,protein_coding,-1,6050,chr11_116021912_116027962
H3f3c,2,119665626,119666036,processed_pseudogene,-1,410,chr2_119665626_119666036
H60b,10,22158586,22288849,protein_coding,1,130263,chr10_22158586_22288849
H60c,10,3256208,3267771,protein_coding,-1,11563,chr10_3256208_3267771
H6pd,4,149979475,150009023,protein_coding,-1,29548,chr4_149979475_150009023
Haao,17,83831156,83847963,protein_coding,-1,16807,chr17_83831156_83847963
Habp2,19,56287137,56320822,protein_coding,1,33685,chr19_56287137_56320822
Habp4,13,64161824,64186537,protein_coding,1,24713,chr13_64161824_64186537
Hace1,10,45577829,45712345,protein_coding,1,134516,chr10_45577829_45712345
Hacl1,14,31598730,31641286,protein_coding,-1,42556,chr14_31598730_31641286
Hadh,3,131233419,131272101,protein_coding,-1,38682,chr3_131233419_131272101
Hadha,5,30118304,30155162,protein_coding,-1,36858,chr5_30118304_30155162
Hadhb,5,30155248,30184593,protein_coding,1,29345,chr5_30155248_30184593
Hagh,17,24840143,24864450,protein_coding,1,24307,chr17_24840143_24864450
Haghl,17,25779843,25785673,protein_coding,-1,5830,chr17_25779843_25785673
Hal,10,93488768,93519304,protein_coding,1,30536,chr10_93488768_93519304
Hamp,7,30942368,30944032,protein_coding,-1,1664,chr7_30942368_30944032
Hamp2,7,30922372,30924681,protein_coding,-1,2309,chr7_30922372_30924681
Hao1,2,134497361,134554368,protein_coding,-1,57007,chr2_134497361_134554368
Hao2,3,98874521,98893239,protein_coding,-1,18718,chr3_98874521_98893239
Hap1,11,100347327,100356128,protein_coding,-1,8801,chr11_100347327_100356128
Hapln1,13,89539796,89611652,protein_coding,1,71856,chr13_89539796_89611652
Hapln2,3,88021750,88027583,protein_coding,-1,5833,chr3_88021750_88027583
Hapln3,7,79115102,79131018,protein_coding,-1,15916,chr7_79115102_79131018
Hapln4,8,70083457,70090862,protein_coding,1,7405,chr8_70083457_70090862
Harbi1,2,91710852,91721545,protein_coding,1,10693,chr2_91710852_91721545
Hars,18,36766528,36783205,protein_coding,-1,16677,chr18_36766528_36783205
Hars2,18,36783008,36792562,protein_coding,1,9554,chr18_36783008_36792562
Has1,17,17843323,17855205,protein_coding,-1,11882,chr17_17843323_17855205
Has2,15,56665627,56694539,protein_coding,-1,28912,chr15_56665627_56694539
Has2os,15,56689944,56778399,processed_transcript,1,88455,chr15_56689944_56778399
Has3,8,106870242,106884566,protein_coding,1,14324,chr8_106870242_106884566
Hat1,2,71388958,71441622,protein_coding,1,52664,chr2_71388958_71441622
Haus1,18,77757567,77773886,protein_coding,-1,16319,chr18_77757567_77773886
Haus2,2,120609383,120621560,protein_coding,1,12177,chr2_120609383_120621560
Haus3,5,34153880,34169527,protein_coding,-1,15647,chr5_34153880_34169527
Haus4,14,54541785,54554616,protein_coding,-1,12831,chr14_54541785_54554616
Haus5,7,30653711,30664994,protein_coding,-1,11283,chr7_30653711_30664994
Haus6,4,86578855,86612055,protein_coding,-1,33200,chr4_86578855_86612055
Haus7,X,73437315,73459044,protein_coding,-1,21729,chrX_73437315_73459044
Haus8,8,71248561,71272934,protein_coding,-1,24373,chr8_71248561_71272934
Havcr2,11,46454935,46481255,protein_coding,1,26320,chr11_46454935_46481255
Hax1,3,89995446,89998780,protein_coding,-1,3334,chr3_89995446_89998780
Hba-a1,11,32283511,32284465,protein_coding,1,954,chr11_32283511_32284465
Hba-a2,11,32296489,32297298,protein_coding,1,809,chr11_32296489_32297298
Hba-ps4,17,26286363,26287061,unprocessed_pseudogene,-1,698,chr17_26286363_26287061
Hbb-bs,7,103826534,103828096,protein_coding,-1,1562,chr7_103826534_103828096
Hbb-bt,7,103812524,103813996,protein_coding,-1,1472,chr7_103812524_103813996
Hbegf,18,36504927,36515805,protein_coding,-1,10878,chr18_36504927_36515805
Hbp1,12,31926254,31950535,protein_coding,-1,24281,chr12_31926254_31950535
Hbq1a,11,32300069,32300873,protein_coding,1,804,chr11_32300069_32300873
Hbq1b,11,32286965,32287784,protein_coding,1,819,chr11_32286965_32287784
Hbs1l,10,21295979,21368898,protein_coding,1,72919,chr10_21295979_21368898
Hc,2,34983331,35061438,protein_coding,-1,78107,chr2_34983331_35061438
Hcar2,5,123863570,123865499,protein_coding,-1,1929,chr5_123863570_123865499
Hccs,X,169250193,169320372,protein_coding,-1,70179,chrX_169250193_169320372
Hcfc1,X,73942792,73966357,protein_coding,-1,23565,chrX_73942792_73966357
Hcfc1r1,17,23673596,23675227,protein_coding,1,1631,chr17_23673596_23675227
Hcfc2,10,82696160,82742428,protein_coding,1,46268,chr10_82696160_82742428
Hck,2,153108468,153151441,protein_coding,1,42973,chr2_153108468_153151441
Hcls1,16,36934983,36963212,protein_coding,1,28229,chr16_36934983_36963212
Hcn1,13,117602320,117987418,protein_coding,1,385098,chr13_117602320_117987418
Hcn2,10,79716634,79736108,protein_coding,1,19474,chr10_79716634_79736108
Hcn3,3,89146074,89160196,protein_coding,-1,14122,chr3_89146074_89160196
Hcn4,9,58823412,58863175,protein_coding,1,39763,chr9_58823412_58863175
Hcrt,11,100761069,100762931,protein_coding,-1,1862,chr11_100761069_100762931
Hcrtr1,4,130130217,130139359,protein_coding,-1,9142,chr4_130130217_130139359
Hcrtr2,9,76225880,76323856,protein_coding,-1,97976,chr9_76225880_76323856
Hcst,7,30417712,30419854,protein_coding,-1,2142,chr7_30417712_30419854
Hdac1,4,129516104,129542713,protein_coding,-1,26609,chr4_129516104_129542713
Hdac10,15,89123307,89128700,protein_coding,-1,5393,chr15_89123307_89128700
Hdac11,6,91156665,91174692,protein_coding,1,18027,chr6_91156665_91174692
Hdac2,10,36974544,37001889,protein_coding,1,27345,chr10_36974544_37001889
Hdac3,18,37935844,37955016,protein_coding,-1,19172,chr18_37935844_37955016
Hdac4,1,91928779,92195699,protein_coding,-1,266920,chr1_91928779_92195699
Hdac5,11,102194432,102230166,protein_coding,-1,35734,chr11_102194432_102230166
Hdac6,X,7930120,7947889,protein_coding,-1,17769,chrX_7930120_7947889
Hdac7,15,97792664,97844502,protein_coding,-1,51838,chr15_97792664_97844502
Hdac8,X,102284639,102505359,protein_coding,-1,220720,chrX_102284639_102505359
Hdac9,12,34047580,34917095,protein_coding,-1,869515,chr12_34047580_34917095
Hdc,2,126593667,126619299,protein_coding,-1,25632,chr2_126593667_126619299
Hddc2,10,31313383,31328204,protein_coding,1,14821,chr10_31313383_31328204
Hddc3,7,80343104,80350547,protein_coding,1,7443,chr7_80343104_80350547
Hdgf,3,87906321,87916132,protein_coding,1,9811,chr3_87906321_87916132
Hdgfl1,13,26768173,26770165,protein_coding,-1,1992,chr13_26768173_26770165
Hdhd2,18,76944092,76975307,protein_coding,1,31215,chr18_76944092_76975307
Hdhd3,4,62499008,62503467,protein_coding,-1,4459,chr4_62499008_62503467
Hdlbp,1,93405940,93478815,protein_coding,-1,72875,chr1_93405940_93478815
Hdx,X,111569931,111697079,protein_coding,-1,127148,chrX_111569931_111697079
Heatr1,13,12395027,12440289,protein_coding,1,45262,chr13_12395027_12440289
Heatr3,8,88137855,88172027,protein_coding,1,34172,chr8_88137855_88172027
Heatr5a,12,51875871,51971321,protein_coding,-1,95450,chr12_51875871_51971321
Heatr5b,17,78752898,78835364,protein_coding,-1,82466,chr17_78752898_78835364
Heatr6,11,83753696,83783754,protein_coding,1,30058,chr11_83753696_83783754
Heatr9,11,83511736,83522175,protein_coding,-1,10439,chr11_83511736_83522175
Hebp1,6,135137522,135198022,protein_coding,-1,60500,chr6_135137522_135198022
Hebp2,10,18539498,18546076,protein_coding,-1,6578,chr10_18539498_18546076
Heca,10,17868612,17948067,protein_coding,-1,79455,chr10_17868612_17948067
Hectd1,12,51743722,51829536,protein_coding,-1,85814,chr12_51743722_51829536
Hectd2,19,36554639,36621135,protein_coding,1,66496,chr19_36554639_36621135
Hectd3,4,116995317,117005277,protein_coding,1,9960,chr4_116995317_117005277
Hecw1,13,14226438,14523228,protein_coding,-1,296790,chr13_14226438_14523228
Hecw2,1,53806876,54195168,protein_coding,-1,388292,chr1_53806876_54195168
Heg1,16,33684370,33771576,protein_coding,1,87206,chr16_33684370_33771576
Helb,10,120083608,120112987,protein_coding,-1,29379,chr10_120083608_120112987
Hells,19,38930915,38971051,protein_coding,1,40136,chr19_38930915_38971051
Helq,5,100762145,100798598,protein_coding,-1,36453,chr5_100762145_100798598
Helt,8,46292039,46294671,protein_coding,-1,2632,chr8_46292039_46294671
Helz,11,107547930,107693826,protein_coding,1,145896,chr11_107547930_107693826
Helz2,2,181227615,181242027,protein_coding,-1,14412,chr2_181227615_181242027
Hemk1,9,107327084,107338350,protein_coding,-1,11266,chr9_107327084_107338350
Henmt1,3,108940059,108960774,protein_coding,1,20715,chr3_108940059_108960774
Hepacam,9,37367351,37386575,protein_coding,1,19224,chr9_37367351_37386575
Hepacam2,6,3457096,3498298,protein_coding,-1,41202,chr6_3457096_3498298
Heph,X,96455359,96574485,protein_coding,1,119126,chrX_96455359_96574485
Hephl1,9,15051841,15112108,protein_coding,-1,60267,chr9_15051841_15112108
Herc1,9,66350450,66508775,protein_coding,1,158325,chr9_66350450_66508775
Herc2,7,56050196,56231800,protein_coding,1,181604,chr7_56050196_56231800
Herc3,6,58831465,58920398,protein_coding,1,88933,chr6_58831465_58920398
Herc4,10,63243810,63317878,protein_coding,1,74068,chr10_63243810_63317878
Herc6,6,57581000,57664632,protein_coding,1,83632,chr6_57581000_57664632
Herpud1,8,94386438,94395377,protein_coding,1,8939,chr8_94386438_94395377
Herpud2,9,25108132,25151820,protein_coding,-1,43688,chr9_25108132_25151820
Hes1,16,30064384,30067796,protein_coding,1,3412,chr16_30064384_30067796
Hes2,4,152158867,152162469,protein_coding,1,3602,chr4_152158867_152162469
Hes3,4,152285972,152291662,protein_coding,-1,5690,chr4_152285972_152291662
Hes5,4,154960923,154962371,protein_coding,1,1448,chr4_154960923_154962371
Hes6,1,91411483,91414038,protein_coding,-1,2555,chr1_91411483_91414038
Hes7,11,69120404,69124055,protein_coding,1,3651,chr11_69120404_69124055
Hexa,9,59539540,59565109,protein_coding,1,25569,chr9_59539540_59565109
Hexb,13,97176331,97198357,protein_coding,-1,22026,chr13_97176331_97198357
Hexdc,11,121204433,121222655,protein_coding,1,18222,chr11_121204433_121222655
Hexim1,11,103116231,103119725,protein_coding,1,3494,chr11_103116231_103119725
Hexim2,11,103132429,103139876,protein_coding,1,7447,chr11_103132429_103139876
Hey1,3,8663359,8667256,protein_coding,-1,3897,chr3_8663359_8667256
Hey2,10,30832359,30842801,protein_coding,-1,10442,chr10_30832359_30842801
Heyl,4,123233556,123249875,protein_coding,1,16319,chr4_123233556_123249875
Hfe,13,23702034,23710854,protein_coding,-1,8820,chr13_23702034_23710854
Hfm1,5,106840192,106926321,protein_coding,-1,86129,chr5_106840192_106926321
Hgd,16,37580153,37632020,protein_coding,1,51867,chr16_37580153_37632020
Hgf,5,16553495,16620152,protein_coding,1,66657,chr5_16553495_16620152
Hgfac,5,35041509,35048461,protein_coding,1,6952,chr5_35041509_35048461
Hgh1,15,76368898,76371437,protein_coding,1,2539,chr15_76368898_76371437
Hgs,11,120467635,120483979,protein_coding,1,16344,chr11_120467635_120483979
Hgsnat,8,25944453,25976753,protein_coding,-1,32300,chr8_25944453_25976753
Hhat,1,192496711,192771223,protein_coding,-1,274512,chr1_192496711_192771223
Hhatl,9,121784016,121792507,protein_coding,-1,8491,chr9_121784016_121792507
Hhex,19,37434810,37451780,protein_coding,1,16970,chr19_37434810_37451780
Hhip,8,79965851,80058006,protein_coding,-1,92155,chr8_79965851_80058006
Hhipl1,12,108306270,108330869,protein_coding,1,24599,chr12_108306270_108330869
Hhipl2,1,183418215,183436808,protein_coding,1,18593,chr1_183418215_183436808
Hhla1,15,65916609,65976804,protein_coding,-1,60195,chr15_65916609_65976804
Hibadh,6,52546228,52640389,protein_coding,-1,94161,chr6_52546228_52640389
Hibch,1,52844929,52920986,protein_coding,1,76057,chr1_52844929_52920986
Hic1,11,75164565,75169519,protein_coding,-1,4954,chr11_75164565_75169519
Hic2,16,17233572,17263430,protein_coding,1,29858,chr16_17233572_17263430
Hid1,11,115347707,115367756,protein_coding,-1,20049,chr11_115347707_115367756
Hif1a,12,73901375,73947530,protein_coding,1,46155,chr12_73901375_73947530
Hif1an,19,44562850,44576274,protein_coding,1,13424,chr19_44562850_44576274
Hif3a,7,17031507,17062427,protein_coding,-1,30920,chr7_17031507_17062427
Higd1a,9,121848563,121858362,protein_coding,-1,9799,chr9_121848563_121858362
Higd1b,11,102835849,102838040,protein_coding,1,2191,chr11_102835849_102838040
Higd2a,13,54590207,54591158,protein_coding,1,951,chr13_54590207_54591158
Hilpda,6,29272488,29275446,protein_coding,1,2958,chr6_29272488_29275446
Hinfp,9,44292440,44305671,protein_coding,-1,13231,chr9_44292440_44305671
Hint1,11,54866383,54870501,protein_coding,1,4118,chr11_54866383_54870501
Hint2,4,43654227,43656466,protein_coding,-1,2239,chr4_43654227_43656466
Hint3,10,30608141,30629632,protein_coding,-1,21491,chr10_30608141_30629632
Hip1,5,135406531,135545120,protein_coding,-1,138589,chr5_135406531_135545120
Hip1r,5,123973628,124005558,protein_coding,1,31930,chr5_123973628_124005558
Hipk1,3,103739815,103791563,protein_coding,-1,51748,chr3_103739815_103791563
Hipk2,6,38694390,38876165,protein_coding,-1,181775,chr6_38694390_38876165
Hipk3,2,104426481,104494446,protein_coding,-1,67965,chr2_104426481_104494446
Hipk4,7,27523267,27531175,protein_coding,1,7908,chr7_27523267_27531175
Hira,16,18877037,18970309,protein_coding,1,93272,chr16_18877037_18970309
Hirip3,7,126861972,126865377,protein_coding,1,3405,chr7_126861972_126865377
Hist1h2al,13,51202727,51203065,processed_pseudogene,-1,338,chr13_51202727_51203065
Hist1h2an,13,21786826,21787218,protein_coding,-1,392,chr13_21786826_21787218
Hist1h2ao,13,21810465,21810944,protein_coding,1,479,chr13_21810465_21810944
Hist1h2ap,13,21833026,21833507,protein_coding,-1,481,chr13_21833026_21833507
Hist1h2bp,13,21787461,21789213,protein_coding,1,1752,chr13_21787461_21789213
Hist1h2bq,13,21806612,21810197,protein_coding,-1,3585,chr13_21806612_21810197
Hist1h2br,13,21833743,21837530,protein_coding,1,3787,chr13_21833743_21837530
Hist1h4m,13,21811746,21812147,protein_coding,1,401,chr13_21811746_21812147
Hist1h4n,13,21831767,21832196,protein_coding,-1,429,chr13_21831767_21832196
Hivep1,13,42052021,42192537,protein_coding,1,140516,chr13_42052021_42192537
Hivep2,10,13966075,14151374,protein_coding,1,185299,chr10_13966075_14151374
Hivep3,4,119733784,120138045,protein_coding,1,404261,chr4_119733784_120138045
Hjurp,1,88262471,88277633,protein_coding,-1,15162,chr1_88262471_88277633
Hk1,10,62268855,62379908,protein_coding,-1,111053,chr10_62268855_62379908
Hk1os,10,62340256,62363367,antisense,1,23111,chr10_62340256_62363367
Hk2,6,82725025,82774454,protein_coding,-1,49429,chr6_82725025_82774454
Hk3,13,55005985,55021385,protein_coding,-1,15400,chr13_55005985_55021385
Hkdc1,10,62383137,62422491,protein_coding,-1,39354,chr10_62383137_62422491
Hlcs,16,94128882,94313571,protein_coding,-1,184689,chr16_94128882_94313571
Hlf,11,90336536,90390895,protein_coding,-1,54359,chr11_90336536_90390895
Hltf,3,20057811,20118490,protein_coding,1,60679,chr3_20057811_20118490
Hlx,1,184727140,184732619,protein_coding,-1,5479,chr1_184727140_184732619
Hmbox1,14,64811600,64949871,protein_coding,-1,138271,chr14_64811600_64949871
Hmbs,9,44336339,44344228,protein_coding,-1,7889,chr9_44336339_44344228
Hmces,6,87913935,87936629,protein_coding,1,22694,chr6_87913935_87936629
Hmcn1,1,150562524,150993435,protein_coding,-1,430911,chr1_150562524_150993435
Hmcn2,2,31314415,31460738,protein_coding,1,146323,chr2_31314415_31460738
Hmg20a,9,56418609,56496936,protein_coding,1,78327,chr9_56418609_56496936
Hmg20b,10,81346048,81350480,protein_coding,-1,4432,chr10_81346048_81350480
Hmga1,17,27556497,27563674,protein_coding,1,7177,chr17_27556497_27563674
Hmga2,10,120361275,120476469,protein_coding,-1,115194,chr10_120361275_120476469
Hmgb1,5,149046702,149184489,protein_coding,-1,137787,chr5_149046702_149184489
Hmgb1-ps1,11,41141763,41142396,processed_pseudogene,1,633,chr11_41141763_41142396
Hmgb1-ps2,X,146175942,146176577,processed_pseudogene,1,635,chrX_146175942_146176577
Hmgb1-ps4,19,6592602,6593236,processed_pseudogene,-1,634,chr19_6592602_6593236
Hmgb1-ps5,3,95530418,95530974,processed_pseudogene,1,556,chr3_95530418_95530974
Hmgb1-ps6,16,31991253,31991868,processed_pseudogene,-1,615,chr16_31991253_31991868
Hmgb1-ps7,7,42020836,42021483,processed_pseudogene,1,647,chr7_42020836_42021483
Hmgb1-rs16,9,104169199,104169811,processed_pseudogene,-1,612,chr9_104169199_104169811
Hmgb1-rs17,8,33484196,33485167,unprocessed_pseudogene,1,971,chr8_33484196_33485167
Hmgb1-rs18,4,67518306,67518932,processed_pseudogene,-1,626,chr4_67518306_67518932
Hmgb1l,6,131608301,131608871,processed_pseudogene,-1,570,chr6_131608301_131608871
Hmgb2,8,57511907,57515999,protein_coding,1,4092,chr8_57511907_57515999
Hmgb3,X,71555918,71560676,protein_coding,1,4758,chrX_71555918_71560676
Hmgb3-ps,14,9863102,9863702,processed_pseudogene,1,600,chr14_9863102_9863702
Hmgb4,4,128260212,128260957,protein_coding,-1,745,chr4_128260212_128260957
Hmgb4os,4,128261044,128262990,antisense,1,1946,chr4_128261044_128262990
Hmgcl,4,135946448,135962617,protein_coding,1,16169,chr4_135946448_135962617
Hmgcll1,9,76014855,76136350,protein_coding,1,121495,chr9_76014855_76136350
Hmgcr,13,96648967,96670936,protein_coding,-1,21969,chr13_96648967_96670936
Hmgcs1,13,119690379,119708260,protein_coding,1,17881,chr13_119690379_119708260
Hmgcs2,3,98280435,98310738,protein_coding,1,30303,chr3_98280435_98310738
Hmgn1,16,96120618,96127729,protein_coding,-1,7111,chr16_96120618_96127729
Hmgn2,4,133964738,133968650,protein_coding,-1,3912,chr4_133964738_133968650
Hmgn2-ps1,5,84123313,84123591,processed_pseudogene,1,278,chr5_84123313_84123591
Hmgn2l6,X,141870135,141870401,processed_pseudogene,-1,266,chrX_141870135_141870401
Hmgn3,9,83109948,83146685,protein_coding,-1,36737,chr9_83109948_83146685
Hmgn5,X,109004534,109013404,protein_coding,-1,8870,chrX_109004534_109013404
Hmgxb3,18,61131277,61177050,protein_coding,-1,45773,chr18_61131277_61177050
Hmgxb4,8,74993356,75031978,protein_coding,1,38622,chr8_74993356_75031978
Hmmr,11,40701395,40733422,protein_coding,-1,32027,chr11_40701395_40733422
Hmox1,8,75093621,75100589,protein_coding,1,6968,chr8_75093621_75100589
Hmox2,16,4726361,4766742,protein_coding,1,40381,chr16_4726361_4766742
Hmx3,7,131542867,131544925,protein_coding,1,2058,chr7_131542867_131544925
Hnf1a,5,114948980,114971094,protein_coding,-1,22114,chr5_114948980_114971094
Hnf1aos1,5,114968784,114998042,antisense,1,29258,chr5_114968784_114998042
Hnf1b,11,83850063,83905819,protein_coding,1,55756,chr11_83850063_83905819
Hnf4a,2,163506808,163572910,protein_coding,1,66102,chr2_163506808_163572910
Hnf4g,3,3508030,3658052,protein_coding,1,150022,chr3_3508030_3658052
Hnmt,2,24002910,24049394,protein_coding,-1,46484,chr2_24002910_24049394
Hnrnpa0,13,58125879,58128556,protein_coding,-1,2677,chr13_58125879_58128556
Hnrnpa1,15,103240432,103246692,protein_coding,1,6260,chr15_103240432_103246692
Hnrnpa1l2-ps,13,74864305,74865356,processed_pseudogene,1,1051,chr13_74864305_74865356
Hnrnpa2b1,6,51460932,51469894,protein_coding,-1,8962,chr6_51460932_51469894
Hnrnpa3,2,75659261,75669407,protein_coding,1,10146,chr2_75659261_75669407
Hnrnpab,11,51600100,51606847,protein_coding,-1,6747,chr11_51600100_51606847
Hnrnpc,14,52073377,52104028,protein_coding,-1,30651,chr14_52073377_52104028
Hnrnpd,5,99955935,99978938,protein_coding,-1,23003,chr5_99955935_99978938
Hnrnpdl,5,100033577,100039664,protein_coding,-1,6087,chr5_100033577_100039664
Hnrnpf,6,117900324,117925622,protein_coding,1,25298,chr6_117900324_117925622
Hnrnph1,11,50376990,50386528,protein_coding,1,9538,chr11_50376990_50386528
Hnrnph2,X,134601179,134607060,protein_coding,1,5881,chrX_134601179_134607060
Hnrnph3,10,63014664,63024217,protein_coding,-1,9553,chr10_63014664_63024217
Hnrnpk,13,58391142,58403343,protein_coding,-1,12201,chr13_58391142_58403343
Hnrnpl,7,28808541,28822266,protein_coding,1,13725,chr7_28808541_28822266
Hnrnpll,17,80029487,80062334,protein_coding,-1,32847,chr17_80029487_80062334
Hnrnpm,17,33646233,33686860,protein_coding,-1,40627,chr17_33646233_33686860
Hnrnpr,4,136310942,136359447,protein_coding,1,48505,chr4_136310942_136359447
Hnrnpu,1,178321107,178337797,protein_coding,-1,16690,chr1_178321107_178337797
Hnrnpul1,7,25721165,25754757,protein_coding,-1,33592,chr7_25721165_25754757
Hnrnpul2,19,8820010,8834143,protein_coding,1,14133,chr19_8820010_8834143
Hoga1,19,42045610,42070953,protein_coding,1,25343,chr19_42045610_42070953
Homer1,13,93299635,93405129,protein_coding,1,105494,chr13_93299635_93405129
Homer2,7,81600481,81707527,protein_coding,-1,107046,chr7_81600481_81707527
Homer3,8,70282827,70294361,protein_coding,1,11534,chr8_70282827_70294361
Homez,14,54852736,54870961,protein_coding,-1,18225,chr14_54852736_54870961
Hook1,4,95967240,96025413,protein_coding,1,58173,chr4_95967240_96025413
Hook2,8,84990603,85003349,protein_coding,1,12746,chr8_84990603_85003349
Hook3,8,26021421,26119224,protein_coding,-1,97803,chr8_26021421_26119224
Hopx,5,77086988,77115121,protein_coding,-1,28133,chr5_77086988_77115121
Hopxos,5,77094532,77102303,antisense,1,7771,chr5_77094532_77102303
Hormad1,3,95559677,95587671,protein_coding,1,27994,chr3_95559677_95587671
Hormad2,11,4345814,4441105,protein_coding,-1,95291,chr11_4345814_4441105
Hoxa5,6,52201754,52204587,protein_coding,-1,2833,chr6_52201754_52204587
Hoxa6,6,52206288,52208722,protein_coding,-1,2434,chr6_52206288_52208722
Hoxa7,6,52214491,52221854,protein_coding,-1,7363,chr6_52214491_52221854
Hoxa9,6,52223100,52231089,protein_coding,-1,7989,chr6_52223100_52231089
Hoxb1,11,96365752,96368256,protein_coding,1,2504,chr11_96365752_96368256
Hoxb3,11,96323326,96347930,protein_coding,1,24604,chr11_96323326_96347930
Hoxb4,11,96318267,96321638,protein_coding,1,3371,chr11_96318267_96321638
Hoxb8,11,96281905,96285315,protein_coding,1,3410,chr11_96281905_96285315
Hoxb9,11,96271457,96276595,protein_coding,1,5138,chr11_96271457_96276595
Hoxc12,15,102936757,102938609,protein_coding,1,1852,chr15_102936757_102938609
Hoxc13,15,102921103,102928814,protein_coding,1,7711,chr15_102921103_102928814
Hoxc4,15,103018934,103036852,protein_coding,1,17918,chr15_103018934_103036852
Hoxc8,15,102990607,102994111,protein_coding,1,3504,chr15_102990607_102994111
Hoxc9,15,102976439,102985099,protein_coding,1,8660,chr15_102976439_102985099
Hoxd10,2,74691924,74695105,protein_coding,1,3181,chr2_74691924_74695105
Hoxd11,2,74679557,74687016,protein_coding,1,7459,chr2_74679557_74687016
Hoxd13,2,74668310,74671599,protein_coding,1,3289,chr2_74668310_74671599
Hoxd9,2,74697727,74700208,protein_coding,1,2481,chr2_74697727_74700208
Hp,8,109575128,109579172,protein_coding,-1,4044,chr8_109575128_109579172
Hp1bp3,4,138216296,138244683,protein_coding,1,28387,chr4_138216296_138244683
Hpca,4,129111570,129122036,protein_coding,-1,10466,chr4_129111570_129122036
Hpcal1,12,17690856,17791933,protein_coding,1,101077,chr12_17690856_17791933
Hpcal4,4,123183227,123194701,protein_coding,1,11474,chr4_123183227_123194701
Hpd,5,123171807,123182727,protein_coding,-1,10920,chr5_123171807_123182727
Hpdl,4,116819904,116821707,protein_coding,-1,1803,chr4_116819904_116821707
Hpgd,8,56294585,56321043,protein_coding,1,26458,chr8_56294585_56321043
Hpgds,6,65117293,65144908,protein_coding,-1,27615,chr6_65117293_65144908
Hpn,7,31098725,31115290,protein_coding,-1,16565,chr7_31098725_31115290
Hprt,X,52988137,53021659,protein_coding,1,33522,chrX_52988137_53021659
Hps1,19,42755105,42779978,protein_coding,-1,24873,chr19_42755105_42779978
Hps3,3,19995945,20035315,protein_coding,-1,39370,chr3_19995945_20035315
Hps4,5,112343083,112378414,protein_coding,1,35331,chr5_112343083_112378414
Hps5,7,46760466,46796064,protein_coding,-1,35598,chr7_46760466_46796064
Hps6,19,46003508,46006173,protein_coding,1,2665,chr19_46003508_46006173
Hpse,5,100679484,100719716,protein_coding,-1,40232,chr5_100679484_100719716
Hpse2,19,42786539,43388355,protein_coding,-1,601816,chr19_42786539_43388355
Hpx,7,105591613,105600137,protein_coding,-1,8524,chr7_105591613_105600137
Hr,14,70552212,70573548,protein_coding,1,21336,chr14_70552212_70573548
Hras,7,141189105,141194005,protein_coding,-1,4900,chr7_141189105_141194005
Hrc,7,45335290,45338974,protein_coding,1,3684,chr7_45335290_45338974
Hrct1,4,43727188,43728639,protein_coding,1,1451,chr4_43727188_43728639
Hrh1,6,114397936,114483296,protein_coding,1,85360,chr6_114397936_114483296
Hrh2,13,54192129,54236180,protein_coding,1,44051,chr13_54192129_54236180
Hrh3,2,180099465,180104488,protein_coding,-1,5023,chr2_180099465_180104488
Hrk,5,118164648,118189478,protein_coding,1,24830,chr5_118164648_118189478
Hrnr,3,93319749,93333570,protein_coding,1,13821,chr3_93319749_93333570
Hs1bp3,12,8313432,8343824,protein_coding,1,30392,chr12_8313432_8343824
Hs2st1,3,144429706,144570181,protein_coding,-1,140475,chr3_144429706_144570181
Hs3st1,5,39613935,39755475,protein_coding,-1,141540,chr5_39613935_39755475
Hs3st2,7,121391859,121501770,protein_coding,1,109911,chr7_121391859_121501770
Hs3st3a1,11,64435332,64522841,protein_coding,1,87509,chr11_64435332_64522841
Hs3st3b1,11,63885792,63922290,protein_coding,-1,36498,chr11_63885792_63922290
Hs3st4,7,123982869,124398989,protein_coding,1,416120,chr7_123982869_124398989
Hs3st5,10,36506814,36834397,protein_coding,1,327583,chr10_36506814_36834397
Hs3st6,17,24752988,24758684,protein_coding,1,5696,chr17_24752988_24758684
Hs6st1,1,36068400,36106446,protein_coding,1,38046,chr1_36068400_36106446
Hs6st2,X,51387212,51681856,protein_coding,-1,294644,chrX_51387212_51681856
Hs6st3,14,119138341,119869815,protein_coding,1,731474,chr14_119138341_119869815
Hsbp1,8,119344488,119348922,protein_coding,1,4434,chr8_119344488_119348922
Hsbp1l1,18,80229758,80247102,protein_coding,-1,17344,chr18_80229758_80247102
Hscb,5,110829070,110839777,protein_coding,-1,10707,chr5_110829070_110839777
Hsd11b1,1,193221634,193264075,protein_coding,-1,42441,chr1_193221634_193264075
Hsd11b2,8,105518755,105523988,protein_coding,1,5233,chr8_105518755_105523988
Hsd17b1,11,101078411,101080527,protein_coding,1,2116,chr11_101078411_101080527
Hsd17b10,X,152001845,152004442,protein_coding,1,2597,chrX_152001845_152004442
Hsd17b11,5,103989762,104021919,protein_coding,-1,32157,chr5_103989762_104021919
Hsd17b12,2,94032689,94157964,protein_coding,-1,125275,chr2_94032689_94157964
Hsd17b14,7,45554893,45567752,protein_coding,1,12859,chr7_45554893_45567752
Hsd17b2,8,117701904,117759027,protein_coding,1,57123,chr8_117701904_117759027
Hsd17b3,13,64058266,64089230,protein_coding,-1,30964,chr13_64058266_64089230
Hsd17b4,18,50128201,50196269,protein_coding,1,68068,chr18_50128201_50196269
Hsd17b6,10,127990936,128007611,protein_coding,-1,16675,chr10_127990936_128007611
Hsd17b7,1,169949535,169969241,protein_coding,-1,19706,chr1_169949535_169969241
Hsd3b1,3,98852194,98859794,protein_coding,-1,7600,chr3_98852194_98859794
Hsd3b2,3,98709255,98724543,protein_coding,-1,15288,chr3_98709255_98724543
Hsd3b3,3,98741523,98763127,protein_coding,-1,21604,chr3_98741523_98763127
Hsd3b5,3,98618634,98630252,protein_coding,-1,11618,chr3_98618634_98630252
Hsd3b6,3,98805504,98814443,protein_coding,-1,8939,chr3_98805504_98814443
Hsd3b7,7,127800604,127803802,protein_coding,1,3198,chr7_127800604_127803802
Hsdl1,8,119561989,119575183,protein_coding,-1,13194,chr8_119561989_119575183
Hsdl2,4,59581563,59618689,protein_coding,1,37126,chr4_59581563_59618689
Hsf1,15,76477422,76501913,protein_coding,1,24491,chr15_76477422_76501913
Hsf2,10,57486385,57513135,protein_coding,1,26750,chr10_57486385_57513135
Hsf2bp,17,31944769,32036349,protein_coding,-1,91580,chr17_31944769_32036349
Hsf4,8,105269801,105275845,protein_coding,1,6044,chr8_105269801_105275845
Hsf5,11,87617164,87659542,protein_coding,1,42378,chr11_87617164_87659542
Hsh2d,8,72189638,72201527,protein_coding,1,11889,chr8_72189638_72201527
Hsp25-ps1,13,45078498,45079127,processed_pseudogene,-1,629,chr13_45078498_45079127
Hsp90aa1,12,110690605,110702728,protein_coding,-1,12123,chr12_110690605_110702728
Hsp90ab1,17,45567775,45573271,protein_coding,-1,5496,chr17_45567775_45573271
Hsp90b1,10,86690209,86705509,protein_coding,-1,15300,chr10_86690209_86705509
Hspa12a,19,58795750,58943654,protein_coding,-1,147904,chr19_58795750_58943654
Hspa12b,2,131127280,131146321,protein_coding,1,19041,chr2_131127280_131146321
Hspa13,16,75745431,75767104,protein_coding,-1,21673,chr16_75745431_75767104
Hspa14,2,3488850,3512814,protein_coding,-1,23964,chr2_3488850_3512814
Hspa1a,17,34969190,34972156,protein_coding,-1,2966,chr17_34969190_34972156
Hspa1b,17,34956436,34959238,protein_coding,-1,2802,chr17_34956436_34959238
Hspa1l,17,34972703,34979285,protein_coding,1,6582,chr17_34972703_34979285
Hspa2,12,76404176,76406938,protein_coding,1,2762,chr12_76404176_76406938
Hspa4,11,53259814,53300457,protein_coding,-1,40643,chr11_53259814_53300457
Hspa4l,3,40645663,40796103,protein_coding,1,150440,chr3_40645663_40796103
Hspa5,2,34771970,34777547,protein_coding,1,5577,chr2_34771970_34777547
Hspa8,9,40800984,40810087,protein_coding,1,9103,chr9_40800984_40810087
Hspa9,18,34937414,34954357,protein_coding,-1,16943,chr18_34937414_34954357
Hspa9-ps1,X,60575192,60578878,processed_pseudogene,-1,3686,chrX_60575192_60578878
Hspb1,5,135887919,135889563,protein_coding,1,1644,chr5_135887919_135889563
Hspb11,4,107253593,107279938,protein_coding,1,26345,chr4_107253593_107279938
Hspb2,9,50751078,50752354,protein_coding,-1,1276,chr9_50751078_50752354
Hspb3,13,113662896,113663676,protein_coding,-1,780,chr13_113662896_113663676
Hspb6,7,30552178,30555443,protein_coding,1,3265,chr7_30552178_30555443
Hspb7,4,141420779,141425311,protein_coding,1,4532,chr4_141420779_141425311
Hspb8,5,116408491,116422864,protein_coding,-1,14373,chr5_116408491_116422864
Hspb9,11,100713850,100714575,protein_coding,1,725,chr11_100713850_100714575
Hspbap1,16,35770375,35828477,protein_coding,1,58102,chr16_35770375_35828477
Hspbp1,7,4660521,4685068,protein_coding,-1,24547,chr7_4660521_4685068
Hspd1,1,55077835,55088243,protein_coding,-1,10408,chr1_55077835_55088243
Hspe1,1,55088132,55091307,protein_coding,1,3175,chr1_55088132_55091307
Hspe1-ps1,12,68090407,68091074,processed_pseudogene,1,667,chr12_68090407_68091074
Hspe1-ps2,12,81399812,81400123,processed_pseudogene,1,311,chr12_81399812_81400123
Hspe1-ps3,5,25391608,25391884,processed_pseudogene,1,276,chr5_25391608_25391884
Hspe1-ps5,2,72955898,72956194,processed_pseudogene,1,296,chr2_72955898_72956194
Hspe1-ps6,4,96072424,96072706,processed_pseudogene,-1,282,chr4_96072424_96072706
Hspe1-rs1,18,47112139,47112653,protein_coding,1,514,chr18_47112139_47112653
Hspg2,4,137468769,137570630,protein_coding,1,101861,chr4_137468769_137570630
Hsph1,5,149614287,149636376,protein_coding,-1,22089,chr5_149614287_149636376
Htatip2,7,49759115,49773975,protein_coding,1,14860,chr7_49759115_49773975
Htatsf1,X,57053583,57067183,protein_coding,1,13600,chrX_57053583_57067183
Htr1a,13,105443639,105448122,protein_coding,1,4483,chr13_105443639_105448122
Htr1b,9,81628291,81633828,protein_coding,-1,5537,chr9_81628291_81633828
Htr1d,4,136423524,136444398,protein_coding,1,20874,chr4_136423524_136444398
Htr1f,16,64924729,65105854,protein_coding,-1,181125,chr16_64924729_65105854
Htr2a,14,74640840,74709494,protein_coding,1,68654,chr14_74640840_74709494
Htr2b,1,86099026,86111970,protein_coding,-1,12944,chr1_86099026_86111970
Htr2c,X,146962513,147197277,protein_coding,1,234764,chrX_146962513_147197277
Htr3a,9,48899213,48911099,protein_coding,-1,11886,chr9_48899213_48911099
Htr3b,9,48935008,48964990,protein_coding,-1,29982,chr9_48935008_48964990
Htr4,18,62324204,62496577,protein_coding,1,172373,chr18_62324204_62496577
Htr5a,5,27842149,27855088,protein_coding,1,12939,chr5_27842149_27855088
Htr5b,1,121509842,121528465,protein_coding,-1,18623,chr1_121509842_121528465
Htr6,4,139061108,139075570,protein_coding,-1,14462,chr4_139061108_139075570
Htr7,19,35958734,36057507,protein_coding,-1,98773,chr19_35958734_36057507
Htra1,7,130936111,130985660,protein_coding,1,49549,chr7_130936111_130985660
Htra2,6,83051266,83055273,protein_coding,-1,4007,chr6_83051266_83055273
Htra3,5,35652023,35679782,protein_coding,-1,27759,chr5_35652023_35679782
Htra4,8,25024929,25038962,protein_coding,-1,14033,chr8_25024929_25038962
Htt,5,34761740,34912534,protein_coding,1,150794,chr5_34761740_34912534
Hunk,16,90386013,90499553,protein_coding,1,113540,chr16_90386013_90499553
Hus1,11,8993137,9011191,protein_coding,-1,18054,chr11_8993137_9011191
Hus1b,13,30946573,30947759,protein_coding,-1,1186,chr13_30946573_30947759
Huwe1,X,151800807,151935417,protein_coding,1,134610,chrX_151800807_151935417
Hvcn1,5,122206804,122242297,protein_coding,1,35493,chr5_122206804_122242297
Hyal1,9,107576927,107581710,protein_coding,1,4783,chr9_107576927_107581710
Hyal2,9,107567945,107572779,protein_coding,1,4834,chr9_107567945_107572779
Hyal3,9,107580818,107587359,protein_coding,1,6541,chr9_107580818_107587359
Hydin,8,110266977,110610253,protein_coding,1,343276,chr8_110266977_110610253
Hyi,4,118359990,118362744,polymorphic_pseudogene,1,2754,chr4_118359990_118362744
Hykk,9,54917283,54949924,protein_coding,1,32641,chr9_54917283_54949924
Hyls1,9,35560820,35570398,protein_coding,-1,9578,chr9_35560820_35570398
Hyou1,9,44379490,44392369,protein_coding,1,12879,chr9_44379490_44392369
Hypk,2,121453290,121458672,protein_coding,1,5382,chr2_121453290_121458672
I0C0044D17Rik,4,98818475,98823840,protein_coding,-1,5365,chr4_98818475_98823840
I730028E13Rik,9,61138515,61145259,lincRNA,1,6744,chr9_61138515_61145259
I730030J21Rik,15,100730481,100732737,processed_transcript,-1,2256,chr15_100730481_100732737
I830077J02Rik,3,105924358,105932664,protein_coding,-1,8306,chr3_105924358_105932664
Iah1,12,21316389,21323819,protein_coding,1,7430,chr12_21316389_21323819
Iars,13,49682100,49734267,protein_coding,1,52167,chr13_49682100_49734267
Iars2,1,185284726,185329396,protein_coding,-1,44670,chr1_185284726_185329396
Iba57,11,59155369,59163739,protein_coding,-1,8370,chr11_59155369_59163739
Ibsp,5,104299171,104311469,protein_coding,1,12298,chr5_104299171_104311469
Ibtk,9,85687360,85749334,protein_coding,-1,61974,chr9_85687360_85749334
Ica1,6,8630527,8778488,protein_coding,-1,147961,chr6_8630527_8778488
Ica1l,1,59982490,60043184,protein_coding,-1,60694,chr1_59982490_60043184
Icam1,9,21015985,21028817,protein_coding,1,12832,chr9_21015985_21028817
Icam2,11,106377656,106388075,protein_coding,-1,10419,chr11_106377656_106388075
Icam4,9,21029373,21030595,protein_coding,1,1222,chr9_21029373_21030595
Icam5,9,21032073,21039036,protein_coding,1,6963,chr9_21032073_21039036
Ice1,13,70551707,70637634,protein_coding,-1,85927,chr13_70551707_70637634
Ice2,9,69397906,69433122,protein_coding,1,35216,chr9_69397906_69433122
Icmt,4,152297227,152307121,protein_coding,1,9894,chr4_152297227_152307121
Icos,1,60977927,61000320,protein_coding,1,22393,chr1_60977927_61000320
Icosl,10,78069302,78083913,protein_coding,1,14611,chr10_78069302_78083913
Id1,2,152736251,152737410,protein_coding,1,1159,chr2_152736251_152737410
Id2,12,25093799,25097140,protein_coding,-1,3341,chr12_25093799_25097140
Id3,4,136143497,136145755,protein_coding,1,2258,chr4_136143497_136145755
Id4,13,48261228,48266026,protein_coding,1,4798,chr13_48261228_48266026
Ide,19,37268743,37337852,protein_coding,-1,69109,chr19_37268743_37337852
Idh1,1,65158616,65186500,protein_coding,-1,27884,chr1_65158616_65186500
Idh2,7,80094846,80115392,protein_coding,-1,20546,chr7_80094846_80115392
Idh3a,9,54586334,54604661,protein_coding,1,18327,chr9_54586334_54604661
Idh3b,2,130279309,130284547,protein_coding,-1,5238,chr2_130279309_130284547
Idh3g,X,73778963,73786897,protein_coding,-1,7934,chrX_73778963_73786897
Idi1,13,8885501,8892451,protein_coding,1,6950,chr13_8885501_8892451
Idi2,13,8952863,8960945,protein_coding,1,8082,chr13_8952863_8960945
Idnk,13,58157649,58164693,protein_coding,1,7044,chr13_58157649_58164693
Ido1,8,24584136,24597009,protein_coding,-1,12873,chr8_24584136_24597009
Ido2,8,24531892,24576333,protein_coding,-1,44441,chr8_24531892_24576333
Ids,X,70343069,70365084,protein_coding,-1,22015,chrX_70343069_70365084
Idua,5,108660331,108684557,protein_coding,1,24226,chr5_108660331_108684557
Ier2,8,84661331,84662854,protein_coding,-1,1523,chr8_84661331_84662854
Ier3,17,35821684,35822923,protein_coding,1,1239,chr17_35821684_35822923
Ier3ip1,18,76930017,76941612,protein_coding,1,11595,chr18_76930017_76941612
Ier5,1,155096361,155099636,protein_coding,-1,3275,chr1_155096361_155099636
Ier5l,2,30471537,30474219,protein_coding,-1,2682,chr2_30471537_30474219
Iffo1,6,125145241,125161782,protein_coding,1,16541,chr6_125145241_125161782
Iffo2,4,139530548,139620382,protein_coding,1,89834,chr4_139530548_139620382
Ifi203,1,173920407,173942672,protein_coding,-1,22265,chr1_173920407_173942672
Ifi204,1,173747293,173766943,protein_coding,-1,19650,chr1_173747293_173766943
Ifi27,12,103434211,103440239,protein_coding,1,6028,chr12_103434211_103440239
Ifi27l2a,12,103442167,103443680,protein_coding,-1,1513,chr12_103442167_103443680
Ifi30,CHR_MG190_MG3751_PATCH,70762774,70766663,processed_transcript;protein_coding,-1,3889,chrCHR_MG190_MG3751_PATCH_70762774_70766663
Ifi35,11,101448407,101458698,protein_coding,1,10291,chr11_101448407_101458698
Ifi47,11,49008581,49096974,protein_coding,1,88393,chr11_49008581_49096974
Ifih1,2,62595798,62646255,protein_coding,-1,50457,chr2_62595798_62646255
Ifit1,19,34640871,34650009,protein_coding,1,9138,chr19_34640871_34650009
Ifit2,19,34550694,34576419,protein_coding,1,25725,chr19_34550694_34576419
Ifit3,19,34583531,34588731,protein_coding,1,5200,chr19_34583531_34588731
Ifitm1,7,140967221,140969825,protein_coding,1,2604,chr7_140967221_140969825
Ifitm10,7,142325837,142373753,protein_coding,-1,47916,chr7_142325837_142373753
Ifitm2,7,140954837,140955987,protein_coding,-1,1150,chr7_140954837_140955987
Ifitm3,7,141009586,141010770,protein_coding,-1,1184,chr7_141009586_141010770
Ifitm5,7,140948958,140950291,protein_coding,-1,1333,chr7_140948958_140950291
Ifitm6,7,141015699,141017924,protein_coding,-1,2225,chr7_141015699_141017924
Ifitm7,16,13981699,13986888,protein_coding,-1,5189,chr16_13981699_13986888
Ifnar1,16,91485238,91507441,protein_coding,1,22203,chr16_91485238_91507441
Ifnar2,16,91372783,91405589,protein_coding,1,32806,chr16_91372783_91405589
Ifngr1,10,19591949,19610229,protein_coding,1,18280,chr10_19591949_19610229
Ifngr2,16,91547072,91565623,protein_coding,1,18551,chr16_91547072_91565623
Ifnlr1,4,135686287,135708181,protein_coding,1,21894,chr4_135686287_135708181
Ifrd1,12,40201567,40248504,protein_coding,-1,46937,chr12_40201567_40248504
Ifrd2,9,107587642,107593385,protein_coding,1,5743,chr9_107587642_107593385
Ift122,6,115853470,115926699,protein_coding,1,73229,chr6_115853470_115926699
Ift140,17,25016085,25099495,protein_coding,1,83410,chr17_25016085_25099495
Ift172,5,31253277,31291116,protein_coding,-1,37839,chr5_31253277_31291116
Ift20,11,78536361,78541737,protein_coding,1,5376,chr11_78536361_78541737
Ift22,5,136908150,136915404,protein_coding,1,7254,chr5_136908150_136915404
Ift27,15,78159463,78174107,protein_coding,-1,14644,chr15_78159463_78174107
Ift43,12,86082541,86162459,protein_coding,1,79918,chr12_86082541_86162459
Ift46,9,44767908,44793447,protein_coding,1,25539,chr9_44767908_44793447
Ift52,2,163017354,163046141,protein_coding,1,28787,chr2_163017354_163046141
Ift57,16,49699233,49765126,protein_coding,1,65893,chr16_49699233_49765126
Ift74,4,94614491,94693229,protein_coding,1,78738,chr4_94614491_94693229
Ift80,3,68892499,69004570,protein_coding,-1,112071,chr3_68892499_69004570
Ift81,5,122550204,122614518,protein_coding,-1,64314,chr5_122550204_122614518
Ift88,14,57424062,57517936,protein_coding,1,93874,chr14_57424062_57517936
Igbp1,X,100494291,100516125,protein_coding,1,21834,chrX_100494291_100516125
Igdcc3,9,65141189,65185872,protein_coding,1,44683,chr9_65141189_65185872
Igdcc4,9,65101486,65137940,protein_coding,1,36454,chr9_65101486_65137940
Igf1,10,87858265,87937042,protein_coding,1,78777,chr10_87858265_87937042
Igf1os,10,87826377,87863381,antisense,-1,37004,chr10_87826377_87863381
Igf1r,7,67952827,68233668,protein_coding,1,280841,chr7_67952827_68233668
Igf2,7,142650766,142666816,protein_coding,-1,16050,chr7_142650766_142666816
Igf2bp1,11,95957163,96005940,protein_coding,-1,48777,chr11_95957163_96005940
Igf2bp2,16,22059009,22163299,protein_coding,-1,104290,chr16_22059009_22163299
Igf2bp3,6,49085223,49214957,protein_coding,-1,129734,chr6_49085223_49214957
Igf2r,17,12682406,12769664,protein_coding,-1,87258,chr17_12682406_12769664
Igfbp1,11,7197782,7202546,protein_coding,1,4764,chr11_7197782_7202546
Igfbp2,1,72824503,72852474,protein_coding,1,27971,chr1_72824503_72852474
Igfbp3,11,7206086,7213923,protein_coding,-1,7837,chr11_7206086_7213923
Igfbp4,11,99041244,99054392,protein_coding,1,13148,chr11_99041244_99054392
Igfbp5,1,72857932,72874884,protein_coding,-1,16952,chr1_72857932_72874884
Igfbp6,15,102144362,102149511,protein_coding,1,5149,chr15_102144362_102149511
Igfbp7,5,77349240,77408041,protein_coding,-1,58801,chr5_77349240_77408041
Igfbpl1,4,45809468,45826923,protein_coding,-1,17455,chr4_45809468_45826923
Igflr1,7,30565427,30567962,protein_coding,1,2535,chr7_30565427_30567962
Igfn1,1,135953578,136006342,protein_coding,-1,52764,chr1_135953578_136006342
Ighmbp2,19,3259076,3283017,protein_coding,-1,23941,chr19_3259076_3283017
Igip,18,36298679,36301517,protein_coding,1,2838,chr18_36298679_36301517
Iglon5,7,43472904,43490075,protein_coding,-1,17171,chr7_43472904_43490075
Igsf1,X,49782536,49797749,protein_coding,-1,15213,chrX_49782536_49797749
Igsf10,3,59316735,59344394,protein_coding,-1,27659,chr3_59316735_59344394
Igsf11,16,38892671,39027159,protein_coding,1,134488,chr16_38892671_39027159
Igsf21,4,140026846,140246784,protein_coding,-1,219938,chr4_140026846_140246784
Igsf23,7,19937305,19950756,protein_coding,-1,13451,chr7_19937305_19950756
Igsf3,3,101377083,101463059,protein_coding,1,85976,chr3_101377083_101463059
Igsf6,7,121064067,121074572,protein_coding,-1,10505,chr7_121064067_121074572
Igsf8,1,172261641,172319841,protein_coding,1,58200,chr1_172261641_172319841
Igsf9,1,172481788,172498878,protein_coding,1,17090,chr1_172481788_172498878
Igsf9b,9,27299204,27357546,protein_coding,1,58342,chr9_27299204_27357546
Igtp,11,58199556,58207591,protein_coding,1,8035,chr11_58199556_58207591
Ihh,1,74945315,74951672,protein_coding,-1,6357,chr1_74945315_74951672
Ik,18,36744656,36757639,protein_coding,1,12983,chr18_36744656_36757639
Ikbip,10,91082940,91102607,protein_coding,1,19667,chr10_91082940_91102607
Ikbkb,8,22659212,22706589,protein_coding,-1,47377,chr8_22659212_22706589
Ikbke,1,131254343,131279606,protein_coding,-1,25263,chr1_131254343_131279606
Ikbkg,X,74393290,74453854,protein_coding,1,60564,chrX_74393290_74453854
Ikzf1,11,11685003,11772926,protein_coding,1,87923,chr11_11685003_11772926
Ikzf2,1,69531214,69687245,protein_coding,-1,156031,chr1_69531214_69687245
Ikzf3,11,98464902,98546031,protein_coding,-1,81129,chr11_98464902_98546031
Ikzf4,10,128630843,128669358,protein_coding,-1,38515,chr10_128630843_128669358
Ikzf5,7,131388652,131410521,protein_coding,-1,21869,chr7_131388652_131410521
Il10ra,9,45253837,45269149,protein_coding,-1,15312,chr9_45253837_45269149
Il10rb,16,91406164,91425834,protein_coding,1,19670,chr16_91406164_91425834
Il11,7,4772373,4782859,protein_coding,-1,10486,chr7_4772373_4782859
Il11ra1,4,41699989,41769474,protein_coding,1,69485,chr4_41699989_41769474
Il12a,3,68690644,68698547,protein_coding,1,7903,chr3_68690644_68698547
Il12rb1,8,70808444,70821424,protein_coding,1,12980,chr8_70808444_70821424
Il12rb2,6,67291318,67376188,protein_coding,-1,84870,chr6_67291318_67376188
Il13ra1,X,36112110,36171259,protein_coding,1,59149,chrX_36112110_36171259
Il15,8,82331632,82403222,protein_coding,-1,71590,chr8_82331632_82403222
Il15ra,2,11705290,11734317,protein_coding,1,29027,chr2_11705290_11734317
Il16,7,83642825,83745726,protein_coding,-1,102901,chr7_83642825_83745726
Il17b,18,61684887,61692538,protein_coding,1,7651,chr18_61684887_61692538
Il17c,8,122422020,122423639,protein_coding,1,1619,chr8_122422020_122423639
Il17d,14,57524777,57543166,protein_coding,1,18389,chr14_57524777_57543166
Il17ra,6,120463247,120487559,protein_coding,1,24312,chr6_120463247_120487559
Il17rb,14,29996135,30008896,protein_coding,-1,12761,chr14_29996135_30008896
Il17rc,6,113471427,113483140,protein_coding,1,11713,chr6_113471427_113483140
Il17rd,14,27038941,27107286,protein_coding,1,68345,chr14_27038941_27107286
Il17re,6,113458484,113470758,protein_coding,1,12274,chr6_113458484_113470758
Il18,9,50554827,50581840,protein_coding,1,27013,chr9_50554827_50581840
Il18bp,7,102014885,102018690,protein_coding,-1,3805,chr7_102014885_102018690
Il18r1,1,40465552,40500854,protein_coding,1,35302,chr1_40465552_40500854
Il1a,2,129299610,129309972,protein_coding,-1,10362,chr2_129299610_129309972
Il1b,2,129364570,129371139,protein_coding,-1,6569,chr2_129364570_129371139
Il1bos,2,129369897,129375748,antisense,1,5851,chr2_129369897_129375748
Il1f5,2,24276954,24283426,protein_coding,1,6472,chr2_24276954_24283426
Il1r1,1,40225080,40317257,protein_coding,1,92177,chr1_40225080_40317257
Il1r2,1,40074079,40125231,protein_coding,1,51152,chr1_40074079_40125231
Il1rap,16,26581704,26730117,protein_coding,1,148413,chr16_26581704_26730117
Il1rapl1,X,86740870,88115645,protein_coding,-1,1374775,chrX_86740870_88115645
Il1rapl2,X,137570608,138846946,protein_coding,1,1276338,chrX_137570608_138846946
Il1rl1,1,40429570,40465415,protein_coding,1,35845,chr1_40429570_40465415
Il1rl2,1,40324610,40367562,protein_coding,1,42952,chr1_40324610_40367562
Il2,3,37120523,37125959,protein_coding,-1,5436,chr3_37120523_37125959
Il20ra,10,19712570,19760053,protein_coding,1,47483,chr10_19712570_19760053
Il20rb,9,100457719,100486788,protein_coding,-1,29069,chr9_100457719_100486788
Il21r,7,125603429,125633570,protein_coding,1,30141,chr7_125603429_125633570
Il22,10,118204942,118210047,protein_coding,1,5105,chr10_118204942_118210047
Il22ra1,4,135728172,135752140,protein_coding,1,23968,chr4_135728172_135752140
Il23a,10,128296139,128298752,protein_coding,-1,2613,chr10_128296139_128298752
Il23r,6,67422932,67491855,protein_coding,-1,68923,chr6_67422932_67491855
Il25,14,54932695,54935837,protein_coding,1,3142,chr14_54932695_54935837
Il27ra,8,84030294,84042589,protein_coding,-1,12295,chr8_84030294_84042589
Il2ra,2,11642807,11693193,protein_coding,1,50386,chr2_11642807_11693193
Il2rb,15,78479256,78495271,protein_coding,-1,16015,chr15_78479256_78495271
Il31ra,13,112519898,112594360,protein_coding,-1,74462,chr13_112519898_112594360
Il33,19,29925114,29960718,protein_coding,1,35604,chr19_29925114_29960718
Il34,8,110741829,110805924,protein_coding,-1,64095,chr8_110741829_110805924
Il3ra,14,14346275,14356011,protein_coding,1,9736,chr14_14346275_14356011
Il4,11,53602982,53618669,protein_coding,-1,15687,chr11_53602982_53618669
Il4i1,7,44816387,44840809,protein_coding,1,24422,chr7_44816387_44840809
Il4ra,7,125552120,125579474,protein_coding,1,27354,chr7_125552120_125579474
Il5,11,53720794,53725106,protein_coding,1,4312,chr11_53720794_53725106
Il5ra,6,106710357,106749037,protein_coding,-1,38680,chr6_106710357_106749037
Il6,5,30013114,30019981,protein_coding,1,6867,chr5_30013114_30019981
Il6ra,3,89864059,89913196,protein_coding,-1,49137,chr3_89864059_89913196
Il6st,13,112464070,112510086,protein_coding,1,46016,chr13_112464070_112510086
Il7,3,7569994,7613760,protein_coding,-1,43766,chr3_7569994_7613760
Il7r,15,9505788,9530176,protein_coding,-1,24388,chr15_9505788_9530176
Il9r,11,32187541,32200279,protein_coding,-1,12738,chr11_32187541_32200279
Ildr1,16,36693978,36726804,protein_coding,1,32826,chr16_36693978_36726804
Ildr2,1,166254139,166316823,protein_coding,1,62684,chr1_166254139_166316823
Ilf2,3,90476126,90488379,protein_coding,1,12253,chr3_90476126_90488379
Ilf3,9,21367871,21405361,protein_coding,1,37490,chr9_21367871_21405361
Ilk,7,105736592,105742925,protein_coding,1,6333,chr7_105736592_105742925
Ilkap,1,91373861,91398815,protein_coding,-1,24954,chr1_91373861_91398815
Iltifb,10,118289629,118295038,protein_coding,-1,5409,chr10_118289629_118295038
Ilvbl,10,78574346,78584502,protein_coding,1,10156,chr10_78574346_78584502
Immp1l,2,105904638,105965558,protein_coding,1,60920,chr2_105904638_105965558
Immp2l,12,41024090,41955588,protein_coding,1,931498,chr12_41024090_41955588
Immt,6,71831331,71877388,protein_coding,1,46057,chr6_71831331_71877388
Imp3,9,56937475,56938398,protein_coding,1,923,chr9_56937475_56938398
Imp4,1,34439851,34449356,protein_coding,1,9505,chr1_34439851_34449356
Impa1,3,10311956,10331439,protein_coding,-1,19483,chr3_10311956_10331439
Impa2,18,67289186,67322472,protein_coding,1,33286,chr18_67289186_67322472
Impact,18,12955852,12992950,protein_coding,1,37098,chr18_12955852_12992950
Impad1,4,4762484,4793355,protein_coding,-1,30871,chr4_4762484_4793355
Impdh1,6,29200434,29216364,protein_coding,-1,15930,chr6_29200434_29216364
Impdh2,9,108560286,108565584,protein_coding,1,5298,chr9_108560286_108565584
Impg1,9,80313330,80465481,protein_coding,-1,152151,chr9_80313330_80465481
Impg2,16,56204313,56273756,protein_coding,1,69443,chr16_56204313_56273756
Ina,19,47014698,47025327,protein_coding,1,10629,chr19_47014698_47025327
Inafm1,7,16272013,16273617,protein_coding,-1,1604,chr7_16272013_16273617
Inafm2,2,118745758,118748810,protein_coding,1,3052,chr2_118745758_118748810
Inca1,11,70688361,70700155,protein_coding,-1,11794,chr11_70688361_70700155
Incenp,19,9872296,9899551,protein_coding,-1,27255,chr19_9872296_9899551
Inf2,12,112588784,112615557,protein_coding,1,26773,chr12_112588784_112615557
Ing1,8,11555571,11563251,protein_coding,1,7680,chr8_11555571_11563251
Ing2,8,47667178,47675556,protein_coding,-1,8378,chr8_47667178_47675556
Ing3,6,21949571,21976038,protein_coding,1,26467,chr6_21949571_21976038
Ing4,6,125039760,125049265,protein_coding,1,9505,chr6_125039760_125049265
Ing5,1,93803965,93822101,protein_coding,1,18136,chr1_93803965_93822101
Inha,1,75507077,75510366,protein_coding,1,3289,chr1_75507077_75510366
Inhba,13,16011851,16031621,protein_coding,1,19770,chr13_16011851_16031621
Inhbb,1,119415465,119422248,protein_coding,-1,6783,chr1_119415465_119422248
Inhbe,10,127348857,127354411,protein_coding,-1,5554,chr10_127348857_127354411
Inip,4,59769637,59801589,protein_coding,-1,31952,chr4_59769637_59801589
Ino80,2,119373042,119477687,protein_coding,-1,104645,chr2_119373042_119477687
Ino80b,6,83121765,83125431,protein_coding,-1,3666,chr6_83121765_83125431
Ino80c,18,24104757,24121953,protein_coding,-1,17196,chr18_24104757_24121953
Ino80d,1,62958418,63114667,protein_coding,-1,156249,chr1_62958418_63114667
Ino80dos,1,63113078,63158290,lincRNA,1,45212,chr1_63113078_63158290
Ino80e,7,126850960,126862377,protein_coding,-1,11417,chr7_126850960_126862377
Inpp1,1,52785427,52817688,protein_coding,-1,32261,chr1_52785427_52817688
Inpp4a,1,37299865,37410736,protein_coding,1,110871,chr1_37299865_37410736
Inpp4b,8,81342556,82127914,protein_coding,1,785358,chr8_81342556_82127914
Inpp5a,7,139389109,139579652,protein_coding,1,190543,chr7_139389109_139579652
Inpp5b,4,124741850,124801511,protein_coding,1,59661,chr4_124741850_124801511
Inpp5d,1,87620312,87720507,protein_coding,1,100195,chr1_87620312_87720507
Inpp5e,2,26396249,26409203,protein_coding,-1,12954,chr2_26396249_26409203
Inpp5f,7,128611328,128696425,protein_coding,1,85097,chr7_128611328_128696425
Inpp5j,11,3494375,3504821,protein_coding,-1,10446,chr11_3494375_3504821
Inpp5k,11,75630988,75648871,protein_coding,1,17883,chr11_75630988_75648871
Inppl1,7,101822632,101838229,protein_coding,-1,15597,chr7_101822632_101838229
Insc,7,114743694,114850383,protein_coding,1,106689,chr7_114743694_114850383
Insig1,5,28071363,28078662,protein_coding,1,7299,chr5_28071363_28078662
Insig2,1,121304353,121332589,protein_coding,-1,28236,chr1_121304353_121332589
Insl5,4,103017872,103026842,protein_coding,-1,8970,chr4_103017872_103026842
Insl6,19,29321344,29325356,protein_coding,-1,4012,chr19_29321344_29325356
Insm1,2,146221921,146225020,protein_coding,1,3099,chr2_146221921_146225020
Insm2,12,55599427,55602086,protein_coding,1,2659,chr12_55599427_55602086
Insr,8,3122061,3279617,protein_coding,-1,157556,chr8_3122061_3279617
Ints1,5,139751282,139775674,protein_coding,-1,24392,chr5_139751282_139775674
Ints10,8,68793929,68831667,protein_coding,1,37738,chr8_68793929_68831667
Ints12,3,133091840,133110988,protein_coding,1,19148,chr3_133091840_133110988
Ints2,11,86210681,86257575,protein_coding,-1,46894,chr11_86210681_86257575
Ints3,3,90391388,90433622,protein_coding,-1,42234,chr3_90391388_90433622
Ints4,7,97480956,97541395,protein_coding,1,60439,chr7_97480956_97541395
Ints5,19,8893005,8897888,protein_coding,1,4883,chr19_8893005_8897888
Ints6,14,62676330,62761169,protein_coding,-1,84839,chr14_62676330_62761169
Ints7,1,191575636,191623688,protein_coding,1,48052,chr1_191575636_191623688
Ints8,4,11199158,11254258,protein_coding,-1,55100,chr4_11199158_11254258
Ints9,14,64950045,65039835,protein_coding,1,89790,chr14_64950045_65039835
Intu,3,40531286,40704774,protein_coding,1,173488,chr3_40531286_40704774
Invs,4,48279760,48431954,protein_coding,1,152194,chr4_48279760_48431954
Ip6k1,9,108002501,108048782,protein_coding,1,46281,chr9_108002501_108048782
Ip6k2,9,108783796,108806337,protein_coding,1,22541,chr9_108783796_108806337
Ip6k3,17,27143965,27167795,protein_coding,-1,23830,chr17_27143965_27167795
Ipcef1,10,6885796,7052478,protein_coding,-1,166682,chr10_6885796_7052478
Ipmk,10,71347763,71433327,protein_coding,1,85564,chr10_71347763_71433327
Ipo11,13,106794439,106936958,protein_coding,-1,142519,chr13_106794439_106936958
Ipo13,4,117894486,117914999,protein_coding,-1,20513,chr4_117894486_117914999
Ipo4,14,55625400,55635957,protein_coding,-1,10557,chr14_55625400_55635957
Ipo5,14,120911224,120947999,protein_coding,1,36775,chr14_120911224_120947999
Ipo7,7,110018274,110056609,protein_coding,1,38335,chr7_110018274_110056609
Ipo8,6,148770683,148831467,protein_coding,-1,60784,chr6_148770683_148831467
Ipo9,1,135382312,135430499,protein_coding,-1,48187,chr1_135382312_135430499
Ipp,4,116507549,116538243,protein_coding,1,30694,chr4_116507549_116538243
Ippk,13,49421249,49464573,protein_coding,1,43324,chr13_49421249_49464573
Iqca,1,90042132,90153401,protein_coding,-1,111269,chr1_90042132_90153401
Iqcb1,16,36828385,36872721,protein_coding,1,44336,chr16_36828385_36872721
Iqcc,4,129615126,129619099,protein_coding,-1,3973,chr4_129615126_129619099
Iqcd,5,120589016,120607118,protein_coding,1,18102,chr5_120589016_120607118
Iqce,5,140661827,140702378,protein_coding,-1,40551,chr5_140661827_140702378
Iqcg,16,33012683,33056218,protein_coding,-1,43535,chr16_33012683_33056218
Iqch,9,63421455,63602493,protein_coding,-1,181038,chr9_63421455_63602493
Iqcj,3,67892220,68056593,protein_coding,1,164373,chr3_67892220_68056593
Iqck,7,118855752,118972652,protein_coding,1,116900,chr7_118855752_118972652
Iqgap1,7,80711583,80825974,protein_coding,-1,114391,chr7_80711583_80825974
Iqgap2,13,95627174,95892483,protein_coding,-1,265309,chr13_95627174_95892483
Iqgap3,3,88081971,88121048,protein_coding,1,39077,chr3_88081971_88121048
Iqsec1,6,90656088,90988685,protein_coding,-1,332597,chr6_90656088_90988685
Iqsec2,X,152144268,152225236,protein_coding,1,80968,chrX_152144268_152225236
Iqsec3,6,121372933,121473678,protein_coding,-1,100745,chr6_121372933_121473678
Iqub,6,24444865,24515067,protein_coding,-1,70202,chr6_24444865_24515067
Irak1,X,74013914,74023918,protein_coding,-1,10004,chrX_74013914_74023918
Irak1bp1,9,82829540,82847687,protein_coding,1,18147,chr9_82829540_82847687
Irak2,6,113638467,113695026,protein_coding,1,56559,chr6_113638467_113695026
Irak3,10,120141648,120202130,protein_coding,-1,60482,chr10_120141648_120202130
Irak4,15,94543643,94581815,protein_coding,1,38172,chr15_94543643_94581815
Ireb2,9,54863789,54912530,protein_coding,1,48741,chr9_54863789_54912530
Irf1,11,53770014,53778374,protein_coding,1,8360,chr11_53770014_53778374
Irf2,8,46739732,46847458,protein_coding,1,107726,chr8_46739732_46847458
Irf2bp1,7,19004044,19006777,protein_coding,1,2733,chr7_19004044_19006777
Irf2bp2,8,126588296,126593986,protein_coding,-1,5690,chr8_126588296_126593986
Irf2bpl,12,86880701,86884798,protein_coding,-1,4097,chr12_86880701_86884798
Irf3,7,44997648,45002848,protein_coding,1,5200,chr7_44997648_45002848
Irf4,13,30749226,30766976,protein_coding,1,17750,chr13_30749226_30766976
Irf5,6,29526625,29541871,protein_coding,1,15246,chr6_29526625_29541871
Irf6,1,193153111,193172023,protein_coding,1,18912,chr1_193153111_193172023
Irf7,7,141262706,141266481,protein_coding,-1,3775,chr7_141262706_141266481
Irf8,8,120736358,120756694,protein_coding,1,20336,chr8_120736358_120756694
Irf9,14,55603571,55610030,protein_coding,1,6459,chr14_55603571_55610030
Irgc1,7,24431922,24452297,protein_coding,-1,20375,chr7_24431922_24452297
Irgm1,11,48861968,48871683,protein_coding,-1,9715,chr11_48861968_48871683
Irgm2,11,58199618,58222782,protein_coding,1,23164,chr11_58199618_58222782
Irgq,7,24530689,24538600,protein_coding,1,7911,chr7_24530689_24538600
Irs1,1,82233101,82291416,protein_coding,-1,58315,chr1_82233101_82291416
Irs2,8,10984681,11008458,protein_coding,-1,23777,chr8_10984681_11008458
Irs4,X,141710998,141725263,protein_coding,-1,14265,chrX_141710998_141725263
Isca1,13,59755409,59769810,protein_coding,-1,14401,chr13_59755409_59769810
Isca2,12,84773251,84775088,protein_coding,1,1837,chr12_84773251_84775088
Iscu,5,113772748,113778288,protein_coding,1,5540,chr5_113772748_113778288
Isg15,4,156199455,156200796,protein_coding,-1,1341,chr4_156199455_156200796
Isg20,7,78913424,78920396,protein_coding,1,6972,chr7_78913424_78920396
Isg20l2,3,87930314,87940686,protein_coding,1,10372,chr3_87930314_87940686
Isl2,9,55538672,55546180,protein_coding,1,7508,chr9_55538672_55546180
Islr,9,58156268,58204306,protein_coding,-1,48038,chr9_58156268_58204306
Islr2,9,58196297,58204319,protein_coding,-1,8022,chr9_58196297_58204319
Ism1,2,139678178,139758581,protein_coding,1,80403,chr2_139678178_139758581
Ism2,12,87278638,87299705,protein_coding,-1,21067,chr12_87278638_87299705
Isoc1,18,58659466,58680368,protein_coding,1,20902,chr18_58659466_58680368
Isoc2a,7,4877153,4896973,protein_coding,1,19820,chr7_4877153_4896973
Isoc2b,7,4844959,4870258,protein_coding,-1,25299,chr7_4844959_4870258
Ist1,8,109671325,109693260,protein_coding,-1,21935,chr8_109671325_109693260
Isx,8,74873173,74893506,protein_coding,1,20333,chr8_74873173_74893506
Isy1,6,87814269,87838798,protein_coding,-1,24529,chr6_87814269_87838798
Isyna1,8,70594373,70597290,protein_coding,1,2917,chr8_70594373_70597290
Itch,2,155133509,155226855,protein_coding,1,93346,chr2_155133509_155226855
Itfg1,8,85717578,85840921,protein_coding,-1,123343,chr8_85717578_85840921
Itfg2,6,128409444,128424931,protein_coding,-1,15487,chr6_128409444_128424931
Itga1,13,114953096,115101964,protein_coding,-1,148868,chr13_114953096_115101964
Itga10,3,96645584,96664519,protein_coding,1,18935,chr3_96645584_96664519
Itga11,9,62677826,62783982,protein_coding,1,106156,chr9_62677826_62783982
Itga2,13,114833081,114932100,protein_coding,-1,99019,chr13_114833081_114932100
Itga2b,11,102453297,102470122,protein_coding,-1,16825,chr11_102453297_102470122
Itga3,11,95044474,95076801,protein_coding,-1,32327,chr11_95044474_95076801
Itga4,2,79255426,79333123,protein_coding,1,77697,chr2_79255426_79333123
Itga5,15,103344286,103366763,protein_coding,-1,22477,chr15_103344286_103366763
Itga6,2,71745616,71858416,protein_coding,1,112800,chr2_71745616_71858416
Itga7,10,128933818,128958282,protein_coding,1,24464,chr10_128933818_128958282
Itga8,2,12106632,12301922,protein_coding,-1,195290,chr2_12106632_12301922
Itga9,9,118606690,118901003,protein_coding,1,294313,chr9_118606690_118901003
Itgad,7,128154376,128223816,protein_coding,1,69440,chr7_128154376_128223816
Itgae,11,73090583,73147446,protein_coding,1,56863,chr11_73090583_73147446
Itgal,7,127296260,127335138,protein_coding,1,38878,chr7_127296260_127335138
Itgam,7,128062640,128118491,protein_coding,1,55851,chr7_128062640_128118491
Itgav,2,83724397,83806916,protein_coding,1,82519,chr2_83724397_83806916
Itgax,7,128129547,128150657,protein_coding,1,21110,chr7_128129547_128150657
Itgb1,8,128685654,128733200,protein_coding,1,47546,chr8_128685654_128733200
Itgb1bp1,12,21267420,21286284,protein_coding,-1,18864,chr12_21267420_21286284
Itgb1bp2,X,101449088,101453541,protein_coding,1,4453,chrX_101449088_101453541
Itgb2,10,77530252,77565708,protein_coding,1,35456,chr10_77530252_77565708
Itgb3,11,104608000,104670476,protein_coding,1,62476,chr11_104608000_104670476
Itgb3bp,4,99765402,99929813,protein_coding,-1,164411,chr4_99765402_99929813
Itgb4,11,115974709,116008412,protein_coding,1,33703,chr11_115974709_116008412
Itgb5,16,33829665,33949338,protein_coding,1,119673,chr16_33829665_33949338
Itgb6,2,60598292,60722643,protein_coding,-1,124351,chr2_60598292_60722643
Itgb7,15,102215995,102231944,protein_coding,-1,15949,chr15_102215995_102231944
Itgb8,12,119158022,119238802,protein_coding,-1,80780,chr12_119158022_119238802
Itgbl1,14,123659971,123975618,protein_coding,1,315647,chr14_123659971_123975618
Itih2,2,10094593,10131396,protein_coding,-1,36803,chr2_10094593_10131396
Itih3,14,30908572,30923760,protein_coding,-1,15188,chr14_30908572_30923760
Itih4,14,30886476,30902353,protein_coding,1,15877,chr14_30886476_30902353
Itih5,2,10153571,10256529,protein_coding,1,102958,chr2_10153571_10256529
Itk,11,46325150,46389515,protein_coding,-1,64365,chr11_46325150_46389515
Itm2a,X,107397099,107403376,protein_coding,-1,6277,chrX_107397099_107403376
Itm2b,14,73362226,73385289,protein_coding,-1,23063,chr14_73362226_73385289
Itm2c,1,85894281,85908675,protein_coding,1,14394,chr1_85894281_85908675
Itpa,2,130667610,130681614,protein_coding,1,14004,chr2_130667610_130681614
Itpa-ps1,2,94384502,94385098,processed_pseudogene,-1,596,chr2_94384502_94385098
Itpa-ps2,9,95675429,95676017,processed_pseudogene,-1,588,chr9_95675429_95676017
Itpk1,12,102568582,102704930,protein_coding,-1,136348,chr12_102568582_102704930
Itpka,2,119742337,119751263,protein_coding,1,8926,chr2_119742337_119751263
Itpkb,1,180330485,180424802,protein_coding,1,94317,chr1_180330485_180424802
Itpkc,7,27207172,27228661,protein_coding,-1,21489,chr7_27207172_27228661
Itpr1,6,108213096,108551109,protein_coding,1,338013,chr6_108213096_108551109
Itpr2,6,146108299,146502223,protein_coding,-1,393924,chr6_146108299_146502223
Itpr3,17,27057304,27122223,protein_coding,1,64919,chr17_27057304_27122223
Itprip,19,47894602,47919299,protein_coding,-1,24697,chr19_47894602_47919299
Itpripl1,2,127138772,127143442,protein_coding,-1,4670,chr2_127138772_127143442
Itpripl2,7,118485111,118491975,protein_coding,-1,6864,chr7_118485111_118491975
Itsn1,16,91729281,91920597,protein_coding,1,191316,chr16_91729281_91920597
Itsn2,12,4592638,4713962,protein_coding,1,121324,chr12_4592638_4713962
Ivd,2,118861954,118882909,protein_coding,1,20955,chr2_118861954_118882909
Ivns1abp,1,151344477,151364422,protein_coding,1,19945,chr1_151344477_151364422
Iws1,18,32067741,32104328,protein_coding,1,36587,chr18_32067741_32104328
Iyd,10,3540240,3554877,protein_coding,1,14637,chr10_3540240_3554877
Izumo1r,9,14885814,14903949,protein_coding,-1,18135,chr9_14885814_14903949
Izumo2,7,44708742,44719844,protein_coding,1,11102,chr7_44708742_44719844
Izumo4,10,80702184,80705373,protein_coding,1,3189,chr10_80702184_80705373
Jade1,3,41555731,41616864,protein_coding,1,61133,chr3_41555731_41616864
Jade2,11,51813455,51857653,protein_coding,-1,44198,chr11_51813455_51857653
Jade3,X,20425688,20519939,protein_coding,1,94251,chrX_20425688_20519939
Jag1,2,137081456,137116644,protein_coding,-1,35188,chr2_137081456_137116644
Jag2,12,112907819,112929776,protein_coding,-1,21957,chr12_112907819_112929776
Jagn1,6,113442569,113448229,protein_coding,1,5660,chr6_113442569_113448229
Jak1,4,101152367,101265282,protein_coding,-1,112915,chr4_101152367_101265282
Jak2,19,29251828,29313080,protein_coding,1,61252,chr19_29251828_29313080
Jak3,8,71676296,71690575,protein_coding,1,14279,chr8_71676296_71690575
Jakmip1,5,37028335,37150607,protein_coding,1,122272,chr5_37028335_37150607
Jakmip2,18,43531407,43687773,protein_coding,-1,156366,chr18_43531407_43687773
Jakmip3,7,138940730,139083977,protein_coding,1,143247,chr7_138940730_139083977
Jam2,16,84774123,84825928,protein_coding,1,51805,chr16_84774123_84825928
Jam3,9,27097384,27155421,protein_coding,-1,58037,chr9_27097384_27155421
Jarid2,13,44729474,44921643,protein_coding,1,192169,chr13_44729474_44921643
Jazf1,6,52768797,53068631,protein_coding,-1,299834,chr6_52768797_53068631
Jdp2,12,85599027,85639878,protein_coding,1,40851,chr12_85599027_85639878
Jkamp,12,72085589,72101461,protein_coding,1,15872,chr12_72085589_72101461
Jmjd1c,10,67096125,67256326,protein_coding,1,160201,chr10_67096125_67256326
Jmjd4,11,59450045,59458567,protein_coding,1,8522,chr11_59450045_59458567
Jmjd6,11,116837432,116843449,protein_coding,-1,6017,chr11_116837432_116843449
Jmjd7,2,120027483,120032594,protein_coding,1,5111,chr2_120027483_120032594
Jmjd8,17,25828867,25831843,protein_coding,1,2976,chr17_25828867_25831843
Jmy,13,93430101,93499808,protein_coding,-1,69707,chr13_93430101_93499808
Josd1,15,79674251,79687919,protein_coding,-1,13668,chr15_79674251_79687919
Josd2,7,44467980,44471662,protein_coding,1,3682,chr7_44467980_44471662
Jph1,1,16964560,17097889,protein_coding,-1,133329,chr1_16964560_17097889
Jph2,2,163336242,163397993,protein_coding,-1,61751,chr2_163336242_163397993
Jph3,8,121729623,121794276,protein_coding,1,64653,chr8_121729623_121794276
Jph4,14,55106826,55116935,protein_coding,-1,10109,chr14_55106826_55116935
Jpx,X,103493556,103565696,lincRNA,1,72140,chrX_103493556_103565696
Jrk,15,74702301,74709535,protein_coding,-1,7234,chr15_74702301_74709535
Jrkl,9,13242607,13245829,protein_coding,-1,3222,chr9_13242607_13245829
Jsrp1,10,80808496,80813498,protein_coding,-1,5002,chr10_80808496_80813498
Jtb,3,90231597,90235838,protein_coding,1,4241,chr3_90231597_90235838
Jun,4,95049034,95052222,protein_coding,-1,3188,chr4_95049034_95052222
Junb,8,84976910,84978718,protein_coding,-1,1808,chr8_84976910_84978718
Jund,8,70698949,70700616,protein_coding,1,1667,chr8_70698949_70700616
Junos,4,95051534,95167318,antisense,1,115784,chr4_95051534_95167318
Jup,11,100368958,100397763,protein_coding,-1,28805,chr11_100368958_100397763
Kalrn,16,33969073,34573532,protein_coding,-1,604459,chr16_33969073_34573532
Kank1,19,25236975,25434496,protein_coding,1,197521,chr19_25236975_25434496
Kank2,9,21766784,21798744,protein_coding,-1,31960,chr9_21766784_21798744
Kank3,17,33810519,33822918,protein_coding,1,12399,chr17_33810519_33822918
Kank4,4,98754898,98817537,protein_coding,-1,62639,chr4_98754898_98817537
Kank4os,4,98793768,98798900,antisense,1,5132,chr4_98793768_98798900
Kansl1,11,104333229,104468861,protein_coding,-1,135632,chr11_104333229_104468861
Kansl1l,1,66719248,66817562,protein_coding,-1,98314,chr1_66719248_66817562
Kansl2,15,98517658,98534264,protein_coding,-1,16606,chr15_98517658_98534264
Kansl2-ps,7,72672818,72674278,processed_pseudogene,1,1460,chr7_72672818_72674278
Kansl3,1,36335730,36369181,protein_coding,-1,33451,chr1_36335730_36369181
Kantr,X,152294828,152327495,protein_coding,-1,32667,chrX_152294828_152327495
Kars,8,111993443,112011323,protein_coding,-1,17880,chr8_111993443_112011323
Kat2a,11,100704746,100712465,protein_coding,-1,7719,chr11_100704746_100712465
Kat2b,17,53566861,53672720,protein_coding,1,105859,chr17_53566861_53672720
Kat2b-ps,5,93390602,93393091,processed_pseudogene,-1,2489,chr5_93390602_93393091
Kat5,19,5603014,5610237,protein_coding,-1,7223,chr19_5603014_5610237
Kat6a,8,22859535,22943259,protein_coding,1,83724,chr8_22859535_22943259
Kat6b,14,21481434,21672478,protein_coding,1,191044,chr14_21481434_21672478
Kat7,11,95274259,95310246,protein_coding,-1,35987,chr11_95274259_95310246
Kat8,7,127912516,127925837,protein_coding,1,13321,chr7_127912516_127925837
Katna1,10,7651764,7763150,protein_coding,1,111386,chr10_7651764_7763150
Katnal1,5,148871584,148929320,protein_coding,-1,57736,chr5_148871584_148929320
Katnal2,18,76977148,77047308,protein_coding,-1,70160,chr18_76977148_77047308
Katnb1,8,95081186,95103149,protein_coding,1,21963,chr8_95081186_95103149
Katnbl1,2,112379211,112414240,protein_coding,1,35029,chr2_112379211_112414240
Kazald1,19,45075241,45079289,protein_coding,1,4048,chr19_45075241_45079289
Kazn,4,142102390,142239401,protein_coding,-1,137011,chr4_142102390_142239401
Kbtbd11,8,15011025,15033333,protein_coding,1,22308,chr8_15011025_15033333
Kbtbd12,6,88545114,88637950,protein_coding,-1,92836,chr6_88545114_88637950
Kbtbd13,9,65388684,65391652,protein_coding,-1,2968,chr9_65388684_65391652
Kbtbd2,6,56777524,56797813,protein_coding,-1,20289,chr6_56777524_56797813
Kbtbd3,9,4309833,4331732,protein_coding,1,21899,chr9_4309833_4331732
Kbtbd4,2,90904740,90911626,protein_coding,1,6886,chr2_90904740_90911626
Kbtbd6,14,79451835,79454818,protein_coding,1,2983,chr14_79451835_79454818
Kbtbd7,14,79426511,79431036,protein_coding,1,4525,chr14_79426511_79431036
Kbtbd8,6,95117240,95129790,protein_coding,1,12550,chr6_95117240_95129790
Kcmf1,6,72841114,72899979,protein_coding,-1,58865,chr6_72841114_72899979
Kcna1,6,126640397,126646384,protein_coding,-1,5987,chr6_126640397_126646384
Kcna10,3,107183056,107195721,protein_coding,1,12665,chr3_107183056_107195721
Kcna2,3,107101146,107115005,protein_coding,1,13859,chr3_107101146_107115005
Kcna3,3,107036169,107038070,protein_coding,1,1901,chr3_107036169_107038070
Kcna4,2,107290639,107298502,protein_coding,1,7863,chr2_107290639_107298502
Kcna5,6,126532551,126535412,protein_coding,-1,2861,chr6_126532551_126535412
Kcna6,6,126708329,126740674,protein_coding,-1,32345,chr6_126708329_126740674
Kcna7,7,45405653,45409763,protein_coding,1,4110,chr7_45405653_45409763
Kcnab1,3,64949196,65378223,protein_coding,1,429027,chr3_64949196_65378223
Kcnab2,4,152390742,152477910,protein_coding,-1,87168,chr4_152390742_152477910
Kcnab3,11,69326258,69333042,protein_coding,1,6784,chr11_69326258_69333042
Kcnb1,2,167095969,167190155,protein_coding,-1,94186,chr2_167095969_167190155
Kcnb2,1,15287254,15723750,protein_coding,1,436496,chr1_15287254_15723750
Kcnc1,7,46396497,46438704,protein_coding,1,42207,chr7_46396497_46438704
Kcnc2,10,112271121,112467024,protein_coding,1,195903,chr10_112271121_112467024
Kcnc3,7,44590664,44604754,protein_coding,1,14090,chr7_44590664_44604754
Kcnc4,3,107438303,107459552,protein_coding,-1,21249,chr3_107438303_107459552
Kcnd1,X,7822289,7838280,protein_coding,1,15991,chrX_7822289_7838280
Kcnd2,6,21215503,21729805,protein_coding,1,514302,chr6_21215503_21729805
Kcnd3,3,105452330,105674002,protein_coding,1,221672,chr3_105452330_105674002
Kcnd3os,3,105441595,105452955,antisense,-1,11360,chr3_105441595_105452955
Kcne1,16,92345982,92359468,protein_coding,-1,13486,chr16_92345982_92359468
Kcne1l,X,142304752,142306294,protein_coding,-1,1542,chrX_142304752_142306294
Kcne2,16,92292389,92298129,protein_coding,1,5740,chr16_92292389_92298129
Kcne3,7,100176502,100184869,protein_coding,1,8367,chr7_100176502_100184869
Kcne4,1,78816758,78820028,protein_coding,1,3270,chr1_78816758_78820028
Kcnf1,12,17172100,17176888,protein_coding,-1,4788,chr12_17172100_17176888
Kcng1,2,168260117,168281736,protein_coding,-1,21619,chr2_168260117_168281736
Kcng2,18,80294546,80364254,protein_coding,-1,69708,chr18_80294546_80364254
Kcng3,17,83585957,83631895,protein_coding,-1,45938,chr17_83585957_83631895
Kcng4,8,119623854,119635680,protein_coding,-1,11826,chr8_119623854_119635680
Kcnh1,1,192190774,192510159,protein_coding,1,319385,chr1_192190774_192510159
Kcnh2,5,24319589,24351604,protein_coding,-1,32015,chr5_24319589_24351604
Kcnh3,15,99224861,99242817,protein_coding,1,17956,chr15_99224861_99242817
Kcnh4,11,100740376,100759942,protein_coding,-1,19566,chr11_100740376_100759942
Kcnh5,12,74897220,75177332,protein_coding,-1,280112,chr12_74897220_75177332
Kcnh6,11,106008124,106034549,protein_coding,1,26425,chr11_106008124_106034549
Kcnh7,2,62693414,63184287,protein_coding,-1,490873,chr2_62693414_63184287
Kcnh8,17,52602709,52979194,protein_coding,1,376485,chr17_52602709_52979194
Kcnip1,11,33629339,33993152,protein_coding,-1,363813,chr11_33629339_33993152
Kcnip2,19,45791839,45816061,protein_coding,-1,24222,chr19_45791839_45816061
Kcnip3,2,127456498,127522094,protein_coding,-1,65596,chr2_127456498_127522094
Kcnip4,5,48389502,49524907,protein_coding,-1,1135405,chr5_48389502_49524907
Kcnj1,9,32372493,32399197,protein_coding,1,26704,chr9_32372493_32399197
Kcnj10,1,172341210,172374085,protein_coding,1,32875,chr1_172341210_172374085
Kcnj11,7,46093953,46100764,protein_coding,-1,6811,chr7_46093953_46100764
Kcnj12,11,61022564,61071131,protein_coding,1,48567,chr11_61022564_61071131
Kcnj13,1,87386363,87394729,protein_coding,-1,8366,chr1_87386363_87394729
Kcnj14,7,45816460,45824782,protein_coding,-1,8322,chr7_45816460_45824782
Kcnj15,16,95257558,95300260,protein_coding,1,42702,chr16_95257558_95300260
Kcnj16,11,110968033,111027968,protein_coding,1,59935,chr11_110968033_111027968
Kcnj2,11,111066164,111076821,protein_coding,1,10657,chr11_111066164_111076821
Kcnj3,2,55435970,55598145,protein_coding,1,162175,chr2_55435970_55598145
Kcnj4,15,79483714,79505241,protein_coding,-1,21527,chr15_79483714_79505241
Kcnj5,9,32314707,32344350,protein_coding,-1,29643,chr9_32314707_32344350
Kcnj6,16,94748636,94997701,protein_coding,-1,249065,chr16_94748636_94997701
Kcnj8,6,142564837,142571614,protein_coding,-1,6777,chr6_142564837_142571614
Kcnj9,1,172320501,172329318,protein_coding,-1,8817,chr1_172320501_172329318
Kcnk1,8,125995170,126030685,protein_coding,1,35515,chr8_125995170_126030685
Kcnk10,12,98429437,98578310,protein_coding,-1,148873,chr12_98429437_98578310
Kcnk12,17,87745801,87797994,protein_coding,-1,52193,chr17_87745801_87797994
Kcnk13,12,99964499,100062682,protein_coding,1,98183,chr12_99964499_100062682
Kcnk15,2,163853651,163859746,protein_coding,1,6095,chr2_163853651_163859746
Kcnk18,19,59219214,59237374,protein_coding,1,18160,chr19_59219214_59237374
Kcnk2,1,189207930,189402273,protein_coding,-1,194343,chr1_189207930_189402273
Kcnk3,5,30588170,30625271,protein_coding,1,37101,chr5_30588170_30625271
Kcnk4,19,6923966,6934515,protein_coding,-1,10549,chr19_6923966_6934515
Kcnk6,7,29221926,29232515,protein_coding,-1,10589,chr7_29221926_29232515
Kcnk7,19,5704367,5707109,protein_coding,1,2742,chr19_5704367_5707109
Kcnk9,15,72501089,72546340,protein_coding,-1,45251,chr15_72501089_72546340
Kcnma1,14,23289431,24014491,protein_coding,-1,725060,chr14_23289431_24014491
Kcnmb1,11,33963013,33973641,protein_coding,1,10628,chr11_33963013_33973641
Kcnmb2,3,31902507,32200180,protein_coding,1,297673,chr3_31902507_32200180
Kcnmb3,3,32471588,32492231,protein_coding,-1,20643,chr3_32471588_32492231
Kcnmb4,10,116417861,116473878,protein_coding,-1,56017,chr10_116417861_116473878
Kcnmb4os1,10,116418052,116421237,antisense,1,3185,chr10_116418052_116421237
Kcnmb4os2,10,116473163,116475319,antisense,1,2156,chr10_116473163_116475319
Kcnn1,8,70842044,70863258,protein_coding,-1,21214,chr8_70842044_70863258
Kcnn2,18,45268860,45686024,protein_coding,1,417164,chr18_45268860_45686024
Kcnn3,3,89520164,89675132,protein_coding,1,154968,chr3_89520164_89675132
Kcnn4,7,24370263,24386690,protein_coding,1,16427,chr7_24370263_24386690
Kcnq1,7,143106362,143427042,protein_coding,1,320680,chr7_143106362_143427042
Kcnq1ot1,7,143203458,143296549,antisense,-1,93091,chr7_143203458_143296549
Kcnq2,2,181075579,181135300,protein_coding,-1,59721,chr2_181075579_181135300
Kcnq3,15,65986387,66286642,protein_coding,-1,300255,chr15_65986387_66286642
Kcnq4,4,120696138,120748612,protein_coding,-1,52474,chr4_120696138_120748612
Kcnq5,1,21398403,21961942,protein_coding,-1,563539,chr1_21398403_21961942
Kcnrg,14,61607457,61612826,protein_coding,1,5369,chr14_61607457_61612826
Kcns1,2,164163619,164171113,protein_coding,-1,7494,chr2_164163619_164171113
Kcns2,15,34837355,34843407,protein_coding,1,6052,chr15_34837355_34843407
Kcns3,12,11090202,11151056,protein_coding,-1,60854,chr12_11090202_11151056
Kcnt1,2,25863734,25918273,protein_coding,1,54539,chr2_25863734_25918273
Kcnt2,1,140246158,140612067,protein_coding,1,365909,chr1_140246158_140612067
Kcnu1,8,25849623,25937939,protein_coding,1,88316,chr8_25849623_25937939
Kcnv1,15,45106284,45114920,protein_coding,-1,8636,chr15_45106284_45114920
Kcnv2,19,27322588,27337179,protein_coding,1,14591,chr19_27322588_27337179
Kcp,6,29473162,29507952,protein_coding,-1,34790,chr6_29473162_29507952
Kctd1,18,14968685,15151446,protein_coding,-1,182761,chr18_14968685_15151446
Kctd10,5,114363567,114380508,protein_coding,-1,16941,chr5_114363567_114380508
Kctd11,11,69878261,69881406,protein_coding,-1,3145,chr11_69878261_69881406
Kctd12,14,102976581,102982637,protein_coding,-1,6056,chr14_102976581_102982637
Kctd12b,X,153685154,153696391,protein_coding,-1,11237,chrX_153685154_153696391
Kctd13,7,126928879,126945631,protein_coding,1,16752,chr7_126928879_126945631
Kctd14,7,97451323,97459557,protein_coding,1,8234,chr7_97451323_97459557
Kctd15,7,34639014,34656732,protein_coding,-1,17718,chr7_34639014_34656732
Kctd16,18,40256962,40531630,protein_coding,1,274668,chr18_40256962_40531630
Kctd17,15,78428564,78439303,protein_coding,1,10739,chr15_78428564_78439303
Kctd18,1,57955101,58018956,protein_coding,-1,63855,chr1_57955101_58018956
Kctd19,8,105382807,105413502,protein_coding,-1,30695,chr8_105382807_105413502
Kctd2,11,115420128,115431274,protein_coding,1,11146,chr11_115420128_115431274
Kctd20,17,28951950,28969549,protein_coding,1,17599,chr17_28951950_28969549
Kctd21,7,97332327,97350213,protein_coding,1,17886,chr7_97332327_97350213
Kctd3,1,188971095,189007841,protein_coding,-1,36746,chr1_188971095_189007841
Kctd4,14,75955009,75966206,protein_coding,1,11197,chr14_75955009_75966206
Kctd5,17,24047734,24073485,protein_coding,-1,25751,chr17_24047734_24073485
Kctd6,14,8214140,8223563,protein_coding,1,9423,chr14_8214140_8223563
Kctd7,5,130144861,130155806,protein_coding,1,10945,chr5_130144861_130155806
Kctd8,5,69109285,69341679,protein_coding,-1,232394,chr5_69109285_69341679
Kctd9,14,67715937,67742310,protein_coding,1,26373,chr14_67715937_67742310
Kdelr1,7,45872772,45883732,protein_coding,1,10960,chr7_45872772_45883732
Kdelr2,5,143403838,143421901,protein_coding,1,18063,chr5_143403838_143421901
Kdelr3,15,79516411,79527739,protein_coding,1,11328,chr15_79516411_79527739
Kdf1,4,133518963,133530790,protein_coding,1,11827,chr4_133518963_133530790
Kdm1a,4,136550540,136602723,protein_coding,-1,52183,chr4_136550540_136602723
Kdm1b,13,47043499,47085279,protein_coding,1,41780,chr13_47043499_47085279
Kdm2a,19,4314419,4398285,protein_coding,-1,83866,chr19_4314419_4398285
Kdm2b,5,122870665,122989823,protein_coding,-1,119158,chr5_122870665_122989823
Kdm3a,6,71588972,71632990,protein_coding,-1,44018,chr6_71588972_71632990
Kdm3b,18,34777047,34838660,protein_coding,1,61613,chr18_34777047_34838660
Kdm4a,4,118136957,118180043,protein_coding,-1,43086,chr4_118136957_118180043
Kdm4b,17,56326062,56402870,protein_coding,1,76808,chr17_56326062_56402870
Kdm4c,4,74242497,74405860,protein_coding,1,163363,chr4_74242497_74405860
Kdm4d,9,14462548,14500482,protein_coding,-1,37934,chr9_14462548_14500482
Kdm4dl,9,14450836,14452022,unprocessed_pseudogene,-1,1186,chr9_14450836_14452022
Kdm5a,6,120364124,120444574,protein_coding,1,80450,chr6_120364124_120444574
Kdm5b,1,134560171,134635285,protein_coding,1,75114,chr1_134560171_134635285
Kdm5c,X,152233020,152274535,protein_coding,1,41515,chrX_152233020_152274535
Kdm5d,Y,897788,956786,protein_coding,1,58998,chrY_897788_956786
Kdm6a,X,18162575,18279936,protein_coding,1,117361,chrX_18162575_18279936
Kdm6b,11,69398508,69413675,protein_coding,-1,15167,chr11_69398508_69413675
Kdm7a,6,39136623,39206789,protein_coding,-1,70166,chr6_39136623_39206789
Kdm8,7,125444676,125462269,protein_coding,1,17593,chr7_125444676_125462269
Kdr,5,75932827,75978458,protein_coding,-1,45631,chr5_75932827_75978458
Kdsr,1,106720459,106759727,protein_coding,-1,39268,chr1_106720459_106759727
Keap1,9,21229730,21239361,protein_coding,-1,9631,chr9_21229730_21239361
Kera,10,97606879,97613692,protein_coding,1,6813,chr10_97606879_97613692
Khdc1a,1,21349641,21352200,protein_coding,1,2559,chr1_21349641_21352200
Khdc1b,1,21383556,21386373,protein_coding,1,2817,chr1_21383556_21386373
Khdc1c,1,21368331,21370845,protein_coding,1,2514,chr1_21368331_21370845
Khdc3,9,73101836,73104438,protein_coding,1,2602,chr9_73101836_73104438
Khdrbs1,4,129703164,129742303,protein_coding,-1,39139,chr4_129703164_129742303
Khdrbs2,1,32172714,32658568,protein_coding,1,485854,chr1_32172714_32658568
Khdrbs3,15,68928420,69101211,protein_coding,1,172791,chr15_68928420_69101211
Khk,5,30921431,30931248,protein_coding,1,9817,chr5_30921431_30931248
Khnyn,14,55884947,55898775,protein_coding,1,13828,chr14_55884947_55898775
Khsrp,17,57021051,57031522,protein_coding,-1,10471,chr17_57021051_57031522
Kidins220,12,24974925,25063152,protein_coding,1,88227,chr12_24974925_25063152
Kif11,19,37376403,37432908,protein_coding,1,56505,chr19_37376403_37432908
Kif13a,13,46749087,46929867,protein_coding,-1,180780,chr13_46749087_46929867
Kif13b,14,64647265,64809617,protein_coding,1,162352,chr14_64647265_64809617
Kif14,1,136466343,136531511,protein_coding,1,65168,chr1_136466343_136531511
Kif15,9,122951046,123018733,protein_coding,1,67687,chr9_122951046_123018733
Kif16b,2,142617474,142901531,protein_coding,-1,284057,chr2_142617474_142901531
Kif16bos,2,142902965,142903572,antisense,1,607,chr2_142902965_142903572
Kif17,4,138250435,138301967,protein_coding,1,51532,chr4_138250435_138301967
Kif18a,2,109280738,109341747,protein_coding,1,61009,chr2_109280738_109341747
Kif19a,11,114765388,114790739,protein_coding,1,25351,chr11_114765388_114790739
Kif1a,1,93015464,93101951,protein_coding,-1,86487,chr1_93015464_93101951
Kif1b,4,149176319,149307693,protein_coding,-1,131374,chr4_149176319_149307693
Kif1c,11,70700548,70731964,protein_coding,1,31416,chr11_70700548_70731964
Kif20a,18,34624613,34633277,protein_coding,1,8664,chr18_34624613_34633277
Kif20b,19,34922361,34975745,protein_coding,1,53384,chr19_34922361_34975745
Kif21a,15,90933276,91049948,protein_coding,-1,116672,chr15_90933276_91049948
Kif21b,1,136131389,136177998,protein_coding,1,46609,chr1_136131389_136177998
Kif22,7,127027729,127042471,protein_coding,-1,14742,chr7_127027729_127042471
Kif22-ps,1,67585053,67587036,processed_pseudogene,1,1983,chr1_67585053_67587036
Kif23,9,61915905,61946774,protein_coding,-1,30869,chr9_61915905_61946774
Kif24,4,41390745,41464887,protein_coding,-1,74142,chr4_41390745_41464887
Kif26a,12,112146208,112181747,protein_coding,1,35539,chr12_112146208_112181747
Kif26b,1,178529125,178939200,protein_coding,1,410075,chr1_178529125_178939200
Kif27,13,58287502,58359122,protein_coding,-1,71620,chr13_58287502_58359122
Kif2a,13,106958996,107022126,protein_coding,-1,63130,chr13_106958996_107022126
Kif2c,4,117159639,117182639,protein_coding,-1,23000,chr4_117159639_117182639
Kif3a,11,53567379,53601967,protein_coding,1,34588,chr11_53567379_53601967
Kif3b,2,153291413,153333390,protein_coding,1,41977,chr2_153291413_153333390
Kif3c,12,3365132,3406494,protein_coding,1,41362,chr12_3365132_3406494
Kif4,X,100625737,100727214,protein_coding,1,101477,chrX_100625737_100727214
Kif5a,10,127225696,127263348,protein_coding,-1,37652,chr10_127225696_127263348
Kif5b,18,6201002,6242174,protein_coding,-1,41172,chr18_6201002_6242174
Kif5c,2,49619298,49774778,protein_coding,1,155480,chr2_49619298_49774778
Kif6,17,49615136,49909847,protein_coding,1,294711,chr17_49615136_49909847
Kif7,7,79698098,79715720,protein_coding,-1,17622,chr7_79698098_79715720
Kif9,9,110476958,110525179,protein_coding,1,48221,chr9_110476958_110525179
Kifap3,1,163779583,163917109,protein_coding,1,137526,chr1_163779583_163917109
Kifc1,17,33875659,33890661,protein_coding,-1,15002,chr17_33875659_33890661
Kifc2,15,76659858,76668196,protein_coding,1,8338,chr15_76659858_76668196
Kifc3,8,95099828,95202812,protein_coding,-1,102984,chr8_95099828_95202812
Kifc5b,17,26917091,26932583,protein_coding,1,15492,chr17_26917091_26932583
Kin,2,10080593,10092806,protein_coding,1,12213,chr2_10080593_10092806
Kirrel,3,87078593,87174747,protein_coding,-1,96154,chr3_87078593_87174747
Kirrel2,7,30447534,30457690,protein_coding,-1,10156,chr7_30447534_30457690
Kirrel3,9,34485894,35036716,protein_coding,1,550822,chr9_34485894_35036716
Kirrel3os,9,34918233,34929509,antisense,-1,11276,chr9_34918233_34929509
Kiss1,1,133321875,133329901,protein_coding,1,8026,chr1_133321875_133329901
Kiss1r,10,79916971,79922273,protein_coding,1,5302,chr10_79916971_79922273
Kit,5,75574916,75656722,protein_coding,1,81806,chr5_75574916_75656722
Kitl,10,100015630,100100416,protein_coding,1,84786,chr10_100015630_100100416
Kiz,2,146855864,146970097,protein_coding,1,114233,chr2_146855864_146970097
Kl,5,150952607,150993817,protein_coding,1,41210,chr5_150952607_150993817
Klb,5,65348314,65384007,protein_coding,1,35693,chr5_65348314_65384007
Klc1,12,111758849,111807844,protein_coding,1,48995,chr12_111758849_111807844
Klc2,19,5107746,5118560,protein_coding,-1,10814,chr19_5107746_5118560
Klc3,7,19394437,19404104,protein_coding,-1,9667,chr7_19394437_19404104
Klc4,17,46630624,46646022,protein_coding,-1,15398,chr17_46630624_46646022
Klf1,8,84901928,84905295,protein_coding,1,3367,chr8_84901928_84905295
Klf10,15,38291463,38300706,protein_coding,-1,9243,chr15_38291463_38300706
Klf11,12,24651274,24662789,protein_coding,1,11515,chr12_24651274_24662789
Klf12,14,99870632,100284679,protein_coding,-1,414047,chr14_99870632_100284679
Klf13,7,63886351,63938915,protein_coding,-1,52564,chr7_63886351_63938915
Klf14,6,30956023,30959078,protein_coding,-1,3055,chr6_30956023_30959078
Klf15,6,90462576,90475238,protein_coding,1,12662,chr6_90462576_90475238
Klf16,10,80567124,80577321,protein_coding,-1,10197,chr10_80567124_80577321
Klf17,4,117757836,117765648,protein_coding,-1,7812,chr4_117757836_117765648
Klf2,8,72319033,72321656,protein_coding,1,2623,chr8_72319033_72321656
Klf3,5,64803388,64832901,protein_coding,1,29513,chr5_64803388_64832901
Klf4,4,55527143,55532466,protein_coding,-1,5323,chr4_55527143_55532466
Klf5,14,99298691,99315036,protein_coding,1,16345,chr14_99298691_99315036
Klf6,13,5861482,5870394,protein_coding,1,8912,chr13_5861482_5870394
Klf7,1,64029447,64122282,protein_coding,-1,92835,chr1_64029447_64122282
Klf8,X,153237466,153396132,protein_coding,1,158666,chrX_153237466_153396132
Klf9,19,23141226,23168134,protein_coding,1,26908,chr19_23141226_23168134
Klhdc1,12,69241176,69284632,protein_coding,1,43456,chr12_69241176_69284632
Klhdc10,6,30401868,30455179,protein_coding,1,53311,chr6_30401868_30455179
Klhdc2,12,69296681,69310687,protein_coding,1,14006,chr12_69296681_69310687
Klhdc3,17,46674550,46680914,protein_coding,-1,6364,chr17_46674550_46680914
Klhdc4,8,121796313,121829569,protein_coding,-1,33256,chr8_121796313_121829569
Klhdc7a,4,139960220,139968026,protein_coding,-1,7806,chr4_139960220_139968026
Klhdc7b,15,89384917,89388867,protein_coding,1,3950,chr15_89384917_89388867
Klhdc8a,1,132298626,132307357,protein_coding,1,8731,chr1_132298626_132307357
Klhdc8b,9,108447636,108461581,protein_coding,-1,13945,chr9_108447636_108461581
Klhdc9,1,171358446,171360798,protein_coding,-1,2352,chr1_171358446_171360798
Klhl1,14,96102736,96519102,protein_coding,-1,416366,chr14_96102736_96519102
Klhl10,11,100441917,100457022,protein_coding,1,15105,chr11_100441917_100457022
Klhl11,11,100462614,100472741,protein_coding,-1,10127,chr11_100462614_100472741
Klhl12,1,134455531,134491018,protein_coding,1,35487,chr1_134455531_134491018
Klhl13,X,23219271,23365082,protein_coding,-1,145811,chrX_23219271_23365082
Klhl14,18,21550377,21654718,protein_coding,-1,104341,chr18_21550377_21654718
Klhl15,X,94234599,94277724,protein_coding,1,43125,chrX_94234599_94277724
Klhl18,9,110425926,110476694,protein_coding,-1,50768,chr9_110425926_110476694
Klhl2,8,64739675,64850017,protein_coding,-1,110342,chr8_64739675_64850017
Klhl20,1,161088375,161131511,protein_coding,-1,43136,chr1_161088375_161131511
Klhl21,4,152008803,152017680,protein_coding,1,8877,chr4_152008803_152017680
Klhl22,16,17759618,17793382,protein_coding,1,33764,chr16_17759618_17793382
Klhl23,2,69821944,69836651,protein_coding,1,14707,chr2_69821944_69836651
Klhl24,16,20097542,20129221,protein_coding,1,31679,chr16_20097542_20129221
Klhl25,7,75848310,75874131,protein_coding,1,25821,chr7_75848310_75874131
Klhl26,8,70450219,70476968,protein_coding,-1,26749,chr8_70450219_70476968
Klhl28,12,64938833,64965534,protein_coding,-1,26701,chr12_64938833_64965534
Klhl29,12,5077472,5375682,protein_coding,-1,298210,chr12_5077472_5375682
Klhl3,13,58000228,58113592,protein_coding,-1,113364,chr13_58000228_58113592
Klhl30,1,91351016,91362416,protein_coding,1,11400,chr1_91351016_91362416
Klhl31,9,77636500,77660127,protein_coding,1,23627,chr9_77636500_77660127
Klhl32,4,24612554,24851124,protein_coding,-1,238570,chr4_24612554_24851124
Klhl33,14,50888582,50897507,protein_coding,-1,8925,chr14_50888582_50897507
Klhl34,X,157818435,157820369,protein_coding,1,1934,chrX_157818435_157820369
Klhl35,7,99466004,99474022,protein_coding,1,8018,chr7_99466004_99474022
Klhl36,8,119862266,119876995,protein_coding,1,14729,chr8_119862266_119876995
Klhl38,15,58314573,58324169,protein_coding,-1,9596,chr15_58314573_58324169
Klhl4,X,114474333,114560829,protein_coding,1,86496,chrX_114474333_114560829
Klhl40,9,121777607,121783818,protein_coding,1,6211,chr9_121777607_121783818
Klhl41,2,69670120,69684230,protein_coding,1,14110,chr2_69670120_69684230
Klhl42,6,147091379,147112778,protein_coding,1,21399,chr6_147091379_147112778
Klhl5,5,65107539,65168188,protein_coding,1,60649,chr5_65107539_65168188
Klhl6,16,19946496,19983037,protein_coding,-1,36541,chr16_19946496_19983037
Klhl7,5,24100605,24160792,protein_coding,1,60187,chr5_24100605_24160792
Klhl8,5,103861973,103911259,protein_coding,-1,49286,chr5_103861973_103911259
Klhl9,4,88718292,88722465,protein_coding,-1,4173,chr4_88718292_88722465
Klk10,7,43781035,43785410,protein_coding,1,4375,chr7_43781035_43785410
Klk11,7,43774604,43779263,protein_coding,1,4659,chr7_43774604_43779263
Klk12,7,43768897,43773585,protein_coding,1,4688,chr7_43768897_43773585
Klk13,7,43712567,43727534,protein_coding,1,14967,chr7_43712567_43727534
Klk14,7,43690418,43695536,protein_coding,1,5118,chr7_43690418_43695536
Klk1b12-ps,7,44004641,44008892,unprocessed_pseudogene,1,4251,chr7_44004641_44008892
Klk1b14-ps,7,44071860,44076002,unprocessed_pseudogene,1,4142,chr7_44071860_44076002
Klk1b19-ps,7,44045159,44048483,unprocessed_pseudogene,1,3324,chr7_44045159_44048483
Klk2-ps,7,43916254,43921873,transcribed_unprocessed_pseudogene,1,5619,chr7_43916254_43921873
Klk6,7,43824499,43832030,protein_coding,1,7531,chr7_43824499_43832030
Klk7,7,43811294,43816359,protein_coding,1,5065,chr7_43811294_43816359
Klk8,7,43797577,43803826,protein_coding,1,6249,chr7_43797577_43803826
Klk9,7,43791891,43796757,protein_coding,1,4866,chr7_43791891_43796757
Klkb1,8,45266689,45294859,protein_coding,-1,28170,chr8_45266689_45294859
Klra2,6,131219223,131247362,protein_coding,-1,28139,chr6_131219223_131247362
Klra5,6,129898996,129917650,protein_coding,-1,18654,chr6_129898996_129917650
Klrb1,6,128705836,128723059,protein_coding,-1,17223,chr6_128705836_128723059
Klrb1f,6,129045901,129057464,protein_coding,1,11563,chr6_129045901_129057464
Klrc1,6,129666015,129678973,protein_coding,-1,12958,chr6_129666015_129678973
Klre1,6,129577905,129585827,protein_coding,1,7922,chr6_129577905_129585827
Klrg1,6,122270596,122282882,protein_coding,-1,12286,chr6_122270596_122282882
Klrg2,6,38625693,38637242,protein_coding,-1,11549,chr6_38625693_38637242
Klri1,6,129697218,129717132,protein_coding,-1,19914,chr6_129697218_129717132
Klri2,6,129729041,129740484,protein_coding,-1,11443,chr6_129729041_129740484
Kmo,1,175620381,175662116,protein_coding,1,41735,chr1_175620381_175662116
Kmt2a,9,44803355,44881296,protein_coding,-1,77941,chr9_44803355_44881296
Kmt2b,7,30568858,30588726,protein_coding,-1,19868,chr7_30568858_30588726
Kmt2c,5,25271798,25498783,protein_coding,-1,226985,chr5_25271798_25498783
Kmt2d,15,98831669,98871204,protein_coding,-1,39535,chr15_98831669_98871204
Kmt2e,5,23434441,23504235,protein_coding,1,69794,chr5_23434441_23504235
Kncn,4,115884400,115889526,protein_coding,1,5126,chr4_115884400_115889526
Kndc1,7,139894696,139941537,protein_coding,1,46841,chr7_139894696_139941537
Knop1,7,118842222,118856254,protein_coding,-1,14032,chr7_118842222_118856254
Knstrn,2,118814003,118853957,protein_coding,1,39954,chr2_118814003_118853957
Kntc1,5,123749716,123821593,protein_coding,1,71877,chr5_123749716_123821593
Kpna1,16,35978750,36037131,protein_coding,1,58381,chr16_35978750_36037131
Kpna2,11,106988629,106999541,protein_coding,-1,10912,chr11_106988629_106999541
Kpna2-ps,17,47620771,47622339,processed_pseudogene,-1,1568,chr17_47620771_47622339
Kpna3,14,61365211,61439874,protein_coding,-1,74663,chr14_61365211_61439874
Kpna4,3,69067149,69127113,protein_coding,-1,59964,chr3_69067149_69127113
Kpna6,4,129643980,129672767,protein_coding,-1,28787,chr4_129643980_129672767
Kpna7,5,144983519,145084030,protein_coding,-1,100511,chr5_144983519_145084030
Kpnb1,11,97159714,97187881,protein_coding,-1,28167,chr11_97159714_97187881
Kptn,7,16119895,16127516,protein_coding,1,7621,chr7_16119895_16127516
Kras,6,145216699,145250239,protein_coding,-1,33540,chr6_145216699_145250239
Krba1,6,48395586,48419781,protein_coding,1,24195,chr6_48395586_48419781
Krcc1,6,71271677,71285319,protein_coding,1,13642,chr6_71271677_71285319
Kremen1,11,5191552,5261558,protein_coding,-1,70006,chr11_5191552_5261558
Kremen2,17,23741197,23745833,protein_coding,-1,4636,chr17_23741197_23745833
Kri1,9,21273457,21287969,protein_coding,-1,14512,chr9_21273457_21287969
Krit1,5,3803184,3845564,protein_coding,1,42380,chr5_3803184_3845564
Krr1,10,111972664,111988432,protein_coding,1,15768,chr10_111972664_111988432
Krt1,15,101845426,101850794,protein_coding,-1,5368,chr15_101845426_101850794
Krt10,11,99385254,99389364,protein_coding,-1,4110,chr11_99385254_99389364
Krt12,11,99415666,99422259,protein_coding,-1,6593,chr11_99415666_99422259
Krt14,11,100203162,100207548,protein_coding,-1,4386,chr11_100203162_100207548
Krt15,11,100131758,100135928,protein_coding,-1,4170,chr11_100131758_100135928
Krt16,11,100246091,100248902,protein_coding,-1,2811,chr11_100246091_100248902
Krt17,11,100256217,100261029,protein_coding,-1,4812,chr11_100256217_100261029
Krt18,15,102028180,102032027,protein_coding,1,3847,chr15_102028180_102032027
Krt19,11,100140810,100148665,protein_coding,-1,7855,chr11_100140810_100148665
Krt2,15,101810689,101818169,protein_coding,-1,7480,chr15_101810689_101818169
Krt20,11,99428403,99438150,protein_coding,-1,9747,chr11_99428403_99438150
Krt222,11,99232761,99244085,protein_coding,-1,11324,chr11_99232761_99244085
Krt23,11,99477974,99493137,protein_coding,-1,15163,chr11_99477974_99493137
Krt24,11,99279959,99285262,protein_coding,-1,5303,chr11_99279959_99285262
Krt25,11,99315516,99322951,protein_coding,-1,7435,chr11_99315516_99322951
Krt26,11,99328550,99337966,protein_coding,-1,9416,chr11_99328550_99337966
Krt27,11,99345565,99351104,protein_coding,-1,5539,chr11_99345565_99351104
Krt28,11,99364872,99374903,protein_coding,-1,10031,chr11_99364872_99374903
Krt36,11,100102007,100105626,protein_coding,-1,3619,chr11_100102007_100105626
Krt39,11,99514114,99521338,protein_coding,-1,7224,chr11_99514114_99521338
Krt40,11,99537485,99543158,protein_coding,-1,5673,chr11_99537485_99543158
Krt42,11,100262882,100269871,protein_coding,-1,6989,chr11_100262882_100269871
Krt7,15,101411043,101430313,protein_coding,1,19270,chr15_101411043_101430313
Krt73,15,101793308,101802346,protein_coding,-1,9038,chr15_101793308_101802346
Krt77,15,101858731,101869705,protein_coding,-1,10974,chr15_101858731_101869705
Krt78,15,101946001,101954287,protein_coding,-1,8286,chr15_101946001_101954287
Krt79,15,101929332,101940324,protein_coding,-1,10992,chr15_101929332_101940324
Krt80,15,101347444,101370162,protein_coding,-1,22718,chr15_101347444_101370162
Krt83,15,101485130,101491512,protein_coding,-1,6382,chr15_101485130_101491512
Krt86,15,101473478,101479986,protein_coding,1,6508,chr15_101473478_101479986
Krt9,11,100186781,100193246,protein_coding,-1,6465,chr11_100186781_100193246
Krtap16-1,11,99984710,99986597,protein_coding,-1,1887,chr11_99984710_99986597
Krtap17-1,11,99993234,99993994,protein_coding,-1,760,chr11_99993234_99993994
Krtap19-2,16,88873627,88874269,protein_coding,-1,642,chr16_88873627_88874269
Krtcap2,3,89245966,89249906,protein_coding,1,3940,chr3_89245966_89249906
Krtcap3,5,31251691,31253202,protein_coding,1,1511,chr5_31251691_31253202
Ksr1,11,79013440,79146407,protein_coding,-1,132967,chr11_79013440_79146407
Ksr2,5,117414000,117775003,protein_coding,1,361003,chr5_117414000_117775003
Kti12,4,108847785,108849413,protein_coding,1,1628,chr4_108847785_108849413
Ktn1,14,47648448,47739894,protein_coding,1,91446,chr14_47648448_47739894
Kxd1,8,70508272,70527956,protein_coding,-1,19684,chr8_70508272_70527956
Ky,9,102505750,102546239,protein_coding,1,40489,chr9_102505750_102546239
Kynu,2,43555329,43682715,protein_coding,1,127386,chr2_43555329_43682715
L1cam,X,73853778,73896105,protein_coding,-1,42327,chrX_73853778_73896105
L1td1,4,98726734,98738480,protein_coding,1,11746,chr4_98726734_98738480
L2hgdh,12,69690433,69724873,protein_coding,-1,34440,chr12_69690433_69724873
L3hypdh,12,72073428,72085439,protein_coding,-1,12011,chr12_72073428_72085439
L3mbtl1,2,162943472,162974522,protein_coding,1,31050,chr2_162943472_162974522
L3mbtl2,15,81663889,81688315,protein_coding,1,24426,chr15_81663889_81688315
L3mbtl3,10,26274468,26375971,protein_coding,-1,101503,chr10_26274468_26375971
L3mbtl4,17,68273797,68780086,protein_coding,1,506289,chr17_68273797_68780086
LOC102637012,7,47057353,47074687,unitary_pseudogene,-1,17334,chr7_47057353_47074687
LOC665443,8,66845797,66846592,processed_pseudogene,1,795,chr8_66845797_66846592
Lacc1,14,77024200,77036904,protein_coding,-1,12704,chr14_77024200_77036904
Lactb,9,66955388,66975484,protein_coding,-1,20096,chr9_66955388_66975484
Lactb2,1,13623330,13660546,protein_coding,-1,37216,chr1_13623330_13660546
Lactbl1,4,136622621,136639110,protein_coding,1,16489,chr4_136622621_136639110
Lad1,1,135818598,135833342,protein_coding,1,14744,chr1_135818598_135833342
Lag3,6,124904361,124911705,protein_coding,-1,7344,chr6_124904361_124911705
Lage3,X,74351276,74353618,protein_coding,-1,2342,chrX_74351276_74353618
Lair1,7,4003402,4063204,protein_coding,-1,59802,chr7_4003402_4063204
Lama1,17,67697259,67822647,protein_coding,1,125388,chr17_67697259_67822647
Lama2,10,26980036,27619758,protein_coding,-1,639722,chr10_26980036_27619758
Lama3,18,12333819,12583013,protein_coding,1,249194,chr18_12333819_12583013
Lama4,10,38965515,39110188,protein_coding,1,144673,chr10_38965515_39110188
Lama5,2,180176373,180225859,protein_coding,-1,49486,chr2_180176373_180225859
Lamb1,12,31265234,31329644,protein_coding,1,64410,chr12_31265234_31329644
Lamb2,9,108479736,108490530,protein_coding,1,10794,chr9_108479736_108490530
Lamb3,1,193207699,193343878,protein_coding,1,136179,chr1_193207699_193343878
Lamc1,1,153218922,153332786,protein_coding,-1,113864,chr1_153218922_153332786
Lamc2,1,153122756,153186447,protein_coding,-1,63691,chr1_153122756_153186447
Lamp1,8,13159161,13175338,protein_coding,1,16177,chr8_13159161_13175338
Lamp2,X,38401357,38456454,protein_coding,-1,55097,chrX_38401357_38456454
Lamp3,16,19653378,19706375,protein_coding,-1,52997,chr16_19653378_19706375
Lamp5,2,136052239,136069917,protein_coding,1,17678,chr2_136052239_136069917
Lamtor1,7,101905904,101926675,protein_coding,1,20771,chr7_101905904_101926675
Lamtor2,3,88549819,88553074,protein_coding,-1,3255,chr3_88549819_88553074
Lamtor3,3,137918506,137928900,protein_coding,1,10394,chr3_137918506_137928900
Lamtor4,5,138255482,138259398,protein_coding,1,3916,chr5_138255482_138259398
Lamtor5,3,107278858,107284082,protein_coding,1,5224,chr3_107278858_107284082
Lancl1,1,67000517,67038872,protein_coding,-1,38355,chr1_67000517_67038872
Lancl2,6,57702540,57739439,protein_coding,1,36899,chr6_57702540_57739439
Lancl3,X,9199902,9268085,protein_coding,1,68183,chrX_9199902_9268085
Lap3,5,45493374,45512691,protein_coding,1,19317,chr5_45493374_45512691
Laptm4a,12,8921664,8938742,protein_coding,1,17078,chr12_8921664_8938742
Laptm4b,15,34238028,34284302,protein_coding,1,46274,chr15_34238028_34284302
Laptm5,4,130913125,130936141,protein_coding,1,23016,chr4_130913125_130936141
Larp1,11,58009064,58062034,protein_coding,1,52970,chr11_58009064_58062034
Larp1b,3,40949828,41040234,protein_coding,1,90406,chr3_40949828_41040234
Larp4,15,99970065,100016358,protein_coding,1,46293,chr15_99970065_100016358
Larp4b,13,9093881,9174451,protein_coding,1,80570,chr13_9093881_9174451
Larp6,9,60712989,60738801,protein_coding,1,25812,chr9_60712989_60738801
Larp7,3,127536714,127553349,protein_coding,-1,16635,chr3_127536714_127553349
Lars,18,42202298,42262194,protein_coding,-1,59896,chr18_42202298_42262194
Lars2,9,123366927,123462666,protein_coding,1,95739,chr9_123366927_123462666
Las1l,X,95935335,95956962,protein_coding,-1,21627,chrX_95935335_95956962
Lasp1,11,97799000,97838764,protein_coding,1,39764,chr11_97799000_97838764
Lat,7,126363824,126369570,protein_coding,-1,5746,chr7_126363824_126369570
Lat2,5,134600022,134615025,protein_coding,-1,15003,chr5_134600022_134615025
Lats1,10,7606978,7716460,protein_coding,1,109482,chr10_7606978_7716460
Lats2,14,57689662,57758388,protein_coding,-1,68726,chr14_57689662_57758388
Lax1,1,133679091,133690108,protein_coding,-1,11017,chr1_133679091_133690108
Layn,9,51054640,51077094,protein_coding,-1,22454,chr9_51054640_51077094
Lbh,17,72918305,72941947,protein_coding,1,23642,chr17_72918305_72941947
Lbp,2,158306493,158332852,protein_coding,1,26359,chr2_158306493_158332852
Lbr,1,181815335,181843046,protein_coding,-1,27711,chr1_181815335_181843046
Lbx1,19,45232684,45235812,protein_coding,-1,3128,chr19_45232684_45235812
Lbx2,6,83086367,83088243,protein_coding,1,1876,chr6_83086367_83088243
Lca5,9,83390293,83441127,protein_coding,-1,50834,chr9_83390293_83441127
Lca5l,16,96158407,96192271,protein_coding,-1,33864,chr16_96158407_96192271
Lcat,8,105939551,105943382,protein_coding,-1,3831,chr8_105939551_105943382
Lck,4,129548344,129573641,protein_coding,-1,25297,chr4_129548344_129573641
Lclat1,17,73107985,73243368,protein_coding,1,135383,chr17_73107985_73243368
Lcmt1,7,123369784,123430358,protein_coding,1,60574,chr7_123369784_123430358
Lcmt2,2,121128307,121140653,protein_coding,-1,12346,chr2_121128307_121140653
Lcn5,2,25657952,25661977,protein_coding,1,4025,chr2_25657952_25661977
Lcn9,2,25823153,25825537,protein_coding,1,2384,chr2_25823153_25825537
Lcor,19,41482637,41586536,protein_coding,1,103899,chr19_41482637_41586536
Lcorl,5,45697181,45857615,protein_coding,-1,160434,chr5_45697181_45857615
Lcp1,14,75131101,75230842,protein_coding,1,99741,chr14_75131101_75230842
Lcp2,11,34046920,34092295,protein_coding,1,45375,chr11_34046920_34092295
Lct,1,128284756,128328318,protein_coding,-1,43562,chr1_128284756_128328318
Lctl,9,64117147,64138118,protein_coding,1,20971,chr9_64117147_64138118
Ldb1,19,46031570,46045214,protein_coding,-1,13644,chr19_46031570_46045214
Ldb2,5,44472132,44799680,protein_coding,-1,327548,chr5_44472132_44799680
Ldb3,14,34526603,34588682,protein_coding,-1,62079,chr14_34526603_34588682
Ldha,7,46841475,46855627,protein_coding,1,14152,chr7_46841475_46855627
Ldha-ps,2,60134055,60135049,processed_pseudogene,1,994,chr2_60134055_60135049
Ldha-ps2,4,119334389,119335445,processed_pseudogene,-1,1056,chr4_119334389_119335445
Ldha-ps3,17,41101038,41102228,processed_pseudogene,1,1190,chr17_41101038_41102228
Ldhal6b,17,5417323,5418767,protein_coding,-1,1444,chr17_5417323_5418767
Ldhb,6,142490249,142507957,protein_coding,-1,17708,chr6_142490249_142507957
Ldhc,7,46861203,46878142,protein_coding,1,16939,chr7_46861203_46878142
Ldhd,8,111623785,111630374,protein_coding,-1,6589,chr8_111623785_111630374
Ldlr,9,21723483,21749919,protein_coding,1,26436,chr9_21723483_21749919
Ldlrad1,4,107209180,107218060,protein_coding,1,8880,chr4_107209180_107218060
Ldlrad2,4,137570876,137582104,protein_coding,-1,11228,chr4_137570876_137582104
Ldlrad3,2,101950203,102186385,protein_coding,-1,236182,chr2_101950203_102186385
Ldlrad4,18,67933257,68268630,protein_coding,1,335373,chr18_67933257_68268630
Ldlrap1,4,134741554,134768024,protein_coding,-1,26470,chr4_134741554_134768024
Ldoc1,X,61709497,61710955,protein_coding,1,1458,chrX_61709497_61710955
Leap2,11,53422181,53423170,protein_coding,-1,989,chr11_53422181_53423170
Lect2,13,56542464,56548502,protein_coding,-1,6038,chr13_56542464_56548502
Lef1,3,131110471,131224356,protein_coding,1,113885,chr3_131110471_131224356
Lefty1,1,180935022,180938400,protein_coding,1,3378,chr1_180935022_180938400
Lefty2,1,180893108,180899103,protein_coding,1,5995,chr1_180893108_180899103
Lekr1,3,65666228,65831355,protein_coding,1,165127,chr3_65666228_65831355
Lemd1,1,132191431,132259227,protein_coding,1,67796,chr1_132191431_132259227
Lemd2,17,27189600,27204469,protein_coding,-1,14869,chr17_27189600_27204469
Lemd3,10,120923413,120979332,protein_coding,-1,55919,chr10_120923413_120979332
Lenep,3,89400988,89402793,protein_coding,-1,1805,chr3_89400988_89402793
Leng1,7,3660098,3665840,protein_coding,-1,5742,chr7_3660098_3665840
Leng8,7,4137039,4148177,protein_coding,1,11138,chr7_4137039_4148177
Leng9,7,4147915,4150374,protein_coding,-1,2459,chr7_4147915_4150374
Leo1,9,75441524,75466432,protein_coding,1,24908,chr9_75441524_75466432
Lep,6,29060220,29073877,protein_coding,1,13657,chr6_29060220_29073877
Lepr,4,101717404,101815352,protein_coding,1,97948,chr4_101717404_101815352
Leprot,4,101647718,101659364,protein_coding,1,11646,chr4_101647718_101659364
Leprotl1,8,34135572,34147033,protein_coding,-1,11461,chr8_34135572_34147033
Letm1,5,33739673,33782817,protein_coding,-1,43144,chr5_33739673_33782817
Letm2,8,25578490,25597582,protein_coding,-1,19092,chr8_25578490_25597582
Letmd1,15,100469023,100479164,protein_coding,1,10141,chr15_100469023_100479164
Lfng,5,140607320,140615545,protein_coding,1,8225,chr5_140607320_140615545
Lgals1,15,78926725,78930465,protein_coding,1,3740,chr15_78926725_78930465
Lgals12,19,7596660,7607193,protein_coding,-1,10533,chr19_7596660_7607193
Lgals3,14,47367751,47386160,protein_coding,1,18409,chr14_47367751_47386160
Lgals3bp,11,118392751,118402092,protein_coding,-1,9341,chr11_118392751_118402092
Lgals4,7,28833854,28841708,protein_coding,1,7854,chr7_28833854_28841708
Lgals7,7,28863853,28866284,protein_coding,1,2431,chr7_28863853_28866284
Lgals8,13,12439415,12464944,protein_coding,-1,25529,chr13_12439415_12464944
Lgals9,11,78962974,78984946,protein_coding,-1,21972,chr11_78962974_78984946
Lgalsl,11,20823576,20831056,protein_coding,-1,7480,chr11_20823576_20831056
Lgi1,19,38264536,38312214,protein_coding,1,47678,chr19_38264536_38312214
Lgi2,5,52533517,52566462,protein_coding,-1,32945,chr5_52533517_52566462
Lgi3,14,70530685,70538324,protein_coding,1,7639,chr14_70530685_70538324
Lgi4,7,31059342,31070935,protein_coding,1,11593,chr7_31059342_31070935
Lgmn,12,102394084,102439813,protein_coding,-1,45729,chr12_102394084_102439813
Lgr4,2,109917647,110014257,protein_coding,1,96610,chr2_109917647_110014257
Lgr5,10,115450311,115587780,protein_coding,-1,137469,chr10_115450311_115587780
Lgr6,1,134983301,135105276,protein_coding,-1,121975,chr1_134983301_135105276
Lgsn,1,31176401,31204725,protein_coding,1,28324,chr1_31176401_31204725
Lhb,7,45420820,45421897,protein_coding,1,1077,chr7_45420820_45421897
Lhcgr,17,88716481,88791990,protein_coding,-1,75509,chr17_88716481_88791990
Lhfp,3,53041528,53261679,protein_coding,1,220151,chr3_53041528_53261679
Lhfpl1,X,145290359,145349089,protein_coding,-1,58730,chrX_145290359_145349089
Lhfpl2,13,94057796,94195409,protein_coding,1,137613,chr13_94057796_94195409
Lhfpl3,5,22746059,23275597,protein_coding,1,529538,chr5_22746059_23275597
Lhfpl4,6,113168090,113195384,protein_coding,-1,27294,chr6_113168090_113195384
Lhfpl5,17,28575641,28585679,protein_coding,1,10038,chr17_28575641_28585679
Lhpp,7,132610638,132706420,protein_coding,1,95782,chr7_132610638_132706420
Lhx1os,11,84525660,84535831,lincRNA,1,10171,chr11_84525660_84535831
Lhx2,2,38339281,38369733,protein_coding,1,30452,chr2_38339281_38369733
Lhx3,2,26200212,26208289,protein_coding,-1,8077,chr2_26200212_26208289
Lhx4,1,155698031,155751684,protein_coding,-1,53653,chr1_155698031_155751684
Lhx5,5,120431699,120441223,protein_coding,1,9524,chr5_120431699_120441223
Lhx6,2,36081953,36105408,protein_coding,-1,23455,chr2_36081953_36105408
Lhx9,1,138825186,138848577,protein_coding,-1,23391,chr1_138825186_138848577
Lias,5,65391497,65410693,protein_coding,1,19196,chr5_65391497_65410693
Lif,11,4257557,4272514,protein_coding,1,14957,chr11_4257557_4272514
Lifr,15,7090614,7197489,protein_coding,1,106875,chr15_7090614_7197489
Lig1,7,13277283,13311433,protein_coding,1,34150,chr7_13277283_13311433
Lig3,11,82781108,82804274,protein_coding,1,23166,chr11_82781108_82804274
Lig4,8,9969049,9977686,protein_coding,-1,8637,chr8_9969049_9977686
Lilra5,7,4237754,4243463,protein_coding,1,5709,chr7_4237754_4243463
Lilra6,7,3908280,3915503,protein_coding,-1,7223,chr7_3908280_3915503
Lima1,15,99778470,99875456,protein_coding,-1,96986,chr15_99778470_99875456
Limch1,5,66745827,67057158,protein_coding,1,311331,chr5_66745827_67057158
Limd1,9,123478706,123521552,protein_coding,1,42846,chr9_123478706_123521552
Limd2,11,106156256,106160860,protein_coding,-1,4604,chr11_106156256_106160860
Lime1,2,181380078,181383628,protein_coding,1,3550,chr2_181380078_181383628
Limk1,5,134656039,134688598,protein_coding,-1,32559,chr5_134656039_134688598
Limk2,11,3344256,3409189,protein_coding,-1,64933,chr11_3344256_3409189
Lims1,10,58323466,58424691,protein_coding,1,101225,chr10_58323466_58424691
Lims2,18,31922290,31958619,protein_coding,1,36329,chr18_31922290_31958619
Lin28a,4,134003330,134018841,protein_coding,-1,15511,chr4_134003330_134018841
Lin28b,10,45376620,45486395,protein_coding,-1,109775,chr10_45376620_45486395
Lin37,7,30555441,30559838,protein_coding,-1,4397,chr7_30555441_30559838
Lin52,12,84451422,84546145,protein_coding,1,94723,chr12_84451422_84546145
Lin54,5,100441918,100500639,protein_coding,-1,58721,chr5_100441918_100500639
Lin7a,10,107271686,107421474,protein_coding,1,149788,chr10_107271686_107421474
Lin7b,7,45367891,45370583,protein_coding,-1,2692,chr7_45367891_45370583
Lin7c,2,109890853,109901003,protein_coding,1,10150,chr2_109890853_109901003
Lin9,1,180641150,180690694,protein_coding,1,49544,chr1_180641150_180690694
Lingo1,9,56618475,56796468,protein_coding,-1,177993,chr9_56618475_56796468
Lingo2,4,35706647,36951747,protein_coding,-1,1245100,chr4_35706647_36951747
Lingo3,10,80832801,80844039,protein_coding,-1,11238,chr10_80832801_80844039
Lingo4,3,94398517,94404501,protein_coding,1,5984,chr3_94398517_94404501
Lipa,19,34492318,34527474,protein_coding,-1,35156,chr19_34492318_34527474
Lipc,9,70798128,70952226,protein_coding,-1,154098,chr9_70798128_70952226
Lipe,7,25379527,25398710,protein_coding,-1,19183,chr7_25379527_25398710
Lipg,18,74939322,74961263,protein_coding,-1,21941,chr18_74939322_74961263
Liph,16,21953817,21995663,protein_coding,-1,41846,chr16_21953817_21995663
Lipi,16,75540514,75586061,protein_coding,-1,45547,chr16_75540514_75586061
Lipm,19,34100933,34122687,protein_coding,1,21754,chr19_34100933_34122687
Lipn,19,34067358,34084918,protein_coding,1,17560,chr19_34067358_34084918
Lipo1,19,33775498,33787459,protein_coding,-1,11961,chr19_33775498_33787459
Lipt1,1,37871738,37876228,protein_coding,1,4490,chr1_37871738_37876228
Lipt2,7,100159277,100161365,protein_coding,1,2088,chr7_100159277_100161365
Litaf,16,10959275,11066157,protein_coding,-1,106882,chr16_10959275_11066157
Lix1,17,17402672,17459387,protein_coding,1,56715,chr17_17402672_17459387
Lix1l,3,96601149,96626171,protein_coding,1,25022,chr3_96601149_96626171
Lkaaear1,2,181696793,181698442,protein_coding,-1,1649,chr2_181696793_181698442
Llgl1,11,60699723,60714186,protein_coding,1,14463,chr11_60699723_60714186
Llgl2,11,115824049,115855780,protein_coding,1,31731,chr11_115824049_115855780
Llph,10,120227070,120232582,protein_coding,1,5512,chr10_120227070_120232582
Llph-ps1,4,116200563,116200952,processed_pseudogene,-1,389,chr4_116200563_116200952
Llph-ps2,X,13218210,13218602,processed_pseudogene,-1,392,chrX_13218210_13218602
Lman1,18,65980738,66022580,protein_coding,-1,41842,chr18_65980738_66022580
Lman1l,9,57607085,57620774,protein_coding,-1,13689,chr9_57607085_57620774
Lman2,13,55343833,55362783,protein_coding,-1,18950,chr13_55343833_55362783
Lman2l,1,36419871,36445271,protein_coding,-1,25400,chr1_36419871_36445271
Lmbr1,5,29229802,29378390,protein_coding,-1,148588,chr5_29229802_29378390
Lmbr1l,15,98903917,98918231,protein_coding,-1,14314,chr15_98903917_98918231
Lmbrd1,1,24678630,24766301,protein_coding,1,87671,chr1_24678630_24766301
Lmbrd2,15,9140550,9202483,protein_coding,1,61933,chr15_9140550_9202483
Lmcd1,6,112273758,112330425,protein_coding,1,56667,chr6_112273758_112330425
Lmf1,17,25579085,25662826,protein_coding,1,83741,chr17_25579085_25662826
Lmf2,15,89351004,89355659,protein_coding,-1,4655,chr15_89351004_89355659
Lmln,16,33062521,33127695,protein_coding,1,65174,chr16_33062521_33127695
Lmna,3,88480147,88509956,protein_coding,-1,29809,chr3_88480147_88509956
Lmnb1,18,56707813,56753424,protein_coding,1,45611,chr18_56707813_56753424
Lmnb2,10,80901203,80918245,protein_coding,-1,17042,chr10_80901203_80918245
Lmntd2,7,141209992,141214080,protein_coding,-1,4088,chr7_141209992_141214080
Lmo1,7,109138572,109175207,protein_coding,-1,36635,chr7_109138572_109175207
Lmo2,2,103957986,103981878,protein_coding,1,23892,chr2_103957986_103981878
Lmo3,6,138362918,138581968,protein_coding,-1,219050,chr6_138362918_138581968
Lmo4,3,144188530,144205220,protein_coding,-1,16690,chr3_144188530_144205220
Lmo7,14,101729957,101934710,protein_coding,1,204753,chr14_101729957_101934710
Lmod1,1,135324807,135368065,protein_coding,1,43258,chr1_135324807_135368065
Lmod3,6,97238534,97252759,protein_coding,-1,14225,chr6_97238534_97252759
Lmtk2,5,144100436,144188204,protein_coding,1,87768,chr5_144100436_144188204
Lmtk3,7,45783738,45804144,protein_coding,1,20406,chr7_45783738_45804144
Lmx1a,1,167689237,167848741,protein_coding,1,159504,chr1_167689237_167848741
Lmx1b,2,33560965,33640608,protein_coding,-1,79643,chr2_33560965_33640608
Lnp1,16,56914344,56928061,protein_coding,-1,13717,chr16_56914344_56928061
Lnpep,17,17521410,17625050,protein_coding,-1,103640,chr17_17521410_17625050
Lnx1,5,74592447,74702912,protein_coding,-1,110465,chr5_74592447_74702912
Lnx2,5,147016655,147076586,protein_coding,-1,59931,chr5_147016655_147076586
Lonp1,17,56614297,56626887,protein_coding,-1,12590,chr17_56614297_56626887
Lonp2,8,86624043,86723873,protein_coding,1,99830,chr8_86624043_86723873
Lonrf1,8,36216064,36249516,protein_coding,-1,33452,chr8_36216064_36249516
Lonrf2,1,38793645,38836711,protein_coding,-1,43066,chr1_38793645_38836711
Lonrf3,X,36328353,36362341,protein_coding,1,33988,chrX_36328353_36362341
Lor,3,92080271,92083142,protein_coding,-1,2871,chr3_92080271_92083142
Lox,18,52516067,52529867,protein_coding,-1,13800,chr18_52516067_52529867
Loxhd1,18,77281958,77442930,protein_coding,1,160972,chr18_77281958_77442930
Loxl1,9,58287738,58313186,protein_coding,-1,25448,chr9_58287738_58313186
Loxl2,14,69609068,69695834,protein_coding,1,86766,chr14_69609068_69695834
Loxl3,6,83034173,83052562,protein_coding,1,18389,chr6_83034173_83052562
Loxl4,19,42593982,42612813,protein_coding,-1,18831,chr19_42593982_42612813
Lpar1,4,58435255,58553898,protein_coding,-1,118643,chr4_58435255_58553898
Lpar2,8,69822429,69831102,protein_coding,1,8673,chr8_69822429_69831102
Lpar4,X,106920625,106933900,protein_coding,1,13275,chrX_106920625_106933900
Lpar5,6,125067920,125082472,protein_coding,1,14552,chr6_125067920_125082472
Lpar6,14,73237895,73243294,protein_coding,1,5399,chr14_73237895_73243294
Lpcat1,13,73467197,73516422,protein_coding,1,49225,chr13_73467197_73516422
Lpcat2,8,92855339,92919279,protein_coding,1,63940,chr8_92855339_92919279
Lpcat2b,5,107431549,107435039,protein_coding,1,3490,chr5_107431549_107435039
Lpcat3,6,124663027,124704418,protein_coding,1,41391,chr6_124663027_124704418
Lpcat4,2,112239468,112247111,protein_coding,1,7643,chr2_112239468_112247111
Lpgat1,1,191717834,191784255,protein_coding,1,66421,chr1_191717834_191784255
Lpin1,12,16535669,16646966,protein_coding,-1,111297,chr12_16535669_16646966
Lpin2,17,71182560,71249817,protein_coding,1,67257,chr17_71182560_71249817
Lpin3,2,160880670,160906002,protein_coding,1,25332,chr2_160880670_160906002
Lpl,8,68880491,68907448,protein_coding,1,26957,chr8_68880491_68907448
Lpo,11,87806428,87828289,protein_coding,-1,21861,chr11_87806428_87828289
Lpp,16,24393507,24992578,protein_coding,1,599071,chr16_24393507_24992578
Lpxn,19,12796193,12833807,protein_coding,1,37614,chr19_12796193_12833807
Lrba,3,86224680,86782692,protein_coding,1,558012,chr3_86224680_86782692
Lrch1,14,74754675,74947876,protein_coding,-1,193201,chr14_74754675_74947876
Lrch2,X,147470375,147554081,protein_coding,-1,83706,chrX_147470375_147554081
Lrch3,16,32914100,33015647,protein_coding,1,101547,chr16_32914100_33015647
Lrcol1,5,110344730,110356094,protein_coding,1,11364,chr5_110344730_110356094
Lrfn1,7,28451980,28468242,protein_coding,1,16262,chr7_28451980_28468242
Lrfn2,17,48932379,49097588,protein_coding,1,165209,chr17_48932379_49097588
Lrfn3,7,30355489,30362772,protein_coding,-1,7283,chr7_30355489_30362772
Lrfn4,19,4611785,4615667,protein_coding,-1,3882,chr19_4611785_4615667
Lrfn5,12,61523150,61858342,protein_coding,1,335192,chr12_61523150_61858342
Lrg1,17,56119678,56122001,protein_coding,-1,2323,chr17_56119678_56122001
Lrguk,6,34029448,34134034,protein_coding,1,104586,chr6_34029448_34134034
Lrif1,3,106684987,106736577,protein_coding,1,51590,chr3_106684987_106736577
Lrig1,6,94604529,94700158,protein_coding,-1,95629,chr6_94604529_94700158
Lrig2,3,104396418,104511918,protein_coding,-1,115500,chr3_104396418_104511918
Lrig3,10,125966168,126015359,protein_coding,1,49191,chr10_125966168_126015359
Lrit3,3,129787881,129804030,protein_coding,-1,16149,chr3_129787881_129804030
Lrmp,6,145115653,145174934,protein_coding,1,59281,chr6_145115653_145174934
Lrp1,10,127538161,127621148,protein_coding,-1,82987,chr10_127538161_127621148
Lrp10,14,54464137,54471497,protein_coding,1,7360,chr14_54464137_54471497
Lrp11,10,7515564,7625483,protein_coding,1,109919,chr10_7515564_7625483
Lrp12,15,39870589,39943994,protein_coding,-1,73405,chr15_39870589_39943994
Lrp1b,2,40595246,42653624,protein_coding,-1,2058378,chr2_40595246_42653624
Lrp2,2,69424340,69586065,protein_coding,-1,161725,chr2_69424340_69586065
Lrp2bp,8,45999303,46029477,protein_coding,1,30174,chr8_45999303_46029477
Lrp3,7,35200027,35215498,protein_coding,-1,15471,chr7_35200027_35215498
Lrp4,2,91457511,91513779,protein_coding,1,56268,chr2_91457511_91513779
Lrp5,19,3584828,3686564,protein_coding,-1,101736,chr19_3584828_3686564
Lrp6,6,134446476,134566965,protein_coding,-1,120489,chr6_134446476_134566965
Lrp8,4,107801869,107876840,protein_coding,1,74971,chr4_107801869_107876840
Lrp8os2,4,107806033,107823022,antisense,-1,16989,chr4_107806033_107823022
Lrpap1,5,35091501,35105766,protein_coding,-1,14265,chr5_35091501_35105766
Lrpprc,17,84705247,84790789,protein_coding,-1,85542,chr17_84705247_84790789
Lrrc1,9,77430823,77544870,protein_coding,-1,114047,chr9_77430823_77544870
Lrrc10,10,117045341,117046768,protein_coding,1,1427,chr10_117045341_117046768
Lrrc10b,19,10455371,10457473,protein_coding,-1,2102,chr19_10455371_10457473
Lrrc14,15,76710623,76717699,protein_coding,1,7076,chr15_76710623_76717699
Lrrc14b,13,74359578,74364005,protein_coding,-1,4427,chr13_74359578_74364005
Lrrc15,16,30269302,30283256,protein_coding,-1,13954,chr16_30269302_30283256
Lrrc17,5,21543559,21575904,protein_coding,1,32345,chr5_21543559_21575904
Lrrc18,14,32991382,33015291,protein_coding,1,23909,chr14_32991382_33015291
Lrrc19,4,94636653,94650144,protein_coding,-1,13491,chr4_94636653_94650144
Lrrc2,9,110951545,110984066,protein_coding,1,32521,chr9_110951545_110984066
Lrrc20,10,61475801,61582791,protein_coding,1,106990,chr10_61475801_61582791
Lrrc23,6,124769863,124779727,protein_coding,-1,9864,chr6_124769863_124779727
Lrrc24,15,76715276,76722173,protein_coding,-1,6897,chr15_76715276_76722173
Lrrc25,8,70616155,70621483,protein_coding,1,5328,chr8_70616155_70621483
Lrrc26,2,25289915,25291180,protein_coding,1,1265,chr2_25289915_25291180
Lrrc27,7,139191175,139242979,protein_coding,1,51804,chr7_139191175_139242979
Lrrc28,7,67513410,67645268,protein_coding,-1,131858,chr7_67513410_67645268
Lrrc29,8,105312265,105326278,protein_coding,-1,14013,chr8_105312265_105326278
Lrrc3,10,77897575,77902536,protein_coding,-1,4961,chr10_77897575_77902536
Lrrc32,7,98489283,98502181,protein_coding,1,12898,chr7_98489283_98502181
Lrrc34,3,30624267,30647869,protein_coding,-1,23602,chr3_30624267_30647869
Lrrc36,8,105413571,105464086,protein_coding,1,50515,chr8_105413571_105464086
Lrrc37a,11,103450709,103504597,protein_coding,-1,53888,chr11_103450709_103504597
Lrrc38,4,143349757,143371032,protein_coding,1,21275,chr4_143349757_143371032
Lrrc39,3,116562973,116583134,protein_coding,1,20161,chr3_116562973_116583134
Lrrc3b,14,15357515,15438987,protein_coding,-1,81472,chr14_15357515_15438987
Lrrc4,6,28661831,28831747,protein_coding,-1,169916,chr6_28661831_28831747
Lrrc40,3,158036662,158068487,protein_coding,1,31825,chr3_158036662_158068487
Lrrc41,4,116075269,116097043,protein_coding,1,21774,chr4_116075269_116097043
Lrrc42,4,107233514,107253532,protein_coding,-1,20018,chr4_107233514_107253532
Lrrc43,5,123489305,123508205,protein_coding,1,18900,chr5_123489305_123508205
Lrrc45,11,120713925,120721128,protein_coding,1,7203,chr11_120713925_120721128
Lrrc46,11,97034602,97041407,protein_coding,-1,6805,chr11_97034602_97041407
Lrrc47,4,154011731,154021513,protein_coding,1,9782,chr4_154011731_154021513
Lrrc49,9,60568859,60688158,protein_coding,-1,119299,chr9_60568859_60688158
Lrrc4b,7,44429018,44463351,protein_coding,1,34333,chr7_44429018_44463351
Lrrc4c,2,96318169,97631666,protein_coding,1,1313497,chr2_96318169_97631666
Lrrc51,7,101912984,101933895,protein_coding,-1,20911,chr7_101912984_101933895
Lrrc55,2,85162334,85197197,protein_coding,-1,34863,chr2_85162334_85197197
Lrrc56,7,141194157,141210055,protein_coding,1,15898,chr7_141194157_141210055
Lrrc57,2,120604238,120609520,protein_coding,-1,5282,chr2_120604238_120609520
Lrrc58,16,37868389,37888858,protein_coding,1,20469,chr16_37868389_37888858
Lrrc59,11,94629767,94645216,protein_coding,1,15449,chr11_94629767_94645216
Lrrc6,15,66379858,66500910,protein_coding,-1,121052,chr15_66379858_66500910
Lrrc61,6,48554796,48570722,protein_coding,1,15926,chr6_48554796_48570722
Lrrc63,14,75084303,75130881,protein_coding,-1,46578,chr14_75084303_75130881
Lrrc66,5,73606642,73632526,protein_coding,-1,25884,chr5_73606642_73632526
Lrrc69,4,14623620,14796060,protein_coding,-1,172440,chr4_14623620_14796060
Lrrc7,3,158082891,158562221,protein_coding,-1,479330,chr3_158082891_158562221
Lrrc71,3,87736923,87748625,protein_coding,-1,11702,chr3_87736923_87748625
Lrrc72,12,36208345,36253398,protein_coding,-1,45053,chr12_36208345_36253398
Lrrc73,17,46253531,46257315,protein_coding,1,3784,chr17_46253531_46257315
Lrrc74a,12,86734369,86763797,protein_coding,1,29428,chr12_86734369_86763797
Lrrc74b,16,17544465,17561247,protein_coding,-1,16782,chr16_17544465_17561247
Lrrc75a,11,62604884,62648523,protein_coding,-1,43639,chr11_62604884_62648523
Lrrc75b,10,75550123,75560330,protein_coding,-1,10207,chr10_75550123_75560330
Lrrc8a,2,30237715,30263790,protein_coding,1,26075,chr2_30237715_30263790
Lrrc8b,5,105415775,105490074,protein_coding,1,74299,chr5_105415775_105490074
Lrrc8c,5,105519388,105613018,protein_coding,1,93630,chr5_105519388_105613018
Lrrc8d,5,105699969,105832436,protein_coding,1,132467,chr5_105699969_105832436
Lrrc8e,8,4226827,4237470,protein_coding,1,10643,chr8_4226827_4237470
Lrrc9,12,72441866,72530750,protein_coding,1,88884,chr12_72441866_72530750
Lrrcc1,3,14533788,14572658,protein_coding,1,38870,chr3_14533788_14572658
Lrrd1,5,3845173,3866596,protein_coding,1,21423,chr5_3845173_3866596
Lrrfip1,1,90998737,91128944,protein_coding,1,130207,chr1_90998737_91128944
Lrrfip2,9,111117592,111225668,protein_coding,1,108076,chr9_111117592_111225668
Lrriq1,10,103046031,103236322,protein_coding,-1,190291,chr10_103046031_103236322
Lrriq3,3,155093434,155194280,protein_coding,1,100846,chr3_155093434_155194280
Lrriq4,3,30644507,30672431,protein_coding,1,27924,chr3_30644507_30672431
Lrrk1,7,66226912,66388350,protein_coding,-1,161438,chr7_66226912_66388350
Lrrk2,15,91673175,91816120,protein_coding,1,142945,chr15_91673175_91816120
Lrrn1,6,107529768,107570214,protein_coding,1,40446,chr6_107529768_107570214
Lrrn2,1,132880273,132940005,protein_coding,1,59732,chr1_132880273_132940005
Lrrn3,12,41451668,41486431,protein_coding,-1,34763,chr12_41451668_41486431
Lrrn4,2,132868305,132880891,protein_coding,-1,12586,chr2_132868305_132880891
Lrrn4cl,19,8850768,8853909,protein_coding,1,3141,chr19_8850768_8853909
Lrrtm1,6,77242689,77257791,protein_coding,1,15102,chr6_77242689_77257791
Lrrtm2,18,35209003,35215024,protein_coding,-1,6021,chr18_35209003_35215024
Lrrtm3,10,63928472,64090277,protein_coding,-1,161805,chr10_63928472_64090277
Lrrtm4,6,80018877,80810143,protein_coding,1,791266,chr6_80018877_80810143
Lrsam1,2,32925216,32961614,protein_coding,-1,36398,chr2_32925216_32961614
Lrtm1,14,29018208,29033645,protein_coding,1,15437,chr14_29018208_29033645
Lrtm2,6,119315133,119330766,protein_coding,-1,15633,chr6_119315133_119330766
Lrwd1,5,136122772,136136074,protein_coding,-1,13302,chr5_136122772_136136074
Lsamp,16,39984361,42181679,protein_coding,1,2197318,chr16_39984361_42181679
Lsg1,16,30560494,30587592,protein_coding,-1,27098,chr16_30560494_30587592
Lsm1,8,25785288,25803975,protein_coding,1,18687,chr8_25785288_25803975
Lsm10,4,126096623,126098584,protein_coding,1,1961,chr4_126096623_126098584
Lsm11,11,45928269,45944935,protein_coding,-1,16666,chr11_45928269_45944935
Lsm12,11,102162497,102185296,protein_coding,-1,22799,chr11_102162497_102185296
Lsm14a,7,34344646,34393315,protein_coding,-1,48669,chr7_34344646_34393315
Lsm14b,2,180024987,180035465,protein_coding,1,10478,chr2_180024987_180035465
Lsm2,17,34981862,34985891,protein_coding,1,4029,chr17_34981862_34985891
Lsm3,6,91515928,91522625,protein_coding,1,6697,chr6_91515928_91522625
Lsm4,8,70673248,70678752,protein_coding,1,5504,chr8_70673248_70678752
Lsm5,6,56701063,56704710,protein_coding,-1,3647,chr6_56701063_56704710
Lsm6,8,78804865,78821140,protein_coding,-1,16275,chr8_78804865_78821140
Lsm7,10,80852821,80855209,protein_coding,-1,2388,chr10_80852821_80855209
Lsm8,6,18848579,18855751,protein_coding,1,7172,chr6_18848579_18855751
Lsmem1,12,40175493,40199490,protein_coding,-1,23997,chr12_40175493_40199490
Lsmem2,9,107592630,107597075,protein_coding,-1,4445,chr9_107592630_107597075
Lsp1,7,142460809,142494867,protein_coding,1,34058,chr7_142460809_142494867
Lsr,7,30957770,30973464,protein_coding,-1,15694,chr7_30957770_30973464
Lss,10,76531588,76557138,protein_coding,1,25550,chr10_76531588_76557138
Lst1,17,35185095,35188439,protein_coding,-1,3344,chr17_35185095_35188439
Lta,17,35203165,35205351,protein_coding,-1,2186,chr17_35203165_35205351
Lta4h,10,93453411,93484875,protein_coding,1,31464,chr10_93453411_93484875
Ltb,17,35194439,35196320,protein_coding,1,1881,chr17_35194439_35196320
Ltb4r1,14,55765962,55768494,protein_coding,1,2532,chr14_55765962_55768494
Ltb4r2,14,55761428,55765138,protein_coding,1,3710,chr14_55761428_55765138
Ltbp1,17,75005568,75392512,protein_coding,1,386944,chr17_75005568_75392512
Ltbp2,12,84783212,84876532,protein_coding,-1,93320,chr12_84783212_84876532
Ltbp3,19,5740904,5758532,protein_coding,1,17628,chr19_5740904_5758532
Ltbp4,7,27305136,27337692,protein_coding,-1,32556,chr7_27305136_27337692
Ltbr,6,125306571,125313885,protein_coding,-1,7314,chr6_125306571_125313885
Ltc4s,11,50236461,50238616,protein_coding,-1,2155,chr11_50236461_50238616
Ltk,2,119751320,119760431,protein_coding,-1,9111,chr2_119751320_119760431
Ltn1,16,87376651,87432612,protein_coding,-1,55961,chr16_87376651_87432612
Ltv1,10,13178140,13193168,protein_coding,-1,15028,chr10_13178140_13193168
Luc7l,17,26252896,26285504,protein_coding,1,32608,chr17_26252896_26285504
Luc7l2,6,38551334,38609470,protein_coding,1,58136,chr6_38551334_38609470
Luc7l3,11,94287890,94321988,protein_coding,-1,34098,chr11_94287890_94321988
Lurap1,4,116132406,116151338,protein_coding,-1,18932,chr4_116132406_116151338
Lurap1l,4,80910646,80955628,protein_coding,1,44982,chr4_80910646_80955628
Luzp1,4,136469761,136554780,protein_coding,1,85019,chr4_136469761_136554780
Luzp2,7,54835498,55268885,protein_coding,1,433387,chr7_54835498_55268885
Luzp4,X,148857640,148924139,protein_coding,1,66499,chrX_148857640_148924139
Lxn,3,67457998,67463926,protein_coding,-1,5928,chr3_67457998_67463926
Ly6a,15,74994877,74998031,protein_coding,-1,3154,chr15_74994877_74998031
Ly6c1,15,75044018,75048830,protein_coding,-1,4812,chr15_75044018_75048830
Ly6c2,15,75108158,75111970,protein_coding,-1,3812,chr15_75108158_75111970
Ly6d,15,74762056,74763620,protein_coding,-1,1564,chr15_74762056_74763620
Ly6e,15,74955051,74959905,protein_coding,1,4854,chr15_74955051_74959905
Ly6e-ps1,12,72620775,72621141,processed_pseudogene,1,366,chr12_72620775_72621141
Ly6g,15,75155240,75159126,protein_coding,1,3886,chr15_75155240_75159126
Ly6g5b,17,35113948,35115428,protein_coding,-1,1480,chr17_35113948_35115428
Ly6g6d,17,35071443,35078065,protein_coding,-1,6622,chr17_35071443_35078065
Ly6g6e,17,35076902,35078804,protein_coding,1,1902,chr17_35076902_35078804
Ly6g6f,17,35080480,35085610,protein_coding,-1,5130,chr17_35080480_35085610
Ly6h,15,75551268,75567255,protein_coding,-1,15987,chr15_75551268_75567255
Ly6i,15,74979534,74983430,protein_coding,-1,3896,chr15_74979534_74983430
Ly6k,15,74796874,74799986,protein_coding,-1,3112,chr15_74796874_74799986
Ly75,2,60292103,60383303,protein_coding,-1,91200,chr2_60292103_60383303
Ly86,13,37345208,37419036,protein_coding,1,73828,chr13_37345208_37419036
Ly9,1,171588624,171607410,protein_coding,-1,18786,chr1_171588624_171607410
Ly96,1,16688051,16709611,protein_coding,1,21560,chr1_16688051_16709611
Lyar,5,38220470,38234306,protein_coding,1,13836,chr5_38220470_38234306
Lyl1,8,84701449,84704940,protein_coding,1,3491,chr8_84701449_84704940
Lyn,4,3678115,3813122,protein_coding,1,135007,chr4_3678115_3813122
Lynx1,15,74747852,74753046,protein_coding,-1,5194,chr15_74747852_74753046
Lypd1,1,125867622,125913101,protein_coding,-1,45479,chr1_125867622_125913101
Lypd6,2,50066429,50193569,protein_coding,1,127140,chr2_50066429_50193569
Lypd6b,2,49787688,49948849,protein_coding,1,161161,chr2_49787688_49948849
Lypla1,1,4807788,4848410,protein_coding,1,40622,chr1_4807788_4848410
Lypla2,4,135968224,135972626,protein_coding,-1,4402,chr4_135968224_135972626
Lyplal1,1,186087731,186117310,protein_coding,-1,29579,chr1_186087731_186117310
Lyrm1,7,119895861,119956963,protein_coding,1,61102,chr7_119895861_119956963
Lyrm2,4,32800253,32801559,protein_coding,1,1306,chr4_32800253_32801559
Lyrm4,13,35978395,36117526,protein_coding,-1,139131,chr13_35978395_36117526
Lyrm7,11,54826866,54860916,protein_coding,-1,34050,chr11_54826866_54860916
Lyrm9,11,78826584,78846870,protein_coding,1,20286,chr11_78826584_78846870
Lysmd1,3,95134088,95139518,protein_coding,1,5430,chr3_95134088_95139518
Lysmd2,9,75625741,75637771,protein_coding,1,12030,chr9_75625741_75637771
Lysmd3,13,81657663,81672871,protein_coding,1,15208,chr13_81657663_81672871
Lysmd4,7,67222544,67307330,protein_coding,1,84786,chr7_67222544_67307330
Lyst,13,13590397,13778803,protein_coding,1,188406,chr13_13590397_13778803
Lyve1,7,110850607,110863239,protein_coding,-1,12632,chr7_110850607_110863239
Lyz1,10,117287797,117292868,protein_coding,-1,5071,chr10_117287797_117292868
Lyz2,10,117277331,117282321,protein_coding,-1,4990,chr10_117277331_117282321
Lyzl4,9,121577843,121642096,protein_coding,-1,64253,chr9_121577843_121642096
Lyzl4os,9,121586997,121614255,antisense,1,27258,chr9_121586997_121614255
Lyzl6,11,103631070,103638890,protein_coding,-1,7820,chr11_103631070_103638890
Lzic,4,149485229,149496668,protein_coding,1,11439,chr4_149485229_149496668
Lztfl1,9,123694416,123717697,protein_coding,-1,23281,chr9_123694416_123717697
Lztr1,16,17508688,17526333,protein_coding,1,17645,chr16_17508688_17526333
Lzts1,8,69132669,69184225,protein_coding,-1,51556,chr8_69132669_69184225
Lzts2,19,45014414,45027111,protein_coding,1,12697,chr19_45014414_45027111
Lzts3,2,130632839,130642803,protein_coding,-1,9964,chr2_130632839_130642803
M1ap,6,82946902,83030309,protein_coding,1,83407,chr6_82946902_83030309
M6pr,6,122308720,122317680,protein_coding,1,8960,chr6_122308720_122317680
M6pr-ps,3,99500550,99501379,processed_pseudogene,1,829,chr3_99500550_99501379
Maats1,16,38297754,38342143,protein_coding,-1,44389,chr16_38297754_38342143
Mab21l1,3,55782510,55785001,protein_coding,1,2491,chr3_55782510_55785001
Mab21l2,3,86545581,86548629,protein_coding,-1,3048,chr3_86545581_86548629
Mab21l3,3,101813076,101848959,protein_coding,-1,35883,chr3_101813076_101848959
Macc1,12,119314270,119469987,protein_coding,1,155717,chr12_119314270_119469987
Macf1,4,123349633,123684360,protein_coding,-1,334727,chr4_123349633_123684360
Macrod1,19,7056810,7198057,protein_coding,1,141247,chr19_7056810_7198057
Macrod2,2,140395309,142392966,protein_coding,1,1997657,chr2_140395309_142392966
Mad1l1,5,140008689,140321552,protein_coding,-1,312863,chr5_140008689_140321552
Mad2l1,6,66535390,66547220,protein_coding,1,11830,chr6_66535390_66547220
Mad2l1bp,17,46147387,46153553,protein_coding,-1,6166,chr17_46147387_46153553
Mad2l2,4,148130384,148145699,protein_coding,1,15315,chr4_148130384_148145699
Madcam1,10,79664559,79668537,protein_coding,1,3978,chr10_79664559_79668537
Madd,2,91137360,91183837,protein_coding,-1,46477,chr2_91137360_91183837
Maea,5,33335509,33373296,protein_coding,1,37787,chr5_33335509_33373296
Mael,1,166201201,166238747,protein_coding,-1,37546,chr1_166201201_166238747
Maf,8,115682942,115707794,protein_coding,-1,24852,chr8_115682942_115707794
Maf1,15,76351294,76354380,protein_coding,1,3086,chr15_76351294_76354380
Mafa,15,75745490,75748228,protein_coding,-1,2738,chr15_75745490_75748228
Mafb,2,160363703,160367065,protein_coding,-1,3362,chr2_160363703_160367065
Maff,15,79346621,79359076,protein_coding,1,12455,chr15_79346621_79359076
Mafg,11,120625117,120633600,protein_coding,-1,8483,chr11_120625117_120633600
Mafk,5,139791513,139802653,protein_coding,1,11140,chr5_139791513_139802653
Mag,7,30899176,30914873,protein_coding,-1,15697,chr7_30899176_30914873
Mageb16,X,79623231,79671435,protein_coding,-1,48204,chrX_79623231_79671435
Mageb16-ps1,X,144555211,144556337,processed_pseudogene,-1,1126,chrX_144555211_144556337
Mageb16-ps2,6,60769967,60771059,processed_pseudogene,-1,1092,chr6_60769967_60771059
Mageb18,X,92118879,92599572,protein_coding,-1,480693,chrX_92118879_92599572
Mageb3,2,121953752,121956092,protein_coding,-1,2340,chr2_121953752_121956092
Maged1,X,94535474,94542143,protein_coding,-1,6669,chrX_94535474_94542143
Maged2,X,150806370,150814345,protein_coding,-1,7975,chrX_150806370_150814345
Magee1,X,105120378,105123927,protein_coding,1,3549,chrX_105120378_105123927
Magee2,X,104854952,104857267,protein_coding,-1,2315,chrX_104854952_104857267
Magef1,16,21331902,21333356,transcribed_processed_pseudogene,-1,1454,chr16_21331902_21333356
Mageh1,X,153036166,153037575,protein_coding,-1,1409,chrX_153036166_153037575
Magel2,7,62377010,62381640,protein_coding,1,4630,chr7_62377010_62381640
Magi1,6,93675455,94283917,protein_coding,-1,608462,chr6_93675455_94283917
Magi2,5,19227036,20704792,protein_coding,1,1477756,chr5_19227036_20704792
Magi3,3,104013259,104220374,protein_coding,-1,207115,chr3_104013259_104220374
Magix,X,7673164,7681251,protein_coding,-1,8087,chrX_7673164_7681251
Magoh,4,107879755,107887424,protein_coding,1,7669,chr4_107879755_107887424
Magohb,6,131284388,131293244,protein_coding,-1,8856,chr6_131284388_131293244
Magt1,X,105968084,106011906,protein_coding,-1,43822,chrX_105968084_106011906
Mak,13,41025008,41079706,protein_coding,-1,54698,chr13_41025008_41079706
Mak16,8,31159463,31168764,protein_coding,-1,9301,chr8_31159463_31168764
Mal,2,127633226,127656695,protein_coding,-1,23469,chr2_127633226_127656695
Mal2,15,54571192,54602847,protein_coding,1,31655,chr15_54571192_54602847
Malat1,19,5795690,5802672,lincRNA,-1,6982,chr19_5795690_5802672
Malsu1,6,49073795,49086751,protein_coding,1,12956,chr6_49073795_49086751
Malt1,18,65430938,65479067,protein_coding,1,48129,chr18_65430938_65479067
Mamdc2,19,23302609,23448442,protein_coding,-1,145833,chr19_23302609_23448442
Mamdc4,2,25563115,25574845,protein_coding,-1,11730,chr2_25563115_25574845
Maml1,11,50255634,50292311,protein_coding,-1,36677,chr11_50255634_50292311
Maml2,9,13297957,13709388,protein_coding,1,411431,chr9_13297957_13709388
Maml3,3,51685907,52105076,protein_coding,-1,419169,chr3_51685907_52105076
Mamld1,X,71050240,71156056,protein_coding,1,105816,chrX_71050240_71156056
Mamstr,7,45639977,45646521,protein_coding,1,6544,chr7_45639977_45646521
Man1a,10,53904785,54076609,protein_coding,-1,171824,chr10_53904785_54076609
Man1a2,3,100562208,100685503,protein_coding,-1,123295,chr3_100562208_100685503
Man1b1,2,25332338,25352212,protein_coding,1,19874,chr2_25332338_25352212
Man1c1,4,134561690,134704290,protein_coding,-1,142600,chr4_134561690_134704290
Man2a1,17,64600736,64755110,protein_coding,1,154374,chr17_64600736_64755110
Man2a2,7,80349097,80371375,protein_coding,-1,22278,chr7_80349097_80371375
Man2b1,8,85083270,85098282,protein_coding,1,15012,chr8_85083270_85098282
Man2b2,5,36806921,36830653,protein_coding,-1,23732,chr5_36806921_36830653
Man2c1,9,57130690,57142722,protein_coding,1,12032,chr9_57130690_57142722
Man2c1os,9,57099950,57131290,antisense,-1,31340,chr9_57099950_57131290
Manba,3,135485611,135571404,protein_coding,1,85793,chr3_135485611_135571404
Manbal,2,157367594,157396763,protein_coding,1,29169,chr2_157367594_157396763
Manea,4,26324506,26346891,protein_coding,-1,22385,chr4_26324506_26346891
Maneal,4,124855239,124862171,protein_coding,-1,6932,chr4_124855239_124862171
Manf,9,106838312,106891979,protein_coding,-1,53667,chr9_106838312_106891979
Mannr,3,29891014,29924191,lincRNA,1,33177,chr3_29891014_29924191
Mansc1,6,134609207,134632488,protein_coding,-1,23281,chr6_134609207_134632488
Mansc4,6,147075060,147087032,protein_coding,-1,11972,chr6_147075060_147087032
Maoa,X,16619698,16687818,protein_coding,1,68120,chrX_16619698_16687818
Maob,X,16709282,16817366,protein_coding,-1,108084,chrX_16709282_16817366
Map10,8,125669818,125673359,protein_coding,1,3541,chr8_125669818_125673359
Map1a,2,121289600,121310832,protein_coding,1,21232,chr2_121289600_121310832
Map1b,13,99421446,99516540,protein_coding,-1,95094,chr13_99421446_99516540
Map1lc3a,2,155276297,155278073,protein_coding,1,1776,chr2_155276297_155278073
Map1lc3b,8,121590361,121598760,protein_coding,1,8399,chr8_121590361_121598760
Map1s,8,70905932,70917529,protein_coding,1,11597,chr8_70905932_70917529
Map2,1,66175273,66442583,protein_coding,1,267310,chr1_66175273_66442583
Map2k1,9,64185770,64253631,protein_coding,-1,67861,chr9_64185770_64253631
Map2k2,10,81105915,81133975,protein_coding,1,28060,chr10_81105915_81133975
Map2k3,11,60932033,60952811,protein_coding,1,20778,chr11_60932033_60952811
Map2k3os,11,60920917,60931867,antisense,-1,10950,chr11_60920917_60931867
Map2k4,11,65688243,65788297,protein_coding,-1,100054,chr11_65688243_65788297
Map2k5,9,63163768,63377902,protein_coding,-1,214134,chr9_63163768_63377902
Map2k6,11,110399122,110525522,protein_coding,1,126400,chr11_110399122_110525522
Map2k7,8,4238740,4247897,protein_coding,1,9157,chr8_4238740_4247897
Map3k1,13,111746428,111808993,protein_coding,-1,62565,chr13_111746428_111808993
Map3k10,7,27656375,27674598,protein_coding,-1,18223,chr7_27656375_27674598
Map3k11,19,5688742,5702865,protein_coding,1,14123,chr19_5688742_5702865
Map3k12,15,102497646,102517064,protein_coding,-1,19418,chr15_102497646_102517064
Map3k13,16,21794346,21933439,protein_coding,1,139093,chr16_21794346_21933439
Map3k14,11,103219762,103267472,protein_coding,-1,47710,chr11_103219762_103267472
Map3k15,X,159988433,160123351,protein_coding,1,134918,chrX_159988433_160123351
Map3k19,1,127814791,127855031,protein_coding,-1,40240,chr1_127814791_127855031
Map3k2,18,32163089,32236751,protein_coding,1,73662,chr18_32163089_32236751
Map3k3,11,106084613,106155446,protein_coding,1,70833,chr11_106084613_106155446
Map3k4,17,12227621,12318796,protein_coding,-1,91175,chr17_12227621_12318796
Map3k5,10,19934472,20142753,protein_coding,1,208281,chr10_19934472_20142753
Map3k6,4,133240818,133252929,protein_coding,1,12111,chr4_133240818_133252929
Map3k7,4,31964097,32023467,protein_coding,1,59370,chr4_31964097_32023467
Map3k7cl,16,87553330,87595336,protein_coding,1,42006,chr16_87553330_87595336
Map3k8,18,4331327,4353015,protein_coding,-1,21688,chr18_4331327_4353015
Map3k9,12,81721010,81781175,protein_coding,-1,60165,chr12_81721010_81781175
Map4,9,109931460,110083955,protein_coding,1,152495,chr9_109931460_110083955
Map4k1,7,28982050,29003279,protein_coding,1,21229,chr7_28982050_29003279
Map4k2,19,6341135,6355615,protein_coding,1,14480,chr19_6341135_6355615
Map4k3,17,80580512,80728485,protein_coding,-1,147973,chr17_80580512_80728485
Map4k4,1,39900913,40026310,protein_coding,1,125397,chr1_39900913_40026310
Map4k5,12,69803750,69893200,protein_coding,-1,89450,chr12_69803750_69893200
Map6,7,99267447,99337137,protein_coding,1,69690,chr7_99267447_99337137
Map6d1,16,20233303,20241358,protein_coding,-1,8055,chr16_20233303_20241358
Map7,10,20148471,20281590,protein_coding,1,133119,chr10_20148471_20281590
Map7d1,4,126232167,126256343,protein_coding,-1,24176,chr4_126232167_126256343
Map7d2,X,159414572,159498757,protein_coding,1,84185,chrX_159414572_159498757
Map9,3,82358044,82395268,protein_coding,1,37224,chr3_82358044_82395268
Mapk1,16,16983382,17047453,protein_coding,1,64071,chr16_16983382_17047453
Mapk10,5,102907948,103211334,protein_coding,-1,303386,chr5_102907948_103211334
Mapk11,15,89142486,89149628,protein_coding,-1,7142,chr15_89142486_89149628
Mapk12,15,89130584,89140703,protein_coding,-1,10119,chr15_89130584_89140703
Mapk13,17,28769297,28780233,protein_coding,1,10936,chr17_28769297_28780233
Mapk14,17,28691329,28748406,protein_coding,1,57077,chr17_28691329_28748406
Mapk15,15,75993769,75999154,protein_coding,1,5385,chr15_75993769_75999154
Mapk1ip1,7,138835823,138846273,protein_coding,-1,10450,chr7_138835823_138846273
Mapk1ip1l,14,47298266,47323204,protein_coding,1,24938,chr14_47298266_47323204
Mapk3,7,126759601,126765819,protein_coding,1,6218,chr7_126759601_126765819
Mapk4,18,73928486,74065359,protein_coding,-1,136873,chr18_73928486_74065359
Mapk6,9,75369062,75410005,protein_coding,-1,40943,chr9_75369062_75410005
Mapk7,11,61488812,61494406,protein_coding,-1,5594,chr11_61488812_61494406
Mapk8,14,33377898,33447158,protein_coding,-1,69260,chr14_33377898_33447158
Mapk8ip1,2,92383676,92401263,protein_coding,-1,17587,chr2_92383676_92401263
Mapk8ip2,15,89453913,89464468,protein_coding,1,10555,chr15_89453913_89464468
Mapk8ip3,17,24892153,24936977,protein_coding,-1,44824,chr17_24892153_24936977
Mapk9,11,49846751,49886421,protein_coding,1,39670,chr11_49846751_49886421
Mapkap1,2,34406771,34624950,protein_coding,1,218179,chr2_34406771_34624950
Mapkapk2,1,131053700,131097826,protein_coding,-1,44126,chr1_131053700_131097826
Mapkapk3,9,107254927,107289877,protein_coding,-1,34950,chr9_107254927_107289877
Mapkapk5,5,121525038,121545905,protein_coding,-1,20867,chr5_121525038_121545905
Mapkbp1,2,119972699,120027408,protein_coding,1,54709,chr2_119972699_120027408
Mapre1,2,153741274,153773310,protein_coding,1,32036,chr2_153741274_153773310
Mapre2,18,23752333,23893861,protein_coding,1,141528,chr18_23752333_23893861
Mapre3,5,30814641,30866106,protein_coding,1,51465,chr5_30814641_30866106
Mapt,11,104231390,104332090,protein_coding,1,100700,chr11_104231390_104332090
Marcks,10,37133375,37138920,protein_coding,-1,5545,chr10_37133375_37138920
Marcksl1,4,129513581,129515985,protein_coding,1,2404,chr4_129513581_129515985
Marcksl1-ps4,13,4248735,4249025,processed_pseudogene,1,290,chr13_4248735_4249025
Marf1,16,14109173,14163351,protein_coding,-1,54178,chr16_14109173_14163351
Mark1,1,184896789,184999570,protein_coding,-1,102781,chr1_184896789_184999570
Mark2,19,7275396,7341860,protein_coding,-1,66464,chr19_7275396_7341860
Mark3,12,111574523,111656221,protein_coding,1,81698,chr12_111574523_111656221
Mark4,7,19424775,19458821,protein_coding,-1,34046,chr7_19424775_19458821
Mars2,1,55237177,55248470,protein_coding,1,11293,chr1_55237177_55248470
Marveld1,19,42147400,42151703,protein_coding,1,4303,chr19_42147400_42151703
Marveld2,13,100595957,100616971,protein_coding,-1,21014,chr13_100595957_100616971
Marveld3,8,109947914,109962203,protein_coding,-1,14289,chr8_109947914_109962203
Mas1,17,12841079,12868143,protein_coding,-1,27064,chr17_12841079_12868143
Masp1,16,23449417,23520815,protein_coding,-1,71398,chr16_23449417_23520815
Masp2,4,148602554,148615499,protein_coding,1,12945,chr4_148602554_148615499
Mast1,8,84911903,84937359,protein_coding,-1,25456,chr8_84911903_84937359
Mast2,4,116306762,116464183,protein_coding,-1,157421,chr4_116306762_116464183
Mast3,8,70778112,70805054,protein_coding,-1,26942,chr8_70778112_70805054
Mast4,13,102732486,103334497,protein_coding,-1,602011,chr13_102732486_103334497
Mastl,2,23115606,23156024,protein_coding,-1,40418,chr2_23115606_23156024
Mat1a,14,41105035,41124412,protein_coding,1,19377,chr14_41105035_41124412
Mat2a,6,72432798,72439558,protein_coding,-1,6760,chr6_72432798_72439558
Mat2b,11,40679314,40695203,protein_coding,-1,15889,chr11_40679314_40695203
Matk,10,81252935,81263365,protein_coding,1,10430,chr10_81252935_81263365
Matn2,15,34306677,34436273,protein_coding,1,129596,chr15_34306677_34436273
Matn3,12,8947929,8972028,protein_coding,1,24099,chr12_8947929_8972028
Matn4,2,164389393,164405160,protein_coding,-1,15767,chr2_164389393_164405160
Matr3,18,35562138,35593835,protein_coding,1,31697,chr18_35562138_35593835
Matr3-ps2,8,104844378,104846373,processed_pseudogene,-1,1995,chr8_104844378_104846373
Mau2,8,70016123,70042734,protein_coding,-1,26611,chr8_70016123_70042734
Mavs,2,131234063,131248025,protein_coding,1,13962,chr2_131234063_131248025
Max,12,76937269,76962201,protein_coding,-1,24932,chr12_76937269_76962201
Maz,7,127022130,127027037,protein_coding,-1,4907,chr7_127022130_127027037
Mb,15,77015487,77050670,protein_coding,-1,35183,chr15_77015487_77050670
Mb21d2,16,28826176,28929673,protein_coding,-1,103497,chr16_28826176_28929673
Mbd1,18,74267605,74282732,protein_coding,1,15127,chr18_74267605_74282732
Mbd2,18,70568189,70626131,protein_coding,1,57942,chr18_70568189_70626131
Mbd3,10,80392539,80399550,protein_coding,-1,7011,chr10_80392539_80399550
Mbd3l2,9,18430654,18446316,protein_coding,1,15662,chr9_18430654_18446316
Mbd4,6,115840697,115853371,protein_coding,-1,12674,chr6_115840697_115853371
Mbd5,2,48949508,49325405,protein_coding,1,375897,chr2_48949508_49325405
Mbd6,10,127281956,127289018,protein_coding,-1,7062,chr10_127281956_127289018
Mbip,12,56328303,56345894,protein_coding,-1,17591,chr12_56328303_56345894
Mbl2,19,30232942,30239687,protein_coding,1,6745,chr19_30232942_30239687
Mblac1,5,138194314,138195621,protein_coding,1,1307,chr5_138194314_138195621
Mblac2,13,81711341,81753275,protein_coding,1,41934,chr13_81711341_81753275
Mbnl1,3,60472830,60629750,protein_coding,1,156920,chr3_60472830_60629750
Mbnl2,14,120275669,120431697,protein_coding,1,156028,chr14_120275669_120431697
Mbnl3,X,51117269,51206532,protein_coding,-1,89263,chrX_51117269_51206532
Mboat1,13,30136489,30246717,protein_coding,1,110228,chr13_30136489_30246717
Mboat2,12,24830879,24964397,protein_coding,1,133518,chr12_24830879_24964397
Mboat4,8,34115030,34125182,protein_coding,1,10152,chr8_34115030_34125182
Mboat7,7,3677789,3693523,protein_coding,-1,15734,chr7_3677789_3693523
Mbp,18,82475146,82585637,protein_coding,1,110491,chr18_82475146_82585637
Mbtd1,11,93885852,93946985,protein_coding,1,61133,chr11_93885852_93946985
Mbtps1,8,119508156,119558735,protein_coding,-1,50579,chr8_119508156_119558735
Mbtps2,X,157535371,157598715,protein_coding,-1,63344,chrX_157535371_157598715
Mc1r,8,123407107,123410744,protein_coding,1,3637,chr8_123407107_123410744
Mc3r,2,172248492,172251114,protein_coding,1,2622,chr2_172248492_172251114
Mc4r,18,66857704,66860506,protein_coding,-1,2802,chr18_66857704_66860506
Mc5r,18,68337596,68342446,protein_coding,1,4850,chr18_68337596_68342446
Mcam,9,44134469,44142727,protein_coding,1,8258,chr9_44134469_44142727
Mcat,15,83546797,83563787,protein_coding,-1,16990,chr15_83546797_83563787
Mcc,18,44425060,44812182,protein_coding,-1,387122,chr18_44425060_44812182
Mccc1,3,35959312,36000678,protein_coding,-1,41366,chr3_35959312_36000678
Mccc1os,3,35999833,36025106,antisense,1,25273,chr3_35999833_36025106
Mccc2,13,99948530,100015639,protein_coding,-1,67109,chr13_99948530_100015639
Mcee,7,64392607,64412125,protein_coding,1,19518,chr7_64392607_64412125
Mcemp1,8,3665754,3669259,protein_coding,1,3505,chr8_3665754_3669259
Mcf2,X,60055956,60179089,protein_coding,-1,123133,chrX_60055956_60179089
Mcf2l,8,12873806,13020905,protein_coding,1,147099,chr8_12873806_13020905
Mcfd2,17,87254443,87265935,protein_coding,-1,11492,chr17_87254443_87265935
Mchr1,15,81235499,81238964,protein_coding,1,3465,chr15_81235499_81238964
Mcidas,13,112993845,113000394,protein_coding,1,6549,chr13_112993845_113000394
Mcl1,3,95658788,95663176,protein_coding,1,4388,chr3_95658788_95663176
Mcm10,2,4989714,5012791,protein_coding,-1,23077,chr2_4989714_5012791
Mcm2,6,88883474,88898780,protein_coding,-1,15306,chr6_88883474_88898780
Mcm3,1,20802968,20820312,protein_coding,-1,17344,chr1_20802968_20820312
Mcm3ap,10,76468927,76515857,protein_coding,1,46930,chr10_76468927_76515857
Mcm4,16,15623897,15637400,protein_coding,-1,13503,chr16_15623897_15637400
Mcm5,8,75109569,75128439,protein_coding,1,18870,chr8_75109569_75128439
Mcm6,1,128331590,128359664,protein_coding,-1,28074,chr1_128331590_128359664
Mcm7,5,138164583,138172422,protein_coding,-1,7839,chr5_138164583_138172422
Mcm8,2,132816141,132844197,protein_coding,1,28056,chr2_132816141_132844197
Mcm9,10,53536315,53630439,protein_coding,-1,94124,chr10_53536315_53630439
Mcmbp,7,128696441,128740495,protein_coding,-1,44054,chr7_128696441_128740495
Mcmdc2,1,9908638,9942085,protein_coding,1,33447,chr1_9908638_9942085
Mcoln1,8,3500457,3515232,protein_coding,1,14775,chr8_3500457_3515232
Mcph1,8,18595131,18803189,protein_coding,1,208058,chr8_18595131_18803189
Mcrs1,15,99242817,99251961,protein_coding,-1,9144,chr15_99242817_99251961
Mctp1,13,76384535,77031810,protein_coding,1,647275,chr13_76384535_77031810
Mctp2,7,72077830,72306608,protein_coding,-1,228778,chr7_72077830_72306608
Mcts1,X,38600578,38613426,protein_coding,1,12848,chrX_38600578_38613426
Mcts2,2,152687035,152687946,protein_coding,1,911,chr2_152687035_152687946
Mcu,10,59446984,59616692,protein_coding,-1,169708,chr10_59446984_59616692
Mcur1,13,43538393,43560191,protein_coding,-1,21798,chr13_43538393_43560191
Mdc1,17,35841515,35859670,protein_coding,1,18155,chr17_35841515_35859670
Mdfic,6,15720661,15802169,protein_coding,1,81508,chr6_15720661_15802169
Mdga1,17,29827949,29970087,protein_coding,-1,142138,chr17_29827949_29970087
Mdga2,12,66466060,67222549,protein_coding,-1,756489,chr12_66466060_67222549
Mdh1,11,21556692,21572367,protein_coding,-1,15675,chr11_21556692_21572367
Mdh1b,1,63698819,63730318,protein_coding,-1,31499,chr1_63698819_63730318
Mdh2,5,135778480,135790398,protein_coding,1,11918,chr5_135778480_135790398
Mdk,2,91929805,91932297,protein_coding,-1,2492,chr2_91929805_91932297
Mdk-ps1,11,102545702,102546022,processed_pseudogene,1,320,chr11_102545702_102546022
Mdm1,10,118141811,118168997,protein_coding,1,27186,chr10_118141811_118168997
Mdm2,10,117688875,117710758,protein_coding,-1,21883,chr10_117688875_117710758
Mdm4,1,132959484,133030561,protein_coding,-1,71077,chr1_132959484_133030561
Mdm4-ps,X,128261411,128267924,processed_pseudogene,1,6513,chrX_128261411_128267924
Mdn1,4,32657119,32775217,protein_coding,1,118098,chr4_32657119_32775217
Mdp1,14,55657879,55660508,protein_coding,-1,2629,chr14_55657879_55660508
Me1,9,86581371,86695953,protein_coding,-1,114582,chr9_86581371_86695953
Me2,18,73769903,73815449,protein_coding,-1,45546,chr18_73769903_73815449
Me3,7,89632392,89854359,protein_coding,1,221967,chr7_89632392_89854359
Mea1,17,46678793,46683111,protein_coding,1,4318,chr17_46678793_46683111
Meaf6,4,125085134,125113238,protein_coding,1,28104,chr4_125085134_125113238
Mecom,3,29951296,30548008,protein_coding,-1,596712,chr3_29951296_30548008
Mecp2,X,74026592,74135363,protein_coding,-1,108771,chrX_74026592_74135363
Mecr,4,131843470,131867786,protein_coding,1,24316,chr4_131843470_131867786
Med1,11,98152154,98193293,protein_coding,-1,41139,chr11_98152154_98193293
Med10,13,69802395,69816104,protein_coding,1,13709,chr13_69802395_69816104
Med11,11,70451919,70453727,protein_coding,1,1808,chr11_70451919_70453727
Med12,X,101274030,101297465,protein_coding,1,23435,chrX_101274030_101297465
Med12l,3,59005825,59318682,protein_coding,1,312857,chr3_59005825_59318682
Med13,11,86267033,86357602,protein_coding,-1,90569,chr11_86267033_86357602
Med13l,5,118560679,118765438,protein_coding,1,204759,chr5_118560679_118765438
Med14,X,12675369,12762073,protein_coding,-1,86704,chrX_12675369_12762073
Med15,16,17651208,17732891,protein_coding,-1,81683,chr16_17651208_17732891
Med16,10,79894708,79908923,protein_coding,-1,14215,chr10_79894708_79908923
Med17,9,15260351,15279931,protein_coding,-1,19580,chr9_15260351_15279931
Med18,4,132458731,132463921,protein_coding,-1,5190,chr4_132458731_132463921
Med19,2,84678402,84688215,protein_coding,1,9813,chr2_84678402_84688215
Med20,17,47611582,47624418,protein_coding,1,12836,chr17_47611582_47624418
Med21,6,146642547,146650732,protein_coding,1,8185,chr6_146642547_146650732
Med22,2,26905262,26910677,protein_coding,-1,5415,chr2_26905262_26910677
Med23,10,24869986,24913681,protein_coding,1,43695,chr10_24869986_24913681
Med24,11,98704591,98729435,protein_coding,-1,24844,chr11_98704591_98729435
Med25,7,44876765,44892712,protein_coding,-1,15947,chr7_44876765_44892712
Med26,8,72494561,72548270,protein_coding,-1,53709,chr8_72494561_72548270
Med27,2,29346819,29524793,protein_coding,1,177974,chr2_29346819_29524793
Med28,5,45520229,45529276,protein_coding,1,9047,chr5_45520229_45529276
Med29,7,28386146,28392708,protein_coding,-1,6562,chr7_28386146_28392708
Med30,15,52712408,52730564,protein_coding,1,18156,chr15_52712408_52730564
Med31,11,72211724,72215592,protein_coding,-1,3868,chr11_72211724_72215592
Med4,14,73510025,73518849,protein_coding,1,8824,chr14_73510025_73518849
Med6,12,81573557,81595008,protein_coding,-1,21451,chr12_81573557_81595008
Med7,11,46436925,46442721,protein_coding,1,5796,chr11_46436925_46442721
Med8,4,118409337,118415782,protein_coding,1,6445,chr4_118409337_118415782
Med9,11,59948206,59962205,protein_coding,1,13999,chr11_59948206_59962205
Med9os,11,59946889,59948142,antisense,-1,1253,chr11_59946889_59948142
Medag,5,149411749,149431723,protein_coding,1,19974,chr5_149411749_149431723
Mef2a,7,67231163,67372858,protein_coding,-1,141695,chr7_67231163_67372858
Mef2b,8,70139711,70167488,protein_coding,1,27777,chr8_70139711_70167488
Mef2c,13,83504034,83667080,protein_coding,1,163046,chr13_83504034_83667080
Mef2d,3,88142372,88172086,protein_coding,1,29714,chr3_88142372_88172086
Meg3,12,109541001,109571726,lincRNA,1,30725,chr12_109541001_109571726
Megf10,18,57133090,57297467,protein_coding,1,164377,chr18_57133090_57297467
Megf11,9,64385626,64709205,protein_coding,1,323579,chr9_64385626_64709205
Megf6,4,154170730,154275713,protein_coding,1,104983,chr4_154170730_154275713
Megf8,7,25317164,25365917,protein_coding,1,48753,chr7_25317164_25365917
Megf9,4,70427065,70534995,protein_coding,-1,107930,chr4_70427065_70534995
Mei1,15,82069996,82126814,protein_coding,1,56818,chr15_82069996_82126814
Mei4,9,81863670,82206007,protein_coding,1,342337,chr9_81863670_82206007
Meig1,2,3409043,3422648,protein_coding,-1,13605,chr2_3409043_3422648
Meikin,11,54370652,54426790,protein_coding,1,56138,chr11_54370652_54426790
Meiob,17,24804289,24839788,protein_coding,1,35499,chr17_24804289_24839788
Meis1,11,18879817,19018985,protein_coding,-1,139168,chr11_18879817_19018985
Meis2,2,115863064,116065839,protein_coding,-1,202775,chr2_115863064_116065839
Meis3,7,16175090,16186504,protein_coding,1,11414,chr7_16175090_16186504
Melk,4,44300876,44364675,protein_coding,1,63799,chr4_44300876_44364675
Memo1,17,74199036,74295521,protein_coding,-1,96485,chr17_74199036_74295521
Men1,19,6334979,6340891,protein_coding,1,5912,chr19_6334979_6340891
Mep1b,18,21061923,21100199,protein_coding,1,38276,chr18_21061923_21100199
Mepce,5,137781906,137787655,protein_coding,-1,5749,chr5_137781906_137787655
Mepe,5,104325329,104338611,protein_coding,1,13282,chr5_104325329_104338611
Mertk,2,128698956,128802894,protein_coding,1,103938,chr2_128698956_128802894
Mesp1,7,79792241,79793788,protein_coding,-1,1547,chr7_79792241_79793788
Mesp2,7,79810727,79813439,protein_coding,1,2712,chr7_79810727_79813439
Mest,6,30723547,30748465,protein_coding,1,24918,chr6_30723547_30748465
Met,6,17463800,17573980,protein_coding,1,110180,chr6_17463800_17573980
Metap1,3,138458956,138489515,protein_coding,-1,30559,chr3_138458956_138489515
Metap1d,2,71453276,71525194,protein_coding,1,71918,chr2_71453276_71525194
Metap2,10,93858489,93897093,protein_coding,-1,38604,chr10_93858489_93897093
Methig1,15,100353149,100384436,protein_coding,1,31287,chr15_100353149_100384436
Metrn,17,25793221,25797136,protein_coding,-1,3915,chr17_25793221_25797136
Metrnl,11,121701544,121716306,protein_coding,1,14762,chr11_121701544_121716306
Mettl1,10,127041414,127046365,protein_coding,1,4951,chr10_127041414_127046365
Mettl11b,1,163702256,163725232,protein_coding,-1,22976,chr1_163702256_163725232
Mettl14,3,123368297,123386108,protein_coding,-1,17811,chr3_123368297_123386108
Mettl15,2,109092297,109280748,protein_coding,-1,188451,chr2_109092297_109280748
Mettl16,11,74770830,74828525,protein_coding,1,57695,chr11_74770830_74828525
Mettl17,14,51884842,51893039,protein_coding,1,8197,chr14_51884842_51893039
Mettl18,1,163994889,163997243,protein_coding,1,2354,chr1_163994889_163997243
Mettl2,11,105126425,105140394,protein_coding,1,13969,chr11_105126425_105140394
Mettl21a,1,64606473,64617242,protein_coding,-1,10769,chr1_64606473_64617242
Mettl21c,1,44009408,44020034,protein_coding,-1,10626,chr1_44009408_44020034
Mettl21e,1,44204070,44218961,protein_coding,-1,14891,chr1_44204070_44218961
Mettl22,16,8470788,8490684,protein_coding,1,19896,chr16_8470788_8490684
Mettl23,11,116843278,116854263,protein_coding,1,10985,chr11_116843278_116854263
Mettl24,10,40683282,40811083,protein_coding,1,127801,chr10_40683282_40811083
Mettl25,10,105763189,105841380,protein_coding,-1,78191,chr10_105763189_105841380
Mettl3,14,52294841,52305128,protein_coding,-1,10287,chr14_52294841_52305128
Mettl4,17,94722590,94750019,protein_coding,-1,27429,chr17_94722590_94750019
Mettl4-ps1,17,71526896,71556543,transcribed_unprocessed_pseudogene,1,29647,chr17_71526896_71556543
Mettl5,2,69871198,69885615,protein_coding,-1,14417,chr2_69871198_69885615
Mettl6,14,31473578,31495040,protein_coding,-1,21462,chr14_31473578_31495040
Mettl7a1,15,100304140,100328662,protein_coding,1,24522,chr15_100304140_100328662
Mettl7a2,15,100353200,100361840,protein_coding,1,8640,chr15_100353200_100361840
Mettl7a3,15,100334929,100340375,protein_coding,1,5446,chr15_100334929_100340375
Mettl8,2,70964561,71055583,protein_coding,-1,91022,chr2_70964561_71055583
Mettl9,7,121034445,121078329,protein_coding,1,43884,chr7_121034445_121078329
Mex3a,3,88532395,88541396,protein_coding,1,9001,chr3_88532395_88541396
Mex3b,7,82867333,82871515,protein_coding,1,4182,chr7_82867333_82871515
Mex3c,18,73573044,73592575,protein_coding,1,19531,chr18_73573044_73592575
Mex3d,10,80380355,80387659,protein_coding,-1,7304,chr10_80380355_80387659
Mfap1a,2,121491911,121506665,protein_coding,-1,14754,chr2_121491911_121506665
Mfap1b,2,121460235,121474067,protein_coding,-1,13832,chr2_121460235_121474067
Mfap2,4,141010418,141015984,protein_coding,1,5566,chr4_141010418_141015984
Mfap3,11,57518664,57533815,protein_coding,1,15151,chr11_57518664_57533815
Mfap3l,8,60632827,60676729,protein_coding,1,43902,chr8_60632827_60676729
Mfap4,11,61485431,61488900,protein_coding,1,3469,chr11_61485431_61488900
Mfap5,6,122505845,122529290,protein_coding,1,23445,chr6_122505845_122529290
Mff,1,82724890,82752394,protein_coding,1,27504,chr1_82724890_82752394
Mfge8,7,79133768,79149060,protein_coding,-1,15292,chr7_79133768_79149060
Mfhas1,8,35587798,35679449,protein_coding,1,91651,chr8_35587798_35679449
Mfn1,3,32529465,32579239,protein_coding,1,49774,chr3_32529465_32579239
Mfn2,4,147873599,147904704,protein_coding,-1,31105,chr4_147873599_147904704
Mfng,15,78755882,78773475,protein_coding,-1,17593,chr15_78755882_78773475
Mfsd1,3,67582741,67604237,protein_coding,1,21496,chr3_67582741_67604237
Mfsd10,5,34633642,34637212,protein_coding,-1,3570,chr5_34633642_34637212
Mfsd11,11,116852440,116875635,protein_coding,1,23195,chr11_116852440_116875635
Mfsd12,10,81357491,81366225,protein_coding,1,8734,chr10_81357491_81366225
Mfsd2a,4,122946850,122961188,protein_coding,-1,14338,chr4_122946850_122961188
Mfsd2b,12,4862440,4874359,protein_coding,-1,11919,chr12_4862440_4874359
Mfsd3,15,76701465,76704239,protein_coding,1,2774,chr15_76701465_76704239
Mfsd5,15,102279454,102281754,protein_coding,1,2300,chr15_102279454_102281754
Mfsd6,1,52656286,52727462,protein_coding,-1,71176,chr1_52656286_52727462
Mfsd7a,5,108441054,108449100,protein_coding,-1,8046,chr5_108441054_108449100
Mfsd8,3,40718384,40846886,protein_coding,-1,128502,chr3_40718384_40846886
Mfsd9,1,40772038,40790687,protein_coding,-1,18649,chr1_40772038_40790687
Mga,2,119897228,119969581,protein_coding,1,72353,chr2_119897228_119969581
Mgam,6,40628831,40769123,protein_coding,1,140292,chr6_40628831_40769123
Mgarp,3,51388412,51396738,protein_coding,-1,8326,chr3_51388412_51396738
Mgat1,11,49244191,49263030,protein_coding,1,18839,chr11_49244191_49263030
Mgat2,12,69184157,69186770,protein_coding,1,2613,chr12_69184157_69186770
Mgat3,15,80173721,80215519,protein_coding,1,41798,chr15_80173721_80215519
Mgat4a,1,37439340,37541016,protein_coding,-1,101676,chr1_37439340_37541016
Mgat4b,11,50210890,50235103,protein_coding,1,24213,chr11_50210890_50235103
Mgat4c,10,101681487,102391469,protein_coding,1,709982,chr10_101681487_102391469
Mgat4e,1,134540941,134549682,protein_coding,-1,8741,chr1_134540941_134549682
Mgat5,1,127205015,127488336,protein_coding,1,283321,chr1_127205015_127488336
Mgat5b,11,116918863,116986948,protein_coding,1,68085,chr11_116918863_116986948
Mgl2,11,70130329,70137550,protein_coding,1,7221,chr11_70130329_70137550
Mgll,6,88724412,88828360,protein_coding,1,103948,chr6_88724412_88828360
Mgme1,2,144270663,144281227,protein_coding,1,10564,chr2_144270663_144281227
Mgmt,7,136894614,137130266,protein_coding,1,235652,chr7_136894614_137130266
Mgp,6,136872435,136875823,protein_coding,-1,3388,chr6_136872435_136875823
Mgrn1,16,4886249,4938296,protein_coding,1,52047,chr16_4886249_4938296
Mgst1,6,138140316,138156755,protein_coding,1,16439,chr6_138140316_138156755
Mgst2,3,51660360,51682677,protein_coding,1,22317,chr3_51660360_51682677
Mgst3,1,167371966,167393841,protein_coding,-1,21875,chr1_167371966_167393841
Mhrt,14,54968678,54974349,antisense,1,5671,chr14_54968678_54974349
Mia,7,27179742,27181157,protein_coding,-1,1415,chr7_27179742_27181157
Mia3,1,183326725,183369553,protein_coding,-1,42828,chr1_183326725_183369553
Miat,5,112213228,112229395,lincRNA,-1,16167,chr5_112213228_112229395
Mib1,18,10725548,10818704,protein_coding,1,93156,chr18_10725548_10818704
Mib2,4,155654677,155669198,protein_coding,-1,14521,chr4_155654677_155669198
Mical1,10,41476314,41487032,protein_coding,1,10718,chr10_41476314_41487032
Mical2,7,112225856,112413106,protein_coding,1,187250,chr7_112225856_112413106
Mical3,6,120931707,121130999,protein_coding,-1,199292,chr6_120931707_121130999
Micall1,15,79108898,79136900,protein_coding,1,28002,chr15_79108898_79136900
Micall2,5,139706696,139736336,protein_coding,-1,29640,chr5_139706696_139736336
Micu1,10,59702477,59864132,protein_coding,1,161655,chr10_59702477_59864132
Micu2,14,57916261,57999262,protein_coding,-1,83001,chr14_57916261_57999262
Micu3,8,40307458,40386308,protein_coding,1,78850,chr8_40307458_40386308
Mid1,X,169685199,170005736,protein_coding,1,320537,chrX_169685199_170005736
Mid1ip1,X,10715013,10719690,protein_coding,1,4677,chrX_10715013_10719690
Mid2,X,140664599,140767715,protein_coding,1,103116,chrX_140664599_140767715
Midn,10,80148272,80158368,protein_coding,1,10096,chr10_80148272_80158368
Mief1,15,80234018,80253371,protein_coding,1,19353,chr15_80234018_80253371
Mief2,11,60728398,60732951,protein_coding,1,4553,chr11_60728398_60732951
Mien1,11,98437708,98438991,protein_coding,-1,1283,chr11_98437708_98438991
Mier1,4,103114390,103165754,protein_coding,1,51364,chr4_103114390_103165754
Mier2,10,79540245,79555199,protein_coding,-1,14954,chr10_79540245_79555199
Mier3,13,111680979,111718596,protein_coding,1,37617,chr13_111680979_111718596
Mif,10,75859353,75860240,protein_coding,-1,887,chr10_75859353_75860240
Mif-ps3,3,92024567,92024911,processed_pseudogene,1,344,chr3_92024567_92024911
Mif-ps7,12,109098227,109098553,processed_pseudogene,1,326,chr12_109098227_109098553
Mif4gd,11,115607918,115612969,protein_coding,-1,5051,chr11_115607918_115612969
Miip,4,147860778,147868816,protein_coding,-1,8038,chr4_147860778_147868816
Mill2,7,18839966,18865402,protein_coding,1,25436,chr7_18839966_18865402
Milr1,11,106751226,106768794,protein_coding,1,17568,chr11_106751226_106768794
Mink1,11,70562881,70614483,protein_coding,1,51602,chr11_70562881_70614483
Minpp1,19,32485769,32515364,protein_coding,1,29595,chr19_32485769_32515364
Minpp1-ps,6,121116798,121118224,processed_pseudogene,1,1426,chr6_121116798_121118224
Mios,6,8209222,8236274,protein_coding,1,27052,chr6_8209222_8236274
Mipep,14,60784573,60905478,protein_coding,1,120905,chr14_60784573_60905478
Mipepos,14,60776329,60784581,antisense,-1,8252,chr14_60776329_60784581
Mipol1,12,57230427,57497199,protein_coding,1,266772,chr12_57230427_57497199
Mir100,9,41531425,41531504,miRNA,1,79,chr9_41531425_41531504
Mir103-2,2,131288052,131288137,miRNA,1,85,chr2_131288052_131288137
Mir106b,5,138165737,138165818,miRNA,-1,81,chr5_138165737_138165818
Mir107,19,34820687,34820773,miRNA,-1,86,chr19_34820687_34820773
Mir1188,12,109611822,109612449,miRNA,1,627,chr12_109611822_109612449
Mir1190,12,101021673,101021768,miRNA,-1,95,chr12_101021673_101021768
Mir1191,7,27205536,27205655,miRNA,1,119,chr7_27205536_27205655
Mir1191b,10,81416240,81416297,miRNA,-1,57,chr10_81416240_81416297
Mir1192,19,23149431,23149551,miRNA,1,120,chr19_23149431_23149551
Mir1193,12,109715671,109715791,miRNA,1,120,chr12_109715671_109715791
Mir1195,17,70860503,70860600,miRNA,-1,97,chr17_70860503_70860600
Mir1197,12,109712317,109712436,miRNA,1,119,chr12_109712317_109712436
Mir1198,X,7807101,7807221,miRNA,1,120,chrX_7807101_7807221
Mir1224,16,20604452,20604536,miRNA,1,84,chr16_20604452_20604536
Mir1249,15,84951526,84951623,miRNA,-1,97,chr15_84951526_84951623
Mir124a-2,3,17795662,17795770,miRNA,1,108,chr3_17795662_17795770
Mir124a-3,2,180894040,180894107,miRNA,1,67,chr2_180894040_180894107
Mir1251,10,92137140,92137223,miRNA,-1,83,chr10_92137140_92137223
Mir1258,18,56538139,56538198,miRNA,1,59,chr18_56538139_56538198
Mir125b-1,9,41581926,41582002,miRNA,1,76,chr9_41581926_41582002
Mir125b-2,16,77646273,77646343,miRNA,1,70,chr16_77646273_77646343
Mir1264,X,147010601,147010686,miRNA,1,85,chrX_147010601_147010686
Mir126a,2,26591357,26591429,miRNA,1,72,chr2_26591357_26591429
Mir128-1,1,128202361,128202430,miRNA,1,69,chr1_128202361_128202430
Mir128-2,9,112118636,112118711,miRNA,-1,75,chr9_112118636_112118711
Mir129-1,6,29022619,29022691,miRNA,1,72,chr6_29022619_29022691
Mir129-2,2,94241364,94241453,miRNA,-1,89,chr2_94241364_94241453
Mir1291,15,98519762,98519878,miRNA,-1,116,chr15_98519762_98519878
Mir130a,2,84741115,84741178,miRNA,-1,63,chr2_84741115_84741178
Mir130b,16,17124061,17124142,miRNA,-1,81,chr16_17124061_17124142
Mir132,11,75173682,75173747,miRNA,1,65,chr11_75173682_75173747
Mir133a-1,18,10782909,10782976,miRNA,-1,67,chr18_10782909_10782976
Mir133c,2,29475215,29475294,miRNA,-1,79,chr2_29475215_29475294
Mir134,12,109734139,109734209,miRNA,1,70,chr12_109734139_109734209
Mir135a-2,10,92072086,92072185,miRNA,-1,99,chr10_92072086_92072185
Mir135b,1,132198088,132198184,miRNA,1,96,chr1_132198088_132198184
Mir137,3,118433857,118433929,miRNA,1,72,chr3_118433857_118433929
Mir138-1,9,122682876,122682974,miRNA,1,98,chr9_122682876_122682974
Mir138-2,8,94324311,94324381,miRNA,1,70,chr8_94324311_94324381
Mir139,7,101475376,101475443,miRNA,1,67,chr7_101475376_101475443
Mir140,8,107551244,107551313,miRNA,1,69,chr8_107551244_107551313
Mir142b,11,87756841,87756955,miRNA,-1,114,chr11_87756841_87756955
Mir145a,18,61647825,61647894,miRNA,-1,69,chr18_61647825_61647894
Mir146,11,43374397,43374461,miRNA,-1,64,chr11_43374397_43374461
Mir146b,19,46342762,46342870,miRNA,1,108,chr19_46342762_46342870
Mir149,1,92850378,92850443,miRNA,1,65,chr1_92850378_92850443
Mir151,15,73254815,73254882,miRNA,-1,67,chr15_73254815_73254882
Mir153,12,117250817,117250885,miRNA,1,68,chr12_117250817_117250885
Mir154,12,109738433,109738498,miRNA,1,65,chr12_109738433_109738498
Mir155,16,84714140,84714204,miRNA,1,64,chr16_84714140_84714204
Mir15a,14,61632027,61632110,miRNA,-1,83,chr14_61632027_61632110
Mir16-1,14,61631880,61631972,miRNA,-1,92,chr14_61631880_61631972
Mir16-2,3,69009902,69009996,miRNA,1,94,chr3_69009902_69009996
Mir17hg,14,115042879,115046727,lincRNA,1,3848,chr14_115042879_115046727
Mir181a-1,1,137966455,137966541,miRNA,1,86,chr1_137966455_137966541
Mir181a-2,2,38852735,38852810,miRNA,1,75,chr2_38852735_38852810
Mir181b-1,1,137966639,137966718,miRNA,1,79,chr1_137966639_137966718
Mir181b-2,2,38853830,38853918,miRNA,1,88,chr2_38853830_38853918
Mir181c,8,84178873,84178961,miRNA,-1,88,chr8_84178873_84178961
Mir181d,8,84178716,84178787,miRNA,-1,71,chr8_84178716_84178787
Mir1839,7,81529855,81529988,miRNA;scaRNA,1,133,chr7_81529855_81529988
Mir1843a,12,80391613,80391677,miRNA,-1,64,chr12_80391613_80391677
Mir185,16,18327401,18327465,miRNA,-1,64,chr16_18327401_18327465
Mir186,3,157544279,157544349,miRNA,1,70,chr3_157544279_157544349
Mir188,X,7247989,7248056,miRNA,-1,67,chrX_7247989_7248056
Mir1894,17,35917889,35917969,miRNA,1,80,chr17_35917889_35917969
Mir1898,15,12171492,12171574,miRNA,1,82,chr15_12171492_12171574
Mir1899,9,8246786,8246881,miRNA,1,95,chr9_8246786_8246881
Mir1900,9,21032251,21032328,miRNA,-1,77,chr9_21032251_21032328
Mir1904,13,109903809,109903888,miRNA,1,79,chr13_109903809_109903888
Mir1906-2,X,88759474,88759553,miRNA,-1,79,chrX_88759474_88759553
Mir190a,9,67236660,67236726,miRNA,-1,66,chr9_67236660_67236726
Mir1912,X,147009441,147009527,miRNA,1,86,chrX_147009441_147009527
Mir192,19,6264844,6264932,miRNA,1,88,chr19_6264844_6264932
Mir1927,1,160295864,160295972,miRNA,-1,108,chr1_160295864_160295972
Mir1929,10,44359676,44359768,miRNA,1,92,chr10_44359676_44359768
Mir1930,10,77641224,77641307,miRNA,1,83,chr10_77641224_77641307
Mir1931,10,93162785,93162903,miRNA,1,118,chr10_93162785_93162903
Mir1933,11,21344588,21344675,miRNA,-1,87,chr11_21344588_21344675
Mir1934,11,69663043,69663125,miRNA,1,82,chr11_69663043_69663125
Mir1938,12,40222712,40222811,miRNA,-1,99,chr12_40222712_40222811
Mir193b,16,13449523,13449601,miRNA,1,78,chr16_13449523_13449601
Mir194-1,1,185313319,185313385,miRNA,1,66,chr1_185313319_185313385
Mir194-2,19,6264643,6264728,miRNA,1,85,chr19_6264643_6264728
Mir1942,15,76215611,76215673,miRNA,-1,62,chr15_76215611_76215673
Mir1945,16,11254368,11254445,miRNA,-1,77,chr16_11254368_11254445
Mir1946a,16,32267450,32267583,miRNA,-1,133,chr16_32267450_32267583
Mir1946b,9,21613444,21613576,miRNA,-1,132,chr9_21613444_21613576
Mir1949,18,35554492,35554636,miRNA;snoRNA,1,144,chr18_35554492_35554636
Mir1950,19,34965396,34965469,miRNA,1,73,chr19_34965396_34965469
Mir1951,2,115638725,115638813,miRNA,1,88,chr2_115638725_115638813
Mir1954,2,32652329,32652414,miRNA,1,85,chr2_32652329_32652414
Mir1955,2,92191977,92192074,miRNA,1,97,chr2_92191977_92192074
Mir1956,3,138526421,138526485,miRNA,1,64,chr3_138526421_138526485
Mir1962,7,135566162,135566282,miRNA,1,120,chr7_135566162_135566282
Mir1963,7,29083636,29083694,miRNA,-1,58,chr7_29083636_29083694
Mir1966,8,105615466,105615573,miRNA,1,107,chr8_105615466_105615573
Mir1967,8,124022641,124022722,miRNA,1,81,chr8_124022641_124022722
Mir1968,8,13189031,13189098,miRNA,-1,67,chr8_13189031_13189098
Mir1970,X,135786114,135786217,miRNA,-1,103,chrX_135786114_135786217
Mir1981,1,184822407,184822488,miRNA,-1,81,chr1_184822407_184822488
Mir1982,10,80828797,80828870,miRNA,1,73,chr10_80828797_80828870
Mir199a-1,9,21496495,21496564,miRNA,-1,69,chr9_21496495_21496564
Mir199b,2,32318460,32318569,miRNA,1,109,chr2_32318460_32318569
Mir1b,18,10785446,10785567,miRNA,1,121,chr18_10785446_10785567
Mir204,19,22750605,22750672,miRNA,1,67,chr19_22750605_22750672
Mir207,4,40722917,40722995,miRNA,1,78,chr4_40722917_40722995
Mir208b,14,54975700,54975776,miRNA,-1,76,chr14_54975700_54975776
Mir210,7,141221384,141221493,miRNA,-1,109,chr7_141221384_141221493
Mir212,11,75173388,75173478,miRNA,1,90,chr11_75173388_75173478
Mir215,1,185313581,185313692,miRNA,1,111,chr1_185313581_185313692
Mir218-1,5,48223942,48224051,miRNA,1,109,chr5_48223942_48224051
Mir218-2,11,35616816,35616925,miRNA,1,109,chr11_35616816_35616925
Mir219a-1,17,34024983,34025092,miRNA,-1,109,chr17_34024983_34025092
Mir21c,8,128278148,128278225,miRNA,-1,77,chr8_128278148_128278225
Mir221,X,19146294,19146388,miRNA,-1,94,chrX_19146294_19146388
Mir222,X,19146893,19146971,miRNA,-1,78,chrX_19146893_19146971
Mir22hg,11,75461539,75466676,processed_transcript,1,5137,chr11_75461539_75466676
Mir23a,8,84208518,84208592,miRNA,1,74,chr8_84208518_84208592
Mir24-2,8,84208815,84208921,miRNA,1,106,chr8_84208815_84208921
Mir25,5,138165321,138165404,miRNA,-1,83,chr5_138165321_138165404
Mir26a-1,9,119031796,119031885,miRNA,1,89,chr9_119031796_119031885
Mir26b,1,74394310,74394394,miRNA,1,84,chr1_74394310_74394394
Mir27a,8,84208672,84208758,miRNA,1,86,chr8_84208672_84208758
Mir2861,2,32712807,32712888,miRNA,-1,81,chr2_32712807_32712888
Mir28a,16,24827855,24827940,miRNA,1,85,chr16_24827855_24827940
Mir28b,8,73016512,73016591,miRNA,1,79,chr8_73016512_73016591
Mir28c,15,53614205,53614279,miRNA,-1,74,chr15_53614205_53614279
Mir296,2,174267047,174267125,miRNA,-1,78,chr2_174267047_174267125
Mir298,2,174267504,174267585,miRNA,-1,81,chr2_174267504_174267585
Mir29a,6,31062660,31062747,miRNA,-1,87,chr6_31062660_31062747
Mir29b-1,6,31063023,31063093,miRNA,-1,70,chr6_31063023_31063093
Mir300,12,109724313,109724391,miRNA,1,78,chr12_109724313_109724391
Mir301,11,87113004,87113089,miRNA,1,85,chr11_87113004_87113089
Mir301b,16,17124400,17124496,miRNA,-1,96,chr16_17124400_17124496
Mir302a,3,127545496,127545564,miRNA,1,68,chr3_127545496_127545564
Mir302b,3,127545228,127545301,miRNA,1,73,chr3_127545228_127545301
Mir302c,3,127545363,127545430,miRNA,1,67,chr3_127545363_127545430
Mir302d,3,127545624,127545689,miRNA,1,65,chr3_127545624_127545689
Mir3057,10,81271597,81271687,miRNA,1,90,chr10_81271597_81271687
Mir3058,10,95559231,95559321,miRNA,-1,90,chr10_95559231_95559321
Mir3059,10,101772692,101772772,miRNA,1,80,chr10_101772692_101772772
Mir3060,11,4139364,4139446,miRNA,1,82,chr11_4139364_4139446
Mir3061,11,52126746,52126836,miRNA,1,90,chr11_52126746_52126836
Mir3064,11,106782693,106782759,miRNA,-1,66,chr11_106782693_106782759
Mir3068,12,87437679,87437757,miRNA,-1,78,chr12_87437679_87437757
Mir3070b,12,109588592,109589188,miRNA,1,596,chr12_109588592_109589188
Mir3072,12,109747878,109747960,miRNA,1,82,chr12_109747878_109747960
Mir3077,14,57798424,57798487,miRNA,1,63,chr14_57798424_57798487
Mir3081,16,44558046,44558129,miRNA,-1,83,chr16_44558046_44558129
Mir3083,17,26948056,26948119,miRNA,-1,63,chr17_26948056_26948119
Mir3084-2,19,60774329,60774397,miRNA,-1,68,chr19_60774329_60774397
Mir3085,19,42280082,42280170,miRNA,-1,88,chr19_42280082_42280170
Mir3086,19,58911673,58911759,miRNA,-1,86,chr19_58911673_58911759
Mir3091,2,180257536,180257611,miRNA,1,75,chr2_180257536_180257611
Mir3092,3,27584900,27584995,miRNA,-1,95,chr3_27584900_27584995
Mir3093,3,88215171,88215257,miRNA,1,86,chr3_88215171_88215257
Mir3094,4,40993695,40993758,miRNA,1,63,chr4_40993695_40993758
Mir3097,5,35021049,35021115,miRNA,1,66,chr5_35021049_35021115
Mir3098,6,125195792,125195878,miRNA,1,86,chr6_125195792_125195878
Mir3099,7,6803587,6803670,miRNA,1,83,chr7_6803587_6803670
Mir30a,1,23272269,23272339,miRNA,1,70,chr1_23272269_23272339
Mir30b,15,68337415,68337510,miRNA,-1,95,chr15_68337415_68337510
Mir30c-1,4,120769534,120769622,miRNA,-1,88,chr4_120769534_120769622
Mir30c-2,1,23291701,23291784,miRNA,1,83,chr1_23291701_23291784
Mir30d,15,68341208,68341289,miRNA,-1,81,chr15_68341208_68341289
Mir31,4,88910557,88910662,miRNA,-1,105,chr4_88910557_88910662
Mir3101,7,27176006,27176093,miRNA,-1,87,chr7_27176006_27176093
Mir3106,8,16168757,16168838,miRNA,-1,81,chr8_16168757_16168838
Mir320,14,70443510,70443591,miRNA,1,81,chr14_70443510_70443591
Mir323,12,109712508,109712593,miRNA,1,85,chr12_109712508_109712593
Mir324,11,70012043,70012131,miRNA,1,88,chr11_70012043_70012131
Mir325,X,105379082,105379179,miRNA,-1,97,chrX_105379082_105379179
Mir326,7,99552269,99552363,miRNA,1,94,chr7_99552269_99552363
Mir329,12,109713481,109713577,miRNA,1,96,chr12_109713481_109713577
Mir330,7,19181465,19181562,miRNA,1,97,chr7_19181465_19181562
Mir335,6,30741299,30741396,miRNA,1,97,chr6_30741299_30741396
Mir337,12,109585789,109586393,miRNA,1,604,chr12_109585789_109586393
Mir338,11,120014765,120014862,miRNA,-1,97,chr11_120014765_120014862
Mir339,5,139369650,139369745,miRNA,-1,95,chr5_139369650_139369745
Mir340,11,50069702,50069799,miRNA,1,97,chr11_50069702_50069799
Mir341,12,109611500,109612103,miRNA,1,603,chr12_109611500_109612103
Mir342,12,108658620,108658718,miRNA,1,98,chr12_108658620_108658718
Mir344,7,61877770,61877864,miRNA,-1,94,chr7_61877770_61877864
Mir344b,7,61790519,61790581,miRNA,-1,62,chr7_61790519_61790581
Mir344c,7,61837311,61837402,miRNA,-1,91,chr7_61837311_61837402
Mir344d-1,7,61683124,61683192,miRNA,-1,68,chr7_61683124_61683192
Mir344d-2,7,61685272,61685351,miRNA,-1,79,chr7_61685272_61685351
Mir344d-3,7,61726249,61726328,miRNA,-1,79,chr7_61726249_61726328
Mir344e,7,61735537,61735602,miRNA,-1,65,chr7_61735537_61735602
Mir344f,7,62046181,62046248,miRNA,-1,67,chr7_62046181_62046248
Mir344g,7,61982289,61982359,miRNA,-1,70,chr7_61982289_61982359
Mir344h-1,7,61739350,61739409,miRNA,-1,59,chr7_61739350_61739409
Mir344h-2,7,61742366,61742425,miRNA,-1,59,chr7_61742366_61742425
Mir344i,7,62085223,62085310,miRNA,-1,87,chr7_62085223_62085310
Mir345,12,108836973,108837068,miRNA,1,95,chr12_108836973_108837068
Mir346,14,34894609,34894706,miRNA,1,97,chr14_34894609_34894706
Mir3470a,6,83090311,83090387,miRNA,-1,76,chr6_83090311_83090387
Mir3470b,16,44013852,44013977,miRNA,1,125,chr16_44013852_44013977
Mir3471-2,4,3537090,3537191,miRNA,1,101,chr4_3537090_3537191
Mir3472,X,145039344,145039414,miRNA,1,70,chrX_145039344_145039414
Mir3473a,X,162874918,162874995,miRNA,-1,77,chrX_162874918_162874995
Mir3473b,10,41670739,41670793,miRNA,1,54,chr10_41670739_41670793
Mir3473c,1,191998403,191998634,miRNA,-1,231,chr1_191998403_191998634
Mir3473d,8,111016450,111016530,miRNA,-1,80,chr8_111016450_111016530
Mir3473e,5,31667231,31667340,miRNA,-1,109,chr5_31667231_31667340
Mir3473f,1,106546496,106546631,miRNA,-1,135,chr1_106546496_106546631
Mir3473g,2,126902250,126902385,miRNA,-1,135,chr2_126902250_126902385
Mir3474,2,158638583,158638640,miRNA,1,57,chr2_158638583_158638640
Mir3475,X,140310948,140311012,miRNA,1,64,chrX_140310948_140311012
Mir34a,4,150068454,150068555,miRNA,1,101,chr4_150068454_150068555
Mir350,1,176772325,176772423,miRNA,-1,98,chr1_176772325_176772423
Mir3569,7,30589380,30589437,miRNA,1,57,chr7_30589380_30589437
Mir361,X,113074824,113074893,miRNA,-1,69,chrX_113074824_113074893
Mir365-1,16,13453840,13453926,miRNA,1,86,chr16_13453840_13453926
Mir369,12,109743418,109743496,miRNA,1,78,chr12_109743418_109743496
Mir370,12,109618258,109618844,miRNA,1,586,chr12_109618258_109618844
Mir374b,X,103573060,103573154,miRNA,-1,94,chrX_103573060_103573154
Mir376a,12,109723781,109723848,miRNA,1,67,chr12_109723781_109723848
Mir376b,12,109723458,109723539,miRNA,1,81,chr12_109723458_109723539
Mir376c,12,109722718,109722803,miRNA,1,85,chr12_109722718_109722803
Mir377,12,109740510,109740577,miRNA,1,67,chr12_109740510_109740577
Mir378a,18,61397835,61397900,miRNA,-1,65,chr18_61397835_61397900
Mir378b,11,88352773,88352864,miRNA,1,91,chr11_88352773_88352864
Mir378c,14,46954830,46954928,miRNA,-1,98,chr14_46954830_46954928
Mir378d,10,126710282,126710391,miRNA,-1,109,chr10_126710282_126710391
Mir379,12,109709060,109709125,miRNA,1,65,chr12_109709060_109709125
Mir380,12,109711803,109711863,miRNA,1,60,chr12_109711803_109711863
Mir381,12,109726822,109726896,miRNA,1,74,chr12_109726822_109726896
Mir382,12,109733771,109733846,miRNA,1,75,chr12_109733771_109733846
Mir383,8,38252133,38252202,miRNA,-1,69,chr8_38252133_38252202
Mir384,X,105344282,105344369,miRNA,-1,87,chrX_105344282_105344369
Mir3960,2,32712900,32712972,miRNA,-1,72,chr2_32712900_32712972
Mir3962,1,194822001,194822064,miRNA,1,63,chr1_194822001_194822064
Mir3970,19,33157112,33157201,miRNA,1,89,chr19_33157112_33157201
Mir409,12,109743158,109743236,miRNA,1,78,chr12_109743158_109743236
Mir411,12,109710175,109710256,miRNA,1,81,chr12_109710175_109710256
Mir412,12,109743289,109743368,miRNA,1,79,chr12_109743289_109743368
Mir421,X,103572921,103572996,miRNA,-1,75,chrX_103572921_103572996
Mir423,11,77078064,77078172,miRNA,-1,108,chr11_77078064_77078172
Mir448,X,147158210,147158321,miRNA,1,111,chrX_147158210_147158321
Mir453,12,109735619,109735700,miRNA,1,81,chr12_109735619_109735700
Mir466b-7,2,10496268,10496355,miRNA,1,87,chr2_10496268_10496355
Mir466i,13,17747473,17747593,miRNA,1,120,chr13_17747473_17747593
Mir466q,3,28419943,28420018,miRNA,1,75,chr3_28419943_28420018
Mir467f,11,69635400,69635519,miRNA,-1,119,chr11_69635400_69635519
Mir484,16,14159626,14159692,miRNA,1,66,chr16_14159626_14159692
Mir485,12,109734902,109734974,miRNA,1,72,chr12_109734902_109734974
Mir486,8,23142555,23142682,miRNA,1,127,chr8_23142555_23142682
Mir487b,12,109727333,109727414,miRNA,1,81,chr12_109727333_109727414
Mir488,1,158505625,158505733,miRNA,1,108,chr1_158505625_158505733
Mir490,6,36421742,36421825,miRNA,1,83,chr6_36421742_36421825
Mir491,4,88122040,88122125,miRNA,1,85,chr4_88122040_88122125
Mir493,12,109580233,109580823,miRNA,1,590,chr12_109580233_109580823
Mir494,12,109715318,109715402,miRNA,1,84,chr12_109715318_109715402
Mir495,12,109718754,109718816,miRNA,1,62,chr12_109718754_109718816
Mir496a,12,109739119,109739197,miRNA,1,78,chr12_109739119_109739197
Mir496b,19,16314892,16315004,miRNA,-1,112,chr19_16314892_16315004
Mir504,X,59097658,59097736,miRNA,-1,78,chrX_59097658_59097736
Mir5098,5,77272757,77272838,miRNA,1,81,chr5_77272757_77272838
Mir5099,12,36816205,36816278,miRNA,1,73,chr12_36816205_36816278
Mir5100,11,60728663,60728726,miRNA,1,63,chr11_60728663_60728726
Mir5103,1,34433121,34433199,miRNA,-1,78,chr1_34433121_34433199
Mir5108,10,61774737,61774821,miRNA,1,84,chr10_61774737_61774821
Mir5110,11,85760616,85760702,miRNA,-1,86,chr11_85760616_85760702
Mir5119,11,98262606,98262662,miRNA,1,56,chr11_98262606_98262662
Mir5121,7,45126918,45126991,miRNA,-1,73,chr7_45126918_45126991
Mir5124a,13,40865791,40865862,miRNA,1,71,chr13_40865791_40865862
Mir5128,2,37688201,37688284,miRNA,-1,83,chr2_37688201_37688284
Mir5129,2,45023100,45023177,miRNA,-1,77,chr2_45023100_45023177
Mir5136,19,8888699,8888774,miRNA,-1,75,chr19_8888699_8888774
Mir539,12,109728129,109728202,miRNA,1,73,chr12_109728129_109728202
Mir541,12,109742409,109742498,miRNA,1,89,chr12_109742409_109742498
Mir543,12,109717258,109717333,miRNA,1,75,chr12_109717258_109717333
Mir544,12,109729325,109729402,miRNA,1,77,chr12_109729325_109729402
Mir551b,3,29416823,29416920,miRNA,1,97,chr3_29416823_29416920
Mir5615-1,10,81104614,81104673,miRNA,-1,59,chr10_81104614_81104673
Mir5615-2,10,81104616,81104675,miRNA,1,59,chr10_81104616_81104675
Mir5616,4,149537863,149537922,miRNA,1,59,chr4_149537863_149537922
Mir5619,5,104048003,104048063,miRNA,1,60,chr5_104048003_104048063
Mir5621,11,115795824,115795886,miRNA,1,62,chr11_115795824_115795886
Mir5623,19,58051167,58051236,miRNA,1,69,chr19_58051167_58051236
Mir5625,5,30647936,30648015,miRNA,1,79,chr5_30647936_30648015
Mir5627,12,44210313,44210373,miRNA,1,60,chr12_44210313_44210373
Mir568,16,43640655,43640737,miRNA,1,82,chr16_43640655_43640737
Mir5709,17,67026147,67026235,miRNA,-1,88,chr17_67026147_67026235
Mir5710,9,54708313,54708381,miRNA,1,68,chr9_54708313_54708381
Mir582,13,109324744,109324824,miRNA,1,80,chr13_109324744_109324824
Mir592,6,27936655,27936750,miRNA,-1,95,chr6_27936655_27936750
Mir599,15,35660831,35660918,miRNA,-1,87,chr15_35660831_35660918
Mir6236,9,110281287,110281409,miRNA,1,122,chr9_110281287_110281409
Mir6237,9,9894431,9894521,miRNA,1,90,chr9_9894431_9894521
Mir6239,14,117953743,117953847,miRNA,-1,104,chr14_117953743_117953847
Mir6240,5,114851948,114852064,miRNA,1,116,chr5_114851948_114852064
Mir6335,2,67781043,67781140,miRNA,1,97,chr2_67781043_67781140
Mir6336,2,42447439,42447568,miRNA,-1,129,chr2_42447439_42447568
Mir6345,1,93352158,93352285,miRNA,1,127,chr1_93352158_93352285
Mir6347,1,167290125,167290225,miRNA,1,100,chr1_167290125_167290225
Mir6352,1,77496653,77496768,miRNA,-1,115,chr1_77496653_77496768
Mir6353,1,84218849,84218961,miRNA,-1,112,chr1_84218849_84218961
Mir6359,18,88972030,88972110,miRNA,1,80,chr18_88972030_88972110
Mir6361,18,32880573,32880673,miRNA,-1,100,chr18_32880573_32880673
Mir6362,16,22605326,22605432,miRNA,1,106,chr16_22605326_22605432
Mir6365,16,13471080,13471180,miRNA,-1,100,chr16_13471080_13471180
Mir6371,6,50572398,50572508,miRNA,1,110,chr6_50572398_50572508
Mir6374,6,83400996,83401102,miRNA,-1,106,chr6_83400996_83401102
Mir6377,3,57616609,57616722,miRNA,1,113,chr3_57616609_57616722
Mir6385,9,58221150,58221254,miRNA,1,104,chr9_58221150_58221254
Mir6389,7,57581061,57581162,miRNA,1,101,chr7_57581061_57581162
Mir6390,14,105623642,105623770,miRNA,-1,128,chr14_105623642_105623770
Mir6391,14,118592369,118592472,miRNA,-1,103,chr14_118592369_118592472
Mir6392,15,84168270,84168377,miRNA,1,107,chr15_84168270_84168377
Mir6394,7,96305667,96305765,miRNA,1,98,chr7_96305667_96305765
Mir6395,8,34166622,34166712,miRNA,-1,90,chr8_34166622_34166712
Mir6397,4,108087357,108087449,miRNA,1,92,chr4_108087357_108087449
Mir6398,4,123616420,123616521,miRNA,1,101,chr4_123616420_123616521
Mir6399,4,138163209,138163292,miRNA,1,83,chr4_138163209_138163292
Mir6403,4,134567723,134567851,miRNA,-1,128,chr4_134567723_134567851
Mir6405,19,44808406,44808529,miRNA,1,123,chr19_44808406_44808529
Mir6412,10,122648339,122648435,miRNA,1,96,chr10_122648339_122648435
Mir6418,5,137529480,137529594,miRNA,-1,114,chr5_137529480_137529594
Mir6419,2,17563514,17563626,miRNA,1,112,chr2_17563514_17563626
Mir6516,11,117077348,117077457,miRNA,1,109,chr11_117077348_117077457
Mir652,X,142739000,142739097,miRNA,1,97,chrX_142739000_142739097
Mir6538,12,26414901,26415010,miRNA,-1,109,chr12_26414901_26415010
Mir654,12,109723218,109723301,miRNA,1,83,chr12_109723218_109723301
Mir6540,16,42303362,42303469,miRNA,-1,107,chr16_42303362_42303469
Mir664,1,185242975,185243043,miRNA,1,68,chr1_185242975_185243043
Mir666,12,109717085,109717183,miRNA,1,98,chr12_109717085_109717183
Mir667,12,109720006,109720097,miRNA,1,91,chr12_109720006_109720097
Mir668,12,109734732,109734797,miRNA,1,65,chr12_109734732_109734797
Mir669n,3,115979902,115979955,miRNA,1,53,chr3_115979902_115979955
Mir669p-2,2,10496497,10496583,miRNA,1,86,chr2_10496497_10496583
Mir670,2,94261300,94261399,miRNA,-1,99,chr2_94261300_94261399
Mir672,X,104116175,104116274,miRNA,-1,99,chrX_104116175_104116274
Mir673,12,109571990,109572588,miRNA,1,598,chr12_109571990_109572588
Mir674,2,117185127,117185226,miRNA,1,99,chr2_117185127_117185226
Mir6769b,8,71631047,71631106,miRNA,-1,59,chr8_71631047_71631106
Mir677,10,128085286,128085363,miRNA,1,77,chr10_128085286_128085363
Mir679,12,109715577,109715650,miRNA,1,73,chr12_109715577_109715650
Mir684-2,4,11134097,11134182,miRNA,1,85,chr4_11134097_11134182
Mir687,14,73206763,73206851,miRNA,-1,88,chr14_73206763_73206851
Mir688,15,102671792,102671866,miRNA,-1,74,chr15_102671792_102671866
Mir6896,1,34117359,34117431,miRNA,1,72,chr1_34117359_34117431
Mir6897,1,36144252,36144313,miRNA,-1,61,chr1_36144252_36144313
Mir6899,1,64042438,64042501,miRNA,-1,63,chr1_64042438_64042501
Mir690,16,28599935,28600043,miRNA,-1,108,chr16_28599935_28600043
Mir6900,1,92464483,92464542,miRNA,-1,59,chr1_92464483_92464542
Mir6902,1,93346092,93346155,miRNA,1,63,chr1_93346092_93346155
Mir6904,1,180587201,180587267,miRNA,1,66,chr1_180587201_180587267
Mir6905,10,24910664,24910733,miRNA,1,69,chr10_24910664_24910733
Mir6906,10,60126776,60126833,miRNA,1,57,chr10_60126776_60126833
Mir6907,10,78408475,78408545,miRNA,-1,70,chr10_78408475_78408545
Mir691,16,74341990,74342067,miRNA,-1,77,chr16_74341990_74342067
Mir6912,10,80609260,80609329,miRNA,1,69,chr10_80609260_80609329
Mir6913,10,81386347,81386412,miRNA,1,65,chr10_81386347_81386412
Mir6916,10,128511968,128512030,miRNA,-1,62,chr10_128511968_128512030
Mir6918,11,4891345,4891402,miRNA,1,57,chr11_4891345_4891402
Mir692-1,17,6895229,6895337,miRNA,-1,108,chr17_6895229_6895337
Mir6920,11,53409197,53409267,miRNA,1,70,chr11_53409197_53409267
Mir6925,11,70705990,70706059,miRNA,1,69,chr11_70705990_70706059
Mir6928,11,101030340,101030409,miRNA,1,69,chr11_101030340_101030409
Mir6929,11,101419187,101419253,miRNA,-1,66,chr11_101419187_101419253
Mir6932,11,107637722,107637779,miRNA,1,57,chr11_107637722_107637779
Mir6935,11,120347350,120347413,miRNA,-1,63,chr11_120347350_120347413
Mir6936,11,120624823,120624876,miRNA,-1,53,chr11_120624823_120624876
Mir6937,12,28679325,28679389,miRNA,1,64,chr12_28679325_28679389
Mir6938,12,85245923,85245985,miRNA,-1,62,chr12_85245923_85245985
Mir6939,12,112659277,112659351,miRNA,-1,74,chr12_112659277_112659351
Mir6942,13,21396578,21396638,miRNA,-1,60,chr13_21396578_21396638
Mir6943,13,55453106,55453171,miRNA,1,65,chr13_55453106_55453171
Mir6944,13,55477681,55477776,miRNA,-1,95,chr13_55477681_55477776
Mir6945,13,55507625,55507692,miRNA,-1,67,chr13_55507625_55507692
Mir6948,14,54643049,54643110,miRNA,-1,61,chr14_54643049_54643110
Mir695,2,155356817,155356925,miRNA,1,108,chr2_155356817_155356925
Mir6951,15,38490473,38490547,miRNA,-1,74,chr15_38490473_38490547
Mir6953,15,76248191,76248258,miRNA,1,67,chr15_76248191_76248258
Mir6955,15,78891840,78891913,miRNA,1,73,chr15_78891840_78891913
Mir6958,15,89185465,89185537,miRNA,-1,72,chr15_89185465_89185537
Mir6959,15,89305658,89305732,miRNA,-1,74,chr15_89305658_89305732
Mir6964,16,97877233,97877291,miRNA,-1,58,chr16_97877233_97877291
Mir6965,17,24240884,24240947,miRNA,-1,63,chr17_24240884_24240947
Mir6966,17,25780808,25780879,miRNA,1,71,chr17_25780808_25780879
Mir697,4,124731694,124731802,miRNA,1,108,chr4_124731694_124731802
Mir6970,17,34845101,34845167,miRNA,-1,66,chr17_34845101_34845167
Mir6972,17,34857569,34857632,miRNA,-1,63,chr17_34857569_34857632
Mir6973b,2,131040319,131040398,miRNA,-1,79,chr2_131040319_131040398
Mir698,4,124743781,124743889,miRNA,1,108,chr4_124743781_124743889
Mir6982,18,60958073,60958140,miRNA,1,67,chr18_60958073_60958140
Mir6984,19,3288920,3288983,miRNA,1,63,chr19_3288920_3288983
Mir6986,19,4623898,4623955,miRNA,-1,57,chr19_4623898_4623955
Mir6989,19,6346480,6346544,miRNA,1,64,chr19_6346480_6346544
Mir6990,19,6914196,6914286,miRNA,-1,90,chr19_6914196_6914286
Mir6992,19,8742971,8743079,miRNA,1,108,chr19_8742971_8743079
Mir6994,19,11923728,11923800,miRNA,1,72,chr19_11923728_11923800
Mir6999,2,91944870,91944930,miRNA,-1,60,chr2_91944870_91944930
Mir7-1,13,58392779,58392886,miRNA,-1,107,chr13_58392779_58392886
Mir7-2,7,78888277,78888373,miRNA,1,96,chr7_78888277_78888373
Mir700,4,135416555,135416633,miRNA,-1,78,chr4_135416555_135416633
Mir7004,2,168640696,168640759,miRNA,-1,63,chr2_168640696_168640759
Mir7009,3,36475461,36475524,miRNA,-1,63,chr3_36475461_36475524
Mir7011,3,88440879,88440951,miRNA,-1,72,chr3_88440879_88440951
Mir7012,3,90270149,90270212,miRNA,1,63,chr3_90270149_90270212
Mir7013,3,95004168,95004239,miRNA,1,71,chr3_95004168_95004239
Mir7014,3,95734911,95734973,miRNA,-1,62,chr3_95734911_95734973
Mir7015,4,120973259,120973322,miRNA,-1,63,chr4_120973259_120973322
Mir7016,4,129684500,129684571,miRNA,-1,71,chr4_129684500_129684571
Mir7019,4,138316132,138316200,miRNA,-1,68,chr4_138316132_138316200
Mir7022,4,148146936,148146996,miRNA,-1,60,chr4_148146936_148146996
Mir7024,5,33898910,33898971,miRNA,-1,61,chr5_33898910_33898971
Mir7026,5,110666075,110666141,miRNA,-1,66,chr5_110666075_110666141
Mir7027,5,114404468,114404539,miRNA,1,71,chr5_114404468_114404539
Mir7028,5,114719515,114719578,miRNA,1,63,chr5_114719515_114719578
Mir7029,5,115580949,115581009,miRNA,1,60,chr5_115580949_115581009
Mir703,5,98475556,98475664,miRNA,-1,108,chr5_98475556_98475664
Mir7030,5,115645573,115645632,miRNA,1,59,chr5_115645573_115645632
Mir7031,5,121819209,121819273,miRNA,-1,64,chr5_121819209_121819273
Mir7035,5,136105522,136105603,miRNA,1,81,chr5_136105522_136105603
Mir7036,5,137296624,137296688,miRNA,-1,64,chr5_137296624_137296688
Mir7036b,5,34574151,34574213,miRNA,1,62,chr5_34574151_34574213
Mir704,6,47803576,47803652,miRNA,-1,76,chr6_47803576_47803652
Mir7044,6,118085192,118085263,miRNA,1,71,chr6_118085192_118085263
Mir7045,6,125097024,125097086,miRNA,1,62,chr6_125097024_125097086
Mir7046,7,24970010,24970075,miRNA,-1,65,chr7_24970010_24970075
Mir7048,7,25217668,25217725,miRNA,-1,57,chr7_25217668_25217725
Mir7049,7,28560925,28560984,miRNA,-1,59,chr7_28560925_28560984
Mir7050,7,31040258,31040317,miRNA,-1,59,chr7_31040258_31040317
Mir7051,7,43457497,43457569,miRNA,1,72,chr7_43457497_43457569
Mir7052,7,44470347,44470411,miRNA,1,64,chr7_44470347_44470411
Mir7054,7,45012426,45012487,miRNA,-1,61,chr7_45012426_45012487
Mir7056,7,47083166,47083224,miRNA,-1,58,chr7_47083166_47083224
Mir7058,7,126367971,126368045,miRNA,-1,74,chr7_126367971_126368045
Mir7059,7,126579474,126579532,miRNA,-1,58,chr7_126579474_126579532
Mir706,6,120034228,120034311,miRNA,-1,83,chr6_120034228_120034311
Mir7060,7,127489251,127489387,miRNA,1,136,chr7_127489251_127489387
Mir7061,7,130908268,130908335,miRNA,1,67,chr7_130908268_130908335
Mir7063,7,141620701,141620791,miRNA,1,90,chr7_141620701_141620791
Mir7067,8,70895508,70895570,miRNA,-1,62,chr8_70895508_70895570
Mir7068,8,72470016,72470089,miRNA,-1,73,chr8_72470016_72470089
Mir7069,8,84867947,84868008,miRNA,1,61,chr8_84867947_84868008
Mir7071,8,88138206,88138274,miRNA,1,68,chr8_88138206_88138274
Mir7075,8,107096025,107096106,miRNA,-1,81,chr8_107096025_107096106
Mir7078,8,117459265,117459328,miRNA,1,63,chr8_117459265_117459328
Mir7079,8,123104975,123105043,miRNA,1,68,chr8_123104975_123105043
Mir708,7,96249424,96249532,miRNA,1,108,chr7_96249424_96249532
Mir7080,8,123130106,123130172,miRNA,1,66,chr8_123130106_123130172
Mir7082,9,21075497,21075588,miRNA,-1,91,chr9_21075497_21075588
Mir7087,9,45939521,45939590,miRNA,-1,69,chr9_45939521_45939590
Mir7089,9,109889643,109889710,miRNA,1,67,chr9_109889643_109889710
Mir709,8,84086099,84086186,miRNA,1,87,chr8_84086099_84086186
Mir7090,9,120955086,120955147,miRNA,1,61,chr9_120955086_120955147
Mir7092,X,74317362,74317429,miRNA,1,67,chrX_74317362_74317429
Mir7093,X,134757631,134757731,miRNA,1,100,chrX_134757631_134757731
Mir7115,11,70438255,70438318,miRNA,1,63,chr11_70438255_70438318
Mir718,X,74023849,74023936,miRNA,-1,87,chrX_74023849_74023936
Mir719,14,60228806,60228915,miRNA,-1,109,chr14_60228806_60228915
Mir721,5,136375716,136375803,miRNA,-1,87,chr5_136375716_136375803
Mir7211,10,94586137,94586199,miRNA,-1,62,chr10_94586137_94586199
Mir7212,15,25948227,25948287,miRNA,1,60,chr15_25948227_25948287
Mir7215,10,62682508,62682558,miRNA,1,50,chr10_62682508_62682558
Mir7220,18,60953873,60953932,miRNA,1,59,chr18_60953873_60953932
Mir7223,11,107996848,107996916,miRNA,1,68,chr11_107996848_107996916
Mir7224,2,67675457,67675516,miRNA,1,59,chr2_67675457_67675516
Mir7227,4,133717050,133717108,miRNA,-1,58,chr4_133717050_133717108
Mir7229,5,113324493,113324545,miRNA,-1,52,chr5_113324493_113324545
Mir7233,6,127788084,127788143,miRNA,-1,59,chr6_127788084_127788143
Mir7236,11,121387145,121387204,miRNA,-1,59,chr11_121387145_121387204
Mir7237,8,121978024,121978086,miRNA,1,62,chr8_121978024_121978086
Mir7239,11,46170087,46170143,miRNA,1,56,chr11_46170087_46170143
Mir7240,8,70798130,70798192,miRNA,1,62,chr8_70798130_70798192
Mir7243,9,102304924,102304975,miRNA,-1,51,chr9_102304924_102304975
Mir744,11,65734733,65734832,miRNA,-1,99,chr11_65734733_65734832
Mir7578,2,27450549,27450630,miRNA,-1,81,chr2_27450549_27450630
Mir758,12,109712810,109712890,miRNA,1,80,chr12_109712810_109712890
Mir761,4,109017655,109017730,miRNA,1,75,chr4_109017655_109017730
Mir763,10,120447991,120448110,miRNA,-1,119,chr10_120447991_120448110
Mir764,X,147002259,147002366,miRNA,1,107,chrX_147002259_147002366
Mir7647,5,123522637,123522695,miRNA,-1,58,chr5_123522637_123522695
Mir7651,11,6401630,6401693,miRNA,1,63,chr11_6401630_6401693
Mir7652,11,55501226,55501281,miRNA,1,55,chr11_55501226_55501281
Mir7656,9,94751829,94751890,miRNA,1,61,chr9_94751829_94751890
Mir7661,6,108489743,108489803,miRNA,1,60,chr6_108489743_108489803
Mir7662,10,62194167,62194227,miRNA,-1,60,chr10_62194167_62194227
Mir7663,10,22729372,22729432,miRNA,-1,60,chr10_22729372_22729432
Mir7664,2,25059811,25059873,miRNA,1,62,chr2_25059811_25059873
Mir7667,17,29595538,29595600,miRNA,1,62,chr17_29595538_29595600
Mir7669,3,90011153,90011210,miRNA,-1,57,chr3_90011153_90011210
Mir7674,2,32050946,32051008,miRNA,1,62,chr2_32050946_32051008
Mir7675,12,11299887,11299944,miRNA,1,57,chr12_11299887_11299944
Mir7681,1,53849424,53849495,miRNA,1,71,chr1_53849424_53849495
Mir7682,1,151442393,151442450,miRNA,1,57,chr1_151442393_151442450
Mir7686,7,139957566,139957622,miRNA,-1,56,chr7_139957566_139957622
Mir7688,10,93433107,93433162,miRNA,1,55,chr10_93433107_93433162
Mir7b,17,56242988,56243098,miRNA,1,110,chr17_56242988_56243098
Mir804,11,50357785,50357879,miRNA,-1,94,chr11_50357785_50357879
Mir8094,17,35251289,35251405,miRNA,1,116,chr17_35251289_35251405
Mir8095,16,22532056,22532184,miRNA,-1,128,chr16_22532056_22532184
Mir8102,11,97744897,97745035,miRNA,1,138,chr11_97744897_97745035
Mir8106,9,122273890,122274028,miRNA,-1,138,chr9_122273890_122274028
Mir8109,8,85700905,85701021,miRNA,1,116,chr8_85700905_85701021
Mir8110,8,89024735,89024831,miRNA,1,96,chr8_89024735_89024831
Mir8111,8,84005628,84005764,miRNA,1,136,chr8_84005628_84005764
Mir8114,1,153899926,153900036,miRNA,1,110,chr1_153899926_153900036
Mir8116,5,137293780,137293876,miRNA,1,96,chr5_137293780_137293876
Mir8120,3,65659288,65659426,miRNA,1,138,chr3_65659288_65659426
Mir872,4,94665157,94665237,miRNA,1,80,chr4_94665157_94665237
Mir875,15,35660970,35661047,miRNA,-1,77,chr15_35660970_35661047
Mir876,4,36645373,36645453,miRNA,-1,80,chr4_36645373_36645453
Mir879,5,9375704,9375779,miRNA,1,75,chr5_9375704_9375779
Mir9-1,3,88215598,88215686,miRNA,1,88,chr3_88215598_88215686
Mir9-2,13,83738814,83738885,miRNA,1,71,chr13_83738814_83738885
Mir9-3,7,79505264,79505353,miRNA,1,89,chr7_79505264_79505353
Mir92b,3,89227116,89227198,miRNA,-1,82,chr3_89227116_89227198
Mir93,5,138165523,138165610,miRNA,-1,87,chr5_138165523_138165610
Mir99a,16,77598936,77599000,miRNA,1,64,chr16_77598936_77599000
Mir99ahg,16,77236317,77773427,processed_transcript,1,537110,chr16_77236317_77773427
Mirg,12,109729764,109749460,lincRNA,1,19696,chr12_109729764_109749460
Mirlet7a-1,13,48538179,48538272,miRNA,-1,93,chr13_48538179_48538272
Mirlet7a-2,9,41536716,41536811,miRNA,1,95,chr9_41536716_41536811
Mirlet7c-1,16,77599657,77599750,miRNA,1,93,chr16_77599657_77599750
Mirlet7d,13,48536012,48536114,miRNA,-1,102,chr13_48536012_48536114
Mirlet7f-1,13,48537829,48537917,miRNA,-1,88,chr13_48537829_48537917
Mirlet7f-2,X,151912346,151912428,miRNA,1,82,chrX_151912346_151912428
Mirlet7g,9,106178840,106178927,miRNA,1,87,chr9_106178840_106178927
Mirlet7i,10,122985640,122985724,miRNA,-1,84,chr10_122985640_122985724
Mis12,11,71019611,71027371,protein_coding,1,7760,chr11_71019611_71027371
Mis18a,16,90719312,90727404,protein_coding,-1,8092,chr16_90719312_90727404
Mis18bp1,12,65132734,65172604,protein_coding,-1,39870,chr12_65132734_65172604
Misp,10,79820989,79830490,protein_coding,1,9501,chr10_79820989_79830490
Mitd1,1,37874801,37890411,protein_coding,-1,15610,chr1_37874801_37890411
Mitf,6,97807052,98021349,protein_coding,1,214297,chr6_97807052_98021349
Mixl1,1,180693043,180697034,protein_coding,-1,3991,chr1_180693043_180697034
Mki67,7,135689784,135716361,protein_coding,-1,26577,chr7_135689784_135716361
Mkks,2,136873780,136891389,protein_coding,-1,17609,chr2_136873780_136891389
Mkln1,6,31398735,31516811,protein_coding,1,118076,chr6_31398735_31516811
Mkln1os,6,31366885,31398773,lincRNA,-1,31888,chr6_31366885_31398773
Mknk1,4,115839198,115879250,protein_coding,1,40052,chr4_115839198_115879250
Mknk2,10,80665327,80678112,protein_coding,-1,12785,chr10_80665327_80678112
Mkrn1,6,39397804,39420462,protein_coding,-1,22658,chr6_39397804_39420462
Mkrn1-ps1,5,88838010,88839399,processed_pseudogene,-1,1389,chr5_88838010_88839399
Mkrn2,6,115601902,115622624,protein_coding,1,20722,chr6_115601902_115622624
Mkrn2os,6,115583544,115592576,protein_coding,-1,9032,chr6_115583544_115592576
Mkrn3,7,62417593,62420139,protein_coding,-1,2546,chr7_62417593_62420139
Mks1,11,87853215,87863803,protein_coding,1,10588,chr11_87853215_87863803
Mkx,18,6934518,7004780,protein_coding,-1,70262,chr18_6934518_7004780
Mlana,19,29697824,29708634,protein_coding,1,10810,chr19_29697824_29708634
Mlc1,15,88955884,88979007,protein_coding,-1,23123,chr15_88955884_88979007
Mlec,5,115142981,115158179,protein_coding,-1,15198,chr5_115142981_115158179
Mlf1,3,67374097,67400003,protein_coding,1,25906,chr3_67374097_67400003
Mlf2,6,124931386,124937238,protein_coding,1,5852,chr6_124931386_124937238
Mlh1,9,111228228,111271791,protein_coding,-1,43563,chr9_111228228_111271791
Mlh3,12,85234520,85270599,protein_coding,-1,36079,chr12_85234520_85270599
Mlip,9,77102081,77352969,protein_coding,-1,250888,chr9_77102081_77352969
Mlkl,8,111311797,111338177,protein_coding,-1,26380,chr8_111311797_111338177
Mllt1,17,56892611,56935415,protein_coding,-1,42804,chr17_56892611_56935415
Mllt10,2,18055237,18212388,protein_coding,1,157151,chr2_18055237_18212388
Mllt11,3,95219135,95232171,protein_coding,-1,13036,chr3_95219135_95232171
Mllt3,4,87769925,88033364,protein_coding,-1,263439,chr4_87769925_88033364
Mllt6,11,97663414,97685463,protein_coding,1,22049,chr11_97663414_97685463
Mlph,1,90915085,90951142,protein_coding,1,36057,chr1_90915085_90951142
Mlst8,17,24473551,24479078,protein_coding,-1,5527,chr17_24473551_24479078
Mlx,11,101087277,101092207,protein_coding,1,4930,chr11_101087277_101092207
Mlxip,5,123394798,123457932,protein_coding,1,63134,chr5_123394798_123457932
Mlxipl,5,135089890,135138382,protein_coding,1,48492,chr5_135089890_135138382
Mlycd,8,119394878,119411102,protein_coding,1,16224,chr8_119394878_119411102
Mmaa,8,79263598,79294937,protein_coding,-1,31339,chr8_79263598_79294937
Mmab,5,114431034,114444060,protein_coding,-1,13026,chr5_114431034_114444060
Mmachc,4,116702279,116708406,protein_coding,-1,6127,chr4_116702279_116708406
Mmadhc,2,50279881,50296801,protein_coding,-1,16920,chr2_50279881_50296801
Mmd,11,90249456,90278589,protein_coding,1,29133,chr11_90249456_90278589
Mmd2,5,142562358,142608800,protein_coding,-1,46442,chr5_142562358_142608800
Mme,3,63241537,63386030,protein_coding,1,144493,chr3_63241537_63386030
Mmel1,4,154869585,154895528,protein_coding,1,25943,chr4_154869585_154895528
Mmgt1,X,56585512,56598069,protein_coding,-1,12557,chrX_56585512_56598069
Mmgt2,11,62648664,62666354,protein_coding,1,17690,chr11_62648664_62666354
Mmp10,9,7502352,7510240,protein_coding,1,7888,chr9_7502352_7510240
Mmp11,10,75923222,75936496,protein_coding,-1,13274,chr10_75923222_75936496
Mmp13,9,7272514,7283331,protein_coding,1,10817,chr9_7272514_7283331
Mmp14,14,54431612,54445364,protein_coding,1,13752,chr14_54431612_54445364
Mmp15,8,95352268,95375080,protein_coding,1,22812,chr8_95352268_95375080
Mmp16,4,17852893,18119145,protein_coding,1,266252,chr4_17852893_18119145
Mmp17,5,129584169,129611099,protein_coding,1,26930,chr5_129584169_129611099
Mmp19,10,128790910,128800824,protein_coding,1,9914,chr10_128790910_128800824
Mmp2,8,92827291,92853420,protein_coding,1,26129,chr8_92827291_92853420
Mmp21,7,133674270,133680061,protein_coding,-1,5791,chr7_133674270_133680061
Mmp23,4,155650655,155653384,protein_coding,-1,2729,chr4_155650655_155653384
Mmp24,2,155775342,155818366,protein_coding,1,43024,chr2_155775342_155818366
Mmp25,17,23628311,23645277,protein_coding,-1,16966,chr17_23628311_23645277
Mmp28,11,83440768,83463071,protein_coding,-1,22303,chr11_83440768_83463071
Mmp8,9,7558456,7568485,protein_coding,1,10029,chr9_7558456_7568485
Mmp9,2,164940780,164955850,protein_coding,1,15070,chr2_164940780_164955850
Mmrn1,6,60924976,60989378,protein_coding,1,64402,chr6_60924976_60989378
Mmrn2,14,34375465,34404287,protein_coding,1,28822,chr14_34375465_34404287
Mms19,19,41941086,41981157,protein_coding,-1,40071,chr19_41941086_41981157
Mms22l,4,24496451,24602950,protein_coding,1,106499,chr4_24496451_24602950
Mn1,5,111417362,111457033,protein_coding,1,39671,chr5_111417362_111457033
Mnat1,12,73123717,73273988,protein_coding,1,150271,chr12_73123717_73273988
Mnd1,3,84087933,84155786,protein_coding,-1,67853,chr3_84087933_84155786
Mnd1-ps,14,9884195,9886768,transcribed_processed_pseudogene,1,2573,chr14_9884195_9886768
Mndal,1,173849126,173880881,protein_coding,-1,31755,chr1_173849126_173880881
Mns1,9,72438011,72462025,protein_coding,1,24014,chr9_72438011_72462025
Mnt,11,74830920,74845725,protein_coding,1,14805,chr11_74830920_74845725
Moap1,12,102742230,102743661,protein_coding,-1,1431,chr12_102742230_102743661
Mob1a,6,83326016,83343776,protein_coding,1,17760,chr6_83326016_83343776
Mob1b,5,88720855,88764220,protein_coding,1,43365,chr5_88720855_88764220
Mob2,7,142008535,142061065,protein_coding,-1,52530,chr7_142008535_142061065
Mob3a,10,80685253,80701977,protein_coding,-1,16724,chr10_80685253_80701977
Mob3b,4,34949074,35157484,protein_coding,-1,208410,chr4_34949074_35157484
Mob3c,4,115828092,115836185,protein_coding,1,8093,chr4_115828092_115836185
Mob4,1,55131231,55154899,protein_coding,1,23668,chr1_55131231_55154899
Mobp,9,120149707,120181484,protein_coding,1,31777,chr9_120149707_120181484
Mocos,18,24653691,24701575,protein_coding,1,47884,chr18_24653691_24701575
Mocs1,17,49428362,49455435,protein_coding,1,27073,chr17_49428362_49455435
Mocs2,13,114818236,114832275,protein_coding,1,14039,chr13_114818236_114832275
Mocs3,2,168230622,168232594,protein_coding,1,1972,chr2_168230622_168232594
Mog,17,37010743,37023398,protein_coding,-1,12655,chr17_37010743_37023398
Mogat1,1,78510991,78538173,protein_coding,1,27182,chr1_78510991_78538173
Mogs,6,83115496,83118898,protein_coding,1,3402,chr6_83115496_83118898
Mok,12,110807798,110840939,protein_coding,-1,33141,chr12_110807798_110840939
Mon1a,9,107888151,107903139,protein_coding,1,14988,chr9_107888151_107903139
Mon1b,8,113635587,113645179,protein_coding,1,9592,chr8_113635587_113645179
Mon2,10,122992060,123076505,protein_coding,-1,84445,chr10_122992060_123076505
Morc1,16,48431237,48630900,protein_coding,1,199663,chr16_48431237_48630900
Morc2a,11,3649191,3690477,protein_coding,1,41286,chr11_3649191_3690477
Morc2b,17,33113351,33139683,protein_coding,-1,26332,chr17_33113351_33139683
Morc3,16,93832121,93876073,protein_coding,1,43952,chr16_93832121_93876073
Morc4,X,139821632,139871677,protein_coding,-1,50045,chrX_139821632_139871677
Morf4l1,9,90091665,90114774,protein_coding,-1,23109,chr9_90091665_90114774
Morf4l2,X,136732942,136743690,protein_coding,-1,10748,chrX_136732942_136743690
Morn1,4,155086577,155145505,protein_coding,1,58928,chr4_155086577_155145505
Morn2,17,80290203,80297476,protein_coding,1,7273,chr17_80290203_80297476
Morn3,5,123035769,123047016,protein_coding,-1,11247,chr5_123035769_123047016
Morn4,19,42074939,42086357,protein_coding,-1,11418,chr19_42074939_42086357
Morn5,2,36049458,36079718,protein_coding,1,30260,chr2_36049458_36079718
Mos,4,3870657,3872105,protein_coding,-1,1448,chr4_3870657_3872105
Mospd1,X,53344598,53370502,protein_coding,-1,25904,chrX_53344598_53370502
Mospd2,X,164936169,164980375,protein_coding,-1,44206,chrX_164936169_164980375
Mospd3,5,137596645,137601058,protein_coding,-1,4413,chr5_137596645_137601058
Mospd4,18,46465215,46465790,processed_pseudogene,-1,575,chr18_46465215_46465790
Mov10,3,104794836,104818563,protein_coding,-1,23727,chr3_104794836_104818563
Mov10l1,15,88982909,89055152,protein_coding,1,72243,chr15_88982909_89055152
Moxd1,10,24223517,24302790,protein_coding,1,79273,chr10_24223517_24302790
Mpc1,17,8282904,8297661,protein_coding,1,14757,chr17_8282904_8297661
Mpc1-ps,12,110858565,110858894,processed_pseudogene,-1,329,chr12_110858565_110858894
Mpc2,1,165460637,165481214,protein_coding,1,20577,chr1_165460637_165481214
Mpdu1,11,69656697,69662642,protein_coding,-1,5945,chr11_69656697_69662642
Mpdz,4,81278500,81442815,protein_coding,-1,164315,chr4_81278500_81442815
Mpeg1,19,12460779,12465283,protein_coding,1,4504,chr19_12460779_12465283
Mpg,11,32226505,32232700,protein_coding,1,6195,chr11_32226505_32232700
Mphosph10,7,64376527,64392268,protein_coding,-1,15741,chr7_64376527_64392268
Mphosph6,8,117791645,117801943,protein_coding,-1,10298,chr8_117791645_117801943
Mphosph8,14,56668248,56697430,protein_coding,1,29182,chr14_56668248_56697430
Mphosph9,5,124250959,124327972,protein_coding,-1,77013,chr5_124250959_124327972
Mpi,9,57544256,57552763,protein_coding,-1,8507,chr9_57544256_57552763
Mpl,4,118442415,118457513,protein_coding,-1,15098,chr4_118442415_118457513
Mplkip,13,17695192,17699748,protein_coding,1,4556,chr13_17695192_17699748
Mpnd,17,56005711,56016790,protein_coding,1,11079,chr17_56005711_56016790
Mpo,11,87793581,87804413,protein_coding,1,10832,chr11_87793581_87804413
Mpp1,X,75109733,75131016,protein_coding,-1,21283,chrX_75109733_75131016
Mpp2,11,102057015,102088515,protein_coding,-1,31500,chr11_102057015_102088515
Mpp3,11,101999652,102028461,protein_coding,-1,28809,chr11_101999652_102028461
Mpp4,1,59120935,59163389,protein_coding,-1,42454,chr1_59120935_59163389
Mpp5,12,78748907,78840714,protein_coding,1,91807,chr12_78748907_78840714
Mpp6,6,50110241,50198939,protein_coding,1,88698,chr6_50110241_50198939
Mpp7,18,7347959,7626866,protein_coding,-1,278907,chr18_7347959_7626866
Mppe1,18,67225043,67245830,protein_coding,-1,20787,chr18_67225043_67245830
Mpped1,15,83779467,83858494,protein_coding,1,79027,chr15_83779467_83858494
Mpped2,2,106693269,106868356,protein_coding,1,175087,chr2_106693269_106868356
Mprip,11,59661305,59780860,protein_coding,1,119555,chr11_59661305_59780860
Mpst,15,78406416,78414013,protein_coding,1,7597,chr15_78406416_78414013
Mpv17,5,31140654,31154251,protein_coding,-1,13597,chr5_31140654_31154251
Mpv17l,16,13903161,13949619,protein_coding,1,46458,chr16_13903161_13949619
Mpv17l2,8,70758646,70760946,protein_coding,-1,2300,chr8_70758646_70760946
Mpz,1,171150711,171161130,protein_coding,1,10419,chr1_171150711_171161130
Mpzl1,1,165592240,165634538,protein_coding,-1,42298,chr1_165592240_165634538
Mpzl2,9,45039799,45054015,protein_coding,1,14216,chr9_45039799_45054015
Mpzl3,9,45055186,45077436,protein_coding,1,22250,chr9_45055186_45077436
Mr1,1,155127277,155146814,protein_coding,-1,19537,chr1_155127277_155146814
Mrap,16,90738207,90749785,protein_coding,1,11578,chr16_90738207_90749785
Mrap2,9,87144306,87184045,protein_coding,1,39739,chr9_87144306_87184045
Mras,9,99385420,99437381,protein_coding,-1,51961,chr9_99385420_99437381
Mrc1,2,14229392,14332057,protein_coding,1,102665,chr2_14229392_14332057
Mrc2,11,105292643,105351139,protein_coding,1,58496,chr11_105292643_105351139
Mre11a,9,14784654,14837123,protein_coding,1,52469,chr9_14784654_14837123
Mreg,1,72159442,72212307,protein_coding,-1,52865,chr1_72159442_72212307
Mrfap1,5,36794867,36796772,protein_coding,-1,1905,chr5_36794867_36796772
Mrgbp,2,180581304,180586304,protein_coding,1,5000,chr2_180581304_180586304
Mrgprb1,7,48444113,48456342,protein_coding,-1,12229,chr7_48444113_48456342
Mrgprc7-ps,7,47810037,47810988,unprocessed_pseudogene,1,951,chr7_47810037_47810988
Mrgpre,7,143778363,143784500,protein_coding,-1,6137,chr7_143778363_143784500
Mrgprf,7,145300828,145309557,protein_coding,1,8729,chr7_145300828_145309557
Mri1,8,84249906,84257326,protein_coding,-1,7420,chr8_84249906_84257326
Mrm1,11,84813061,84819515,protein_coding,-1,6454,chr11_84813061_84819515
Mro,18,73859385,73881333,protein_coding,1,21948,chr18_73859385_73881333
Mroh1,15,76380261,76453038,protein_coding,1,72777,chr15_76380261_76453038
Mroh2a,1,88226986,88262289,protein_coding,1,35303,chr1_88226986_88262289
Mroh2b,15,4898737,4962205,protein_coding,1,63468,chr15_4898737_4962205
Mroh4,15,74606029,74636353,protein_coding,-1,30324,chr15_74606029_74636353
Mroh5,15,73760067,73839699,protein_coding,-1,79632,chr15_73760067_73839699
Mroh6,15,75884137,75888770,protein_coding,-1,4633,chr15_75884137_75888770
Mroh7,4,106680417,106730925,protein_coding,-1,50508,chr4_106680417_106730925
Mroh8,2,157208550,157279549,protein_coding,-1,70999,chr2_157208550_157279549
Mrpl1,5,96209493,96266727,protein_coding,1,57234,chr5_96209493_96266727
Mrpl10,11,97041560,97049213,protein_coding,1,7653,chr11_97041560_97049213
Mrpl11,19,4962147,4966999,protein_coding,1,4852,chr19_4962147_4966999
Mrpl12,11,120484613,120489065,protein_coding,1,4452,chr11_120484613_120489065
Mrpl13,15,55534094,55557748,protein_coding,-1,23654,chr15_55534094_55557748
Mrpl14,17,45686322,45698495,protein_coding,1,12173,chr17_45686322_45698495
Mrpl15,1,4773206,4785739,protein_coding,-1,12533,chr1_4773206_4785739
Mrpl16,19,11770391,11774960,protein_coding,1,4569,chr19_11770391_11774960
Mrpl17,7,105803206,105811099,protein_coding,-1,7893,chr7_105803206_105811099
Mrpl18,17,12911349,12916345,protein_coding,-1,4996,chr17_12911349_12916345
Mrpl19,6,81957851,81965958,protein_coding,-1,8107,chr6_81957851_81965958
Mrpl2,17,46646229,46650139,protein_coding,1,3910,chr17_46646229_46650139
Mrpl20,4,155802878,155809975,protein_coding,1,7097,chr4_155802878_155809975
Mrpl21,19,3282901,3292837,protein_coding,1,9936,chr19_3282901_3292837
Mrpl22,11,58171661,58179565,protein_coding,1,7904,chr11_58171661_58179565
Mrpl23,7,142532686,142540747,protein_coding,1,8061,chr7_142532686_142540747
Mrpl23-ps1,2,74591330,74591909,processed_pseudogene,-1,579,chr2_74591330_74591909
Mrpl24,3,87919506,87923672,protein_coding,1,4166,chr3_87919506_87923672
Mrpl27,11,94653767,94660089,protein_coding,1,6322,chr11_94653767_94660089
Mrpl28,17,26123500,26126613,protein_coding,1,3113,chr17_26123500_26126613
Mrpl3,9,105053239,105079888,protein_coding,1,26649,chr9_105053239_105079888
Mrpl30,1,37890477,37898535,protein_coding,1,8058,chr1_37890477_37898535
Mrpl32,13,14608184,14613165,protein_coding,-1,4981,chr13_14608184_14613165
Mrpl33,5,31596935,31664384,protein_coding,1,67449,chr5_31596935_31664384
Mrpl34,8,71464959,71465747,protein_coding,1,788,chr8_71464959_71465747
Mrpl35,6,71812997,71826969,protein_coding,-1,13972,chr6_71812997_71826969
Mrpl36,13,73328513,73332178,protein_coding,1,3665,chr13_73328513_73332178
Mrpl37,4,107055874,107066868,protein_coding,-1,10994,chr4_107055874_107066868
Mrpl38,11,116131817,116138868,protein_coding,-1,7051,chr11_116131817_116138868
Mrpl39,16,84717576,84735742,protein_coding,-1,18166,chr16_84717576_84735742
Mrpl4,9,21002738,21008839,protein_coding,1,6101,chr9_21002738_21008839
Mrpl40,16,18872018,18876862,protein_coding,-1,4844,chr16_18872018_18876862
Mrpl41,2,24974117,24975098,protein_coding,-1,981,chr2_24974117_24975098
Mrpl42,10,95480805,95501940,protein_coding,-1,21135,chr10_95480805_95501940
Mrpl43,19,45004829,45006442,protein_coding,-1,1613,chr19_45004829_45006442
Mrpl44,1,79776018,79781445,protein_coding,1,5427,chr1_79776018_79781445
Mrpl45,11,97315716,97329920,protein_coding,1,14204,chr11_97315716_97329920
Mrpl46,7,78775236,78783531,protein_coding,-1,8295,chr7_78775236_78783531
Mrpl47,3,32725397,32737605,protein_coding,-1,12208,chr3_32725397_32737605
Mrpl48,7,100545751,100608301,protein_coding,-1,62550,chr7_100545751_100608301
Mrpl48-ps,4,88599175,88599810,processed_pseudogene,-1,635,chr4_88599175_88599810
Mrpl49,19,6053622,6057785,protein_coding,-1,4163,chr19_6053622_6057785
Mrpl50,4,49512596,49521093,protein_coding,-1,8497,chr4_49512596_49521093
Mrpl51,6,125191801,125196269,protein_coding,1,4468,chr6_125191801_125196269
Mrpl52,14,54426909,54429756,protein_coding,1,2847,chr14_54426909_54429756
Mrpl53,6,83109040,83109939,protein_coding,1,899,chr6_83109040_83109939
Mrpl54,10,81264713,81266934,protein_coding,-1,2221,chr10_81264713_81266934
Mrpl55,11,59202486,59206134,protein_coding,1,3648,chr11_59202486_59206134
Mrpl57,14,57826234,57829296,protein_coding,1,3062,chr14_57826234_57829296
Mrpl9,3,94443318,94451130,protein_coding,1,7812,chr3_94443318_94451130
Mrps10,17,47368886,47381417,protein_coding,1,12531,chr17_47368886_47381417
Mrps11,7,78783119,78792989,protein_coding,1,9870,chr7_78783119_78792989
Mrps12,7,28739641,28741820,protein_coding,-1,2179,chr7_28739641_28741820
Mrps14,1,160195215,160202170,protein_coding,1,6955,chr1_160195215_160202170
Mrps15,4,126046925,126055532,protein_coding,1,8607,chr4_126046925_126055532
Mrps16,14,20389304,20393634,protein_coding,-1,4330,chr14_20389304_20393634
Mrps17,5,129715497,129722556,protein_coding,1,7059,chr5_129715497_129722556
Mrps18a,17,46110986,46128910,protein_coding,1,17924,chr17_46110986_46128910
Mrps18b,17,35910379,35916389,protein_coding,-1,6010,chr17_35910379_35916389
Mrps18c,5,100798627,100804471,protein_coding,1,5844,chr5_100798627_100804471
Mrps2,2,28468066,28471178,protein_coding,1,3112,chr2_28468066_28471178
Mrps21,3,95862634,95871519,protein_coding,-1,8885,chr3_95862634_95871519
Mrps22,9,98588730,98601660,protein_coding,-1,12930,chr9_98588730_98601660
Mrps23,11,88204388,88211507,protein_coding,1,7119,chr11_88204388_88211507
Mrps24,11,5703983,5715680,protein_coding,-1,11697,chr11_5703983_5715680
Mrps25,6,92169525,92184033,protein_coding,-1,14508,chr6_92169525_92184033
Mrps26,2,130563742,130568695,protein_coding,1,4953,chr2_130563742_130568695
Mrps27,13,99344786,99415562,protein_coding,1,70776,chr13_99344786_99415562
Mrps28,3,8802146,8923918,protein_coding,-1,121772,chr3_8802146_8923918
Mrps30,13,118378381,118387252,protein_coding,-1,8871,chr13_118378381_118387252
Mrps31,8,22411361,22429665,protein_coding,1,18304,chr8_22411361_22429665
Mrps33,6,39801804,39810988,protein_coding,-1,9184,chr6_39801804_39810988
Mrps34,17,24895116,24897502,protein_coding,1,2386,chr17_24895116_24897502
Mrps35,6,147042764,147073991,protein_coding,1,31227,chr6_147042764_147073991
Mrps36,13,100735955,100744659,protein_coding,-1,8704,chr13_100735955_100744659
Mrps36-ps1,17,53866715,53867020,processed_pseudogene,-1,305,chr17_53866715_53867020
Mrps36-ps2,7,105690259,105690567,processed_pseudogene,-1,308,chr7_105690259_105690567
Mrps5,2,127587222,127606829,protein_coding,1,19607,chr2_127587222_127606829
Mrps6,16,92058270,92112227,protein_coding,1,53957,chr16_92058270_92112227
Mrps7,11,115603925,115608036,protein_coding,1,4111,chr11_115603925_115608036
Mrps9,1,42851233,42905683,protein_coding,1,54450,chr1_42851233_42905683
Mrrf,2,36136389,36190647,protein_coding,1,54258,chr2_36136389_36190647
Mrs2,13,24987483,25020379,protein_coding,-1,32896,chr13_24987483_25020379
Mrto4,4,139347435,139352576,protein_coding,-1,5141,chr4_139347435_139352576
Mrvi1,7,110868266,110982461,protein_coding,-1,114195,chr7_110868266_110982461
Ms4a1,19,11249675,11266241,protein_coding,-1,16566,chr19_11249675_11266241
Ms4a14,19,11301249,11314454,protein_coding,-1,13205,chr19_11301249_11314454
Ms4a15,19,10978307,10993250,protein_coding,-1,14943,chr19_10978307_10993250
Ms4a4a,19,11375523,11392790,protein_coding,1,17267,chr19_11375523_11392790
Ms4a4b,19,11443553,11467055,protein_coding,1,23502,chr19_11443553_11467055
Ms4a6b,19,11516512,11531256,protein_coding,1,14744,chr19_11516512_11531256
Ms4a6c,19,11469366,11482192,protein_coding,1,12826,chr19_11469366_11482192
Ms4a6d,19,11586604,11604849,protein_coding,-1,18245,chr19_11586604_11604849
Ms4a7,19,11321039,11336146,protein_coding,-1,15107,chr19_11321039_11336146
Ms4a8a,19,11067471,11081102,protein_coding,-1,13631,chr19_11067471_11081102
Msantd1,5,34908012,34923839,protein_coding,1,15827,chr5_34908012_34923839
Msantd2,9,37489021,37524625,protein_coding,1,35604,chr9_37489021_37524625
Msantd3,4,48539935,48561919,protein_coding,1,21984,chr4_48539935_48561919
Msantd4,9,4376562,4386870,protein_coding,1,10308,chr9_4376562_4386870
Msc,1,14753346,14755992,protein_coding,-1,2646,chr1_14753346_14755992
Msh2,17,87672330,87723713,protein_coding,1,51383,chr17_87672330_87723713
Msh3,13,92211872,92355003,protein_coding,-1,143131,chr13_92211872_92355003
Msh4,3,153857149,153906138,protein_coding,-1,48989,chr3_153857149_153906138
Msh5,17,35028605,35046745,protein_coding,-1,18140,chr17_35028605_35046745
Msh6,17,87975062,87990892,protein_coding,1,15830,chr17_87975062_87990892
Msi1,5,115429599,115455698,protein_coding,1,26099,chr5_115429599_115455698
Msi2,11,88339382,88718513,protein_coding,-1,379131,chr11_88339382_88718513
Msl1,11,98795516,98807859,protein_coding,1,12343,chr11_98795516_98807859
Msl2,9,101074101,101104800,protein_coding,1,30699,chr9_101074101_101104800
Msl3,X,168654117,168673898,protein_coding,-1,19781,chrX_168654117_168673898
Msl3l2,10,56106917,56116880,protein_coding,1,9963,chr10_56106917_56116880
Msln,17,25748613,25754378,protein_coding,-1,5765,chr17_25748613_25754378
Mslnl,17,25736042,25748330,protein_coding,1,12288,chr17_25736042_25748330
Msmb,14,32142023,32158370,protein_coding,1,16347,chr14_32142023_32158370
Msmo1,8,64718139,64733792,protein_coding,-1,15653,chr8_64718139_64733792
Msn,X,96096042,96168552,protein_coding,1,72510,chrX_96096042_96168552
Msra,14,64122625,64455903,protein_coding,-1,333278,chr14_64122625_64455903
Msrb1,17,24736642,24742778,protein_coding,1,6136,chr17_24736642_24742778
Msrb2,2,19371440,19394976,protein_coding,1,23536,chr2_19371440_19394976
Msrb3,10,120781096,120899101,protein_coding,-1,118005,chr10_120781096_120899101
Mss51,14,20482867,20496901,protein_coding,-1,14034,chr14_20482867_20496901
Mst1,9,108080436,108085003,protein_coding,1,4567,chr9_108080436_108085003
Mst1r,9,107906873,107920383,protein_coding,1,13510,chr9_107906873_107920383
Mstn,1,53061640,53068079,protein_coding,1,6439,chr1_53061640_53068079
Msto1,3,88905107,88913999,protein_coding,-1,8892,chr3_88905107_88913999
Msx2,13,53466884,53473074,protein_coding,-1,6190,chr13_53466884_53473074
Mt1,8,94179082,94180327,protein_coding,1,1245,chr8_94179082_94180327
Mt2,8,94172664,94173568,protein_coding,1,904,chr8_94172664_94173568
Mt3,8,94152607,94154146,protein_coding,1,1539,chr8_94152607_94154146
Mta1,12,113098278,113137206,protein_coding,1,38928,chr12_113098278_113137206
Mta2,19,8941875,8952303,protein_coding,1,10428,chr19_8941875_8952303
Mta3,17,83706163,83821516,protein_coding,1,115353,chr17_83706163_83821516
Mtag2,7,45366163,45367948,antisense,1,1785,chr7_45366163_45367948
Mtap,4,89137122,89181081,protein_coding,1,43959,chr4_89137122_89181081
Mtbp,15,55557408,55626423,protein_coding,1,69015,chr15_55557408_55626423
Mtch1,17,29332072,29347934,protein_coding,-1,15862,chr17_29332072_29347934
Mtch2,2,90847155,90866810,protein_coding,1,19655,chr2_90847155_90866810
Mtcl1,17,66336982,66449750,protein_coding,-1,112768,chr17_66336982_66449750
Mtcp1,X,75410444,75416588,protein_coding,-1,6144,chrX_75410444_75416588
Mtdh,15,34082694,34145624,protein_coding,1,62930,chr15_34082694_34145624
Mterf1a,5,3890581,3893933,protein_coding,-1,3352,chr5_3890581_3893933
Mterf1b,5,4192367,4197651,protein_coding,1,5284,chr5_4192367_4197651
Mterf2,10,85119433,85128027,protein_coding,-1,8594,chr10_85119433_85128027
Mterf3,13,66906968,66933088,protein_coding,-1,26120,chr13_66906968_66933088
Mterf4,1,93299211,93305915,protein_coding,-1,6704,chr1_93299211_93305915
Mtf1,4,124802104,124849800,protein_coding,1,47696,chr4_124802104_124849800
Mtf2,5,108065674,108109004,protein_coding,1,43330,chr5_108065674_108109004
Mtfmt,9,65435782,65453054,protein_coding,1,17272,chr9_65435782_65453054
Mtfp1,11,4091480,4095445,protein_coding,-1,3965,chr11_4091480_4095445
Mtfr1,3,19187327,19220817,protein_coding,1,33490,chr3_19187327_19220817
Mtfr1l,4,134525550,134535387,protein_coding,-1,9837,chr4_134525550_134535387
Mtfr2,10,20347770,20361304,protein_coding,1,13534,chr10_20347770_20361304
Mtg1,7,140137564,140150786,protein_coding,1,13222,chr7_140137564_140150786
Mtg2,2,180070588,180085902,protein_coding,1,15314,chr2_180070588_180085902
Mthfd1,12,76255298,76319803,protein_coding,1,64505,chr12_76255298_76319803
Mthfd1l,10,3973118,4167081,protein_coding,1,193963,chr10_3973118_4167081
Mthfd2,6,83305691,83325908,protein_coding,-1,20217,chr6_83305691_83325908
Mthfd2l,5,90931117,91021368,protein_coding,1,90251,chr5_90931117_91021368
Mthfr,4,148039077,148059551,protein_coding,1,20474,chr4_148039077_148059551
Mthfr-ps1,5,78473885,78474735,processed_pseudogene,1,850,chr5_78473885_78474735
Mthfs,9,89210676,89377713,protein_coding,1,167037,chr9_89210676_89377713
Mthfsd,8,121091628,121108392,protein_coding,-1,16764,chr8_121091628_121108392
Mthfsl,9,88688602,88720296,protein_coding,-1,31694,chr9_88688602_88720296
Mtif2,11,29526408,29545279,protein_coding,1,18871,chr11_29526408_29545279
Mtif3,5,146951573,146963800,protein_coding,-1,12227,chr5_146951573_146963800
Mtm1,X,71210767,71315691,protein_coding,1,104924,chrX_71210767_71315691
Mtmr1,X,71364760,71419196,protein_coding,1,54436,chrX_71364760_71419196
Mtmr10,7,64287653,64340806,protein_coding,1,53153,chr7_64287653_64340806
Mtmr11,3,96162004,96171718,protein_coding,1,9714,chr3_96162004_96171718
Mtmr12,15,12205028,12274496,protein_coding,1,69468,chr15_12205028_12274496
Mtmr14,6,113237843,113281392,protein_coding,1,43549,chr6_113237843_113281392
Mtmr2,9,13748410,13806481,protein_coding,1,58071,chr9_13748410_13806481
Mtmr3,11,4480868,4594863,protein_coding,-1,113995,chr11_4480868_4594863
Mtmr4,11,87592162,87616302,protein_coding,1,24140,chr11_87592162_87616302
Mtmr6,14,60265228,60302370,protein_coding,1,37142,chr14_60265228_60302370
Mtmr7,8,40551095,40634797,protein_coding,-1,83702,chr8_40551095_40634797
Mtmr9,14,63519651,63543982,protein_coding,-1,24331,chr14_63519651_63543982
Mtnr1a,8,45069137,45088506,protein_coding,1,19369,chr8_45069137_45088506
Mto1,9,78448208,78475348,protein_coding,1,27140,chr9_78448208_78475348
Mtor,4,148448611,148557683,protein_coding,1,109072,chr4_148448611_148557683
Mtpap,18,4375592,4397330,protein_coding,1,21738,chr18_4375592_4397330
Mtpn,6,35508906,35539888,protein_coding,-1,30982,chr6_35508906_35539888
Mtr,13,12182712,12258113,protein_coding,-1,75401,chr13_12182712_12258113
Mtrf1,14,79397772,79423587,protein_coding,1,25815,chr14_79397772_79423587
Mtrf1l,10,5811887,5823910,protein_coding,-1,12023,chr10_5811887_5823910
Mtrr,13,68560780,68582149,protein_coding,-1,21369,chr13_68560780_68582149
Mtss1,15,58941234,59082005,protein_coding,-1,140771,chr15_58941234_59082005
Mttp,3,138089854,138144968,protein_coding,-1,55114,chr3_138089854_138144968
Mturn,6,54681624,54703851,protein_coding,1,22227,chr6_54681624_54703851
Mtus1,8,40990914,41133726,protein_coding,-1,142812,chr8_40990914_41133726
Mtus2,5,147957320,148316065,protein_coding,1,358745,chr5_147957320_148316065
Mtx1,3,89209081,89227088,protein_coding,-1,18007,chr3_89209081_89227088
Mtx2,2,74825803,74878431,protein_coding,1,52628,chr2_74825803_74878431
Mtx3,13,92844760,92858230,protein_coding,1,13470,chr13_92844760_92858230
Muc1,3,89229057,89233381,protein_coding,1,4324,chr3_89229057_89233381
Muc13,16,33794037,33819934,protein_coding,1,25897,chr16_33794037_33819934
Muc15,2,110721340,110739527,protein_coding,1,18187,chr2_110721340_110739527
Muc16,9,18495455,18674530,protein_coding,-1,179075,chr9_18495455_18674530
Muc19,15,91838326,91934555,protein_coding,1,96229,chr15_91838326_91934555
Muc2,7,141690340,141754693,protein_coding,1,64353,chr7_141690340_141754693
Muc4,16,32735886,32782391,protein_coding,1,46505,chr16_32735886_32782391
Muc5ac,7,141788972,141819231,protein_coding,1,30259,chr7_141788972_141819231
Muc5b,7,141839070,141873084,protein_coding,1,34014,chr7_141839070_141873084
Muc6,7,141633456,141655319,protein_coding,-1,21863,chr7_141633456_141655319
Mucl1,15,103751919,103877308,protein_coding,-1,125389,chr15_103751919_103877308
Mul1,4,138434671,138442265,protein_coding,1,7594,chr4_138434671_138442265
Mup-ps1,4,60085840,60088577,unprocessed_pseudogene,1,2737,chr4_60085840_60088577
Mup16,4,61477830,61519531,protein_coding,-1,41701,chr4_61477830_61519531
Mup2,4,60135932,60154289,protein_coding,-1,18357,chr4_60135932_60154289
Mup3,4,62083476,62087342,protein_coding,-1,3866,chr4_62083476_62087342
Mup5,4,61831319,61835233,protein_coding,-1,3914,chr4_61831319_61835233
Mus81,19,5482345,5488402,protein_coding,-1,6057,chr19_5482345_5488402
Musk,4,58285960,58374303,protein_coding,1,88343,chr4_58285960_58374303
Mustn1,14,30879200,30881610,protein_coding,1,2410,chr14_30879200_30881610
Mutyh,4,116807723,116819440,protein_coding,1,11717,chr4_116807723_116819440
Mvb12a,8,71542922,71548085,protein_coding,1,5163,chr8_71542922_71548085
Mvb12b,2,33729953,33887946,protein_coding,-1,157993,chr2_33729953_33887946
Mvd,8,122433601,122443422,protein_coding,-1,9821,chr8_122433601_122443422
Mvk,5,114444269,114460591,protein_coding,1,16322,chr5_114444269_114460591
Mvp,7,126986860,127014621,protein_coding,-1,27761,chr7_126986860_127014621
Mx1,16,97447035,97462907,polymorphic_pseudogene,-1,15872,chr16_97447035_97462907
Mx2,16,97535308,97560900,polymorphic_pseudogene,1,25592,chr16_97535308_97560900
Mxd1,6,86647042,86669161,protein_coding,-1,22119,chr6_86647042_86669161
Mxd3,13,55325168,55329823,protein_coding,-1,4655,chr13_55325168_55329823
Mxd4,5,34173883,34187720,protein_coding,-1,13837,chr5_34173883_34187720
Mxi1,19,53310518,53375810,protein_coding,1,65292,chr19_53310518_53375810
Mxra7,11,116803062,116828046,protein_coding,-1,24984,chr11_116803062_116828046
Mxra8,4,155839680,155844088,protein_coding,1,4408,chr4_155839680_155844088
Myadm,7,3289080,3300442,protein_coding,1,11362,chr7_3289080_3300442
Myadml2,11,120646031,120648158,protein_coding,-1,2127,chr11_120646031_120648158
Myb,10,21124935,21160984,protein_coding,-1,36049,chr10_21124935_21160984
Mybbp1a,11,72441355,72451768,protein_coding,1,10413,chr11_72441355_72451768
Mybl1,1,9667415,9700209,protein_coding,-1,32794,chr1_9667415_9700209
Mybl2,2,163054687,163084688,protein_coding,1,30001,chr2_163054687_163084688
Mybpc1,10,88518279,88605152,protein_coding,-1,86873,chr10_88518279_88605152
Mybpc2,7,44501699,44524656,protein_coding,-1,22957,chr7_44501699_44524656
Mybpc3,2,91118144,91136516,protein_coding,1,18372,chr2_91118144_91136516
Mybphl,3,108364911,108380057,protein_coding,1,15146,chr3_108364911_108380057
Myc,15,61985391,61990374,protein_coding,1,4983,chr15_61985391_61990374
Mycbp,4,123904832,123912269,protein_coding,1,7437,chr4_123904832_123912269
Mycbp2,14,103113411,103346814,protein_coding,-1,233403,chr14_103113411_103346814
Mycbpap,11,94501347,94521742,protein_coding,-1,20395,chr11_94501347_94521742
Mycl,4,122995652,123002485,protein_coding,1,6833,chr4_122995652_123002485
Mycn,12,12936093,12941914,protein_coding,-1,5821,chr12_12936093_12941914
Myd88,9,119335934,119341411,protein_coding,-1,5477,chr9_119335934_119341411
Mydgf,17,56175744,56183920,protein_coding,-1,8176,chr17_56175744_56183920
Myef2,2,125084628,125123661,protein_coding,-1,39033,chr2_125084628_125123661
Myf5,10,107482908,107486134,protein_coding,-1,3226,chr10_107482908_107486134
Myf6,10,107492853,107494737,protein_coding,-1,1884,chr10_107492853_107494737
Myg1,15,102331709,102338139,protein_coding,1,6430,chr15_102331709_102338139
Myh1,11,67200052,67224575,protein_coding,1,24523,chr11_67200052_67224575
Myh10,11,68691559,68816632,protein_coding,1,125073,chr11_68691559_68816632
Myh11,16,14194535,14291372,protein_coding,-1,96837,chr16_14194535_14291372
Myh13,11,67321658,67371586,protein_coding,1,49928,chr11_67321658_67371586
Myh14,7,44605803,44670843,protein_coding,-1,65040,chr7_44605803_44670843
Myh15,16,49057486,49199104,protein_coding,1,141618,chr16_49057486_49199104
Myh2,11,67171027,67197517,protein_coding,1,26490,chr11_67171027_67197517
Myh3,11,67078300,67102291,protein_coding,1,23991,chr11_67078300_67102291
Myh4,11,67238029,67260446,protein_coding,1,22417,chr11_67238029_67260446
Myh6,14,54941921,54966927,protein_coding,-1,25006,chr14_54941921_54966927
Myh7,14,54970684,54994626,protein_coding,-1,23942,chr14_54970684_54994626
Myh7b,2,155611212,155634307,protein_coding,1,23095,chr2_155611212_155634307
Myh8,11,67277124,67308634,protein_coding,1,31510,chr11_67277124_67308634
Myh9,15,77760587,77842175,protein_coding,-1,81588,chr15_77760587_77842175
Myl1,1,66924295,66945404,protein_coding,-1,21109,chr1_66924295_66945404
Myl12a,17,70993656,71002878,protein_coding,-1,9222,chr17_70993656_71002878
Myl12b,17,70973133,70990890,protein_coding,-1,17757,chr17_70973133_70990890
Myl2,5,122100951,122113472,protein_coding,1,12521,chr5_122100951_122113472
Myl3,9,110741861,110769798,protein_coding,1,27937,chr9_110741861_110769798
Myl4,11,104550663,104595753,protein_coding,1,45090,chr11_104550663_104595753
Myl6,10,128490860,128494145,protein_coding,-1,3285,chr10_128490860_128494145
Myl6b,10,128494157,128498685,protein_coding,-1,4528,chr10_128494157_128498685
Myl9,2,156775420,156781658,protein_coding,1,6238,chr2_156775420_156781658
Mylip,13,45389742,45412022,protein_coding,1,22280,chr13_45389742_45412022
Mylk,16,34745210,35002420,protein_coding,1,257210,chr16_34745210_35002420
Mylk3,8,85324303,85386345,protein_coding,-1,62042,chr8_85324303_85386345
Mylk4,13,32700827,32783954,protein_coding,-1,83127,chr13_32700827_32783954
Mylpf,7,127208890,127214298,protein_coding,1,5408,chr7_127208890_127214298
Mynn,3,30602065,30619873,protein_coding,1,17808,chr3_30602065_30619873
Myo10,15,25622525,25813673,protein_coding,1,191148,chr15_25622525_25813673
Myo15,11,60469339,60528369,protein_coding,1,59030,chr11_60469339_60528369
Myo15b,11,115858406,115892603,protein_coding,1,34197,chr11_115858406_115892603
Myo16,8,10153911,10634742,protein_coding,1,480831,chr8_10153911_10634742
Myo18a,11,77763246,77865980,protein_coding,1,102734,chr11_77763246_77865980
Myo18b,5,112688876,112896362,protein_coding,-1,207486,chr5_112688876_112896362
Myo19,11,84880148,84911226,protein_coding,1,31078,chr11_84880148_84911226
Myo1a,10,127705170,127720940,protein_coding,1,15770,chr10_127705170_127720940
Myo1b,1,51749765,51916071,protein_coding,-1,166306,chr1_51749765_51916071
Myo1c,11,75650504,75673910,protein_coding,1,23406,chr11_75650504_75673910
Myo1d,11,80482126,80780025,protein_coding,-1,297899,chr11_80482126_80780025
Myo1e,9,70207350,70399766,protein_coding,1,192416,chr9_70207350_70399766
Myo1f,17,33555707,33607764,protein_coding,1,52057,chr17_33555707_33607764
Myo1g,11,6506548,6520965,protein_coding,-1,14417,chr11_6506548_6520965
Myo1h,5,114289166,114365357,protein_coding,1,76191,chr5_114289166_114365357
Myo3a,2,22227503,22618252,protein_coding,1,390749,chr2_22227503_22618252
Myo3b,2,70039126,70429198,protein_coding,1,390072,chr2_70039126_70429198
Myo5a,9,75071015,75223688,protein_coding,1,152673,chr9_75071015_75223688
Myo5b,18,74440936,74771493,protein_coding,1,330557,chr18_74440936_74771493
Myo5c,9,75232020,75305451,protein_coding,1,73431,chr9_75232020_75305451
Myo6,9,80165031,80311729,protein_coding,1,146698,chr9_80165031_80311729
Myo7a,7,98051060,98119524,protein_coding,-1,68464,chr7_98051060_98119524
Myo9a,9,59750896,59928866,protein_coding,1,177970,chr9_59750896_59928866
Myo9b,8,71272714,71360713,protein_coding,1,87999,chr8_71272714_71360713
Myoc,1,162639155,162649693,protein_coding,1,10538,chr1_162639155_162649693
Myocd,11,65176561,65269989,protein_coding,-1,93428,chr11_65176561_65269989
Myod1,7,46376474,46379099,protein_coding,1,2625,chr7_46376474_46379099
Myof,19,37899036,38043577,protein_coding,-1,144541,chr19_37899036_38043577
Myog,1,134289989,134292548,protein_coding,1,2559,chr1_134289989_134292548
Myom1,17,71002633,71126856,protein_coding,1,124223,chr17_71002633_71126856
Myom2,8,15057653,15133541,protein_coding,1,75888,chr8_15057653_15133541
Myom3,4,135759715,135815564,protein_coding,1,55849,chr4_135759715_135815564
Myoz1,14,20649107,20656540,protein_coding,-1,7433,chr14_20649107_20656540
Myoz2,3,123006206,123035015,protein_coding,-1,28809,chr3_123006206_123035015
Myoz3,18,60573750,60591788,protein_coding,-1,18038,chr18_60573750_60591788
Mypn,10,63115795,63203952,protein_coding,-1,88157,chr10_63115795_63203952
Mypop,7,18991245,19001766,protein_coding,1,10521,chr7_18991245_19001766
Mypopos,7,18993234,19001222,antisense,-1,7988,chr7_18993234_19001222
Myrf,19,10208272,10240748,protein_coding,-1,32476,chr19_10208272_10240748
Myrfl,10,116776535,116896919,protein_coding,-1,120384,chr10_116776535_116896919
Myrip,9,120301513,120474841,protein_coding,1,173328,chr9_120301513_120474841
Mysm1,4,94942040,94979100,protein_coding,-1,37060,chr4_94942040_94979100
Myt1,2,181763332,181827797,protein_coding,1,64465,chr2_181763332_181827797
Myt1l,12,29528384,29923213,protein_coding,1,394829,chr12_29528384_29923213
Myzap,9,71504347,71592360,protein_coding,-1,88013,chr9_71504347_71592360
Mzb1,18,35647267,35649367,protein_coding,-1,2100,chr18_35647267_35649367
Mzf1,7,13042303,13054764,protein_coding,-1,12461,chr7_13042303_13054764
Mzt1,14,99034544,99046134,protein_coding,-1,11590,chr14_99034544_99046134
Mzt2,16,15848441,15863369,protein_coding,-1,14928,chr16_15848441_15863369
N4bp1,8,86808160,86885258,protein_coding,-1,77098,chr8_86808160_86885258
N4bp2,5,65763521,65830108,protein_coding,1,66587,chr5_65763521_65830108
N4bp2l1,5,150571644,150597188,protein_coding,-1,25544,chr5_150571644_150597188
N4bp2l2,5,150608007,150666183,protein_coding,-1,58176,chr5_150608007_150666183
N4bp3,11,51643063,51650842,protein_coding,-1,7779,chr11_51643063_51650842
N6amt1,16,87354185,87368742,protein_coding,1,14557,chr16_87354185_87368742
Naa10,X,73916873,73921944,protein_coding,-1,5071,chrX_73916873_73921944
Naa11,5,97382198,97392379,protein_coding,-1,10181,chr5_97382198_97392379
Naa15,3,51415148,51476507,protein_coding,1,61359,chr3_51415148_51476507
Naa16,14,79325269,79390778,protein_coding,-1,65509,chr14_79325269_79390778
Naa20,2,145902099,145916425,protein_coding,1,14326,chr2_145902099_145916425
Naa25,5,121397936,121444378,protein_coding,1,46442,chr5_121397936_121444378
Naa30,14,49172226,49191031,protein_coding,1,18805,chr14_49172226_49191031
Naa35,13,59585259,59635922,protein_coding,1,50663,chr13_59585259_59635922
Naa38,11,69395487,69396680,protein_coding,1,1193,chr11_69395487_69396680
Naa40,19,7225668,7241183,protein_coding,-1,15515,chr19_7225668_7241183
Naa50,16,44139830,44163366,protein_coding,1,23536,chr16_44139830_44163366
Naa60,16,3872375,3904770,protein_coding,1,32395,chr16_3872375_3904770
Naaa,5,92257659,92278170,protein_coding,-1,20511,chr5_92257659_92278170
Naalad2,9,18321951,18402995,protein_coding,-1,81044,chr9_18321951_18402995
Naaladl1,19,6105782,6115792,protein_coding,1,10010,chr19_6105782_6115792
Naaladl2,3,23798102,25144261,protein_coding,-1,1346159,chr3_23798102_25144261
Nab1,1,52457294,52500679,protein_coding,-1,43385,chr1_52457294_52500679
Nab2,10,127660918,127668568,protein_coding,-1,7650,chr10_127660918_127668568
Nabp1,1,51465862,51478425,protein_coding,-1,12563,chr1_51465862_51478425
Nabp2,10,128401395,128411492,protein_coding,-1,10097,chr10_128401395_128411492
Naca,10,128035575,128048637,protein_coding,1,13062,chr10_128035575_128048637
Nacad,11,6597823,6606053,protein_coding,-1,8230,chr11_6597823_6606053
Nacc1,8,84670479,84687902,protein_coding,-1,17423,chr8_84670479_84687902
Nacc2,2,26055535,26123220,protein_coding,-1,67685,chr2_26055535_26123220
Nadk,4,155562378,155591001,protein_coding,1,28623,chr4_155562378_155591001
Nadk2,15,9071260,9110891,protein_coding,1,39631,chr15_9071260_9110891
Nadsyn1,7,143795584,143822849,protein_coding,-1,27265,chr7_143795584_143822849
Nae1,8,104511028,104534637,protein_coding,-1,23609,chr8_104511028_104534637
Naf1,8,66860217,66890564,protein_coding,1,30347,chr8_66860217_66890564
Naga,15,82329532,82338925,protein_coding,-1,9393,chr15_82329532_82338925
Nagk,6,83794982,83804018,protein_coding,1,9036,chr6_83794982_83804018
Naglu,11,101070012,101077672,protein_coding,1,7660,chr11_101070012_101077672
Nagpa,16,5195289,5204012,protein_coding,-1,8723,chr16_5195289_5204012
Naif1,2,32450457,32456953,protein_coding,1,6496,chr2_32450457_32456953
Naip1,13,100407764,100452869,protein_coding,-1,45105,chr13_100407764_100452869
Naip2,13,100144063,100202092,protein_coding,-1,58029,chr13_100144063_100202092
Naip3,13,100340144,100378960,unprocessed_pseudogene,-1,38816,chr13_100340144_100378960
Naip5,13,100211739,100246323,protein_coding,-1,34584,chr13_100211739_100246323
Nalcn,14,123276634,123627144,protein_coding,-1,350510,chr14_123276634_123627144
Nampt,12,32819545,32853349,protein_coding,1,33804,chr12_32819545_32853349
Nanog,6,122707489,122714633,protein_coding,1,7144,chr6_122707489_122714633
Nanog-ps1,X,89883389,89883638,processed_pseudogene,-1,249,chrX_89883389_89883638
Nanos1,19,60755987,60759914,protein_coding,1,3927,chr19_60755987_60759914
Nanos2,7,18987400,18988962,protein_coding,1,1562,chr7_18987400_18988962
Nanos3,8,84173731,84185217,protein_coding,-1,11486,chr8_84173731_84185217
Nanp,2,151029685,151039398,protein_coding,-1,9713,chr2_151029685_151039398
Nans,4,46489248,46503632,protein_coding,1,14384,chr4_46489248_46503632
Nap1l1,10,111473223,111498150,protein_coding,1,24927,chr10_111473223_111498150
Nap1l2,X,103184176,103186640,protein_coding,-1,2464,chrX_103184176_103186640
Nap1l3,X,122394565,122397401,protein_coding,-1,2836,chrX_122394565_122397401
Nap1l4,7,143513579,143549106,protein_coding,-1,35527,chr7_143513579_143549106
Nap1l5,6,58905233,58907076,protein_coding,-1,1843,chr6_58905233_58907076
Napa,7,16098458,16117975,protein_coding,1,19517,chr7_16098458_16117975
Napb,2,148693985,148732467,protein_coding,-1,38482,chr2_148693985_148732467
Napepld,5,21662901,21701396,protein_coding,-1,38495,chr5_21662901_21701396
Napg,18,62977831,62999450,protein_coding,1,21619,chr18_62977831_62999450
Naprt,15,75890956,75894481,protein_coding,-1,3525,chr15_75890956_75894481
Napsa,7,44572380,44586862,protein_coding,1,14482,chr7_44572380_44586862
Narf,11,121237253,121255856,protein_coding,1,18603,chr11_121237253_121255856
Nars,18,64499647,64516652,protein_coding,-1,17005,chr18_64499647_64516652
Nars2,7,96951505,97064758,protein_coding,1,113253,chr7_96951505_97064758
Nasp,4,116601052,116627941,protein_coding,-1,26889,chr4_116601052_116627941
Nasp-ps1,6,63160275,63160965,processed_pseudogene,1,690,chr6_63160275_63160965
Nat1,8,67480921,67492104,protein_coding,1,11183,chr8_67480921_67492104
Nat10,2,103721256,103761270,protein_coding,-1,40014,chr2_103721256_103761270
Nat14,7,4922028,4925006,protein_coding,1,2978,chr7_4922028_4925006
Nat2,8,67494858,67502584,protein_coding,1,7726,chr8_67494858_67502584
Nat8,6,85830388,85832082,protein_coding,-1,1694,chr6_85830388_85832082
Nat8l,5,33995984,34005916,protein_coding,1,9932,chr5_33995984_34005916
Nat9,11,115182832,115187859,protein_coding,-1,5027,chr11_115182832_115187859
Natd1,11,60902246,60914750,protein_coding,-1,12504,chr11_60902246_60914750
Nav1,1,135434580,135688105,protein_coding,-1,253525,chr1_135434580_135688105
Nav2,7,48908716,49610090,protein_coding,1,701374,chr7_48908716_49610090
Nav3,10,109681259,110456204,protein_coding,-1,774945,chr10_109681259_110456204
Nbas,12,13269133,13583811,protein_coding,1,314678,chr12_13269133_13583811
Nbea,3,55625195,56183701,protein_coding,-1,558506,chr3_55625195_56183701
Nbeal1,1,60180599,60338328,protein_coding,1,157729,chr1_60180599_60338328
Nbeal2,9,110624789,110654161,protein_coding,-1,29372,chr9_110624789_110654161
Nbl1,4,139082284,139092993,protein_coding,-1,10709,chr4_139082284_139092993
Nbn,4,15957925,15992589,protein_coding,1,34664,chr4_15957925_15992589
Nbr1,11,101552149,101581951,protein_coding,1,29802,chr11_101552149_101581951
Ncald,15,37366175,37792570,protein_coding,-1,426395,chr15_37366175_37792570
Ncam1,9,49502136,49798925,protein_coding,-1,296789,chr9_49502136_49798925
Ncam2,16,81200697,81626828,protein_coding,1,426131,chr16_81200697_81626828
Ncan,8,70093085,70120873,protein_coding,-1,27788,chr8_70093085_70120873
Ncapd2,6,125168007,125191701,protein_coding,-1,23694,chr6_125168007_125191701
Ncapd3,9,27030175,27095315,protein_coding,1,65140,chr9_27030175_27095315
Ncapg,5,45669919,45700546,protein_coding,1,30627,chr5_45669919_45700546
Ncapg2,12,116405402,116463731,protein_coding,1,58329,chr12_116405402_116463731
Ncaph,2,127103809,127133954,protein_coding,-1,30145,chr2_127103809_127133954
Ncaph2,15,89355719,89372826,protein_coding,1,17107,chr15_89355719_89372826
Ncbp1,4,46138613,46172403,protein_coding,1,33790,chr4_46138613_46172403
Ncbp2,16,31948513,31961781,protein_coding,1,13268,chr16_31948513_31961781
Nccrp1,7,28543596,28547254,protein_coding,-1,3658,chr7_28543596_28547254
Ncdn,4,126743750,126753438,protein_coding,-1,9688,chr4_126743750_126753438
Nceh1,3,27182965,27284608,protein_coding,1,101643,chr3_27182965_27284608
Ncf1,5,134220053,134229625,protein_coding,-1,9572,chr5_134220053_134229625
Ncf2,1,152800194,152836991,protein_coding,1,36797,chr1_152800194_152836991
Ncf4,15,78244801,78262580,protein_coding,1,17779,chr15_78244801_78262580
Nck1,9,100492293,100546134,protein_coding,-1,53841,chr9_100492293_100546134
Nck2,1,43444579,43570515,protein_coding,1,125936,chr1_43444579_43570515
Nckap1,2,80500512,80581380,protein_coding,-1,80868,chr2_80500512_80581380
Nckap1l,15,103453794,103498810,protein_coding,1,45016,chr15_103453794_103498810
Nckap5,1,125913620,126830799,protein_coding,-1,917179,chr1_125913620_126830799
Nckap5l,15,99422035,99457748,protein_coding,-1,35713,chr15_99422035_99457748
Nckipsd,9,108808368,108818844,protein_coding,1,10476,chr9_108808368_108818844
Ncl,1,86344719,86359400,protein_coding,-1,14681,chr1_86344719_86359400
Ncln,10,81486249,81496392,protein_coding,-1,10143,chr10_81486249_81496392
Ncmap,4,135369576,135398227,protein_coding,-1,28651,chr4_135369576_135398227
Ncoa1,12,4247362,4477182,protein_coding,-1,229820,chr12_4247362_4477182
Ncoa2,1,13139105,13374083,protein_coding,-1,234978,chr1_13139105_13374083
Ncoa3,2,165992636,166073242,protein_coding,1,80606,chr2_165992636_166073242
Ncoa4,14,32159865,32179855,protein_coding,1,19990,chr14_32159865_32179855
Ncoa5,2,165000357,165034867,protein_coding,-1,34510,chr2_165000357_165034867
Ncoa6,2,155390656,155473894,protein_coding,-1,83238,chr2_155390656_155473894
Ncoa7,10,30628999,30803326,protein_coding,-1,174327,chr10_30628999_30803326
Ncor1,11,62316426,62458541,protein_coding,-1,142115,chr11_62316426_62458541
Ncor2,5,125017153,125179219,protein_coding,-1,162066,chr5_125017153_125179219
Ncr3-ps,17,35180535,35184662,unprocessed_pseudogene,1,4127,chr17_35180535_35184662
Ncs1,2,31245823,31295989,protein_coding,1,50166,chr2_31245823_31295989
Ncstn,1,172066013,172082795,protein_coding,-1,16782,chr1_172066013_172082795
Ndc1,4,107367784,107416346,protein_coding,1,48562,chr4_107367784_107416346
Ndc80,17,71496100,71526857,protein_coding,-1,30757,chr17_71496100_71526857
Nde1,16,14163275,14192928,protein_coding,1,29653,chr16_14163275_14192928
Ndel1,11,68821434,68871858,protein_coding,-1,50424,chr11_68821434_68871858
Ndfip1,18,38410396,38465303,protein_coding,1,54907,chr18_38410396_38465303
Ndfip2,14,105258573,105309298,protein_coding,1,50725,chr14_105258573_105309298
Ndn,7,62346569,62350262,protein_coding,1,3693,chr7_62346569_62350262
Ndnf,6,65671590,65712326,protein_coding,1,40736,chr6_65671590_65712326
Ndor1,2,25244819,25256022,protein_coding,-1,11203,chr2_25244819_25256022
Ndp,X,16885521,16911774,protein_coding,-1,26253,chrX_16885521_16911774
Ndrg1,15,66929318,66969640,protein_coding,-1,40322,chr15_66929318_66969640
Ndrg2,14,51905271,51914158,protein_coding,-1,8887,chr14_51905271_51914158
Ndrg3,2,156927345,156992056,protein_coding,-1,64711,chr2_156927345_156992056
Ndrg4,8,95676980,95715119,protein_coding,1,38139,chr8_95676980_95715119
Ndst1,18,60684494,60748650,protein_coding,-1,64156,chr18_60684494_60748650
Ndst2,14,20723730,20734562,protein_coding,-1,10832,chr14_20723730_20734562
Ndst3,3,123526166,123690853,protein_coding,-1,164687,chr3_123526166_123690853
Ndst4,3,125404076,125728899,protein_coding,1,324823,chr3_125404076_125728899
Ndufa1,X,37187588,37191163,protein_coding,-1,3575,chrX_37187588_37191163
Ndufa10,1,92439010,92473860,protein_coding,-1,34850,chr1_92439010_92473860
Ndufa11,17,56717767,56722141,protein_coding,1,4374,chr17_56717767_56722141
Ndufa12,10,94198720,94221443,protein_coding,1,22723,chr10_94198720_94221443
Ndufa13,8,69894180,69902558,protein_coding,-1,8378,chr8_69894180_69902558
Ndufa2,18,36742332,36744557,protein_coding,-1,2225,chr18_36742332_36744557
Ndufa3,7,3617373,3620327,protein_coding,1,2954,chr7_3617373_3620327
Ndufa4,6,11900292,11907497,protein_coding,-1,7205,chr6_11900292_11907497
Ndufa4l2,10,127514967,127517154,protein_coding,1,2187,chr10_127514967_127517154
Ndufa5,6,24518666,24528013,protein_coding,-1,9347,chr6_24518666_24528013
Ndufa6,15,82350140,82354322,protein_coding,-1,4182,chr15_82350140_82354322
Ndufa7,17,33824572,33838317,protein_coding,1,13745,chr17_33824572_33838317
Ndufa8,2,36036326,36049406,protein_coding,-1,13080,chr2_36036326_36049406
Ndufa9,6,126821721,126849136,protein_coding,-1,27415,chr6_126821721_126849136
Ndufab1,7,122085403,122101886,protein_coding,-1,16483,chr7_122085403_122101886
Ndufaf1,2,119655446,119662827,protein_coding,-1,7381,chr2_119655446_119662827
Ndufaf2,13,108002715,108158623,protein_coding,-1,155908,chr13_108002715_108158623
Ndufaf3,9,108565537,108567434,protein_coding,-1,1897,chr9_108565537_108567434
Ndufaf4,4,24898083,24905001,protein_coding,1,6918,chr4_24898083_24905001
Ndufaf5,2,140170649,140203689,protein_coding,1,33040,chr2_140170649_140203689
Ndufaf6,4,11051045,11076205,protein_coding,-1,25160,chr4_11051045_11076205
Ndufaf7,17,78937136,78948052,protein_coding,1,10916,chr17_78937136_78948052
Ndufb10,17,24722060,24724478,protein_coding,-1,2418,chr17_24722060_24724478
Ndufb11,X,20615326,20617619,protein_coding,-1,2293,chrX_20615326_20617619
Ndufb2,6,39592574,39603382,protein_coding,1,10808,chr6_39592574_39603382
Ndufb3,1,58586384,58595964,protein_coding,1,9580,chr1_58586384_58595964
Ndufb4,16,37647170,37654453,protein_coding,-1,7283,chr16_37647170_37654453
Ndufb5,3,32736990,32751566,protein_coding,1,14576,chr3_32736990_32751566
Ndufb6,4,40270591,40279421,protein_coding,-1,8830,chr4_40270591_40279421
Ndufb7,8,83566671,83571626,protein_coding,1,4955,chr8_83566671_83571626
Ndufb8,19,44548572,44555440,protein_coding,-1,6868,chr19_44548572_44555440
Ndufb9,15,58933756,58939488,protein_coding,1,5732,chr15_58933756_58939488
Ndufc1,3,51404677,51408988,protein_coding,-1,4311,chr3_51404677_51408988
Ndufc2,7,97400003,97407802,protein_coding,1,7799,chr7_97400003_97407802
Ndufs1,1,63143596,63176833,protein_coding,-1,33237,chr1_63143596_63176833
Ndufs2,1,171234853,171251388,protein_coding,-1,16535,chr1_171234853_171251388
Ndufs3,2,90894634,90904827,protein_coding,-1,10193,chr2_90894634_90904827
Ndufs4,13,114287795,114388258,protein_coding,-1,100463,chr13_114287795_114388258
Ndufs5,4,123712710,123718202,protein_coding,-1,5492,chr4_123712710_123718202
Ndufs6,13,73319838,73328542,protein_coding,-1,8704,chr13_73319838_73328542
Ndufs7,10,80249121,80256794,protein_coding,1,7673,chr10_80249121_80256794
Ndufs8,19,3908863,3912774,protein_coding,-1,3911,chr19_3908863_3912774
Ndufv1,19,4007384,4012806,protein_coding,-1,5422,chr19_4007384_4012806
Ndufv2,17,66078638,66101559,protein_coding,-1,22921,chr17_66078638_66101559
Ndufv3,17,31520115,31531331,protein_coding,1,11216,chr17_31520115_31531331
Neat1,19,5824708,5845478,lincRNA,-1,20770,chr19_5824708_5845478
Neb,2,52136647,52378474,protein_coding,-1,241827,chr2_52136647_52378474
Nebl,2,17343909,17731464,protein_coding,-1,387555,chr2_17343909_17731464
Necab1,4,14952245,15149794,protein_coding,-1,197549,chr4_14952245_15149794
Necab2,8,119446719,119472640,protein_coding,1,25921,chr8_119446719_119472640
Necab3,2,154544399,154558890,protein_coding,-1,14491,chr2_154544399_154558890
Necap1,6,122874474,122888941,protein_coding,1,14467,chr6_122874474_122888941
Necap2,4,141066512,141078357,protein_coding,-1,11845,chr4_141066512_141078357
Nedd1,10,92684746,92722420,protein_coding,-1,37674,chr10_92684746_92722420
Nedd4,9,72662346,72749852,protein_coding,1,87506,chr9_72662346_72749852
Nedd4l,18,64887705,65217828,protein_coding,1,330123,chr18_64887705_65217828
Nedd8,14,55662263,55672124,protein_coding,-1,9861,chr14_55662263_55672124
Nedd9,13,41309581,41487362,protein_coding,-1,177781,chr13_41309581_41487362
Nefh,11,4938754,4948064,protein_coding,-1,9310,chr11_4938754_4948064
Nefl,14,68083863,68089095,protein_coding,1,5232,chr14_68083863_68089095
Nefm,14,68082590,68124846,protein_coding,-1,42256,chr14_68082590_68124846
Negr1,3,156561794,157316445,protein_coding,1,754651,chr3_156561794_157316445
Neil1,9,57142800,57148305,protein_coding,-1,5505,chr9_57142800_57148305
Neil2,14,63182443,63193856,protein_coding,-1,11413,chr14_63182443_63193856
Nek1,8,60993195,61131346,protein_coding,1,138151,chr8_60993195_61131346
Nek10,14,14803415,15012059,protein_coding,1,208644,chr14_14803415_15012059
Nek11,9,105162156,105395524,protein_coding,-1,233368,chr9_105162156_105395524
Nek2,1,191821444,191833050,protein_coding,1,11606,chr1_191821444_191833050
Nek3,8,22128283,22166435,protein_coding,-1,38152,chr8_22128283_22166435
Nek4,14,30951377,30988821,protein_coding,1,37444,chr14_30951377_30988821
Nek5,8,22073616,22125053,protein_coding,-1,51437,chr8_22073616_22125053
Nek6,2,38511643,38594606,protein_coding,1,82963,chr2_38511643_38594606
Nek7,1,138482875,138620141,protein_coding,-1,137266,chr1_138482875_138620141
Nek8,11,78166106,78176675,protein_coding,-1,10569,chr11_78166106_78176675
Nek9,12,85299514,85339362,protein_coding,-1,39848,chr12_85299514_85339362
Nelfa,5,33897916,33936413,protein_coding,-1,38497,chr5_33897916_33936413
Nelfb,2,25199712,25211489,protein_coding,-1,11777,chr2_25199712_25211489
Nelfcd,2,174415804,174427502,protein_coding,1,11698,chr2_174415804_174427502
Nelfe,17,34850391,34856372,protein_coding,1,5981,chr17_34850391_34856372
Nell1,7,49974864,50866608,protein_coding,1,891744,chr7_49974864_50866608
Nell1os,7,50517309,50575971,antisense,-1,58662,chr7_50517309_50575971
Nell2,15,95075230,95528559,protein_coding,-1,453329,chr15_95075230_95528559
Nemf,12,69310522,69357165,protein_coding,-1,46643,chr12_69310522_69357165
Nenf,1,191306789,191318194,protein_coding,-1,11405,chr1_191306789_191318194
Neo1,9,58874687,59036441,protein_coding,-1,161754,chr9_58874687_59036441
Nepn,10,52388972,52404625,protein_coding,1,15653,chr10_52388972_52404625
Nes,3,87971078,87980451,protein_coding,1,9373,chr3_87971078_87980451
Net1,13,3882018,3918220,protein_coding,-1,36202,chr13_3882018_3918220
Neto1,18,86394952,86506718,protein_coding,1,111766,chr18_86394952_86506718
Neto2,8,85636588,85700924,protein_coding,-1,64336,chr8_85636588_85700924
Neu1,17,34931253,34935953,protein_coding,1,4700,chr17_34931253_34935953
Neu2,1,87509889,87597845,protein_coding,1,87956,chr1_87509889_87597845
Neu3,7,99811439,99828417,protein_coding,-1,16978,chr7_99811439_99828417
Neu4,1,94020451,94028334,protein_coding,1,7883,chr1_94020451_94028334
Neurl1a,19,47178820,47259441,protein_coding,1,80621,chr19_47178820_47259441
Neurl1b,17,26414829,26446349,protein_coding,1,31520,chr17_26414829_26446349
Neurl2,2,164830732,164833456,protein_coding,-1,2724,chr2_164830732_164833456
Neurl3,1,36264597,36274679,protein_coding,-1,10082,chr1_36264597_36274679
Neurl4,11,69901072,69913820,protein_coding,1,12748,chr11_69901072_69913820
Neurod1,2,79452521,79456751,protein_coding,-1,4230,chr2_79452521_79456751
Neurod2,11,98325415,98329648,protein_coding,-1,4233,chr11_98325415_98329648
Neurod4,10,130268152,130280240,protein_coding,-1,12088,chr10_130268152_130280240
Neurod6,6,55677822,55681263,protein_coding,-1,3441,chr6_55677822_55681263
Neurog2,3,127633135,127635631,protein_coding,1,2496,chr3_127633135_127635631
Neurog3,10,62133090,62134763,protein_coding,1,1673,chr10_62133090_62134763
Nexn,3,152236982,152266350,protein_coding,-1,29368,chr3_152236982_152266350
Nf1,11,79339693,79581612,protein_coding,1,241919,chr11_79339693_79581612
Nf2,11,4765845,4849536,protein_coding,-1,83691,chr11_4765845_4849536
Nfam1,15,82992973,83033306,protein_coding,-1,40333,chr15_82992973_83033306
Nfasc,1,132564690,132741797,protein_coding,-1,177107,chr1_132564690_132741797
Nfat5,8,107293470,107379517,protein_coding,1,86047,chr8_107293470_107379517
Nfatc1,18,80606205,80713071,protein_coding,-1,106866,chr18_80606205_80713071
Nfatc2,2,168476410,168601657,protein_coding,-1,125247,chr2_168476410_168601657
Nfatc2ip,7,126382854,126396737,protein_coding,-1,13883,chr7_126382854_126396737
Nfatc3,8,106058840,106130537,protein_coding,1,71697,chr8_106058840_106130537
Nfatc4,14,55823144,55833943,protein_coding,1,10799,chr14_55823144_55833943
Nfe2,15,103248212,103258403,protein_coding,-1,10191,chr15_103248212_103258403
Nfe2l1,11,96817414,96829968,protein_coding,-1,12554,chr11_96817414_96829968
Nfe2l2,2,75675513,75704641,protein_coding,-1,29128,chr2_75675513_75704641
Nfe2l3,6,51432670,51458768,protein_coding,1,26098,chr6_51432670_51458768
Nfia,4,97772734,98118874,protein_coding,1,346140,chr4_97772734_98118874
Nfib,4,82290173,82705750,protein_coding,-1,415577,chr4_82290173_82705750
Nfic,10,81396186,81455635,protein_coding,-1,59449,chr10_81396186_81455635
Nfil3,13,52967209,52981073,protein_coding,-1,13864,chr13_52967209_52981073
Nfix,8,84699876,84800344,protein_coding,-1,100468,chr8_84699876_84800344
Nfkb1,3,135584655,135691547,protein_coding,-1,106892,chr3_135584655_135691547
Nfkb2,19,46304320,46312385,protein_coding,1,8065,chr19_46304320_46312385
Nfkbia,12,55489410,55492647,protein_coding,-1,3237,chr12_55489410_55492647
Nfkbib,7,28758251,28767512,protein_coding,-1,9261,chr7_28758251_28767512
Nfkbid,7,30421732,30428746,protein_coding,1,7014,chr7_30421732_30428746
Nfkbie,17,45555703,45563169,protein_coding,1,7466,chr17_45555703_45563169
Nfkbil1,17,35220175,35235792,protein_coding,-1,15617,chr17_35220175_35235792
Nfkbiz,16,55811375,55838899,protein_coding,-1,27524,chr16_55811375_55838899
Nfrkb,9,31386192,31421333,protein_coding,1,35141,chr9_31386192_31421333
Nfs1,2,156123639,156144186,protein_coding,-1,20547,chr2_156123639_156144186
Nfu1,6,87009236,87028461,protein_coding,1,19225,chr6_87009236_87028461
Nfx1,4,40970906,41025993,protein_coding,1,55087,chr4_40970906_41025993
Nfxl1,5,72513301,72559684,protein_coding,-1,46383,chr5_72513301_72559684
Nfya,17,48382988,48409906,protein_coding,-1,26918,chr17_48382988_48409906
Nfyb,10,82748701,82764144,protein_coding,-1,15443,chr10_82748701_82764144
Nfyc,4,120757438,120831572,protein_coding,-1,74134,chr4_120757438_120831572
Ngb,12,87097531,87102539,protein_coding,-1,5008,chr12_87097531_87102539
Ngdn,14,55015454,55024137,protein_coding,1,8683,chr14_55015454_55024137
Ngef,1,87476834,87573870,protein_coding,-1,97036,chr1_87476834_87573870
Ngf,3,102469919,102521013,protein_coding,1,51094,chr3_102469919_102521013
Ngfr,11,95568818,95587735,protein_coding,-1,18917,chr11_95568818_95587735
Ngly1,14,16249280,16311926,protein_coding,1,62646,chr14_16249280_16311926
Ngrn,7,80261215,80265374,protein_coding,1,4159,chr7_80261215_80265374
Nhej1,1,74967139,75125200,protein_coding,-1,158061,chr1_74967139_75125200
Nhlh1,1,172052292,172057573,protein_coding,-1,5281,chr1_172052292_172057573
Nhlh2,3,102010076,102015492,protein_coding,1,5416,chr3_102010076_102015492
Nhlrc1,13,47012557,47014850,protein_coding,-1,2293,chr13_47012557_47014850
Nhlrc2,19,56548261,56603503,protein_coding,1,55242,chr19_56548261_56603503
Nhlrc3,3,53448583,53463332,protein_coding,-1,14749,chr3_53448583_53463332
Nhlrc4,17,25942233,25944961,protein_coding,-1,2728,chr17_25942233_25944961
Nhp2,11,51619735,51623714,protein_coding,1,3979,chr11_51619735_51623714
Nhs,X,161833296,162159730,protein_coding,-1,326434,chrX_161833296_162159730
Nhsl1,10,18318985,18533892,protein_coding,1,214907,chr10_18318985_18533892
Nhsl2,X,101849385,102092055,protein_coding,1,242670,chrX_101849385_102092055
Nicn1,9,108290429,108296498,protein_coding,1,6069,chr9_108290429_108296498
Nid1,13,13437551,13512269,protein_coding,1,74718,chr13_13437551_13512269
Nid2,14,19751265,19811787,protein_coding,1,60522,chr14_19751265_19811787
Nif3l1,1,58445151,58481816,protein_coding,1,36665,chr1_58445151_58481816
Nifk,1,118321839,118333822,protein_coding,1,11983,chr1_118321839_118333822
Nim1k,13,119710094,119755882,protein_coding,-1,45788,chr13_119710094_119755882
Nin,12,70011435,70113717,protein_coding,-1,102282,chr12_70011435_70113717
Ninj1,13,49187485,49196244,protein_coding,1,8759,chr13_49187485_49196244
Ninj2,6,120093350,120200339,protein_coding,1,106989,chr6_120093350_120200339
Ninl,2,150934519,151039382,protein_coding,-1,104863,chr2_150934519_151039382
Nip7,8,107056877,107060931,protein_coding,1,4054,chr8_107056877_107060931
Nipa1,7,55977567,56019954,protein_coding,-1,42387,chr7_55977567_56019954
Nipa2,7,55931287,55962476,protein_coding,-1,31189,chr7_55931287_55962476
Nipal1,5,72647795,72671078,protein_coding,1,23283,chr5_72647795_72671078
Nipal2,15,34572799,34679212,protein_coding,-1,106413,chr15_34572799_34679212
Nipal3,4,135445420,135495038,protein_coding,-1,49618,chr4_135445420_135495038
Nipal4,11,46148155,46166508,protein_coding,-1,18353,chr11_46148155_46166508
Nipbl,15,8290617,8444463,protein_coding,-1,153846,chr15_8290617_8444463
Nipsnap1,11,4873951,4894200,protein_coding,1,20249,chr11_4873951_4894200
Nipsnap3b,4,53011880,53022060,protein_coding,1,10180,chr4_53011880_53022060
Nisch,14,31170930,31216946,protein_coding,-1,46016,chr14_31170930_31216946
Nit1,1,171338008,171345646,protein_coding,-1,7638,chr1_171338008_171345646
Nit2,16,57156665,57167341,protein_coding,-1,10676,chr16_57156665_57167341
Nkain1,4,130531602,130574173,protein_coding,-1,42571,chr4_130531602_130574173
Nkain2,10,31689310,32890462,protein_coding,-1,1201152,chr10_31689310_32890462
Nkain3,4,20118874,20778866,protein_coding,-1,659992,chr4_20118874_20778866
Nkain4,2,180934772,180954699,protein_coding,-1,19927,chr2_180934772_180954699
Nkap,X,37126795,37150746,protein_coding,1,23951,chrX_37126795_37150746
Nkapl,13,21467047,21468509,protein_coding,-1,1462,chr13_21467047_21468509
Nkd1,8,88521354,88594884,protein_coding,1,73530,chr8_88521354_88594884
Nkd2,13,73818534,73847631,protein_coding,-1,29097,chr13_73818534_73847631
Nkiras1,14,18271136,18284003,protein_coding,1,12867,chr14_18271136_18284003
Nkiras2,11,100619244,100627607,protein_coding,1,8363,chr11_100619244_100627607
Nkpd1,7,19517838,19525056,protein_coding,1,7218,chr7_19517838_19525056
Nkrf,X,36887540,36903513,protein_coding,-1,15973,chrX_36887540_36903513
Nktr,9,121719169,121756843,protein_coding,1,37674,chr9_121719169_121756843
Nkx2-1,12,56531958,56536908,protein_coding,-1,4950,chr12_56531958_56536908
Nkx2-2,2,147177546,147194243,protein_coding,-1,16697,chr2_147177546_147194243
Nkx2-2os,2,147184083,147331681,antisense;misc_RNA,1,147598,chr2_147184083_147331681
Nkx2-5,17,26838664,26845009,protein_coding,-1,6345,chr17_26838664_26845009
Nkx2-9,12,56611389,56613284,protein_coding,-1,1895,chr12_56611389_56613284
Nkx3-1,14,69190638,69194662,protein_coding,1,4024,chr14_69190638_69194662
Nkx6-1,5,101658139,101664996,protein_coding,-1,6857,chr5_101658139_101664996
Nkx6-2,7,139579376,139582797,protein_coding,-1,3421,chr7_139579376_139582797
Nkx6-3,8,23153269,23158948,protein_coding,1,5679,chr8_23153269_23158948
Nle1,11,82900768,82908411,protein_coding,-1,7643,chr11_82900768_82908411
Nlgn1,3,25426215,26332460,protein_coding,-1,906245,chr3_25426215_26332460
Nlgn2,11,69823122,69837784,protein_coding,-1,14662,chr11_69823122_69837784
Nlgn3,X,101299168,101325963,protein_coding,1,26795,chrX_101299168_101325963
Nlk,11,78567168,78697373,protein_coding,-1,130205,chr11_78567168_78697373
Nlk-ps1,2,87163948,87167315,processed_pseudogene,-1,3367,chr2_87163948_87167315
Nln,13,104023057,104109614,protein_coding,-1,86557,chr13_104023057_104109614
Nlrc3,16,3945007,3976632,protein_coding,-1,31625,chr16_3945007_3976632
Nlrc4,17,74425438,74459142,protein_coding,-1,33704,chr17_74425438_74459142
Nlrc5,8,94434356,94527272,protein_coding,1,92916,chr8_94434356_94527272
Nlrp12,7,3217458,3249740,protein_coding,-1,32282,chr7_3217458_3249740
Nlrp1a,11,71092236,71144704,protein_coding,-1,52468,chr11_71092236_71144704
Nlrp1b,11,71153102,71242913,protein_coding,-1,89811,chr11_71153102_71242913
Nlrp1c-ps,11,71242430,71285232,transcribed_unprocessed_pseudogene,-1,42802,chr11_71242430_71285232
Nlrp2,7,5298547,5351035,protein_coding,-1,52488,chr7_5298547_5351035
Nlrp3,11,59541568,59566956,protein_coding,1,25388,chr11_59541568_59566956
Nlrp4c,7,6045161,6105150,protein_coding,1,59989,chr7_6045161_6105150
Nlrp4f,13,65177111,65205977,protein_coding,-1,28866,chr13_65177111_65205977
Nlrp4g,9,124348872,124363459,transcribed_unprocessed_pseudogene,1,14587,chr9_124348872_124363459
Nlrp5,7,23385889,23441922,protein_coding,1,56033,chr7_23385889_23441922
Nlrp5-ps,7,14530652,14622479,transcribed_unprocessed_pseudogene,-1,91827,chr7_14530652_14622479
Nlrp6,7,140920902,140929192,protein_coding,1,8290,chr7_140920902_140929192
Nlrx1,9,44252717,44268599,protein_coding,-1,15882,chr9_44252717_44268599
Nmb,7,80902227,80905076,protein_coding,-1,2849,chr7_80902227_80905076
Nmbr,10,14705591,14770850,protein_coding,1,65259,chr10_14705591_14770850
Nmd3,3,69721985,69756373,protein_coding,1,34388,chr3_69721985_69756373
Nme1,11,93956979,93968521,protein_coding,-1,11542,chr11_93956979_93968521
Nme2,11,93949814,93956259,protein_coding,-1,6445,chr11_93949814_93956259
Nme3,17,24896500,24897522,protein_coding,1,1022,chr17_24896500_24897522
Nme4,17,26091734,26095602,protein_coding,-1,3868,chr17_26091734_26095602
Nme5,18,34562634,34579115,protein_coding,-1,16481,chr18_34562634_34579115
Nme6,9,109832749,109843116,protein_coding,1,10367,chr9_109832749_109843116
Nme7,1,164304121,164437725,protein_coding,1,133604,chr1_164304121_164437725
Nme8,13,19645078,19697794,protein_coding,-1,52716,chr13_19645078_19697794
Nmi,2,51948487,51973494,protein_coding,-1,25007,chr2_51948487_51973494
Nmnat1,4,149467572,149485202,protein_coding,-1,17630,chr4_149467572_149485202
Nmnat2,1,152954993,153119261,protein_coding,1,164268,chr1_152954993_153119261
Nmnat3,9,98287435,98420438,protein_coding,1,133003,chr9_98287435_98420438
Nmral1,16,4710059,4719356,protein_coding,-1,9297,chr16_4710059_4719356
Nmrk1,19,18631950,18652428,protein_coding,1,20478,chr19_18631950_18652428
Nmrk2,10,81198170,81202051,protein_coding,-1,3881,chr10_81198170_81202051
Nmt1,11,103028190,103068912,protein_coding,1,40722,chr11_103028190_103068912
Nmt2,2,3284212,3328877,protein_coding,1,44665,chr2_3284212_3328877
Nmur1,1,86386303,86426228,protein_coding,-1,39925,chr1_86386303_86426228
Nnat,2,157560078,157562522,protein_coding,1,2444,chr2_157560078_157562522
Nnmt,9,48591877,48605153,protein_coding,-1,13276,chr9_48591877_48605153
Nnt,13,119335448,119408997,protein_coding,-1,73549,chr13_119335448_119408997
Noa1,5,77294182,77310084,protein_coding,-1,15902,chr5_77294182_77310084
Nob1,8,107412486,107425051,protein_coding,-1,12565,chr8_107412486_107425051
Nobox,6,43303674,43309554,protein_coding,-1,5880,chr6_43303674_43309554
Noc2l,4,156235919,156247616,protein_coding,1,11697,chr4_156235919_156247616
Noc3l,19,38788128,38819237,protein_coding,-1,31109,chr19_38788128_38819237
Noc4l,5,110648418,110653417,protein_coding,-1,4999,chr5_110648418_110653417
Nod1,6,54923949,54972612,protein_coding,-1,48663,chr6_54923949_54972612
Nod2,8,88647315,88688474,protein_coding,1,41159,chr8_88647315_88688474
Nodal,10,61417972,61425338,protein_coding,1,7366,chr10_61417972_61425338
Nog,11,89300638,89302332,protein_coding,-1,1694,chr11_89300638_89302332
Nol10,12,17348458,17430095,protein_coding,1,81637,chr12_17348458_17430095
Nol11,11,107166663,107189381,protein_coding,-1,22718,chr11_107166663_107189381
Nol12,15,78934933,78943638,protein_coding,1,8705,chr15_78934933_78943638
Nol3,8,105276140,105281939,protein_coding,1,5799,chr8_105276140_105281939
Nol4,18,22693181,23041653,protein_coding,-1,348472,chr18_22693181_23041653
Nol4l,2,153407462,153529971,protein_coding,-1,122509,chr2_153407462_153529971
Nol6,4,41114427,41124455,protein_coding,-1,10028,chr4_41114427_41124455
Nol7,13,43398390,43407097,protein_coding,1,8707,chr13_43398390_43407097
Nol8,13,49653078,49679016,protein_coding,1,25938,chr13_49653078_49679016
Nol9,4,152039321,152061494,protein_coding,1,22173,chr4_152039321_152061494
Nolc1,19,46075863,46085530,protein_coding,1,9667,chr19_46075863_46085530
Nom1,5,29434664,29457843,protein_coding,1,23179,chr5_29434664_29457843
Nomo1,7,46033698,46084212,protein_coding,1,50514,chr7_46033698_46084212
Nono,X,101429318,101448591,protein_coding,1,19273,chrX_101429318_101448591
Nop10,2,112261926,112263269,protein_coding,1,1343,chr2_112261926_112263269
Nop14,5,34638536,34660148,protein_coding,-1,21612,chr5_34638536_34660148
Nop16,13,54584185,54590090,protein_coding,-1,5905,chr13_54584185_54590090
Nop2,6,125131909,125144753,protein_coding,1,12844,chr6_125131909_125144753
Nop56,2,130274430,130279313,protein_coding,1,4883,chr2_130274430_130279313
Nop58,1,59684971,59719044,protein_coding,1,34073,chr1_59684971_59719044
Nop9,14,55745693,55755500,protein_coding,1,9807,chr14_55745693_55755500
Nos1,5,117781032,117958840,protein_coding,1,177808,chr5_117781032_117958840
Nos1ap,1,170302668,170589861,protein_coding,-1,287193,chr1_170302668_170589861
Nos2,11,78920787,78960254,protein_coding,1,39467,chr11_78920787_78960254
Nos3,5,24364810,24384474,protein_coding,1,19664,chr5_24364810_24384474
Nosip,7,45062429,45078210,protein_coding,1,15781,chr7_45062429_45078210
Nostrin,2,69135800,69189330,protein_coding,1,53530,chr2_69135800_69189330
Notch1,2,26457903,26516663,protein_coding,-1,58760,chr2_26457903_26516663
Notch2,3,98013527,98150361,protein_coding,1,136834,chr3_98013527_98150361
Notch3,17,32120820,32166852,protein_coding,-1,46032,chr17_32120820_32166852
Notch4,17,34564268,34588503,protein_coding,1,24235,chr17_34564268_34588503
Notum,11,120653788,120661175,protein_coding,-1,7387,chr11_120653788_120661175
Nova1,12,46694517,46818929,protein_coding,-1,124412,chr12_46694517_46818929
Nova2,7,18925888,18965319,protein_coding,1,39431,chr7_18925888_18965319
Nox1,X,134086421,134221956,protein_coding,-1,135535,chrX_134086421_134221956
Nox3,17,3635240,3696261,protein_coding,-1,61021,chr17_3635240_3696261
Nox4,7,87246096,87398710,protein_coding,1,152614,chr7_87246096_87398710
Noxo1,17,24696234,24700529,protein_coding,1,4295,chr17_24696234_24700529
Noxred1,12,87221040,87238732,protein_coding,-1,17692,chr12_87221040_87238732
Npas1,7,16455721,16477728,protein_coding,-1,22007,chr7_16455721_16477728
Npas2,1,39193731,39363236,protein_coding,1,169505,chr1_39193731_39363236
Npas3,12,53248157,54072175,protein_coding,1,824018,chr12_53248157_54072175
Npas4,19,4984355,4990316,protein_coding,-1,5961,chr19_4984355_4990316
Npat,9,53537047,53574342,protein_coding,1,37295,chr9_53537047_53574342
Npb,11,120608477,120609093,protein_coding,1,616,chr11_120608477_120609093
Npbwr1,1,5913707,5917398,protein_coding,-1,3691,chr1_5913707_5917398
Npc1,18,12189692,12236400,protein_coding,-1,46708,chr18_12189692_12236400
Npc1l1,11,6211013,6230143,protein_coding,-1,19130,chr11_6211013_6230143
Npc2,12,84754562,84773152,protein_coding,-1,18590,chr12_84754562_84773152
Npdc1,2,25399351,25409494,protein_coding,1,10143,chr2_25399351_25409494
Npepl1,2,174110349,174123070,protein_coding,1,12721,chr2_174110349_174123070
Npepps,11,97205842,97280638,protein_coding,-1,74796,chr11_97205842_97280638
Npff,15,102523839,102524942,protein_coding,-1,1103,chr15_102523839_102524942
Npffr1,10,61595492,61628565,protein_coding,1,33073,chr10_61595492_61628565
Npffr2,5,89527429,89583740,protein_coding,1,56311,chr5_89527429_89583740
Nphp1,2,127740732,127788897,protein_coding,-1,48165,chr2_127740732_127788897
Nphp3,9,104002544,104043818,protein_coding,1,41274,chr9_104002544_104043818
Nphp4,4,152476706,152563183,protein_coding,1,86477,chr4_152476706_152563183
Nphs1,7,30458315,30487223,protein_coding,1,28908,chr7_30458315_30487223
Nphs2,1,156310727,156328035,protein_coding,1,17308,chr1_156310727_156328035
Npl,1,153503015,153550045,protein_coding,-1,47030,chr1_153503015_153550045
Nploc4,11,120380370,120437708,protein_coding,-1,57338,chr11_120380370_120437708
Npm1,11,33152287,33163206,protein_coding,-1,10919,chr11_33152287_33163206
Npm2,14,70647302,70659244,protein_coding,-1,11942,chr14_70647302_70659244
Npm3,19,45747734,45749591,protein_coding,-1,1857,chr19_45747734_45749591
Npm3-ps1,6,85076192,85076719,processed_pseudogene,1,527,chr6_85076192_85076719
Npnt,3,132881745,132950291,protein_coding,-1,68546,chr3_132881745_132950291
Nppa,4,148000722,148002079,protein_coding,1,1357,chr4_148000722_148002079
Nppb,4,147985788,147987205,protein_coding,1,1417,chr4_147985788_147987205
Nppc,1,86666291,86670571,protein_coding,-1,4280,chr1_86666291_86670571
Npr1,3,90450591,90465866,protein_coding,-1,15275,chr3_90450591_90465866
Npr2,4,43631935,43651244,protein_coding,1,19309,chr4_43631935_43651244
Npr3,15,11839896,11907287,protein_coding,-1,67391,chr15_11839896_11907287
Nprl2,9,107542226,107545706,protein_coding,1,3480,chr9_107542226_107545706
Nprl3,11,32225628,32267707,protein_coding,-1,42079,chr11_32225628_32267707
Npsr1,9,24097996,24316398,protein_coding,1,218402,chr9_24097996_24316398
Nptn,9,58582240,58657955,protein_coding,1,75715,chr9_58582240_58657955
Nptx1,11,119538719,119547753,protein_coding,-1,9034,chr11_119538719_119547753
Nptx2,5,144545902,144557478,protein_coding,1,11576,chr5_144545902_144557478
Nptxr,15,79786351,79804766,protein_coding,-1,18415,chr15_79786351_79804766
Npw,17,24657330,24658457,protein_coding,-1,1127,chr17_24657330_24658457
Npy,6,49822710,49829507,protein_coding,1,6797,chr6_49822710_49829507
Npy1r,8,66697192,66706792,protein_coding,1,9600,chr8_66697192_66706792
Npy2r,3,82538383,82548084,protein_coding,-1,9701,chr3_82538383_82548084
Npy5r,8,66679965,66688128,protein_coding,-1,8163,chr8_66679965_66688128
Npy6r,18,44270127,44277700,protein_coding,1,7573,chr18_44270127_44277700
Nqo1,8,107388225,107403206,protein_coding,-1,14981,chr8_107388225_107403206
Nqo2,13,33964687,33988443,protein_coding,1,23756,chr13_33964687_33988443
Nr1d1,11,98767932,98775333,protein_coding,-1,7401,chr11_98767932_98775333
Nr1d2,14,18204054,18239127,protein_coding,-1,35073,chr14_18204054_18239127
Nr1h2,7,44549616,44553951,protein_coding,-1,4335,chr7_44549616_44553951
Nr1h3,2,91184061,91202834,protein_coding,-1,18773,chr2_91184061_91202834
Nr1h4,10,89454234,89533585,protein_coding,-1,79351,chr10_89454234_89533585
Nr1h5,3,102939658,102964133,protein_coding,-1,24475,chr3_102939658_102964133
Nr1i3,1,171213970,171220701,protein_coding,1,6731,chr1_171213970_171220701
Nr2c1,10,94148023,94197211,protein_coding,1,49188,chr10_94148023_94197211
Nr2c2,6,92091390,92174294,protein_coding,1,82904,chr6_92091390_92174294
Nr2c2ap,8,70131333,70133749,protein_coding,1,2416,chr8_70131333_70133749
Nr2e1,10,42561963,42583632,protein_coding,-1,21669,chr10_42561963_42583632
Nr2e3,9,59942771,59960659,protein_coding,-1,17888,chr9_59942771_59960659
Nr2f1,13,78188973,78199757,protein_coding,-1,10784,chr13_78188973_78199757
Nr2f2,7,70351944,70366735,protein_coding,-1,14791,chr7_70351944_70366735
Nr2f6,8,71374123,71381960,protein_coding,-1,7837,chr8_71374123_71381960
Nr3c1,18,39410545,39519421,protein_coding,-1,108876,chr18_39410545_39519421
Nr3c2,8,76899442,77245012,protein_coding,1,345570,chr8_76899442_77245012
Nr4a1,15,101254269,101274795,protein_coding,1,20526,chr15_101254269_101274795
Nr4a2,2,57106830,57124003,protein_coding,-1,17173,chr2_57106830_57124003
Nr4a3,4,48045153,48086447,protein_coding,1,41294,chr4_48045153_48086447
Nr5a2,1,136842571,136960448,protein_coding,-1,117877,chr1_136842571_136960448
Nr6a1,2,38723370,38927688,protein_coding,-1,204318,chr2_38723370_38927688
Nradd,9,110621135,110624452,protein_coding,-1,3317,chr9_110621135_110624452
Nrap,19,56320035,56390037,protein_coding,-1,70002,chr19_56320035_56390037
Nrarp,2,25180758,25183339,protein_coding,1,2581,chr2_25180758_25183339
Nras,3,103058285,103067914,protein_coding,1,9629,chr3_103058285_103067914
Nrbf2,10,67266689,67285305,protein_coding,-1,18616,chr10_67266689_67285305
Nrbp1,5,31240864,31251566,protein_coding,1,10702,chr5_31240864_31251566
Nrbp2,15,76085518,76091627,protein_coding,-1,6109,chr15_76085518_76091627
Nrcam,12,44328885,44601964,protein_coding,1,273079,chr12_44328885_44601964
Nrd1,4,109000655,109061777,protein_coding,1,61122,chr4_109000655_109061777
Nrde2,12,100125452,100159653,protein_coding,-1,34201,chr12_100125452_100159653
Nrep,18,33437019,33464029,protein_coding,-1,27010,chr18_33437019_33464029
Nrf1,6,30047988,30153458,protein_coding,1,105470,chr6_30047988_30153458
Nrg1,8,31814551,32884797,protein_coding,-1,1070246,chr8_31814551_32884797
Nrg2,18,36017652,36197380,protein_coding,-1,179728,chr18_36017652_36197380
Nrg3,14,38368952,39473088,protein_coding,-1,1104136,chr14_38368952_39473088
Nrg3os,14,38898302,38958794,antisense,1,60492,chr14_38898302_38958794
Nrg4,9,55220222,55326844,protein_coding,-1,106622,chr9_55220222_55326844
Nrgn,9,37544492,37552904,protein_coding,-1,8412,chr9_37544492_37552904
Nrip1,16,76287400,76373827,protein_coding,-1,86427,chr16_76287400_76373827
Nrip2,6,128399296,128416427,protein_coding,1,17131,chr6_128399296_128416427
Nrip3,7,109758055,109782025,protein_coding,-1,23970,chr7_109758055_109782025
Nrk,X,138914430,139010532,protein_coding,1,96102,chrX_138914430_139010532
Nrl,14,55518978,55524981,protein_coding,-1,6003,chr14_55518978_55524981
Nrm,17,35861318,35865402,protein_coding,1,4084,chr17_35861318_35865402
Nrn1,13,36725361,36735131,protein_coding,-1,9770,chr13_36725361_36735131
Nrn1l,8,105893567,105895023,protein_coding,1,1456,chr8_105893567_105895023
Nron,2,33805816,33813591,antisense;misc_RNA,1,7775,chr2_33805816_33813591
Nrp1,8,128358604,128503363,protein_coding,1,144759,chr8_128358604_128503363
Nrp2,1,62703285,62818695,protein_coding,1,115410,chr1_62703285_62818695
Nrros,16,32142785,32165594,protein_coding,-1,22809,chr16_32142785_32165594
Nrsn1,13,25252040,25270502,protein_coding,-1,18462,chr13_25252040_25270502
Nrsn2,2,152368755,152376638,protein_coding,-1,7883,chr2_152368755_152376638
Nrtn,17,56751325,56757530,protein_coding,-1,6205,chr17_56751325_56757530
Nrxn1,17,90033631,91093071,protein_coding,-1,1059440,chr17_90033631_91093071
Nrxn2,19,6418731,6544169,protein_coding,1,125438,chr19_6418731_6544169
Nrxn3,12,88722876,90334935,protein_coding,1,1612059,chr12_88722876_90334935
Nsa2,13,97129424,97137937,protein_coding,-1,8513,chr13_97129424_97137937
Nsa2-ps1,19,22441135,22441914,processed_pseudogene,1,779,chr19_22441135_22441914
Nsa2-ps2,X,136328299,136329071,processed_pseudogene,1,772,chrX_136328299_136329071
Nsd1,13,55209782,55318325,protein_coding,1,108543,chr13_55209782_55318325
Nsdhl,X,72918557,72958514,protein_coding,1,39957,chrX_72918557_72958514
Nsf,11,103821782,103954056,protein_coding,-1,132274,chr11_103821782_103954056
Nsfl1c,2,151494182,151511414,protein_coding,1,17232,chr2_151494182_151511414
Nsg1,5,38137192,38159907,protein_coding,-1,22715,chr5_38137192_38159907
Nsg2,11,32000463,32059202,protein_coding,1,58739,chr11_32000463_32059202
Nsl1,1,191063012,191086474,protein_coding,1,23462,chr1_191063012_191086474
Nsmaf,4,6396207,6454271,protein_coding,-1,58064,chr4_6396207_6454271
Nsmce1,7,125467640,125491596,protein_coding,-1,23956,chr7_125467640_125491596
Nsmce2,15,59374247,59601684,protein_coding,1,227437,chr15_59374247_59601684
Nsmce4a,7,130532526,130573118,protein_coding,-1,40592,chr7_130532526_130573118
Nsmf,2,25054355,25062881,protein_coding,1,8526,chr2_25054355_25062881
Nsun2,13,69533746,69635780,protein_coding,1,102034,chr13_69533746_69635780
Nsun3,16,62732444,62786818,protein_coding,-1,54374,chr16_62732444_62786818
Nsun4,4,116032842,116053876,protein_coding,-1,21034,chr4_116032842_116053876
Nsun5,5,135369953,135376805,protein_coding,1,6852,chr5_135369953_135376805
Nsun6,2,14995131,15055069,protein_coding,-1,59938,chr2_14995131_15055069
Nsun7,5,66259897,66298026,protein_coding,1,38129,chr5_66259897_66298026
Nt5c,11,115490420,115491862,protein_coding,-1,1442,chr11_115490420_115491862
Nt5c1a,4,123201504,123216275,protein_coding,1,14771,chr4_123201504_123216275
Nt5c1b,12,10369973,10390175,protein_coding,1,20202,chr12_10369973_10390175
Nt5c2,19,46883317,47015153,protein_coding,-1,131836,chr19_46883317_47015153
Nt5c3,6,56882400,56923932,protein_coding,-1,41532,chr6_56882400_56923932
Nt5c3b,11,100422321,100441808,protein_coding,-1,19487,chr11_100422321_100441808
Nt5dc1,10,34288288,34418552,protein_coding,-1,130264,chr10_34288288_34418552
Nt5dc2,14,31131053,31139124,protein_coding,1,8071,chr14_31131053_31139124
Nt5dc3,10,86779005,86838389,protein_coding,1,59384,chr10_86779005_86838389
Nt5e,9,88327197,88372092,protein_coding,1,44895,chr9_88327197_88372092
Nt5m,11,59839447,59880968,protein_coding,1,41521,chr11_59839447_59880968
Ntan1,16,13818845,13835451,protein_coding,1,16606,chr16_13818845_13835451
Ntf3,6,126101412,126166910,protein_coding,-1,65498,chr6_126101412_126166910
Ntf5,7,45413695,45417179,protein_coding,1,3484,chr7_45413695_45417179
Nthl1,17,24632680,24638837,protein_coding,1,6157,chr17_24632680_24638837
Ntm,9,28994750,29963141,protein_coding,-1,968391,chr9_28994750_29963141
Ntmt1,2,30807826,30823033,protein_coding,1,15207,chr2_30807826_30823033
Ntn1,11,68209364,68400823,protein_coding,-1,191459,chr11_68209364_68400823
Ntn3,17,24203848,24209531,protein_coding,-1,5683,chr17_24203848_24209531
Ntn4,10,93640681,93747207,protein_coding,1,106526,chr10_93640681_93747207
Ntn5,7,45684022,45694556,protein_coding,1,10534,chr7_45684022_45694556
Ntng1,3,109780040,110144011,protein_coding,-1,363971,chr3_109780040_110144011
Ntng2,2,29194541,29253005,protein_coding,-1,58464,chr2_29194541_29253005
Ntpcr,8,125729963,125748235,protein_coding,1,18272,chr8_125729963_125748235
Ntrk1,3,87778244,87795162,protein_coding,-1,16918,chr3_87778244_87795162
Ntrk2,13,58806569,59133970,protein_coding,1,327401,chr13_58806569_59133970
Ntrk3,7,78175959,78738012,protein_coding,-1,562053,chr7_78175959_78738012
Nts,10,102481756,102490486,protein_coding,-1,8730,chr10_102481756_102490486
Ntsr1,2,180499976,180544980,protein_coding,1,45004,chr2_180499976_180544980
Ntsr2,12,16653382,16660227,protein_coding,1,6845,chr12_16653382_16660227
Nuak1,10,84370905,84440597,protein_coding,-1,69692,chr10_84370905_84440597
Nuak2,1,132316126,132333488,protein_coding,1,17362,chr1_132316126_132333488
Nub1,5,24685532,24710378,protein_coding,1,24846,chr5_24685532_24710378
Nubp1,16,10411948,10424428,protein_coding,1,12480,chr16_10411948_10424428
Nubp2,17,24882611,24886349,protein_coding,-1,3738,chr17_24882611_24886349
Nubpl,12,52097737,52312744,protein_coding,1,215007,chr12_52097737_52312744
Nucb1,7,45490458,45510406,protein_coding,-1,19948,chr7_45490458_45510406
Nucb2,7,116504369,116540584,protein_coding,1,36215,chr7_116504369_116540584
Nucks1,1,131910534,131936321,protein_coding,1,25787,chr1_131910534_131936321
Nudc,4,133532542,133545996,protein_coding,-1,13454,chr4_133532542_133545996
Nudc-ps1,8,29286431,29286981,processed_pseudogene,-1,550,chr8_29286431_29286981
Nudcd1,15,44373163,44428307,protein_coding,-1,55144,chr15_44373163_44428307
Nudcd2,11,40733667,40740046,protein_coding,1,6379,chr11_40733667_40740046
Nudcd3,11,6105691,6200415,protein_coding,-1,94724,chr11_6105691_6200415
Nudt1,5,140321656,140338137,protein_coding,1,16481,chr5_140321656_140338137
Nudt10,X,6168696,6173015,protein_coding,-1,4319,chrX_6168696_6173015
Nudt11,X,6047453,6055110,protein_coding,1,7657,chrX_6047453_6055110
Nudt12,17,58999618,59013372,protein_coding,-1,13754,chr17_58999618_59013372
Nudt12os,17,58996251,59024981,antisense,1,28730,chr17_58996251_59024981
Nudt13,14,20294697,20317578,protein_coding,1,22881,chr14_20294697_20317578
Nudt14,12,112934291,112942124,protein_coding,-1,7833,chr12_112934291_112942124
Nudt15,14,73518877,73548242,protein_coding,-1,29365,chr14_73518877_73548242
Nudt16,9,105128903,105131824,protein_coding,-1,2921,chr9_105128903_105131824
Nudt16l1,16,4938761,4941032,protein_coding,1,2271,chr16_4938761_4941032
Nudt17,3,96706067,96708562,protein_coding,-1,2495,chr3_96706067_96708562
Nudt18,14,70577637,70582688,protein_coding,1,5051,chr14_70577637_70582688
Nudt19,7,35547185,35556304,protein_coding,-1,9119,chr7_35547185_35556304
Nudt2,4,41465151,41480926,protein_coding,1,15775,chr4_41465151_41480926
Nudt21,8,94015496,94037031,protein_coding,-1,21535,chr8_94015496_94037031
Nudt22,19,6993018,6996117,protein_coding,-1,3099,chr19_6993018_6996117
Nudt3,17,27579382,27623495,protein_coding,-1,44113,chr17_27579382_27623495
Nudt4,10,95547007,95564146,protein_coding,-1,17139,chr10_95547007_95564146
Nudt5,2,5845019,5871895,protein_coding,1,26876,chr2_5845019_5871895
Nudt6,3,37404910,37420211,protein_coding,-1,15301,chr3_37404910_37420211
Nudt7,8,114133557,114154739,protein_coding,1,21182,chr8_114133557_114154739
Nudt8,19,4000580,4002103,protein_coding,1,1523,chr19_4000580_4002103
Nudt9,5,104046306,104065379,protein_coding,1,19073,chr5_104046306_104065379
Nuf2,1,169497934,169531464,protein_coding,-1,33530,chr1_169497934_169531464
Nufip1,14,76110891,76137379,protein_coding,1,26488,chr14_76110891_76137379
Nufip2,11,77686155,77741921,protein_coding,1,55766,chr11_77686155_77741921
Nuggc,14,65598546,65648531,protein_coding,1,49985,chr14_65598546_65648531
Numa1,7,101934111,102014964,protein_coding,1,80853,chr7_101934111_102014964
Numb,12,83794034,83921934,protein_coding,-1,127900,chr12_83794034_83921934
Numbl,7,27258433,27282144,protein_coding,1,23711,chr7_27258433_27282144
Nup107,10,117750621,117792705,protein_coding,-1,42084,chr10_117750621_117792705
Nup133,8,123897123,123949265,protein_coding,-1,52142,chr8_123897123_123949265
Nup153,13,46679905,46727940,protein_coding,-1,48035,chr13_46679905_46727940
Nup155,15,8109273,8161247,protein_coding,1,51974,chr15_8109273_8161247
Nup160,2,90677215,90736328,protein_coding,1,59113,chr2_90677215_90736328
Nup188,2,30286397,30344266,protein_coding,1,57869,chr2_30286397_30344266
Nup205,6,35177421,35247596,protein_coding,1,70175,chr6_35177421_35247596
Nup210,6,91013068,91116829,protein_coding,-1,103761,chr6_91013068_91116829
Nup210l,3,90104132,90212048,protein_coding,1,107916,chr3_90104132_90212048
Nup214,2,31974436,32053975,protein_coding,1,79539,chr2_31974436_32053975
Nup35,2,80617236,80658906,protein_coding,1,41670,chr2_80617236_80658906
Nup37,10,88146992,88178390,protein_coding,1,31398,chr10_88146992_88178390
Nup43,10,7593267,7678881,protein_coding,1,85614,chr10_7593267_7678881
Nup50,15,84923411,84942963,protein_coding,1,19552,chr15_84923411_84942963
Nup54,5,92415540,92435219,protein_coding,-1,19679,chr5_92415540_92435219
Nup62,7,44816088,44830812,protein_coding,1,14724,chr7_44816088_44830812
Nup62cl,X,140006805,140062712,protein_coding,-1,55907,chrX_140006805_140062712
Nup85,11,115564434,115583985,protein_coding,1,19551,chr11_115564434_115583985
Nup88,11,70943058,70969973,protein_coding,-1,26915,chr11_70943058_70969973
Nup93,8,94214564,94317227,protein_coding,1,102663,chr8_94214564_94317227
Nup98,7,102119398,102210176,protein_coding,-1,90778,chr7_102119398_102210176
Nupl1,14,60184612,60251431,protein_coding,-1,66819,chr14_60184612_60251431
Nupl2,5,24164963,24184013,protein_coding,1,19050,chr5_24164963_24184013
Nupr1,7,126623249,126630861,protein_coding,-1,7612,chr7_126623249_126630861
Nupr1l,5,129908540,129913789,protein_coding,1,5249,chr5_129908540_129913789
Nus1,10,52417547,52440183,protein_coding,1,22636,chr10_52417547_52440183
Nusap1,2,119618298,119651244,protein_coding,1,32946,chr2_119618298_119651244
Nutf2,8,105860580,105879330,protein_coding,1,18750,chr8_105860580_105879330
Nutf2-ps1,19,53588168,53589068,protein_coding,-1,900,chr19_53588168_53589068
Nutm1,2,112247948,112259291,protein_coding,-1,11343,chr2_112247948_112259291
Nvl,1,181087138,181144204,protein_coding,-1,57066,chr1_181087138_181144204
Nwd1,8,72646711,72717876,protein_coding,1,71165,chr8_72646711_72717876
Nwd2,5,63649102,63810546,protein_coding,1,161444,chr5_63649102_63810546
Nxf1,19,8757073,8770922,protein_coding,1,13849,chr19_8757073_8770922
Nxf2,X,134944526,134964754,protein_coding,-1,20228,chrX_134944526_134964754
Nxf3,X,136072099,136085255,protein_coding,-1,13156,chrX_136072099_136085255
Nxf7,X,135579555,135598777,protein_coding,-1,19222,chrX_135579555_135598777
Nxn,11,76257198,76399140,protein_coding,-1,141942,chr11_76257198_76399140
Nxnl1,8,71560555,71566601,protein_coding,-1,6046,chr8_71560555_71566601
Nxnl2,13,51171022,51175188,protein_coding,1,4166,chr13_51171022_51175188
Nxpe1-ps,9,48418321,48431959,transcribed_unprocessed_pseudogene,1,13638,chr9_48418321_48431959
Nxpe2,9,48318006,48353454,protein_coding,-1,35448,chr9_48318006_48353454
Nxpe3,16,55839953,55895285,protein_coding,-1,55332,chr16_55839953_55895285
Nxpe4,9,48162023,48400025,protein_coding,1,238002,chr9_48162023_48400025
Nxph1,6,8948431,9249032,protein_coding,1,300601,chr6_8948431_9249032
Nxph2,2,23321246,23401973,protein_coding,1,80727,chr2_23321246_23401973
Nxph3,11,95509845,95514570,protein_coding,-1,4725,chr11_95509845_95514570
Nxph4,10,127525473,127534559,protein_coding,-1,9086,chr10_127525473_127534559
Nxt1,2,148672601,148676027,protein_coding,1,3426,chr2_148672601_148676027
Nxt2,X,142226770,142239692,protein_coding,1,12922,chrX_142226770_142239692
Nyap1,5,137729899,137741607,protein_coding,-1,11708,chr5_137729899_137741607
Nyap2,1,81076950,81341764,protein_coding,1,264814,chr1_81076950_81341764
Nynrin,14,55854010,55874736,protein_coding,1,20726,chr14_55854010_55874736
Nyx,X,13466110,13489313,protein_coding,1,23203,chrX_13466110_13489313
Oacyl,18,65698268,65751601,protein_coding,1,53333,chr18_65698268_65751601
Oaf,9,43221235,43239911,protein_coding,-1,18676,chr9_43221235_43239911
Oard1,17,48406117,48417266,protein_coding,1,11149,chr17_48406117_48417266
Oas1b,5,120812635,120824163,polymorphic_pseudogene,1,11528,chr5_120812635_120824163
Oas1c,5,120800194,120812514,protein_coding,-1,12320,chr5_120800194_120812514
Oas1h,5,120861421,120873506,protein_coding,1,12085,chr5_120861421_120873506
Oas2,5,120730333,120749853,protein_coding,-1,19520,chr5_120730333_120749853
Oas3,5,120753098,120777661,protein_coding,-1,24563,chr5_120753098_120777661
Oasl2,5,114896936,114912234,protein_coding,1,15298,chr5_114896936_114912234
Oat,7,132557478,132576398,protein_coding,-1,18920,chr7_132557478_132576398
Oat-rs1,X,75915216,75916526,processed_pseudogene,1,1310,chrX_75915216_75916526
Oaz1,10,80826656,80829290,protein_coding,1,2634,chr10_80826656_80829290
Oaz1-ps,17,17345456,17346140,processed_pseudogene,-1,684,chr17_17345456_17346140
Oaz2,9,65668001,65690300,protein_coding,1,22299,chr9_65668001_65690300
Oaz3,3,94432414,94443915,protein_coding,-1,11501,chr3_94432414_94443915
Obox6,7,15833241,15839678,protein_coding,-1,6437,chr7_15833241_15839678
Obp2b,2,25737009,25740097,protein_coding,1,3088,chr2_25737009_25740097
Obscn,11,58994256,59139170,protein_coding,-1,144914,chr11_58994256_59139170
Obsl1,1,75479310,75506452,protein_coding,-1,27142,chr1_75479310_75506452
Oc90,15,65876053,65912397,protein_coding,-1,36344,chr15_65876053_65912397
Oca2,7,56239760,56536518,protein_coding,1,296758,chr7_56239760_56536518
Ocel1,8,71371298,71379361,protein_coding,1,8063,chr8_71371298_71379361
Ociad1,5,73292784,73314069,protein_coding,1,21285,chr5_73292784_73314069
Ociad2,5,73322199,73341028,protein_coding,-1,18829,chr5_73322199_73341028
Ocln,13,100496507,100552718,protein_coding,-1,56211,chr13_100496507_100552718
Ocm,5,144019804,144026670,protein_coding,-1,6866,chr5_144019804_144026670
Ocrl,X,47912387,47965868,protein_coding,1,53481,chrX_47912387_47965868
Odc1,12,17544794,17551505,protein_coding,1,6711,chr12_17544794_17551505
Odf1,15,38219203,38226735,protein_coding,1,7532,chr15_38219203_38226735
Odf2,2,29889221,29931746,protein_coding,1,42525,chr2_29889221_29931746
Odf2l,3,145118588,145153915,protein_coding,1,35327,chr3_145118588_145153915
Odf3,7,140847805,140851018,protein_coding,1,3213,chr7_140847805_140851018
Odf3b,15,89377449,89379587,protein_coding,-1,2138,chr15_89377449_89379587
Odf3l2,10,79639526,79645738,protein_coding,-1,6212,chr10_79639526_79645738
Odf4,11,68921835,68927081,protein_coding,-1,5246,chr11_68921835_68927081
Ofd1,X,166390033,166440704,protein_coding,-1,50671,chrX_166390033_166440704
Ogdh,11,6291633,6356642,protein_coding,1,65009,chr11_6291633_6356642
Ogdhl,14,32322019,32348151,protein_coding,1,26132,chr14_32322019_32348151
Ogfod1,8,94037198,94067921,protein_coding,1,30723,chr8_94037198_94067921
Ogfod2,5,124112297,124115483,protein_coding,1,3186,chr5_124112297_124115483
Ogfod3,11,121177591,121204711,protein_coding,-1,27120,chr11_121177591_121204711
Ogfr,2,180589245,180595836,protein_coding,1,6591,chr2_180589245_180595836
Ogfrl1,1,23366424,23397772,protein_coding,-1,31348,chr1_23366424_23397772
Ogg1,6,113326972,113335068,protein_coding,1,8096,chr6_113326972_113335068
Ogn,13,49608046,49624501,protein_coding,1,16455,chr13_49608046_49624501
Ogt,X,101640060,101684351,protein_coding,1,44291,chrX_101640060_101684351
Oip5,2,119609512,119618469,protein_coding,-1,8957,chr2_119609512_119618469
Oit3,10,59422958,59441778,protein_coding,-1,18820,chr10_59422958_59441778
Ola1,2,73092801,73218924,protein_coding,-1,126123,chr2_73092801_73218924
Olah,2,3341982,3397210,protein_coding,-1,55228,chr2_3341982_3397210
Olfm1,2,28192992,28230736,protein_coding,1,37744,chr2_28192992_28230736
Olfm2,9,20667690,20746349,protein_coding,-1,78659,chr9_20667690_20746349
Olfm3,3,114904078,115125722,protein_coding,1,221644,chr3_114904078_115125722
Olfm4,14,79984081,80023139,protein_coding,1,39058,chr14_79984081_80023139
Olfml1,7,107567446,107591094,protein_coding,1,23648,chr7_107567446_107591094
Olfml2a,2,38931978,38963753,protein_coding,1,31775,chr2_38931978_38963753
Olfml2b,1,170644532,170682789,protein_coding,1,38257,chr1_170644532_170682789
Olfml3,3,103722222,103738001,protein_coding,-1,15779,chr3_103722222_103738001
Olfr1005-ps1,2,85669822,85672240,unprocessed_pseudogene,1,2418,chr2_85669822_85672240
Olfr103,17,37334303,37339698,protein_coding,-1,5395,chr17_37334303_37339698
Olfr1030,2,85979276,85988294,protein_coding,1,9018,chr2_85979276_85988294
Olfr1033,2,86020633,86045171,protein_coding,1,24538,chr2_86020633_86045171
Olfr1089,2,86732584,86733701,protein_coding,-1,1117,chr2_86732584_86733701
Olfr110,17,37492468,37500207,protein_coding,1,7739,chr17_37492468_37500207
Olfr111,17,37508030,37532449,protein_coding,1,24419,chr17_37508030_37532449
Olfr112,17,37561668,37569451,protein_coding,-1,7783,chr17_37561668_37569451
Olfr1124,2,87430275,87436623,protein_coding,1,6348,chr2_87430275_87436623
Olfr1127-ps1,2,87523482,87524373,unprocessed_pseudogene,-1,891,chr2_87523482_87524373
Olfr113,17,37573877,37577663,protein_coding,-1,3786,chr17_37573877_37577663
Olfr114,17,37589233,37592743,protein_coding,-1,3510,chr17_37589233_37592743
Olfr115,17,37608940,37627109,protein_coding,-1,18169,chr17_37608940_37627109
Olfr116,17,37620577,37627199,protein_coding,-1,6622,chr17_37620577_37627199
Olfr1181,2,88420321,88426171,protein_coding,-1,5850,chr2_88420321_88426171
Olfr1320,X,49672333,49684825,protein_coding,1,12492,chrX_49672333_49684825
Olfr1338,4,118751975,118758737,protein_coding,-1,6762,chr4_118751975_118758737
Olfr1344,7,6438688,6442161,protein_coding,1,3473,chr7_6438688_6442161
Olfr1357,10,78611003,78618074,protein_coding,-1,7071,chr10_78611003_78618074
Olfr1372-ps1,11,52154722,52168159,transcribed_unprocessed_pseudogene,-1,13437,chr11_52154722_52168159
Olfr1393,11,49278304,49282769,protein_coding,1,4465,chr11_49278304_49282769
Olfr1396,11,49026649,49114874,protein_coding,-1,88225,chr11_49026649_49114874
Olfr1397-ps1,11,108687074,108688035,unprocessed_pseudogene,-1,961,chr11_108687074_108688035
Olfr1417,19,11826803,11839219,protein_coding,-1,12416,chr19_11826803_11839219
Olfr1420,19,11886565,11898079,protein_coding,1,11514,chr19_11886565_11898079
Olfr1426,19,12086746,12092013,protein_coding,-1,5267,chr19_12086746_12092013
Olfr1432,19,12227755,12232596,protein_coding,-1,4841,chr19_12227755_12232596
Olfr1439-ps1,19,12339738,12341130,unprocessed_pseudogene,-1,1392,chr19_12339738_12341130
Olfr1444,19,12857283,12863440,protein_coding,1,6157,chr19_12857283_12863440
Olfr1460-ps1,19,13158200,13159316,unprocessed_pseudogene,1,1116,chr19_13158200_13159316
Olfr153,2,87531796,87533053,protein_coding,1,1257,chr2_87531796_87533053
Olfr1543-ps1,9,38456452,38457523,unprocessed_pseudogene,1,1071,chr9_38456452_38457523
Olfr155,4,43851565,43857595,protein_coding,1,6030,chr4_43851565_43857595
Olfr1556-ps1,10,106502737,106503202,unprocessed_pseudogene,1,465,chr10_106502737_106503202
Olfr18,9,20312152,20336094,protein_coding,-1,23942,chr9_20312152_20336094
Olfr184-ps1,16,59006586,59007417,unprocessed_pseudogene,-1,831,chr16_59006586_59007417
Olfr212,6,116506516,116517965,protein_coding,1,11449,chr6_116506516_116517965
Olfr235,19,12261032,12270387,protein_coding,1,9355,chr19_12261032_12270387
Olfr239,17,33191302,33202506,protein_coding,1,11204,chr17_33191302_33202506
Olfr25,9,38329060,38335889,protein_coding,1,6829,chr9_38329060_38335889
Olfr266,3,106820485,106826287,protein_coding,-1,5802,chr3_106820485_106826287
Olfr267,4,58782704,58787716,protein_coding,-1,5012,chr4_58782704_58787716
Olfr268-ps1,2,111844262,111851838,unprocessed_pseudogene,-1,7576,chr2_111844262_111851838
Olfr274-ps1,4,52842198,52843046,unprocessed_pseudogene,-1,848,chr4_52842198_52843046
Olfr275,4,52814604,52828269,protein_coding,1,13665,chr4_52814604_52828269
Olfr277-ps1,14,124589055,124589339,unprocessed_pseudogene,1,284,chr14_124589055_124589339
Olfr279,15,98492402,98502637,protein_coding,1,10235,chr15_98492402_98502637
Olfr287,15,98206971,98221056,protein_coding,-1,14085,chr15_98206971_98221056
Olfr288,15,98186013,98195542,protein_coding,-1,9529,chr15_98186013_98195542
Olfr31,14,14322828,14331791,protein_coding,1,8963,chr14_14322828_14331791
Olfr316,11,58752734,58759671,protein_coding,1,6937,chr11_58752734_58759671
Olfr369-ps1,9,3233346,3236427,unprocessed_pseudogene,1,3081,chr9_3233346_3236427
Olfr400-ps1,11,74104841,74110791,unprocessed_pseudogene,1,5950,chr11_74104841_74110791
Olfr407-ps1,11,74280715,74281732,unprocessed_pseudogene,-1,1017,chr11_74280715_74281732
Olfr414,1,174424064,174434747,protein_coding,1,10683,chr1_174424064_174434747
Olfr416-ps1,1,174374547,174375683,unprocessed_pseudogene,1,1136,chr1_174374547_174375683
Olfr456,6,42486163,42487214,protein_coding,-1,1051,chr6_42486163_42487214
Olfr458,6,42459979,42465196,protein_coding,-1,5217,chr6_42459979_42465196
Olfr46,7,140601269,140617678,protein_coding,1,16409,chr7_140601269_140617678
Olfr464,11,87913268,87920967,protein_coding,-1,7699,chr11_87913268_87920967
Olfr5,7,6478322,6486941,protein_coding,-1,8619,chr7_6478322_6486941
Olfr53,7,140646452,140653085,protein_coding,1,6633,chr7_140646452_140653085
Olfr536,7,140500849,140507396,protein_coding,-1,6547,chr7_140500849_140507396
Olfr539,7,140659930,140678580,protein_coding,1,18650,chr7_140659930_140678580
Olfr540-ps1,7,140669126,140669737,unprocessed_pseudogene,-1,611,chr7_140669126_140669737
Olfr543,7,102476579,102481679,protein_coding,-1,5100,chr7_102476579_102481679
Olfr544,7,102482031,102488313,protein_coding,-1,6282,chr7_102482031_102488313
Olfr545,7,102491466,102499573,protein_coding,-1,8107,chr7_102491466_102499573
Olfr546-ps1,7,102521331,102521656,unprocessed_pseudogene,1,325,chr7_102521331_102521656
Olfr55,17,33168447,33180753,protein_coding,1,12306,chr17_33168447_33180753
Olfr550,7,102571442,102583011,protein_coding,1,11569,chr7_102571442_102583011
Olfr556,7,102664899,102673270,protein_coding,1,8371,chr7_102664899_102673270
Olfr557,7,102695910,102700707,protein_coding,1,4797,chr7_102695910_102700707
Olfr559,7,102723207,102727491,protein_coding,-1,4284,chr7_102723207_102727491
Olfr56,11,48978889,49135387,protein_coding,1,156498,chr11_48978889_49135387
Olfr560,7,102751818,102759366,protein_coding,-1,7548,chr7_102751818_102759366
Olfr564,7,102803480,102804430,protein_coding,1,950,chr7_102803480_102804430
Olfr568,7,102877122,102878063,protein_coding,1,941,chr7_102877122_102878063
Olfr577,7,102971180,102975943,protein_coding,-1,4763,chr7_102971180_102975943
Olfr580-ps1,7,103013136,103014490,unprocessed_pseudogene,-1,1354,chr7_103013136_103014490
Olfr648,7,104177598,104183392,protein_coding,-1,5794,chr7_104177598_104183392
Olfr658,7,104642877,104647305,protein_coding,-1,4428,chr7_104642877_104647305
Olfr661,7,104686501,104691354,protein_coding,1,4853,chr7_104686501_104691354
Olfr687,7,105272852,105276431,transcribed_unprocessed_pseudogene,1,3579,chr7_105272852_105276431
Olfr688,7,105288095,105289060,protein_coding,1,965,chr7_105288095_105289060
Olfr689,7,105311165,105319662,protein_coding,1,8497,chr7_105311165_105319662
Olfr690,7,105328225,105334104,protein_coding,-1,5879,chr7_105328225_105334104
Olfr691,7,105335509,105342270,protein_coding,-1,6761,chr7_105335509_105342270
Olfr692,7,105368230,105369355,protein_coding,1,1125,chr7_105368230_105369355
Olfr70,4,43694784,43700807,protein_coding,-1,6023,chr4_43694784_43700807
Olfr71,4,43704562,43710255,protein_coding,-1,5693,chr4_43704562_43710255
Olfr719-ps,5,106906729,106906980,unprocessed_pseudogene,1,251,chr5_106906729_106906980
Olfr754-ps1,17,37249430,37250891,unprocessed_pseudogene,1,1461,chr17_37249430_37250891
Olfr755-ps1,17,37276648,37278105,unprocessed_pseudogene,1,1457,chr17_37276648_37278105
Olfr756-ps1,17,37285142,37286069,unprocessed_pseudogene,-1,927,chr17_37285142_37286069
Olfr78,7,102738511,102759471,protein_coding,-1,20960,chr7_102738511_102759471
Olfr856-ps1,9,19657057,19658647,unprocessed_pseudogene,-1,1590,chr9_19657057_19658647
Olfr857,9,19709433,19714930,protein_coding,1,5497,chr9_19709433_19714930
Olfr877,9,37854269,37857320,protein_coding,1,3051,chr9_37854269_37857320
Olfr878,9,37917840,37922474,protein_coding,1,4634,chr9_37917840_37922474
Olfr881,9,37991825,37996408,protein_coding,1,4583,chr9_37991825_37996408
Olfr886-ps1,9,38069587,38070748,unprocessed_pseudogene,1,1161,chr9_38069587_38070748
Olfr908,9,38516034,38516965,polymorphic_pseudogene,1,931,chr9_38516034_38516965
Olfr920,9,38752299,38760117,protein_coding,1,7818,chr9_38752299_38760117
Olfr987,2,85330779,85339315,protein_coding,-1,8536,chr2_85330779_85339315
Olfr988,2,85352428,85363227,protein_coding,-1,10799,chr2_85352428_85363227
Olfr99,17,37279043,37283460,protein_coding,-1,4417,chr17_37279043_37283460
Olfr990-ps1,2,85388132,85389035,unprocessed_pseudogene,-1,903,chr2_85388132_85389035
Olig1,16,91269772,91271933,protein_coding,1,2161,chr16_91269772_91271933
Olig2,16,91225457,91228677,protein_coding,1,3220,chr16_91225457_91228677
Olr1,6,129485244,129507165,protein_coding,-1,21921,chr6_129485244_129507165
Oma1,4,103313812,103371868,protein_coding,1,58056,chr4_103313812_103371868
Omd,13,49582462,49592822,protein_coding,1,10360,chr13_49582462_49592822
Omg,11,79500982,79504084,protein_coding,-1,3102,chr11_79500982_79504084
Omp,7,98143359,98145502,protein_coding,-1,2143,chr7_98143359_98145502
Onecut1,9,74861921,74891781,protein_coding,1,29860,chr9_74861921_74891781
Onecut2,18,64340020,64400987,protein_coding,1,60967,chr18_64340020_64400987
Onecut3,10,80494835,80517276,protein_coding,1,22441,chr10_80494835_80517276
Ooep,9,78376109,78378725,protein_coding,-1,2616,chr9_78376109_78378725
Opa1,16,29579334,29654884,protein_coding,1,75550,chr16_29579334_29654884
Opa3,7,19228334,19256543,protein_coding,1,28209,chr7_19228334_19256543
Opalin,19,41061710,41077113,protein_coding,-1,15403,chr19_41061710_41077113
Opcml,9,27790775,28925410,protein_coding,1,1134635,chr9_27790775_28925410
Ophn1,X,98554277,98891025,protein_coding,-1,336748,chrX_98554277_98891025
Oplah,15,76296601,76328015,protein_coding,-1,31414,chr15_76296601_76328015
Opn1mw,X,74127464,74150760,protein_coding,1,23296,chrX_74127464_74150760
Opn1sw,6,29376671,29388468,protein_coding,-1,11797,chr6_29376671_29388468
Opn3,1,175662421,175692776,protein_coding,-1,30355,chr1_175662421_175692776
Opn4,14,34590618,34600142,protein_coding,-1,9524,chr14_34590618_34600142
Opn5,17,42556783,42611395,protein_coding,-1,54612,chr17_42556783_42611395
Oprd1,4,132110726,132144486,protein_coding,-1,33760,chr4_132110726_132144486
Oprk1,1,5588466,5606131,protein_coding,1,17665,chr1_5588466_5606131
Oprl1,2,181715016,181720985,protein_coding,1,5969,chr2_181715016_181720985
Oprm1,10,6758506,7038198,protein_coding,1,279692,chr10_6758506_7038198
Optc,1,133897199,133907999,protein_coding,-1,10800,chr1_133897199_133907999
Optn,2,5020642,5064051,protein_coding,-1,43409,chr2_5020642_5064051
Orai1,5,123015074,123030456,protein_coding,1,15382,chr5_123015074_123030456
Orai2,5,136147459,136170713,protein_coding,-1,23254,chr5_136147459_136170713
Orai3,7,127769815,127775150,protein_coding,1,5335,chr7_127769815_127775150
Orc1,4,108579423,108614833,protein_coding,1,35410,chr4_108579423_108614833
Orc2,1,58462771,58505109,protein_coding,-1,42338,chr1_58462771_58505109
Orc3,4,34570796,34614944,protein_coding,-1,44148,chr4_34570796_34614944
Orc4,2,48902824,48950277,protein_coding,-1,47453,chr2_48902824_48950277
Orc5,5,22486485,22550429,protein_coding,-1,63944,chr5_22486485_22550429
Orc6,8,85299632,85308278,protein_coding,1,8646,chr8_85299632_85308278
Ormdl1,1,53297095,53310309,protein_coding,1,13214,chr1_53297095_53310309
Ormdl2,10,128817902,128821645,protein_coding,-1,3743,chr10_128817902_128821645
Ormdl3,11,98581256,98587368,protein_coding,-1,6112,chr11_98581256_98587368
Os9,10,127095650,127121131,protein_coding,-1,25481,chr10_127095650_127121131
Osbp,19,11965941,11994112,protein_coding,1,28171,chr19_11965941_11994112
Osbp2,11,3703731,3863903,protein_coding,-1,160172,chr11_3703731_3863903
Osbpl10,9,114978569,115232225,protein_coding,1,253656,chr9_114978569_115232225
Osbpl11,16,33185071,33243312,protein_coding,1,58241,chr16_33185071_33243312
Osbpl1a,18,12755314,12941841,protein_coding,-1,186527,chr18_12755314_12941841
Osbpl2,2,180119306,180162680,protein_coding,1,43374,chr2_180119306_180162680
Osbpl3,6,50293330,50456201,protein_coding,-1,162871,chr6_50293330_50456201
Osbpl5,7,143688762,143756985,protein_coding,-1,68223,chr7_143688762_143756985
Osbpl6,2,76406508,76600647,protein_coding,1,194139,chr2_76406508_76600647
Osbpl7,11,97050628,97068904,protein_coding,1,18276,chr11_97050628_97068904
Osbpl8,10,111164752,111297249,protein_coding,1,132497,chr10_111164752_111297249
Osbpl9,4,109061145,109202272,protein_coding,-1,141127,chr4_109061145_109202272
Oscar,7,3609813,3616157,protein_coding,-1,6344,chr7_3609813_3616157
Oscp1,4,126058565,126092195,protein_coding,1,33630,chr4_126058565_126092195
Oser1,2,163405822,163424697,protein_coding,-1,18875,chr2_163405822_163424697
Osgep,14,50906478,50924893,protein_coding,-1,18415,chr14_50906478_50924893
Osgepl1,1,53313624,53326343,protein_coding,1,12719,chr1_53313624_53326343
Osgin1,8,119434124,119446256,protein_coding,1,12132,chr8_119434124_119446256
Osgin2,4,15997121,16013888,protein_coding,-1,16767,chr4_15997121_16013888
Osmr,15,6813577,6874969,protein_coding,-1,61392,chr15_6813577_6874969
Osr1,12,9570116,9581500,protein_coding,1,11384,chr12_9570116_9581500
Ost4,5,30905885,30907788,protein_coding,-1,1903,chr5_30905885_30907788
Ostc,3,130695912,130709444,protein_coding,-1,13532,chr3_130695912_130709444
Ostf1,19,18516137,18631823,protein_coding,-1,115686,chr19_18516137_18631823
Ostm1,10,42583822,42702459,protein_coding,1,118637,chr10_42583822_42702459
Ostn,16,27307489,27351212,protein_coding,1,43723,chr16_27307489_27351212
Otoa,7,121081650,121163097,protein_coding,1,81447,chr7_121081650_121163097
Otof,5,30367062,30461932,protein_coding,-1,94870,chr5_30367062_30461932
Otog,7,46240987,46311434,protein_coding,1,70447,chr7_46240987_46311434
Otogl,10,107760531,107912134,protein_coding,-1,151603,chr10_107760531_107912134
Otop1,5,38275972,38304217,protein_coding,1,28245,chr5_38275972_38304217
Otop2,11,115307163,115332303,protein_coding,1,25140,chr11_115307163_115332303
Otop3,11,115334731,115346927,protein_coding,1,12196,chr11_115334731_115346927
Otos,1,92644218,92648841,protein_coding,-1,4623,chr1_92644218_92648841
Otp,13,94875602,94885130,protein_coding,1,9528,chr13_94875602_94885130
Otub1,19,7198202,7206316,protein_coding,-1,8114,chr19_7198202_7206316
Otub2,12,103388682,103406350,protein_coding,1,17668,chr12_103388682_103406350
Otud1,2,19657752,19660583,protein_coding,1,2831,chr2_19657752_19660583
Otud3,4,138895379,138913945,protein_coding,-1,18566,chr4_138895379_138913945
Otud4,8,79639618,79677724,protein_coding,1,38106,chr8_79639618_79677724
Otud5,X,7841364,7876626,protein_coding,1,35262,chrX_7841364_7876626
Otud6b,4,14809498,14826587,protein_coding,-1,17089,chr4_14809498_14826587
Otud7a,7,63444751,63759028,protein_coding,1,314277,chr7_63444751_63759028
Otud7b,3,96104527,96161129,protein_coding,1,56602,chr3_96104527_96161129
Otulin,15,27542635,27630693,protein_coding,-1,88058,chr15_27542635_27630693
Otx1,11,21994764,22002897,protein_coding,-1,8133,chr11_21994764_22002897
Ovca2,11,75175942,75178835,protein_coding,-1,2893,chr11_75175942_75178835
Ovgp1,3,105973711,105987423,protein_coding,1,13712,chr3_105973711_105987423
Ovol1,19,5549136,5560646,protein_coding,-1,11510,chr19_5549136_5560646
Ovol2,2,144305175,144332146,protein_coding,-1,26971,chr2_144305175_144332146
Ovol3,7,30233439,30235725,protein_coding,-1,2286,chr7_30233439_30235725
Oxa1l,14,54360834,54369673,protein_coding,1,8839,chr14_54360834_54369673
Oxct1,15,4026383,4155344,protein_coding,1,128961,chr15_4026383_4155344
Oxct2a,4,123321875,123323634,protein_coding,-1,1759,chr4_123321875_123323634
Oxct2b,4,123116266,123118000,protein_coding,1,1734,chr4_123116266_123118000
Oxgr1,14,120019585,120042435,protein_coding,-1,22850,chr14_120019585_120042435
Oxld1,11,120456606,120458068,protein_coding,-1,1462,chr11_120456606_120458068
Oxnad1,14,32085374,32103202,protein_coding,1,17828,chr14_32085374_32103202
Oxr1,15,41447482,41861048,protein_coding,1,413566,chr15_41447482_41861048
Oxsm,14,16238652,16249808,protein_coding,-1,11156,chr14_16238652_16249808
Oxsr1,9,119238432,119322427,protein_coding,-1,83995,chr9_119238432_119322427
Oxt,2,130576173,130577054,protein_coding,1,881,chr2_130576173_130577054
Oxtr,6,112473683,112489943,protein_coding,-1,16260,chr6_112473683_112489943
P2rx1,11,72999103,73015200,protein_coding,1,16097,chr11_72999103_73015200
P2rx2,5,110339812,110343212,protein_coding,-1,3400,chr5_110339812_110343212
P2rx3,2,84998583,85037462,protein_coding,-1,38879,chr2_84998583_85037462
P2rx4,5,122707544,122729738,protein_coding,1,22194,chr5_122707544_122729738
P2rx5,11,73160421,73172685,protein_coding,1,12264,chr11_73160421_73172685
P2rx6,16,17561885,17577800,protein_coding,1,15915,chr16_17561885_17577800
P2rx7,5,122643911,122691432,protein_coding,1,47521,chr5_122643911_122691432
P2ry1,3,61002795,61008982,protein_coding,1,6187,chr3_61002795_61008982
P2ry12,3,59216272,59262871,protein_coding,-1,46599,chr3_59216272_59262871
P2ry13,3,59207892,59210882,protein_coding,-1,2990,chr3_59207892_59210882
P2ry14,3,59113855,59153618,protein_coding,-1,39763,chr3_59113855_59153618
P2ry2,7,100996568,101012866,protein_coding,-1,16298,chr7_100996568_101012866
P2ry4,X,100590154,100594869,protein_coding,-1,4715,chrX_100590154_100594869
P2ry6,7,100937630,100974649,protein_coding,-1,37019,chr7_100937630_100974649
P3h1,4,119232915,119248975,protein_coding,1,16060,chr4_119232915_119248975
P3h2,16,25959288,26105784,protein_coding,-1,146496,chr16_25959288_26105784
P3h3,6,124841089,124857752,protein_coding,-1,16663,chr6_124841089_124857752
P3h4,11,100408456,100414836,protein_coding,-1,6380,chr11_100408456_100414836
P4ha1,10,59323296,59373304,protein_coding,1,50008,chr10_59323296_59373304
P4ha2,11,54100095,54131665,protein_coding,1,31570,chr11_54100095_54131665
P4ha3,7,100285520,100319699,protein_coding,1,34179,chr7_100285520_100319699
P4hb,11,120560298,120573253,protein_coding,-1,12955,chr11_120560298_120573253
P4htm,9,108578862,108597667,protein_coding,-1,18805,chr9_108578862_108597667
Pa2g4,10,128557766,128565987,protein_coding,-1,8221,chr10_128557766_128565987
Pabpc1,15,36595661,36609668,protein_coding,-1,14007,chr15_36595661_36609668
Pabpc1l,2,164025450,164050538,protein_coding,1,25088,chr2_164025450_164050538
Pabpc1l2b-ps,X,103013698,103014387,processed_pseudogene,1,689,chrX_103013698_103014387
Pabpc2,18,39773497,39776082,protein_coding,1,2585,chr18_39773497_39776082
Pabpc4,4,123262351,123298925,protein_coding,1,36574,chr4_123262351_123298925
Pabpc4l,3,46442197,46448219,protein_coding,-1,6022,chr3_46442197_46448219
Pabpc5,X,119927196,119930165,protein_coding,1,2969,chrX_119927196_119930165
Pabpc6,17,9666495,9669717,protein_coding,-1,3222,chr17_9666495_9669717
Pabpn1,14,54892500,54898169,protein_coding,1,5669,chr14_54892500_54898169
Pabpn1l,8,122619471,122622739,protein_coding,-1,3268,chr8_122619471_122622739
Pacrg,17,10403012,10840311,protein_coding,-1,437299,chr17_10403012_10840311
Pacs1,19,5133158,5273119,protein_coding,-1,139961,chr19_5133158_5273119
Pacs2,12,113014508,113074401,protein_coding,1,59893,chr12_113014508_113074401
Pacsin1,17,27655509,27711482,protein_coding,1,55973,chr17_27655509_27711482
Pacsin2,15,83375607,83464606,protein_coding,-1,88999,chr15_83375607_83464606
Pacsin3,2,91255954,91264679,protein_coding,1,8725,chr2_91255954_91264679
Padi1,4,140812983,140845778,protein_coding,-1,32795,chr4_140812983_140845778
Padi2,4,140906344,140952586,protein_coding,1,46242,chr4_140906344_140952586
Padi3,4,140785365,140810648,protein_coding,-1,25283,chr4_140785365_140810648
Padi4,4,140745865,140774236,protein_coding,-1,28371,chr4_140745865_140774236
Padi6,4,140727355,140742643,protein_coding,-1,15288,chr4_140727355_140742643
Paf1,7,28392951,28399388,protein_coding,1,6437,chr7_28392951_28399388
Pafah1b1,11,74673949,74724670,protein_coding,-1,50721,chr11_74673949_74724670
Pafah1b1-ps1,3,96407517,96409059,processed_pseudogene,-1,1542,chr3_96407517_96409059
Pafah1b1-ps2,7,7061444,7063452,unprocessed_pseudogene,-1,2008,chr7_7061444_7063452
Pafah1b2,9,45962859,46012690,protein_coding,-1,49831,chr9_45962859_46012690
Pafah1b3,7,25295049,25297986,protein_coding,-1,2937,chr7_25295049_25297986
Pafah2,4,134396320,134427413,protein_coding,1,31093,chr4_134396320_134427413
Pag1,3,9687479,9833679,protein_coding,-1,146200,chr3_9687479_9833679
Pagr1a,7,127015033,127017352,protein_coding,-1,2319,chr7_127015033_127017352
Pah,10,87521795,87584136,protein_coding,1,62341,chr10_87521795_87584136
Paics,5,76951307,76967509,protein_coding,1,16202,chr5_76951307_76967509
Paip1,13,119428601,119458218,protein_coding,1,29617,chr13_119428601_119458218
Paip2,18,35598617,35617187,protein_coding,1,18570,chr18_35598617_35617187
Paip2b,6,83805401,83831741,protein_coding,-1,26340,chr6_83805401_83831741
Pak1,7,97788541,97912381,protein_coding,1,123840,chr7_97788541_97912381
Pak1ip1,13,41001023,41013015,protein_coding,1,11992,chr13_41001023_41013015
Pak2,16,32016290,32079342,protein_coding,-1,63052,chr16_32016290_32079342
Pak3,X,143518591,143797796,protein_coding,1,279205,chrX_143518591_143797796
Pak4,7,28558819,28598185,protein_coding,-1,39366,chr7_28558819_28598185
Pak6,2,118663303,118698020,protein_coding,1,34717,chr2_118663303_118698020
Pak7,2,136081104,136387967,protein_coding,-1,306863,chr2_136081104_136387967
Palb2,7,122107262,122132985,protein_coding,-1,25723,chr7_122107262_122132985
Pald1,10,61319656,61383530,protein_coding,-1,63874,chr10_61319656_61383530
Palld,8,61511433,61902690,protein_coding,-1,391257,chr8_61511433_61902690
Palm,10,79793572,79820896,protein_coding,1,27324,chr10_79793572_79820896
Palm3,8,84021471,84030295,protein_coding,1,8824,chr8_84021471_84030295
Palmd,3,116918258,116968987,protein_coding,-1,50729,chr3_116918258_116968987
Pam,1,97795114,98095646,protein_coding,-1,300532,chr1_97795114_98095646
Pam16,16,4616464,4624988,protein_coding,-1,8524,chr16_4616464_4624988
Pamr1,2,102550012,102643041,protein_coding,1,93029,chr2_102550012_102643041
Pan2,10,128303335,128321358,protein_coding,1,18023,chr10_128303335_128321358
Pan3,5,147430161,147548502,protein_coding,1,118341,chr5_147430161_147548502
Panct2,1,96871126,96907796,antisense,1,36670,chr1_96871126_96907796
Pank1,19,34806940,34879455,protein_coding,-1,72515,chr19_34806940_34879455
Pank2,2,131262495,131299188,protein_coding,1,36693,chr2_131262495_131299188
Pank3,11,35769484,35791285,protein_coding,1,21801,chr11_35769484_35791285
Pank4,4,154964123,154980938,protein_coding,1,16815,chr4_154964123_154980938
Pantr1,1,42590782,42694842,lincRNA,-1,104060,chr1_42590782_42694842
Pantr2,1,42707061,42713454,processed_transcript,-1,6393,chr1_42707061_42713454
Panx1,9,15002128,15045478,protein_coding,-1,43350,chr9_15002128_15045478
Panx2,15,89059734,89073567,protein_coding,1,13833,chr15_89059734_89073567
Paox,7,140115799,140137224,protein_coding,1,21425,chr7_140115799_140137224
Papln,12,83763634,83792382,protein_coding,1,28748,chr12_83763634_83792382
Papola,12,105784694,105838944,protein_coding,1,54250,chr12_105784694_105838944
Papolb,5,142525838,142530076,protein_coding,-1,4238,chr5_142525838_142530076
Papolg,11,23862646,23895253,protein_coding,-1,32607,chr11_23862646_23895253
Pappa,4,65124174,65357509,protein_coding,1,233335,chr4_65124174_65357509
Pappa2,1,158711727,158980490,protein_coding,-1,268763,chr1_158711727_158980490
Papss1,3,131564768,131643671,protein_coding,1,78903,chr3_131564768_131643671
Papss2,19,32595790,32667187,protein_coding,1,71397,chr19_32595790_32667187
Paqr3,5,97082329,97111596,protein_coding,-1,29267,chr5_97082329_97111596
Paqr4,17,23736186,23740867,protein_coding,-1,4681,chr17_23736186_23740867
Paqr5,9,61953481,62026856,protein_coding,-1,73375,chr9_61953481_62026856
Paqr6,3,88364584,88368541,protein_coding,1,3957,chr3_88364584_88368541
Paqr7,4,134496697,134510235,protein_coding,1,13538,chr4_134496697_134510235
Paqr8,1,20890606,20939650,protein_coding,1,49044,chr1_20890606_20939650
Paqr9,9,95559657,95568023,protein_coding,1,8366,chr9_95559657_95568023
Pard3,8,127063893,127612286,protein_coding,1,548393,chr8_127063893_127612286
Pard3b,1,61638824,62642284,protein_coding,1,1003460,chr1_61638824_62642284
Pard3bos1,1,61767415,61851540,antisense,-1,84125,chr1_61767415_61851540
Pard6a,8,105701148,105703496,protein_coding,1,2348,chr8_105701148_105703496
Pard6b,2,168081004,168101203,protein_coding,1,20199,chr2_168081004_168101203
Pard6g,18,80046890,80119639,protein_coding,1,72749,chr18_80046890_80119639
Parg,14,32201949,32297550,protein_coding,1,95601,chr14_32201949_32297550
Park7,4,150897133,150914437,protein_coding,-1,17304,chr4_150897133_150914437
Parl,16,20279818,20302387,protein_coding,-1,22569,chr16_20279818_20302387
Parm1,5,91517615,91626894,protein_coding,1,109279,chr5_91517615_91626894
Parn,16,13537960,13668170,protein_coding,-1,130210,chr16_13537960_13668170
Parp1,1,180568924,180601254,protein_coding,1,32330,chr1_180568924_180601254
Parp10,15,76231174,76243441,protein_coding,-1,12267,chr15_76231174_76243441
Parp11,6,127446840,127494261,protein_coding,1,47421,chr6_127446840_127494261
Parp12,6,39086410,39118349,protein_coding,-1,31939,chr6_39086410_39118349
Parp14,16,35832874,35871544,protein_coding,-1,38670,chr16_35832874_35871544
Parp16,9,65195353,65239224,protein_coding,1,43871,chr9_65195353_65239224
Parp2,14,50807841,50821301,protein_coding,1,13460,chr14_50807841_50821301
Parp3,9,106470322,106476949,protein_coding,-1,6627,chr9_106470322_106476949
Parp4,14,56575619,56659794,protein_coding,1,84175,chr14_56575619_56659794
Parp6,9,59617284,59650285,protein_coding,1,33001,chr9_59617284_59650285
Parp8,13,116854820,117025537,protein_coding,-1,170717,chr13_116854820_117025537
Parp9,16,35938470,35972605,protein_coding,1,34135,chr16_35938470_35972605
Parpbp,10,88091432,88146941,protein_coding,-1,55509,chr10_88091432_88146941
Pars2,4,106651069,106655282,protein_coding,1,4213,chr4_106651069_106655282
Parva,7,112427505,112591692,protein_coding,1,164187,chr7_112427505_112591692
Parvb,15,84232043,84315688,protein_coding,1,83645,chr15_84232043_84315688
Parvg,15,84324026,84342978,protein_coding,1,18952,chr15_84324026_84342978
Pask,1,93308770,93343482,protein_coding,-1,34712,chr1_93308770_93343482
Pate2,9,35570284,35690318,protein_coding,1,120034,chr9_35570284_35690318
Pate4,9,35607093,35611941,protein_coding,-1,4848,chr9_35607093_35611941
Patl1,19,11912399,11945091,protein_coding,1,32692,chr19_11912399_11945091
Patl2,2,122120108,122186189,protein_coding,-1,66081,chr2_122120108_122186189
Patz1,11,3288874,3309083,protein_coding,1,20209,chr11_3288874_3309083
Paupar,2,105657862,105661343,lincRNA,-1,3481,chr2_105657862_105661343
Pawr,10,108332121,108414240,protein_coding,1,82119,chr10_108332121_108414240
Pax1,2,147361925,147393295,protein_coding,1,31370,chr2_147361925_147393295
Pax2,19,44756045,44837871,protein_coding,1,81826,chr19_44756045_44837871
Pax3,1,78101267,78197134,protein_coding,-1,95867,chr1_78101267_78197134
Pax4,6,28442334,28449353,protein_coding,-1,7019,chr6_28442334_28449353
Pax5,4,44524757,44710487,protein_coding,-1,185730,chr4_44524757_44710487
Pax6,2,105668900,105697364,protein_coding,1,28464,chr2_105668900_105697364
Pax6os1,2,105536080,105670330,antisense,-1,134250,chr2_105536080_105670330
Pax7,4,139737062,139833528,protein_coding,-1,96466,chr4_139737062_139833528
Pax9,12,56691767,56712822,protein_coding,1,21055,chr12_56691767_56712822
Paxbp1,16,91014037,91044543,protein_coding,-1,30506,chr16_91014037_91044543
Paxip1,5,27740080,27791691,protein_coding,-1,51611,chr5_27740080_27791691
Pbdc1,X,105079756,105117090,protein_coding,1,37334,chrX_105079756_105117090
Pbk,14,65805837,65817822,protein_coding,1,11985,chr14_65805837_65817822
Pbld1,10,63060162,63077962,protein_coding,1,17800,chr10_63060162_63077962
Pbld2,10,63024315,63058813,protein_coding,1,34498,chr10_63024315_63058813
Pbrm1,14,31019138,31121592,protein_coding,1,102454,chr14_31019138_31121592
Pbx1,1,168119364,168432270,protein_coding,-1,312906,chr1_168119364_168432270
Pbx2,17,34591266,34597400,protein_coding,1,6134,chr17_34591266_34597400
Pbx3,2,34171457,34373142,protein_coding,-1,201685,chr2_34171457_34373142
Pbx4,8,69832491,69872292,protein_coding,1,39801,chr8_69832491_69872292
Pbxip1,3,89436706,89450952,protein_coding,1,14246,chr3_89436706_89450952
Pcbd1,10,61089331,61094324,protein_coding,1,4993,chr10_61089331_61094324
Pcbd2,13,55727368,55776830,protein_coding,1,49462,chr13_55727368_55776830
Pcbp1,6,86524492,86526321,protein_coding,-1,1829,chr6_86524492_86526321
Pcbp2,15,102470539,102500061,protein_coding,1,29522,chr15_102470539_102500061
Pcbp3,10,76761857,76961887,protein_coding,-1,200030,chr10_76761857_76961887
Pcbp4,9,106453291,106464012,protein_coding,1,10721,chr9_106453291_106464012
Pcca,14,122534324,122891100,protein_coding,1,356776,chr14_122534324_122891100
Pccb,9,100982032,101034898,protein_coding,-1,52866,chr9_100982032_101034898
Pcdh1,18,38185914,38212053,protein_coding,-1,26139,chr18_38185914_38212053
Pcdh10,3,45378398,45435623,protein_coding,1,57225,chr3_45378398_45435623
Pcdh11x,X,120290259,120910619,protein_coding,1,620360,chrX_120290259_120910619
Pcdh12,18,38267089,38284402,protein_coding,-1,17313,chr18_38267089_38284402
Pcdh15,10,73099342,74649737,protein_coding,1,1550395,chr10_73099342_74649737
Pcdh17,14,84443563,84539002,protein_coding,1,95439,chr14_84443563_84539002
Pcdh18,3,49743296,49757325,protein_coding,-1,14029,chr3_49743296_49757325
Pcdh19,X,133582860,133688987,protein_coding,-1,106127,chrX_133582860_133688987
Pcdh20,14,88464743,88471396,protein_coding,-1,6653,chr14_88464743_88471396
Pcdh7,5,57717967,58133230,protein_coding,1,415263,chr5_57717967_58133230
Pcdh8,14,79766775,79771312,protein_coding,-1,4537,chr14_79766775_79771312
Pcdh9,14,93013410,93890679,protein_coding,-1,877269,chr14_93013410_93890679
Pcdha1,18,36930184,37187661,protein_coding,1,257477,chr18_36930184_37187661
Pcdha11,18,37005203,37187657,protein_coding,1,182454,chr18_37005203_37187657
Pcdha12,18,37020149,37187657,protein_coding,1,167508,chr18_37020149_37187657
Pcdha2,18,36939205,37187657,protein_coding,1,248452,chr18_36939205_37187657
Pcdha3,18,36946105,37187657,protein_coding,1,241552,chr18_36946105_37187657
Pcdha5,18,36960440,37187657,protein_coding,1,227217,chr18_36960440_37187657
Pcdha8,18,36992371,37187657,protein_coding,1,195286,chr18_36992371_37187657
Pcdha9,18,36997880,37187657,protein_coding,1,189777,chr18_36997880_37187657
Pcdhac1,18,37090013,37187657,protein_coding,1,97644,chr18_37090013_37187657
Pcdhac2,18,37143503,37187657,protein_coding,1,44154,chr18_37143503_37187657
Pcdhb10,18,37411664,37414514,protein_coding,1,2850,chr18_37411664_37414514
Pcdhb11,18,37421418,37425836,protein_coding,1,4418,chr18_37421418_37425836
Pcdhb12,18,37435621,37438654,protein_coding,1,3033,chr18_37435621_37438654
Pcdhb13,18,37442500,37446209,protein_coding,1,3709,chr18_37442500_37446209
Pcdhb14,18,37447656,37456350,protein_coding,1,8694,chr18_37447656_37456350
Pcdhb15,18,37473540,37476340,protein_coding,1,2800,chr18_37473540_37476340
Pcdhb16,18,37477814,37483038,protein_coding,1,5224,chr18_37477814_37483038
Pcdhb17,18,37484795,37489454,protein_coding,1,4659,chr18_37484795_37489454
Pcdhb18,18,37489465,37494505,protein_coding,1,5040,chr18_37489465_37494505
Pcdhb19,18,37496991,37504128,protein_coding,1,7137,chr18_37496991_37504128
Pcdhb2,18,37294812,37297624,protein_coding,1,2812,chr18_37294812_37297624
Pcdhb20,18,37504264,37507822,protein_coding,1,3558,chr18_37504264_37507822
Pcdhb21,18,37513621,37518325,protein_coding,1,4704,chr18_37513621_37518325
Pcdhb22,18,37517871,37524479,protein_coding,1,6608,chr18_37517871_37524479
Pcdhb3,18,37300799,37304585,protein_coding,1,3786,chr18_37300799_37304585
Pcdhb4,18,37307455,37311172,protein_coding,1,3717,chr18_37307455_37311172
Pcdhb5,18,37320381,37323915,protein_coding,1,3534,chr18_37320381_37323915
Pcdhb6,18,37333921,37337674,protein_coding,1,3753,chr18_37333921_37337674
Pcdhb7,18,37341702,37345202,protein_coding,1,3500,chr18_37341702_37345202
Pcdhb8,18,37355121,37358604,protein_coding,1,3483,chr18_37355121_37358604
Pcdhb9,18,37400855,37403909,protein_coding,1,3054,chr18_37400855_37403909
Pcdhga1,18,37661793,37841873,protein_coding,1,180080,chr18_37661793_37841873
Pcdhga10,18,37746993,37841873,protein_coding,1,94880,chr18_37746993_37841873
Pcdhga11,18,37755731,37841873,protein_coding,1,86142,chr18_37755731_37841873
Pcdhga12,18,37765580,37841873,protein_coding,1,76293,chr18_37765580_37841873
Pcdhga2,18,37668953,37841870,protein_coding,1,172917,chr18_37668953_37841870
Pcdhga3,18,37674307,37841873,protein_coding,1,167566,chr18_37674307_37841873
Pcdhga4,18,37685210,37841873,protein_coding,1,156663,chr18_37685210_37841873
Pcdhga5,18,37694380,37841873,protein_coding,1,147493,chr18_37694380_37841873
Pcdhga6,18,37707039,37841873,protein_coding,1,134834,chr18_37707039_37841873
Pcdhga7,18,37714764,37841873,protein_coding,1,127109,chr18_37714764_37841873
Pcdhga8,18,37725706,37841873,protein_coding,1,116167,chr18_37725706_37841873
Pcdhga9,18,37736936,37841870,protein_coding,1,104934,chr18_37736936_37841870
Pcdhgb1,18,37680233,37841870,protein_coding,1,161637,chr18_37680233_37841870
Pcdhgb2,18,37689828,37841873,protein_coding,1,152045,chr18_37689828_37841873
Pcdhgb4,18,37720369,37841870,protein_coding,1,121501,chr18_37720369_37841870
Pcdhgb5,18,37731009,37841873,protein_coding,1,110864,chr18_37731009_37841873
Pcdhgb6,18,37742094,37841873,protein_coding,1,99779,chr18_37742094_37841873
Pcdhgb7,18,37751600,37841873,protein_coding,1,90273,chr18_37751600_37841873
Pcdhgb8,18,37761801,37841870,polymorphic_pseudogene,1,80069,chr18_37761801_37841870
Pcdhgc3,18,37806364,37841873,protein_coding,1,35509,chr18_37806364_37841873
Pcdhgc4,18,37815079,37841873,protein_coding,1,26794,chr18_37815079_37841873
Pcdhgc5,18,37819513,37841873,protein_coding,1,22360,chr18_37819513_37841873
Pced1a,2,130417247,130424701,protein_coding,-1,7454,chr2_130417247_130424701
Pced1b,15,97247107,97385680,protein_coding,1,138573,chr15_97247107_97385680
Pcf11,7,92643543,92669934,protein_coding,-1,26391,chr7_92643543_92669934
Pcgf1,6,83077869,83080855,protein_coding,1,2986,chr6_83077869_83080855
Pcgf2,11,97688823,97700497,protein_coding,-1,11674,chr11_97688823_97700497
Pcgf3,5,108461232,108506976,protein_coding,1,45744,chr5_108461232_108506976
Pcgf5,19,36348309,36460970,protein_coding,1,112661,chr19_36348309_36460970
Pcgf6,19,47033617,47050906,protein_coding,-1,17289,chr19_47033617_47050906
Pcid2,8,13077189,13105459,protein_coding,-1,28270,chr8_13077189_13105459
Pcif1,2,164879304,164894454,protein_coding,1,15150,chr2_164879304_164894454
Pck1,2,173153048,173159273,protein_coding,1,6225,chr2_173153048_173159273
Pck2,14,55540266,55551242,protein_coding,1,10976,chr14_55540266_55551242
Pclo,5,14514918,14863459,protein_coding,1,348541,chr5_14514918_14863459
Pcm1,8,41239752,41332344,protein_coding,1,92592,chr8_41239752_41332344
Pcmt1,10,7555137,7681136,protein_coding,-1,125999,chr10_7555137_7681136
Pcmtd1,1,7088920,7173628,protein_coding,1,84708,chr1_7088920_7173628
Pcmtd2,2,181837854,181857461,protein_coding,1,19607,chr2_181837854_181857461
Pcna,2,132249162,132253314,protein_coding,-1,4152,chr2_132249162_132253314
Pcna-ps1,X,99796471,99797663,processed_pseudogene,1,1192,chrX_99796471_99797663
Pcna-ps2,19,9283380,9284160,processed_pseudogene,1,780,chr19_9283380_9284160
Pcnp,16,56007245,56029739,protein_coding,-1,22494,chr16_56007245_56029739
Pcnt,10,76351263,76442786,protein_coding,-1,91523,chr10_76351263_76442786
Pcnx,12,81860023,82000924,protein_coding,1,140901,chr12_81860023_82000924
Pcolce,5,137605103,137613784,protein_coding,-1,8681,chr5_137605103_137613784
Pcolce2,9,95637601,95698096,protein_coding,1,60495,chr9_95637601_95698096
Pcp2,8,3623371,3625545,protein_coding,-1,2174,chr8_3623371_3625545
Pcp4,16,96467606,96525793,protein_coding,1,58187,chr16_96467606_96525793
Pcp4l1,1,171173262,171196268,protein_coding,-1,23006,chr1_171173262_171196268
Pcsk1,13,75089826,75134861,protein_coding,1,45035,chr13_75089826_75134861
Pcsk1n,X,7919822,7924410,protein_coding,1,4588,chrX_7919822_7924410
Pcsk2,2,143546156,143816285,protein_coding,1,270129,chr2_143546156_143816285
Pcsk2os1,2,143535476,143547837,antisense,-1,12361,chr2_143535476_143547837
Pcsk2os2,2,143747583,143795965,antisense,-1,48382,chr2_143747583_143795965
Pcsk4,10,80321283,80329498,protein_coding,-1,8215,chr10_80321283_80329498
Pcsk5,19,17432319,17837632,protein_coding,-1,405313,chr19_17432319_17837632
Pcsk6,7,65861734,66050386,protein_coding,1,188652,chr7_65861734_66050386
Pcsk7,9,45906497,45929726,protein_coding,1,23229,chr9_45906497_45929726
Pcsk9,4,106442329,106464329,protein_coding,-1,22000,chr4_106442329_106464329
Pctp,11,89982665,90002894,protein_coding,-1,20229,chr11_89982665_90002894
Pcx,19,4510472,4621752,protein_coding,1,111280,chr19_4510472_4621752
Pcyox1,6,86386006,86397154,protein_coding,-1,11148,chr6_86386006_86397154
Pcyox1l,18,61696837,61707635,protein_coding,-1,10798,chr18_61696837_61707635
Pcyt1a,16,32430921,32475070,protein_coding,1,44149,chr16_32430921_32475070
Pcyt1b,X,93654863,93749951,protein_coding,1,95088,chrX_93654863_93749951
Pcyt2,11,120610087,120617936,protein_coding,-1,7849,chr11_120610087_120617936
Pdap1,5,145128769,145140238,protein_coding,-1,11469,chr5_145128769_145140238
Pdc,1,150319417,150333906,protein_coding,1,14489,chr1_150319417_150333906
Pdcd10,3,75516490,75556856,protein_coding,-1,40366,chr3_75516490_75556856
Pdcd11,19,47090768,47131865,protein_coding,1,41097,chr19_47090768_47131865
Pdcd1lg2,19,29410919,29471161,protein_coding,1,60242,chr19_29410919_29471161
Pdcd2,17,15519208,15527301,protein_coding,-1,8093,chr17_15519208_15527301
Pdcd2l,7,34184499,34196661,protein_coding,-1,12162,chr7_34184499_34196661
Pdcd4,19,53892231,53929860,protein_coding,1,37629,chr19_53892231_53929860
Pdcd5,7,35641982,35647521,protein_coding,-1,5539,chr7_35641982_35647521
Pdcd6,13,74303509,74317580,protein_coding,-1,14071,chr13_74303509_74317580
Pdcd6ip,9,113651744,113708259,protein_coding,-1,56515,chr9_113651744_113708259
Pdcd7,9,65346104,65359643,protein_coding,1,13539,chr9_65346104_65359643
Pdcl,2,37350074,37359332,protein_coding,-1,9258,chr2_37350074_37359332
Pdcl2,5,76312115,76331156,protein_coding,-1,19041,chr5_76312115_76331156
Pdcl3,1,38985608,38997238,protein_coding,1,11630,chr1_38985608_38997238
Pde10a,17,8525372,8986648,protein_coding,1,461276,chr17_8525372_8986648
Pde11a,2,75989141,76338774,protein_coding,-1,349633,chr2_75989141_76338774
Pde12,14,26659958,26669883,protein_coding,-1,9925,chr14_26659958_26669883
Pde1a,2,79834453,80129458,protein_coding,-1,295005,chr2_79834453_80129458
Pde1b,15,103503034,103530052,protein_coding,1,27018,chr15_103503034_103530052
Pde1c,6,56069804,56652487,protein_coding,-1,582683,chr6_56069804_56652487
Pde2a,7,101421691,101512827,protein_coding,1,91136,chr7_101421691_101512827
Pde3a,6,141249269,141507448,protein_coding,1,258179,chr6_141249269_141507448
Pde3b,7,114415281,114539251,protein_coding,1,123970,chr7_114415281_114539251
Pde4a,9,21165714,21213248,protein_coding,1,47534,chr9_21165714_21213248
Pde4b,4,102087543,102607259,protein_coding,1,519716,chr4_102087543_102607259
Pde4c,8,70723720,70751186,protein_coding,1,27466,chr8_70723720_70751186
Pde4d,13,108449948,109953461,protein_coding,1,1503513,chr13_108449948_109953461
Pde4dip,3,97689824,97888707,protein_coding,-1,198883,chr3_97689824_97888707
Pde5a,3,122728947,122859374,protein_coding,1,130427,chr3_122728947_122859374
Pde6a,18,61220315,61289924,protein_coding,1,69609,chr18_61220315_61289924
Pde6b,5,108388391,108432397,protein_coding,1,44006,chr5_108388391_108432397
Pde6c,19,38132781,38183958,protein_coding,1,51177,chr19_38132781_38183958
Pde6d,1,86542994,86582629,protein_coding,-1,39635,chr1_86542994_86582629
Pde6g,11,120447605,120453500,protein_coding,-1,5895,chr11_120447605_120453500
Pde6h,6,136923832,136968865,protein_coding,1,45033,chr6_136923832_136968865
Pde7a,3,19223108,19311322,protein_coding,-1,88214,chr3_19223108_19311322
Pde7b,10,20398004,20725078,protein_coding,-1,327074,chr10_20398004_20725078
Pde8a,7,81213596,81334533,protein_coding,1,120937,chr7_81213596_81334533
Pde8b,13,95024454,95250336,protein_coding,-1,225882,chr13_95024454_95250336
Pde9a,17,31386210,31476310,protein_coding,1,90100,chr17_31386210_31476310
Pdf,8,107044698,107048614,protein_coding,-1,3916,chr8_107044698_107048614
Pdgfa,5,138976014,138997370,protein_coding,-1,21356,chr5_138976014_138997370
Pdgfb,15,79995874,80014977,protein_coding,-1,19103,chr15_79995874_80014977
Pdgfc,3,81036416,81214040,protein_coding,1,177624,chr3_81036416_81214040
Pdgfd,9,6168584,6378850,protein_coding,1,210266,chr9_6168584_6378850
Pdgfra,5,75152292,75198215,protein_coding,1,45923,chr5_75152292_75198215
Pdgfrb,18,61045150,61085061,protein_coding,1,39911,chr18_61045150_61085061
Pdgfrl,8,40926212,40990785,protein_coding,1,64573,chr8_40926212_40990785
Pdha1,X,160122209,160138413,protein_coding,-1,16204,chrX_160122209_160138413
Pdhb,14,8165996,8173025,protein_coding,-1,7029,chr14_8165996_8173025
Pdhx,2,103021075,103073513,protein_coding,-1,52438,chr2_103021075_103073513
Pdia2,17,26195999,26199087,protein_coding,-1,3088,chr17_26195999_26199087
Pdia3,2,121413775,121438687,protein_coding,1,24912,chr2_121413775_121438687
Pdia4,6,47796141,47813430,protein_coding,-1,17289,chr6_47796141_47813430
Pdia5,16,35397312,35490873,protein_coding,-1,93561,chr16_35397312_35490873
Pdia6,12,17266545,17284770,protein_coding,1,18225,chr12_17266545_17284770
Pdik1l,4,134275002,134287895,protein_coding,-1,12893,chr4_134275002_134287895
Pdk1,2,71873224,71903858,protein_coding,1,30634,chr2_71873224_71903858
Pdk2,11,95026258,95041354,protein_coding,-1,15096,chr11_95026258_95041354
Pdk3,X,93764607,93832201,protein_coding,-1,67594,chrX_93764607_93832201
Pdk4,6,5483351,5496309,protein_coding,-1,12958,chr6_5483351_5496309
Pdlim1,19,40221173,40271842,protein_coding,-1,50669,chr19_40221173_40271842
Pdlim2,14,70164218,70177681,protein_coding,-1,13463,chr14_70164218_70177681
Pdlim3,8,45885461,45919548,protein_coding,1,34087,chr8_45885461_45919548
Pdlim4,11,54054928,54069014,protein_coding,-1,14086,chr11_54054928_54069014
Pdlim5,3,142239590,142395696,protein_coding,-1,156106,chr3_142239590_142395696
Pdlim7,13,55495795,55513676,protein_coding,-1,17881,chr13_55495795_55513676
Pdp1,4,11958184,11966452,protein_coding,-1,8268,chr4_11958184_11966452
Pdp2,8,104591451,104599026,protein_coding,1,7575,chr8_104591451_104599026
Pdpk1,17,24073680,24150924,protein_coding,-1,77244,chr17_24073680_24150924
Pdpn,4,143267431,143299564,protein_coding,-1,32133,chr4_143267431_143299564
Pdpr,8,111094630,111137074,protein_coding,1,42444,chr8_111094630_111137074
Pdrg1,2,153008890,153015427,protein_coding,-1,6537,chr2_153008890_153015427
Pds5a,5,65605721,65698273,protein_coding,-1,92552,chr5_65605721_65698273
Pds5b,5,150673739,150810690,protein_coding,1,136951,chr5_150673739_150810690
Pdss1,2,22895522,22940266,protein_coding,1,44744,chr2_22895522_22940266
Pdss2,10,43221486,43464882,protein_coding,1,243396,chr10_43221486_43464882
Pdxdc1,16,13833148,13903131,protein_coding,-1,69983,chr16_13833148_13903131
Pdxk,10,78436744,78464975,protein_coding,-1,28231,chr10_78436744_78464975
Pdxk-ps,17,32076083,32107350,transcribed_unprocessed_pseudogene,-1,31267,chr17_32076083_32107350
Pdxp,15,78913919,78919517,protein_coding,1,5598,chr15_78913919_78919517
Pdyn,2,129686565,129699844,protein_coding,-1,13279,chr2_129686565_129699844
Pdzd11,X,100622883,100626568,protein_coding,-1,3685,chrX_100622883_100626568
Pdzd2,15,12359711,12739924,protein_coding,-1,380213,chr15_12359711_12739924
Pdzd3,9,44247307,44251471,protein_coding,-1,4164,chr9_44247307_44251471
Pdzd4,X,73793359,73824969,protein_coding,-1,31610,chrX_73793359_73824969
Pdzd7,19,45026906,45045717,protein_coding,-1,18811,chr19_45026906_45045717
Pdzd8,19,59297178,59345780,protein_coding,-1,48602,chr19_59297178_59345780
Pdzd9,7,120658731,120670343,protein_coding,-1,11612,chr7_120658731_120670343
Pdzk1,3,96829284,96870926,protein_coding,1,41642,chr3_96829284_96870926
Pdzk1ip1,4,115088708,115093899,protein_coding,1,5191,chr4_115088708_115093899
Pdzph1,17,58878808,58991375,protein_coding,-1,112567,chr17_58878808_58991375
Pdzrn3,6,101149609,101377897,protein_coding,-1,228288,chr6_101149609_101377897
Pdzrn4,15,92396881,92771819,protein_coding,1,374938,chr15_92396881_92771819
Pea15a,1,172196728,172206804,protein_coding,-1,10076,chr1_172196728_172206804
Pea15b,5,77511178,77511748,transcribed_processed_pseudogene,-1,570,chr5_77511178_77511748
Peak1,9,56201126,56418067,protein_coding,-1,216941,chr9_56201126_56418067
Peak1os,9,56257890,56267780,antisense,1,9890,chr9_56257890_56267780
Pear1,3,87747890,87824306,protein_coding,-1,76416,chr3_87747890_87824306
Pebp1,5,117282654,117287625,protein_coding,-1,4971,chr5_117282654_117287625
Pebp4,14,69840420,70059918,protein_coding,1,219498,chr14_69840420_70059918
Pecam1,11,106654217,106750628,protein_coding,-1,96411,chr11_106654217_106750628
Pecr,1,72259167,72284314,protein_coding,-1,25147,chr1_72259167_72284314
Pef1,4,130102558,130128135,protein_coding,1,25577,chr4_130102558_130128135
Peg10,6,4747306,4760517,protein_coding,1,13211,chr6_4747306_4760517
Peg12,7,62461871,62464510,protein_coding,-1,2639,chr7_62461871_62464510
Peg13,15,72805600,72810324,sense_intronic,-1,4724,chr15_72805600_72810324
Peg3,7,6703892,6730431,protein_coding,-1,26539,chr7_6703892_6730431
Peli1,11,21091291,21150323,protein_coding,1,59032,chr11_21091291_21150323
Peli2,14,48120823,48281575,protein_coding,1,160752,chr14_48120823_48281575
Peli3,19,4929717,4943127,protein_coding,-1,13410,chr19_4929717_4943127
Pelo,13,115088355,115090186,protein_coding,-1,1831,chr13_115088355_115090186
Pelp1,11,70392883,70410031,protein_coding,-1,17148,chr11_70392883_70410031
Pemt,11,59970614,60046489,protein_coding,-1,75875,chr11_59970614_60046489
Penk,4,4133531,4138819,protein_coding,-1,5288,chr4_4133531_4138819
Pepd,7,34912379,35044708,protein_coding,1,132329,chr7_34912379_35044708
Per1,11,69095217,69109960,protein_coding,1,14743,chr11_69095217_69109960
Per2,1,91415982,91459324,protein_coding,-1,43342,chr1_91415982_91459324
Per3,4,151003652,151044665,protein_coding,-1,41013,chr4_151003652_151044665
Perm1,4,156215868,156221307,protein_coding,1,5439,chr4_156215868_156221307
Perp,10,18845020,18857073,protein_coding,1,12053,chr10_18845020_18857073
Pes1,11,3963975,3980004,protein_coding,1,16029,chr11_3963975_3980004
Pet100,8,3621548,3625848,protein_coding,1,4300,chr8_3621548_3625848
Pet117,2,144368996,144373721,protein_coding,1,4725,chr2_144368996_144373721
Pex1,5,3596066,3637232,protein_coding,1,41166,chr5_3596066_3637232
Pex10,4,155067016,155072433,protein_coding,1,5417,chr4_155067016_155072433
Pex11a,7,79735957,79743131,protein_coding,-1,7174,chr7_79735957_79743131
Pex11b,3,96635376,96645366,protein_coding,1,9990,chr3_96635376_96645366
Pex11g,8,3457105,3467680,protein_coding,-1,10575,chr8_3457105_3467680
Pex12,11,83294642,83302586,protein_coding,-1,7944,chr11_83294642_83302586
Pex13,11,23646479,23665959,protein_coding,-1,19480,chr11_23646479_23665959
Pex13-ps,2,72632270,72633426,processed_pseudogene,1,1156,chr2_72632270_72633426
Pex14,4,148960535,149099876,protein_coding,-1,139341,chr4_148960535_149099876
Pex16,2,92374676,92381217,protein_coding,1,6541,chr2_92374676_92381217
Pex19,1,172126755,172136493,protein_coding,1,9738,chr1_172126755_172136493
Pex2,3,5560188,5576239,protein_coding,-1,16051,chr3_5560188_5576239
Pex26,6,121183667,121198837,protein_coding,1,15170,chr6_121183667_121198837
Pex3,10,13523842,13553142,protein_coding,-1,29300,chr10_13523842_13553142
Pex5,6,124396816,124415067,protein_coding,-1,18251,chr6_124396816_124415067
Pex5l,3,32949408,33143247,protein_coding,-1,193839,chr3_32949408_33143247
Pex6,17,46711463,46725541,protein_coding,1,14078,chr17_46711463_46725541
Pex7,10,19853900,19907689,protein_coding,-1,53789,chr10_19853900_19907689
Pf4,5,90772435,90773383,protein_coding,1,948,chr5_90772435_90773383
Pfas,11,68985697,69008460,protein_coding,-1,22763,chr11_68985697_69008460
Pfdn1,18,36403676,36454524,protein_coding,-1,50848,chr18_36403676_36454524
Pfdn2,1,171345670,171359254,protein_coding,1,13584,chr1_171345670_171359254
Pfdn4,2,170496428,170519123,protein_coding,1,22695,chr2_170496428_170519123
Pfdn5,15,102326116,102331873,protein_coding,1,5757,chr15_102326116_102331873
Pfdn6,17,33938821,33940343,protein_coding,-1,1522,chr17_33938821_33940343
Pfkfb1,X,150588229,150643878,protein_coding,1,55649,chrX_150588229_150643878
Pfkfb2,1,130689182,130729253,protein_coding,-1,40071,chr1_130689182_130729253
Pfkfb3,2,11471433,11554077,protein_coding,-1,82644,chr2_11471433_11554077
Pfkfb4,9,108991778,109032228,protein_coding,1,40450,chr9_108991778_109032228
Pfkl,10,77986947,78010083,protein_coding,-1,23136,chr10_77986947_78010083
Pfkm,15,98092589,98132451,protein_coding,1,39862,chr15_98092589_98132451
Pfkp,13,6579768,6648777,protein_coding,-1,69009,chr13_6579768_6648777
Pfn1,11,70651850,70654644,protein_coding,-1,2794,chr11_70651850_70654644
Pfn2,3,57841895,57848079,protein_coding,-1,6184,chr3_57841895_57848079
Pfn3,13,55414688,55415232,protein_coding,-1,544,chr13_55414688_55415232
Pfn4,12,4769022,4778813,protein_coding,1,9791,chr12_4769022_4778813
Pgam1,19,41911923,41918660,protein_coding,1,6737,chr19_41911923_41918660
Pgam1-ps1,11,21683308,21684056,processed_pseudogene,-1,748,chr11_21683308_21684056
Pgam1-ps2,7,27469771,27470535,processed_pseudogene,-1,764,chr7_27469771_27470535
Pgam2,11,5801640,5803733,protein_coding,-1,2093,chr11_5801640_5803733
Pgam5,5,110259130,110269913,protein_coding,-1,10783,chr5_110259130_110269913
Pgap1,1,54472994,54557684,protein_coding,-1,84690,chr1_54472994_54557684
Pgap2,7,102210208,102238567,protein_coding,1,28359,chr7_102210208_102238567
Pgap3,11,98388677,98400490,protein_coding,-1,11813,chr11_98388677_98400490
Pgbd1,13,21421275,21441058,protein_coding,-1,19783,chr13_21421275_21441058
Pgbd5,8,124369049,124439658,protein_coding,-1,70609,chr8_124369049_124439658
Pgd,4,149149991,149166771,protein_coding,-1,16780,chr4_149149991_149166771
Pgf,12,85166635,85177790,protein_coding,-1,11155,chr12_85166635_85177790
Pggt1b,18,46235351,46280993,protein_coding,-1,45642,chr18_46235351_46280993
Pgk1,X,106187100,106203699,protein_coding,1,16599,chrX_106187100_106203699
Pgk1-ps1,16,81908998,81909462,processed_pseudogene,1,464,chr16_81908998_81909462
Pgk1-ps3,3,18564538,18565738,processed_pseudogene,1,1200,chr3_18564538_18565738
Pgk1-rs7,12,10898986,10900240,processed_pseudogene,-1,1254,chr12_10898986_10900240
Pgls,8,71592176,71601092,protein_coding,1,8916,chr8_71592176_71601092
Pglyrp1,7,18871331,18890459,protein_coding,1,19128,chr7_18871331_18890459
Pglyrp2,17,32412459,32424167,protein_coding,-1,11708,chr17_32412459_32424167
Pgm1,4,99898374,99987294,protein_coding,1,88920,chr4_99898374_99987294
Pgm2,5,64092950,64128351,protein_coding,1,35401,chr5_64092950_64128351
Pgm2l1,7,100227394,100278868,protein_coding,1,51474,chr7_100227394_100278868
Pgm3,9,86554377,86571842,protein_coding,-1,17465,chr9_86554377_86571842
Pgm5,19,24683016,24861855,protein_coding,-1,178839,chr19_24683016_24861855
Pgp,17,24470392,24473110,protein_coding,1,2718,chr17_24470392_24473110
Pgpep1,8,70646435,70660388,protein_coding,-1,13953,chr8_70646435_70660388
Pgpep1l,7,68236610,68264233,protein_coding,-1,27623,chr7_68236610_68264233
Pgr,9,8899833,8968611,protein_coding,1,68778,chr9_8899833_8968611
Pgr15l,X,97072596,97082104,protein_coding,1,9508,chrX_97072596_97082104
Pgrmc1,X,36598206,36606079,protein_coding,1,7873,chrX_36598206_36606079
Pgrmc2,3,41066326,41083046,protein_coding,-1,16720,chr3_41066326_41083046
Pgs1,11,117986292,118024011,protein_coding,1,37719,chr11_117986292_118024011
Phactr1,13,42680623,43138526,protein_coding,1,457903,chr13_42680623_43138526
Phactr2,10,13207717,13474412,protein_coding,-1,266695,chr10_13207717_13474412
Phactr3,2,178118975,178338492,protein_coding,1,219517,chr2_178118975_178338492
Phactr4,4,132355923,132422489,protein_coding,-1,66566,chr4_132355923_132422489
Phax,18,56562443,56587712,protein_coding,1,25269,chr18_56562443_56587712
Phb,11,95666957,95680773,protein_coding,1,13816,chr11_95666957_95680773
Phb2,6,124712336,124716950,protein_coding,1,4614,chr6_124712336_124716950
Phc1,6,122317731,122340561,protein_coding,-1,22830,chr6_122317731_122340561
Phc2,4,128654702,128752881,protein_coding,1,98179,chr4_128654702_128752881
Phc3,3,30899371,30969415,protein_coding,-1,70044,chr3_30899371_30969415
Phex,X,157162075,157415312,protein_coding,-1,253237,chrX_157162075_157415312
Phf1,17,26933052,26937908,protein_coding,1,4856,chr17_26933052_26937908
Phf10,17,14945009,14961273,protein_coding,-1,16264,chr17_14945009_14961273
Phf11b,14,59320964,59341351,protein_coding,-1,20387,chr14_59320964_59341351
Phf11c,14,59380833,59395381,protein_coding,-1,14548,chr14_59380833_59395381
Phf11d,14,59347407,59365470,protein_coding,-1,18063,chr14_59347407_59365470
Phf12,11,77982754,78030539,protein_coding,1,47785,chr11_77982754_78030539
Phf13,4,151989633,151996258,protein_coding,-1,6625,chr4_151989633_151996258
Phf14,6,11907809,12081205,protein_coding,1,173396,chr6_11907809_12081205
Phf19,2,34893757,34914026,protein_coding,-1,20269,chr2_34893757_34914026
Phf2,13,48801750,48871119,protein_coding,-1,69369,chr13_48801750_48871119
Phf20,2,156196466,156309952,protein_coding,1,113486,chr2_156196466_156309952
Phf20l1,15,66577560,66647976,protein_coding,1,70416,chr15_66577560_66647976
Phf21a,2,92093117,92364666,protein_coding,1,271549,chr2_92093117_92364666
Phf21b,15,84785381,84856049,protein_coding,-1,70668,chr15_84785381_84856049
Phf23,11,69995777,70000009,protein_coding,1,4232,chr11_69995777_70000009
Phf3,1,30802339,30873921,protein_coding,-1,71582,chr1_30802339_30873921
Phf5a,15,81864520,81871911,protein_coding,-1,7391,chr15_81864520_81871911
Phf6,X,52912266,52956943,protein_coding,1,44677,chrX_52912266_52956943
Phf7,14,31237689,31251317,protein_coding,-1,13628,chr14_31237689_31251317
Phf8,X,151520672,151633859,protein_coding,1,113187,chrX_151520672_151633859
Phgdh,3,98313170,98339990,protein_coding,-1,26820,chr3_98313170_98339990
Phgdh-ps1,7,83710966,83711719,processed_pseudogene,-1,753,chr7_83710966_83711719
Phip,9,82866159,82975516,protein_coding,-1,109357,chr9_82866159_82975516
Phka1,X,102513975,102644246,protein_coding,-1,130271,chrX_102513975_102644246
Phka2,X,160502166,160598878,protein_coding,1,96712,chrX_160502166_160598878
Phkb,8,85840959,86061376,protein_coding,1,220417,chr8_85840959_86061376
Phkg1,5,129863421,129898549,protein_coding,-1,35128,chr5_129863421_129898549
Phkg2,7,127573340,127583307,protein_coding,1,9967,chr7_127573340_127583307
Phlda1,10,111506286,111508645,protein_coding,1,2359,chr10_111506286_111508645
Phlda3,1,135766119,135769136,protein_coding,1,3017,chr1_135766119_135769136
Phldb1,9,44686304,44735198,protein_coding,-1,48894,chr9_44686304_44735198
Phldb2,16,45746243,45953598,protein_coding,-1,207355,chr16_45746243_45953598
Phldb3,7,24610763,24629297,protein_coding,1,18534,chr7_24610763_24629297
Phlpp1,1,106171752,106394250,protein_coding,1,222498,chr1_106171752_106394250
Phlpp2,8,109868542,109944671,protein_coding,1,76129,chr8_109868542_109944671
Phospho1,11,95824499,95832140,protein_coding,1,7641,chr11_95824499_95832140
Phospho2,2,69789623,69800005,protein_coding,1,10382,chr2_69789623_69800005
Phox2a,7,101818313,101822726,protein_coding,1,4413,chr7_101818313_101822726
Phpt1,2,25573430,25575224,protein_coding,-1,1794,chr2_25573430_25575224
Phrf1,7,141228784,141262750,protein_coding,1,33966,chr7_141228784_141262750
Phtf1,3,103968110,104024598,protein_coding,1,56488,chr3_103968110_104024598
Phtf1os,3,103964536,103968581,antisense,-1,4045,chr3_103964536_103968581
Phtf2,5,20758663,20882124,protein_coding,-1,123461,chr5_20758663_20882124
Phyh,2,4919019,4938730,protein_coding,1,19711,chr2_4919019_4938730
Phyhd1,2,30266203,30282149,protein_coding,1,15946,chr2_30266203_30282149
Phyhip,14,70457476,70468832,protein_coding,1,11356,chr14_70457476_70468832
Phyhipl,10,70557682,70655965,protein_coding,-1,98283,chr10_70557682_70655965
Phykpl,11,51584757,51604489,protein_coding,1,19732,chr11_51584757_51604489
Pi15,1,17601901,17630939,protein_coding,1,29038,chr1_17601901_17630939
Pi16,17,29317680,29330593,protein_coding,1,12913,chr17_29317680_29330593
Pi4k2a,19,42090470,42122087,protein_coding,1,31617,chr19_42090470_42122087
Pi4k2b,5,52741574,52769340,protein_coding,1,27766,chr5_52741574_52769340
Pi4ka,16,17280351,17406314,protein_coding,-1,125963,chr16_17280351_17406314
Pi4kb,3,94974731,95006843,protein_coding,1,32112,chr3_94974731_95006843
Pianp,6,124996694,125003096,protein_coding,1,6402,chr6_124996694_125003096
Pias1,9,62878368,62987924,protein_coding,-1,109556,chr9_62878368_62987924
Pias2,18,77065208,77153800,protein_coding,1,88592,chr18_77065208_77153800
Pias3,3,96696384,96706070,protein_coding,1,9686,chr3_96696384_96706070
Pias4,10,81153266,81167923,protein_coding,-1,14657,chr10_81153266_81167923
Pibf1,14,99099424,99254493,protein_coding,1,155069,chr14_99099424_99254493
Picalm,7,90130213,90213465,protein_coding,1,83252,chr7_90130213_90213465
Pick1,15,79229173,79249484,protein_coding,1,20311,chr15_79229173_79249484
Pid1,1,84036296,84364180,protein_coding,-1,327884,chr1_84036296_84364180
Pidd1,7,141438113,141444025,protein_coding,-1,5912,chr7_141438113_141444025
Piezo1,8,122481698,122551329,protein_coding,-1,69631,chr8_122481698_122551329
Piezo2,18,63010213,63387183,protein_coding,-1,376970,chr18_63010213_63387183
Pif1,9,65587160,65595967,protein_coding,1,8807,chr9_65587160_65595967
Pifo,3,105996957,106014646,protein_coding,-1,17689,chr3_105996957_106014646
Piga,X,164419787,164433916,protein_coding,1,14129,chrX_164419787_164433916
Pigb,9,73007419,73040378,protein_coding,-1,32959,chr9_73007419_73040378
Pigc,1,161969186,161973435,protein_coding,1,4249,chr1_161969186_161973435
Pigf,17,86997256,87025406,protein_coding,-1,28150,chr17_86997256_87025406
Pigg,5,108312609,108349355,protein_coding,1,36746,chr5_108312609_108349355
Pigh,12,79080664,79089651,protein_coding,-1,8987,chr12_79080664_79089651
Pigk,3,152714100,152980408,protein_coding,1,266308,chr3_152714100_152980408
Pigl,11,62458460,62514417,protein_coding,1,55957,chr11_62458460_62514417
Pigm,1,172376546,172384099,protein_coding,1,7553,chr1_172376546_172384099
Pign,1,105518422,105663677,protein_coding,-1,145255,chr1_105518422_105663677
Pigo,4,43017635,43025819,protein_coding,-1,8184,chr4_43017635_43025819
Pigp,16,94358763,94371842,protein_coding,-1,13079,chr16_94358763_94371842
Pigq,17,25926421,25944936,protein_coding,-1,18515,chr17_25926421_25944936
Pigr,1,130826684,130852249,protein_coding,1,25565,chr1_130826684_130852249
Pigs,11,78328415,78342782,protein_coding,1,14367,chr11_78328415_78342782
Pigt,2,164497520,164508301,protein_coding,1,10781,chr2_164497520_164508301
Pigu,2,155278243,155357430,protein_coding,-1,79187,chr2_155278243_155357430
Pigv,4,133660387,133672647,protein_coding,-1,12260,chr4_133660387_133672647
Pigw,11,84876315,84880285,protein_coding,-1,3970,chr11_84876315_84880285
Pigx,16,32084416,32099740,protein_coding,-1,15324,chr16_32084416_32099740
Pigyl,9,22156846,22158358,protein_coding,1,1512,chr9_22156846_22158358
Pigz,16,31933851,31946046,protein_coding,1,12195,chr16_31933851_31946046
Pih1d1,7,45154303,45160065,protein_coding,1,5762,chr7_45154303_45160065
Pih1d2,9,50617321,50625000,protein_coding,1,7679,chr9_50617321_50625000
Pik3ap1,19,41272377,41385102,protein_coding,-1,112725,chr19_41272377_41385102
Pik3c2a,7,116337265,116443449,protein_coding,-1,106184,chr7_116337265_116443449
Pik3c2b,1,133045667,133108687,protein_coding,1,63020,chr1_133045667_133108687
Pik3c2g,6,139587221,139969284,protein_coding,1,382063,chr6_139587221_139969284
Pik3c3,18,30272747,30348126,protein_coding,1,75379,chr18_30272747_30348126
Pik3ca,3,32397671,32468486,protein_coding,1,70815,chr3_32397671_32468486
Pik3cb,9,99036654,99140621,protein_coding,-1,103967,chr9_99036654_99140621
Pik3cd,4,149649168,149702571,protein_coding,-1,53403,chr4_149649168_149702571
Pik3cg,12,32173473,32208659,protein_coding,-1,35186,chr12_32173473_32208659
Pik3ip1,11,3330401,3342971,protein_coding,1,12570,chr11_3330401_3342971
Pik3r1,13,101680563,101768217,protein_coding,-1,87654,chr13_101680563_101768217
Pik3r2,8,70768171,70776713,protein_coding,-1,8542,chr8_70768171_70776713
Pik3r3,4,116221618,116303056,protein_coding,1,81438,chr4_116221618_116303056
Pik3r4,9,105642978,105687657,protein_coding,1,44679,chr9_105642978_105687657
Pik3r5,11,68432121,68497849,protein_coding,1,65728,chr11_68432121_68497849
Pik3r6,11,68503019,68552698,protein_coding,1,49679,chr11_68503019_68552698
Pikfyve,1,65186683,65278695,protein_coding,1,92012,chr1_65186683_65278695
Pilra,5,137821952,137836281,protein_coding,-1,14329,chr5_137821952_137836281
Pim1,17,29490753,29496112,protein_coding,1,5359,chr17_29490753_29496112
Pim2,X,7878262,7883432,protein_coding,1,5170,chrX_7878262_7883432
Pim3,15,88862186,88865726,protein_coding,1,3540,chr15_88862186_88865726
Pin1,9,20652095,20666584,protein_coding,1,14489,chr9_20652095_20666584
Pin1rt1,2,104713926,104716379,protein_coding,-1,2453,chr2_104713926_104716379
Pin4,X,102119447,102127669,protein_coding,1,8222,chrX_102119447_102127669
Pink1,4,138313409,138326307,protein_coding,-1,12898,chr4_138313409_138326307
Pinlyp,7,24541658,24546118,protein_coding,-1,4460,chr7_24541658_24546118
Pinx1,14,63860364,63919859,protein_coding,1,59495,chr14_63860364_63919859
Pip4k2a,2,18842255,18998126,protein_coding,-1,155871,chr2_18842255_18998126
Pip4k2b,11,97715157,97744704,protein_coding,-1,29547,chr11_97715157_97744704
Pip4k2c,10,127197067,127211585,protein_coding,-1,14518,chr10_127197067_127211585
Pip5k1a,3,95058530,95106930,protein_coding,-1,48400,chr3_95058530_95106930
Pip5k1b,19,24294794,24555872,protein_coding,-1,261078,chr19_24294794_24555872
Pip5k1c,10,81292963,81319973,protein_coding,1,27010,chr10_81292963_81319973
Pip5kl1,2,32574797,32583782,protein_coding,1,8985,chr2_32574797_32583782
Pipox,11,77880615,77894096,protein_coding,-1,13481,chr11_77880615_77894096
Pir,X,164269371,164373011,protein_coding,1,103640,chrX_164269371_164373011
Pirb,7,3711409,3720391,protein_coding,-1,8982,chr7_3711409_3720391
Pirt,11,66911981,66929876,protein_coding,1,17895,chr11_66911981_66929876
Pisd,5,32736301,32785646,protein_coding,-1,49345,chr5_32736301_32785646
Pisd-ps1,11,3125904,3131004,transcribed_unprocessed_pseudogene,1,5100,chr11_3125904_3131004
Pisd-ps2,17,3076578,3084183,transcribed_unprocessed_pseudogene,-1,7605,chr17_3076578_3084183
Pithd1,4,135975460,135987264,protein_coding,-1,11804,chr4_135975460_135987264
Pitpna,11,75588097,75628804,protein_coding,1,40707,chr11_75588097_75628804
Pitpnb,5,111330763,111388359,protein_coding,1,57596,chr5_111330763_111388359
Pitpnc1,11,107207892,107470699,protein_coding,-1,262807,chr11_107207892_107470699
Pitpnm1,19,4099998,4113965,protein_coding,1,13967,chr19_4099998_4113965
Pitpnm2,5,124118690,124249760,protein_coding,-1,131070,chr5_124118690_124249760
Pitpnm2os1,5,124229725,124237137,antisense,1,7412,chr5_124229725_124237137
Pitpnm3,11,72047528,72135778,protein_coding,-1,88250,chr11_72047528_72135778
Pitrm1,13,6548149,6580515,protein_coding,1,32366,chr13_6548149_6580515
Pitx1,13,55825051,55836192,protein_coding,-1,11141,chr13_55825051_55836192
Pitx3,19,46135685,46148326,protein_coding,-1,12641,chr19_46135685_46148326
Piwil1,5,128702524,128755474,protein_coding,1,52950,chr5_128702524_128755474
Piwil2,14,70372477,70429383,protein_coding,-1,56906,chr14_70372477_70429383
Piwil4,9,14696230,14740740,protein_coding,-1,44510,chr9_14696230_14740740
Pja1,X,99465734,99471273,protein_coding,-1,5539,chrX_99465734_99471273
Pja2,17,64281005,64331916,protein_coding,-1,50911,chr17_64281005_64331916
Pkd1,17,24549834,24596508,protein_coding,1,46674,chr17_24549834_24596508
Pkd1l1,11,8826708,8973266,protein_coding,-1,146558,chr11_8826708_8973266
Pkd1l2,8,116995679,117082449,protein_coding,-1,86770,chr8_116995679_117082449
Pkd1l3,8,109614517,109674386,protein_coding,1,59869,chr8_109614517_109674386
Pkd2,5,104459450,104505819,protein_coding,1,46369,chr5_104459450_104505819
Pkd2l1,19,44147637,44192442,protein_coding,-1,44805,chr19_44147637_44192442
Pkd2l2,18,34408489,34444116,protein_coding,1,35627,chr18_34408489_34444116
Pkdcc,17,83215292,83225070,protein_coding,1,9778,chr17_83215292_83225070
Pkdrej,15,85814670,85821734,protein_coding,-1,7064,chr15_85814670_85821734
Pkhd1,1,20057779,20618064,protein_coding,-1,560285,chr1_20057779_20618064
Pkhd1l1,15,44457494,44601369,protein_coding,1,143875,chr15_44457494_44601369
Pkia,3,7366669,7445366,protein_coding,1,78697,chr3_7366669_7445366
Pkib,10,57631981,57741112,protein_coding,1,109131,chr10_57631981_57741112
Pkig,2,163658386,163726158,protein_coding,1,67772,chr2_163658386_163726158
Pklr,3,89136142,89146784,protein_coding,1,10642,chr3_89136142_89146784
Pkm,9,59656368,59679375,protein_coding,1,23007,chr9_59656368_59679375
Pkmyt1,17,23726336,23736735,protein_coding,1,10399,chr17_23726336_23736735
Pkn1,8,83666536,83699179,protein_coding,-1,32643,chr8_83666536_83699179
Pkn2,3,142790902,142882004,protein_coding,-1,91102,chr3_142790902_142882004
Pkn3,2,30077684,30091022,protein_coding,1,13338,chr2_30077684_30091022
Pknox1,17,31564734,31607693,protein_coding,1,42959,chr17_31564734_31607693
Pknox2,9,36890982,37147407,protein_coding,-1,256425,chr9_36890982_37147407
Pkp1,1,135871395,135919207,protein_coding,-1,47812,chr1_135871395_135919207
Pkp2,16,16213318,16272712,protein_coding,1,59394,chr16_16213318_16272712
Pkp3,7,141078218,141090510,protein_coding,1,12292,chr7_141078218_141090510
Pkp4,2,59160850,59355208,protein_coding,1,194358,chr2_59160850_59355208
Pla1a,16,38396117,38433145,protein_coding,-1,37028,chr16_38396117_38433145
Pla2g10,16,13715057,13730983,protein_coding,-1,15926,chr16_13715057_13730983
Pla2g12a,3,129878606,129895825,protein_coding,1,17219,chr3_129878606_129895825
Pla2g15,8,106150399,106164715,protein_coding,1,14316,chr8_106150399_106164715
Pla2g1b,5,115466262,115474722,protein_coding,1,8460,chr5_115466262_115474722
Pla2g2a,4,138831857,138835186,polymorphic_pseudogene,1,3329,chr4_138831857_138835186
Pla2g2c,4,138724792,138746132,protein_coding,1,21340,chr4_138724792_138746132
Pla2g2d,4,138775735,138782046,protein_coding,1,6311,chr4_138775735_138782046
Pla2g2e,4,138877942,138882817,protein_coding,1,4875,chr4_138877942_138882817
Pla2g3,11,3488284,3499350,protein_coding,1,11066,chr11_3488284_3499350
Pla2g4a,1,149829618,149961290,protein_coding,-1,131672,chr1_149829618_149961290
Pla2g4c,7,13324655,13360672,protein_coding,1,36017,chr7_13324655_13360672
Pla2g4d,2,120265595,120289197,protein_coding,-1,23602,chr2_120265595_120289197
Pla2g4e,2,120166412,120245335,protein_coding,-1,78923,chr2_120166412_120245335
Pla2g4f,2,120299957,120314165,protein_coding,-1,14208,chr2_120299957_120314165
Pla2g5,4,138799244,138863482,protein_coding,-1,64238,chr4_138799244_138863482
Pla2g6,15,79286228,79328390,protein_coding,-1,42162,chr15_79286228_79328390
Pla2g7,17,43568098,43612201,protein_coding,1,44103,chr17_43568098_43612201
Pla2r1,2,60417543,60553308,protein_coding,-1,135765,chr2_60417543_60553308
Plaa,4,94567514,94603244,protein_coding,-1,35730,chr4_94567514_94603244
Plac8,5,100553725,100572245,protein_coding,-1,18520,chr5_100553725_100572245
Plac8l1,18,42178683,42196709,protein_coding,-1,18026,chr18_42178683_42196709
Plag1,4,3900996,3938423,protein_coding,-1,37427,chr4_3900996_3938423
Plagl1,10,13060504,13131694,protein_coding,1,71190,chr10_13060504_13131694
Plagl2,2,153227759,153241426,protein_coding,-1,13667,chr2_153227759_153241426
Plat,8,22757727,22782844,protein_coding,1,25117,chr8_22757727_22782844
Plau,14,20836660,20843385,protein_coding,1,6725,chr14_20836660_20843385
Plaur,7,24462484,24475968,protein_coding,1,13484,chr7_24462484_24475968
Plb1,5,32232708,32366520,protein_coding,1,133812,chr5_32232708_32366520
Plbd1,6,136612070,136661928,protein_coding,-1,49858,chr6_136612070_136661928
Plbd2,5,120483282,120503625,protein_coding,-1,20343,chr5_120483282_120503625
Plcb1,2,134786067,135475258,protein_coding,1,689191,chr2_134786067_135475258
Plcb2,2,118707517,118728438,protein_coding,-1,20921,chr2_118707517_118728438
Plcb3,19,6952325,6976470,protein_coding,-1,24145,chr19_6952325_6976470
Plcb4,2,135659011,136014593,protein_coding,1,355582,chr2_135659011_136014593
Plcd1,9,119071527,119093502,protein_coding,-1,21975,chr9_119071527_119093502
Plcd3,11,103070304,103101658,protein_coding,-1,31354,chr11_103070304_103101658
Plcd4,1,74542888,74567794,protein_coding,1,24906,chr1_74542888_74567794
Plce1,19,38481109,38785030,protein_coding,1,303921,chr19_38481109_38785030
Plcg1,2,160731300,160775760,protein_coding,1,44460,chr2_160731300_160775760
Plcg2,8,117498291,117635142,protein_coding,1,136851,chr8_117498291_117635142
Plch1,3,63696234,63899472,protein_coding,-1,203238,chr3_63696234_63899472
Plch2,4,154983115,155056784,protein_coding,-1,73669,chr4_154983115_155056784
Plcl1,1,55405921,55754285,protein_coding,1,348364,chr1_55405921_55754285
Plcl2,17,50509403,50688484,protein_coding,1,179081,chr17_50509403_50688484
Plcxd1,5,110099969,110105953,protein_coding,1,5984,chr5_110099969_110105953
Plcxd2,16,45959263,46010218,protein_coding,-1,50955,chr16_45959263_46010218
Plcxd3,15,4375491,4575553,protein_coding,1,200062,chr15_4375491_4575553
Plcz1,6,139989673,140041457,protein_coding,-1,51784,chr6_139989673_140041457
Pld1,3,27938695,28133362,protein_coding,1,194667,chr3_27938695_28133362
Pld2,11,70540064,70558110,protein_coding,1,18046,chr11_70540064_70558110
Pld3,7,27532000,27553218,protein_coding,-1,21218,chr7_27532000_27553218
Pld4,12,112760655,112768990,protein_coding,1,8335,chr12_112760655_112768990
Pld5,1,175962306,176275312,protein_coding,-1,313006,chr1_175962306_176275312
Pld6,11,59783897,59787645,protein_coding,-1,3748,chr11_59783897_59787645
Plec,15,76170974,76232574,protein_coding,-1,61600,chr15_76170974_76232574
Plek,11,16971206,17052381,protein_coding,-1,81175,chr11_16971206_17052381
Plek2,12,78888691,78906964,protein_coding,-1,18273,chr12_78888691_78906964
Plekha1,7,130865756,130913312,protein_coding,1,47556,chr7_130865756_130913312
Plekha2,8,25039144,25102376,protein_coding,-1,63232,chr8_25039144_25102376
Plekha3,2,76675281,76696828,protein_coding,1,21547,chr2_76675281_76696828
Plekha4,7,45526330,45554229,protein_coding,1,27899,chr7_45526330_45554229
Plekha5,6,140424054,140597110,protein_coding,1,173056,chr6_140424054_140597110
Plekha6,1,133164210,133303435,protein_coding,1,139225,chr1_133164210_133303435
Plekha7,7,116123485,116308376,protein_coding,-1,184891,chr7_116123485_116308376
Plekha8,6,54595111,54645839,protein_coding,1,50728,chr6_54595111_54645839
Plekhb1,7,100642892,100662414,protein_coding,-1,19522,chr7_100642892_100662414
Plekhb2,1,34849976,34879580,protein_coding,1,29604,chr1_34849976_34879580
Plekhd1,12,80692591,80724214,protein_coding,1,31623,chr12_80692591_80724214
Plekhf1,7,38216972,38228016,protein_coding,-1,11044,chr7_38216972_38228016
Plekhf2,4,10988662,11007927,protein_coding,-1,19265,chr4_10988662_11007927
Plekhg1,10,3740364,3967303,protein_coding,1,226939,chr10_3740364_3967303
Plekhg2,7,28359604,28372599,protein_coding,-1,12995,chr7_28359604_28372599
Plekhg3,12,76530891,76580488,protein_coding,1,49597,chr12_76530891_76580488
Plekhg4,8,105373274,105382862,protein_coding,1,9588,chr8_105373274_105382862
Plekhg5,4,152072498,152115400,protein_coding,1,42902,chr4_152072498_152115400
Plekhg6,6,125362660,125380793,protein_coding,-1,18133,chr6_125362660_125380793
Plekhh1,12,79029163,79081655,protein_coding,1,52492,chr12_79029163_79081655
Plekhh2,17,84511895,84622138,protein_coding,1,110243,chr17_84511895_84622138
Plekhh3,11,101162679,101171351,protein_coding,-1,8672,chr11_101162679_101171351
Plekhj1,10,80796099,80798626,protein_coding,-1,2527,chr10_80796099_80798626
Plekhm1,11,103364275,103412687,protein_coding,-1,48412,chr11_103364275_103412687
Plekhm2,4,141625734,141664899,protein_coding,-1,39165,chr4_141625734_141664899
Plekhm3,1,64785983,64956824,protein_coding,-1,170841,chr1_64785983_64956824
Plekhn1,4,156221456,156234857,protein_coding,-1,13401,chr4_156221456_156234857
Plekho1,3,95988429,95996001,protein_coding,-1,7572,chr3_95988429_95996001
Plekho2,9,65552698,65580040,protein_coding,-1,27342,chr9_65552698_65580040
Plekhs1,19,56461640,56486752,protein_coding,1,25112,chr19_56461640_56486752
Plet1,9,50494525,50505482,protein_coding,1,10957,chr9_50494525_50505482
Plet1os,9,50488795,50507823,antisense,-1,19028,chr9_50488795_50507823
Plg,17,12378608,12419385,protein_coding,1,40777,chr17_12378608_12419385
Plgrkt,19,29348599,29367390,protein_coding,-1,18791,chr19_29348599_29367390
Plin2,4,86648386,86670060,protein_coding,-1,21674,chr4_86648386_86670060
Plin3,17,56277476,56292873,protein_coding,-1,15397,chr17_56277476_56292873
Plin4,17,56100591,56109803,protein_coding,-1,9212,chr17_56100591_56109803
Plin5,17,56111601,56117596,protein_coding,-1,5995,chr17_56111601_56117596
Plk-ps1,5,35554184,35555970,processed_pseudogene,1,1786,chr5_35554184_35555970
Plk1,7,122159439,122169873,protein_coding,1,10434,chr7_122159439_122169873
Plk2,13,110395046,110400844,protein_coding,1,5798,chr13_110395046_110400844
Plk3,4,117128655,117133963,protein_coding,-1,5308,chr4_117128655_117133963
Plk4,3,40700300,40816883,protein_coding,1,116583,chr3_40700300_40816883
Plk5,10,80356459,80365489,protein_coding,1,9030,chr10_80356459_80365489
Pllp,8,94674894,94696278,protein_coding,-1,21384,chr8_94674894_94696278
Pln,10,53337667,53345987,protein_coding,1,8320,chr10_53337667_53345987
Plod1,4,147909753,147936767,protein_coding,-1,27014,chr4_147909753_147936767
Plod2,9,92542223,92608428,protein_coding,1,66205,chr9_92542223_92608428
Plod3,5,136987019,136996648,protein_coding,1,9629,chr5_136987019_136996648
Plp1,X,136822671,136839733,protein_coding,1,17062,chrX_136822671_136839733
Plp2,X,7667941,7671390,protein_coding,-1,3449,chrX_7667941_7671390
Plrg1,3,83055522,83072355,protein_coding,1,16833,chr3_83055522_83072355
Pls1,9,95752642,95845311,protein_coding,-1,92669,chr9_95752642_95845311
Pls3,X,75785654,75875182,protein_coding,-1,89528,chrX_75785654_75875182
Plscr1,9,92249750,92272278,protein_coding,1,22528,chr9_92249750_92272278
Plscr2,9,92275602,92297752,protein_coding,1,22150,chr9_92275602_92297752
Plscr3,11,69846376,69852058,protein_coding,1,5682,chr11_69846376_69852058
Plscr4,9,92457373,92492456,protein_coding,1,35083,chr9_92457373_92492456
Plscr5,9,92192936,92209772,protein_coding,1,16836,chr9_92192936_92209772
Pltp,2,164839518,164857711,protein_coding,-1,18193,chr2_164839518_164857711
Plvap,8,71497765,71511752,protein_coding,-1,13987,chr8_71497765_71511752
Plxdc1,11,97923238,97986444,protein_coding,-1,63206,chr11_97923238_97986444
Plxdc2,2,16356304,16755839,protein_coding,1,399535,chr2_16356304_16755839
Plxna1,6,89316314,89362620,protein_coding,-1,46306,chr6_89316314_89362620
Plxna2,1,194618218,194816869,protein_coding,1,198651,chr1_194618218_194816869
Plxna3,X,74329066,74344689,protein_coding,1,15623,chrX_74329066_74344689
Plxna4,6,32144268,32588192,protein_coding,-1,443924,chr6_32144268_32588192
Plxna4os1,6,32511073,32515576,antisense,1,4503,chr6_32511073_32515576
Plxnb1,9,109095389,109119917,protein_coding,1,24528,chr9_109095389_109119917
Plxnb2,15,89155549,89180788,protein_coding,-1,25239,chr15_89155549_89180788
Plxnb3,X,73757090,73772514,protein_coding,1,15424,chrX_73757090_73772514
Plxnc1,10,94790866,94944835,protein_coding,-1,153969,chr10_94790866_94944835
Plxnd1,6,115954811,115995005,protein_coding,-1,40194,chr6_115954811_115995005
Pm20d1,1,131797381,131821473,protein_coding,1,24092,chr1_131797381_131821473
Pm20d2,4,33174230,33189737,protein_coding,-1,15507,chr4_33174230_33189737
Pmaip1,18,66458533,66465565,protein_coding,1,7032,chr18_66458533_66465565
Pmch,10,88091072,88092375,protein_coding,1,1303,chr10_88091072_88092375
Pmel,10,128704195,128720238,protein_coding,1,16043,chr10_128704195_128720238
Pmepa1,2,173224458,173276533,protein_coding,-1,52075,chr2_173224458_173276533
Pmf1,3,88394143,88410331,protein_coding,-1,16188,chr3_88394143_88410331
Pmfbp1,8,109494027,109542640,protein_coding,1,48613,chr8_109494027_109542640
Pml,9,58218076,58249786,protein_coding,-1,31710,chr9_58218076_58249786
Pmm1,15,81951108,81960930,protein_coding,-1,9822,chr15_81951108_81960930
Pmm2,16,8637674,8662467,protein_coding,1,24793,chr16_8637674_8662467
Pmp22,11,63128982,63159547,protein_coding,1,30565,chr11_63128982_63159547
Pmpca,2,26389339,26397122,protein_coding,1,7783,chr2_26389339_26397122
Pmpcb,5,21737141,21757152,protein_coding,1,20011,chr5_21737141_21757152
Pms1,1,53189187,53297018,protein_coding,-1,107831,chr1_53189187_53297018
Pms2,5,143909964,143933968,protein_coding,1,24004,chr5_143909964_143933968
Pmvk,3,89454541,89469013,protein_coding,1,14472,chr3_89454541_89469013
Pnck,X,73655994,73660117,protein_coding,-1,4123,chrX_73655994_73660117
Pnisr,4,21847583,21876475,protein_coding,1,28892,chr4_21847583_21876475
Pnkd,1,74284930,74353694,protein_coding,1,68764,chr1_74284930_74353694
Pnkp,7,44857139,44862992,protein_coding,1,5853,chr7_44857139_44862992
Pnldc1,17,12888729,12910230,protein_coding,-1,21501,chr17_12888729_12910230
Pnlip,19,58652498,58681788,protein_coding,1,29290,chr19_58652498_58681788
Pnliprp2,19,58759719,58777534,protein_coding,1,17815,chr19_58759719_58777534
Pnma1,12,84146131,84148489,protein_coding,-1,2358,chr12_84146131_84148489
Pnma2,14,66911170,66921023,protein_coding,1,9853,chr14_66911170_66921023
Pnma3,X,73064787,73068191,protein_coding,1,3404,chrX_73064787_73068191
Pnma5,X,73033981,73037103,protein_coding,-1,3122,chrX_73033981_73037103
Pnmal1,7,16959679,16964607,protein_coding,1,4928,chr7_16959679_16964607
Pnmal2,7,16944682,16948828,protein_coding,1,4146,chr7_16944682_16948828
Pnn,12,59066884,59073998,protein_coding,1,7114,chr12_59066884_59073998
Pno1,11,17203198,17211568,protein_coding,-1,8370,chr11_17203198_17211568
Pnoc,14,65400673,65425472,protein_coding,-1,24799,chr14_65400673_65425472
Pnp,14,50931082,50965237,protein_coding,1,34155,chr14_50931082_50965237
Pnp2,14,50955992,50964749,protein_coding,1,8757,chr14_50955992_50964749
Pnpla1,17,28858411,28890309,protein_coding,1,31898,chr17_28858411_28890309
Pnpla2,7,141455198,141460743,protein_coding,1,5545,chr7_141455198_141460743
Pnpla3,15,84167837,84187236,protein_coding,1,19399,chr15_84167837_84187236
Pnpla6,8,3515384,3544267,protein_coding,1,28883,chr8_3515384_3544267
Pnpla7,2,24976033,25054057,protein_coding,1,78024,chr2_24976033_25054057
Pnpla8,12,44221370,44322532,protein_coding,1,101162,chr12_44221370_44322532
Pnpo,11,96937825,96943986,protein_coding,-1,6161,chr11_96937825_96943986
Pnpt1,11,29130744,29161828,protein_coding,1,31084,chr11_29130744_29161828
Pnrc1,4,33245423,33290163,protein_coding,-1,44740,chr4_33245423_33290163
Pnrc2,4,135870918,135873850,protein_coding,-1,2932,chr4_135870918_135873850
Poc1a,9,106281061,106350521,protein_coding,1,69460,chr9_106281061_106350521
Poc1b,10,99107036,99198074,protein_coding,1,91038,chr10_99107036_99198074
Poc5,13,96388294,96417737,protein_coding,1,29443,chr13_96388294_96417737
Podn,4,108014791,108096445,protein_coding,-1,81654,chr4_108014791_108096445
Podnl1,8,84125989,84132527,protein_coding,1,6538,chr8_84125989_84132527
Podxl,6,31519488,31563981,protein_coding,-1,44493,chr6_31519488_31563981
Podxl2,6,88842558,88875044,protein_coding,-1,32486,chr6_88842558_88875044
Pof1b,X,112638431,112698651,protein_coding,-1,60220,chrX_112638431_112698651
Pofut1,2,153241533,153270247,protein_coding,1,28714,chr2_153241533_153270247
Pofut2,10,77259218,77269575,protein_coding,1,10357,chr10_77259218_77269575
Pogk,1,166384622,166409863,protein_coding,-1,25241,chr1_166384622_166409863
Poglut1,16,38525137,38550258,protein_coding,-1,25121,chr16_38525137_38550258
Pogz,3,94837567,94882326,protein_coding,1,44759,chr3_94837567_94882326
Pola1,X,93304767,93632155,protein_coding,-1,327388,chrX_93304767_93632155
Pola2,19,5940542,5964202,protein_coding,-1,23660,chr19_5940542_5964202
Polb,8,22628126,22653435,protein_coding,-1,25309,chr8_22628126_22653435
Pold1,7,44532746,44548849,protein_coding,-1,16103,chr7_44532746_44548849
Pold2,11,5872180,5878292,protein_coding,-1,6112,chr11_5872180_5878292
Pold3,7,100082111,100121565,protein_coding,-1,39454,chr7_100082111_100121565
Pold4,19,4231898,4233634,protein_coding,1,1736,chr19_4231898_4233634
Poldip2,11,78512193,78522736,protein_coding,1,10543,chr11_78512193_78522736
Poldip3,15,83125976,83149384,protein_coding,-1,23408,chr15_83125976_83149384
Pole,5,110286306,110337474,protein_coding,1,51168,chr5_110286306_110337474
Pole2,12,69201773,69228195,protein_coding,-1,26422,chr12_69201773_69228195
Pole3,4,62522649,62525068,protein_coding,-1,2419,chr4_62522649_62525068
Pole4,6,82618992,82705365,protein_coding,-1,86373,chr6_82618992_82705365
Polg,7,79446231,79466362,protein_coding,-1,20131,chr7_79446231_79466362
Polg2,11,106768253,106779537,protein_coding,-1,11284,chr11_106768253_106779537
Polh,17,46171355,46202645,protein_coding,-1,31290,chr17_46171355_46202645
Poli,18,70508680,70530620,protein_coding,-1,21940,chr18_70508680_70530620
Polk,13,96480690,96542579,protein_coding,-1,61889,chr13_96480690_96542579
Poll,19,45552275,45560531,protein_coding,-1,8256,chr19_45552275_45560531
Polm,11,5827860,5838016,protein_coding,-1,10156,chr11_5827860_5838016
Poln,5,34007179,34169448,protein_coding,-1,162269,chr5_34007179_34169448
Polq,16,37011786,37095417,protein_coding,1,83631,chr16_37011786_37095417
Polr1a,6,71909053,71984935,protein_coding,1,75882,chr6_71909053_71984935
Polr1b,2,129100995,129126594,protein_coding,1,25599,chr2_129100995_129126594
Polr1c,17,46243920,46248054,protein_coding,-1,4134,chr17_46243920_46248054
Polr1d,5,147077050,147111597,protein_coding,1,34547,chr5_147077050_147111597
Polr1e,4,45018583,45036565,protein_coding,1,17982,chr4_45018583_45036565
Polr2a,11,69733997,69758637,protein_coding,-1,24640,chr11_69733997_69758637
Polr2b,5,77310147,77349324,protein_coding,1,39177,chr5_77310147_77349324
Polr2c,8,94857450,94873535,protein_coding,1,16085,chr8_94857450_94873535
Polr2d,18,31789159,31796701,protein_coding,1,7542,chr18_31789159_31796701
Polr2e,10,80035949,80039795,protein_coding,-1,3846,chr10_80035949_80039795
Polr2f,15,79141009,79151774,protein_coding,1,10765,chr15_79141009_79151774
Polr2g,19,8793127,8798577,protein_coding,-1,5450,chr19_8793127_8798577
Polr2h,16,20717665,20722267,protein_coding,1,4602,chr16_20717665_20722267
Polr2i,7,30231948,30233390,protein_coding,1,1442,chr7_30231948_30233390
Polr2j,5,136116631,136122947,protein_coding,1,6316,chr5_136116631_136122947
Polr2k,15,36174010,36177010,protein_coding,1,3000,chr15_36174010_36177010
Polr2l,7,141471860,141475132,protein_coding,-1,3272,chr7_141471860_141475132
Polr2m,9,71478437,71485935,protein_coding,-1,7498,chr9_71478437_71485935
Polr3a,14,24448696,24487058,protein_coding,-1,38362,chr14_24448696_24487058
Polr3b,10,84622292,84727178,protein_coding,1,104886,chr10_84622292_84727178
Polr3c,3,96711490,96727628,protein_coding,-1,16138,chr3_96711490_96727628
Polr3d,14,70438757,70443447,protein_coding,-1,4690,chr14_70438757_70443447
Polr3e,7,120917744,120947432,protein_coding,1,29688,chr7_120917744_120947432
Polr3f,2,144527718,144541995,protein_coding,1,14277,chr2_144527718_144541995
Polr3g,13,81673843,81711013,protein_coding,-1,37170,chr13_81673843_81711013
Polr3gl,3,96577872,96594181,protein_coding,-1,16309,chr3_96577872_96594181
Polr3h,15,81888228,81926240,protein_coding,-1,38012,chr15_81888228_81926240
Polr3k,2,181864337,181870830,protein_coding,1,6493,chr2_181864337_181870830
Polrmt,10,79736123,79746581,protein_coding,-1,10458,chr10_79736123_79746581
Pom121,5,135376141,135394546,protein_coding,-1,18405,chr5_135376141_135394546
Pom121l2,13,21981194,21988734,protein_coding,1,7540,chr13_21981194_21988734
Pomc,12,3954951,3960642,protein_coding,1,5691,chr12_3954951_3960642
Pomgnt1,4,116123840,116159849,protein_coding,1,36009,chr4_116123840_116159849
Pomgnt2,9,121981606,121997110,protein_coding,-1,15504,chr9_121981606_121997110
Pomk,8,25980604,25994133,protein_coding,-1,13529,chr8_25980604_25994133
Pomp,5,147860461,147876456,protein_coding,1,15995,chr5_147860461_147876456
Pomt1,2,32236590,32255005,protein_coding,1,18415,chr2_32236590_32255005
Pomt2,12,87106861,87147968,protein_coding,-1,41107,chr12_87106861_87147968
Pon1,6,5168090,5193946,protein_coding,-1,25856,chr6_5168090_5193946
Pon2,6,5264147,5298455,protein_coding,-1,34308,chr6_5264147_5298455
Pon3,6,5220852,5256286,protein_coding,-1,35434,chr6_5220852_5256286
Pop1,15,34495304,34530648,protein_coding,1,35344,chr15_34495304_34530648
Pop4,7,38261996,38271423,protein_coding,-1,9427,chr7_38261996_38271423
Pop5,5,115235836,115245351,protein_coding,1,9515,chr5_115235836_115245351
Pop7,5,137501438,137502518,protein_coding,-1,1080,chr5_137501438_137502518
Popdc2,16,38362209,38378216,protein_coding,1,16007,chr16_38362209_38378216
Popdc3,10,45178098,45318452,protein_coding,1,140354,chr10_45178098_45318452
Por,5,135670033,135735326,protein_coding,1,65293,chr5_135670033_135735326
Porcn,X,8193848,8206525,protein_coding,-1,12677,chrX_8193848_8206525
Postn,3,54361109,54391037,protein_coding,1,29928,chr3_54361109_54391037
Pot1a,6,25743737,25809246,protein_coding,-1,65509,chr6_25743737_25809246
Pot1b,17,55651923,55712628,protein_coding,-1,60705,chr17_55651923_55712628
Pou1f1,16,65520511,65535005,protein_coding,1,14494,chr16_65520511_65535005
Pou2af1,9,51213708,51240080,protein_coding,1,26372,chr9_51213708_51240080
Pou2f1,1,165865154,166002678,protein_coding,-1,137524,chr1_165865154_166002678
Pou2f2,7,25087344,25179726,protein_coding,-1,92382,chr7_25087344_25179726
Pou2f3,9,43123939,43210369,protein_coding,-1,86430,chr9_43123939_43210369
Pou3f1,4,124656807,124660655,protein_coding,1,3848,chr4_124656807_124660655
Pou3f2,4,22482780,22488366,protein_coding,-1,5586,chr4_22482780_22488366
Pou3f3,1,42694925,42703176,protein_coding,1,8251,chr1_42694925_42703176
Pou3f4,X,110814280,110817207,protein_coding,1,2927,chrX_110814280_110817207
Pou4f1,14,104461676,104467999,protein_coding,-1,6323,chr14_104461676_104467999
Pou4f2,8,78433010,78436645,protein_coding,-1,3635,chr8_78433010_78436645
Pou4f3,18,42394539,42397249,protein_coding,1,2710,chr18_42394539_42397249
Pou5f2,13,78024902,78026295,protein_coding,1,1393,chr13_78024902_78026295
Pou6f1,15,100575318,100599984,protein_coding,-1,24666,chr15_100575318_100599984
Pou6f2,13,18121098,18397686,protein_coding,-1,276588,chr13_18121098_18397686
Pp2d1,17,53507460,53539451,protein_coding,-1,31991,chr17_53507460_53539451
Ppa1,10,61648552,61674168,protein_coding,1,25616,chr10_61648552_61674168
Ppa2,3,133310110,133378235,protein_coding,1,68125,chr3_133310110_133378235
Ppan,9,20888175,20892178,protein_coding,1,4003,chr9_20888175_20892178
Ppara,15,85734983,85802819,protein_coding,1,67836,chr15_85734983_85802819
Ppard,17,28232700,28301474,protein_coding,1,68774,chr17_28232700_28301474
Pparg,6,115360951,115490399,protein_coding,1,129448,chr6_115360951_115490399
Ppargc1a,5,51454250,51567726,protein_coding,-1,113476,chr5_51454250_51567726
Ppargc1b,18,61298136,61400431,protein_coding,-1,102295,chr18_61298136_61400431
Ppat,5,76913249,76951578,protein_coding,-1,38329,chr5_76913249_76951578
Ppcdc,9,57385095,57440124,protein_coding,-1,55029,chr9_57385095_57440124
Ppcs,4,119418530,119422420,protein_coding,-1,3890,chr4_119418530_119422420
Ppdpf,2,181187247,181188771,protein_coding,1,1524,chr2_181187247_181188771
Ppef1,X,160623094,160735765,protein_coding,-1,112671,chrX_160623094_160735765
Ppef2,5,92226679,92256278,protein_coding,-1,29599,chr5_92226679_92256278
Ppfia1,7,144476758,144553729,protein_coding,-1,76971,chr7_144476758_144553729
Ppfia2,10,106470339,106935952,protein_coding,1,465613,chr10_106470339_106935952
Ppfia3,7,45339122,45367019,protein_coding,-1,27897,chr7_45339122_45367019
Ppfia4,1,134296783,134332928,protein_coding,-1,36145,chr1_134296783_134332928
Ppfibp1,6,146888487,147032025,protein_coding,1,143538,chr6_146888487_147032025
Ppfibp2,7,107595207,107748583,protein_coding,1,153376,chr7_107595207_107748583
Pphln1,15,93398350,93491510,protein_coding,1,93160,chr15_93398350_93491510
Ppia,11,6415443,6419817,protein_coding,1,4374,chr11_6415443_6419817
Ppib,9,66060222,66066623,protein_coding,1,6401,chr9_66060222_66066623
Ppic,18,53406332,53418115,protein_coding,-1,11783,chr18_53406332_53418115
Ppid,3,79591342,79603650,protein_coding,1,12308,chr3_79591342_79603650
Ppie,4,123127115,123139951,protein_coding,-1,12836,chr4_123127115_123139951
Ppif,14,25694154,25700468,protein_coding,1,6314,chr14_25694154_25700468
Ppifos,14,25696974,25701282,antisense,-1,4308,chr14_25696974_25701282
Ppig,2,69722545,69754012,protein_coding,1,31467,chr2_69722545_69754012
Ppih,4,119300010,119320546,protein_coding,-1,20536,chr4_119300010_119320546
Ppil1,17,29250803,29264186,protein_coding,-1,13383,chr17_29250803_29264186
Ppil2,16,17086555,17111257,protein_coding,-1,24702,chr16_17086555_17111257
Ppil3,1,58430994,58445486,protein_coding,-1,14492,chr1_58430994_58445486
Ppil4,10,7792891,7823135,protein_coding,1,30244,chr10_7792891_7823135
Ppil6,10,41490439,41514286,protein_coding,1,23847,chr10_41490439_41514286
Ppip5k1,2,121310561,121355396,protein_coding,-1,44835,chr2_121310561_121355396
Ppip5k2,1,97706048,97770411,protein_coding,-1,64363,chr1_97706048_97770411
Ppl,16,5086291,5132421,protein_coding,-1,46130,chr16_5086291_5132421
Ppm1a,12,72757455,72799819,protein_coding,1,42364,chr12_72757455_72799819
Ppm1b,17,84956741,85023991,protein_coding,1,67250,chr17_84956741_85023991
Ppm1d,11,85311244,85347066,protein_coding,1,35822,chr11_85311244_85347066
Ppm1e,11,87226906,87359023,protein_coding,-1,132117,chr11_87226906_87359023
Ppm1f,16,16896469,16927364,protein_coding,1,30895,chr16_16896469_16927364
Ppm1g,5,31202664,31220687,protein_coding,-1,18023,chr5_31202664_31220687
Ppm1h,10,122678762,122945795,protein_coding,1,267033,chr10_122678762_122945795
Ppm1j,3,104781056,104786018,protein_coding,1,4962,chr3_104781056_104786018
Ppm1k,6,57506502,57535468,protein_coding,-1,28966,chr6_57506502_57535468
Ppm1l,3,69316861,69560802,protein_coding,1,243941,chr3_69316861_69560802
Ppm1m,9,106194947,106199746,protein_coding,-1,4799,chr9_106194947_106199746
Ppm1n,7,19276805,19280064,protein_coding,-1,3259,chr7_19276805_19280064
Ppme1,7,100326737,100372307,protein_coding,-1,45570,chr7_100326737_100372307
Ppox,1,171275990,171281186,protein_coding,-1,5196,chr1_171275990_171281186
Ppp1ca,19,4192064,4195420,protein_coding,1,3356,chr19_4192064_4195420
Ppp1cb,5,32458843,32517433,protein_coding,1,58590,chr5_32458843_32517433
Ppp1cc,5,122158278,122175273,protein_coding,1,16995,chr5_122158278_122175273
Ppp1r10,17,35916434,35932283,protein_coding,1,15849,chr17_35916434_35932283
Ppp1r11,17,36948356,36951741,protein_coding,-1,3385,chr17_36948356_36951741
Ppp1r12a,10,108162193,108284475,protein_coding,1,122282,chr10_108162193_108284475
Ppp1r12b,1,134754658,134955942,protein_coding,-1,201284,chr1_134754658_134955942
Ppp1r12c,7,4481520,4501680,protein_coding,-1,20160,chr7_4481520_4501680
Ppp1r13b,12,111828457,111908110,protein_coding,-1,79653,chr12_111828457_111908110
Ppp1r13l,7,19359749,19378533,protein_coding,1,18784,chr7_19359749_19378533
Ppp1r14a,7,29289308,29293801,protein_coding,1,4493,chr7_29289308_29293801
Ppp1r14b,19,6974968,6977324,protein_coding,1,2356,chr19_6974968_6977324
Ppp1r14c,10,3366057,3464975,protein_coding,1,98918,chr10_3366057_3464975
Ppp1r14d,2,119218119,119229906,protein_coding,-1,11787,chr2_119218119_119229906
Ppp1r15a,7,45522916,45526268,protein_coding,-1,3352,chr7_45522916_45526268
Ppp1r15b,1,133131143,133139783,protein_coding,1,8640,chr1_133131143_133139783
Ppp1r16a,15,76671615,76694919,protein_coding,1,23304,chr15_76671615_76694919
Ppp1r16b,2,158665398,158766334,protein_coding,1,100936,chr2_158665398_158766334
Ppp1r17,6,56017497,56032689,protein_coding,1,15192,chr6_56017497_56032689
Ppp1r18,17,35865593,35875596,protein_coding,1,10003,chr17_35865593_35875596
Ppp1r1a,15,103530279,103538003,protein_coding,-1,7724,chr15_103530279_103538003
Ppp1r1b,11,98348404,98357796,protein_coding,1,9392,chr11_98348404_98357796
Ppp1r1c,2,79707780,79818496,protein_coding,1,110716,chr2_79707780_79818496
Ppp1r2,16,31251537,31275277,protein_coding,-1,23740,chr16_31251537_31275277
Ppp1r2-ps1,17,6324025,6324642,processed_pseudogene,-1,617,chr17_6324025_6324642
Ppp1r2-ps2,6,90905819,90906453,processed_pseudogene,1,634,chr6_90905819_90906453
Ppp1r2-ps3,19,30538928,30539545,processed_pseudogene,-1,617,chr19_30538928_30539545
Ppp1r2-ps4,9,66805306,66805938,processed_pseudogene,-1,632,chr9_66805306_66805938
Ppp1r2-ps6,17,6253903,6254523,processed_pseudogene,1,620,chr17_6253903_6254523
Ppp1r2-ps7,X,22461632,22462394,transcribed_processed_pseudogene,1,762,chrX_22461632_22462394
Ppp1r21,17,88530118,88588367,protein_coding,1,58249,chr17_88530118_88588367
Ppp1r26,2,28446800,28455508,protein_coding,1,8708,chr2_28446800_28455508
Ppp1r27,11,120549979,120551132,protein_coding,-1,1153,chr11_120549979_120551132
Ppp1r32,19,10474235,10482928,protein_coding,-1,8693,chr19_10474235_10482928
Ppp1r35,5,137778849,137780110,protein_coding,1,1261,chr5_137778849_137780110
Ppp1r36,12,76417538,76439492,protein_coding,1,21954,chr12_76417538_76439492
Ppp1r37,7,19530800,19563076,protein_coding,-1,32276,chr7_19530800_19563076
Ppp1r3a,6,14713977,14755274,protein_coding,-1,41297,chr6_14713977_14755274
Ppp1r3b,8,35375739,35388139,protein_coding,1,12400,chr8_35375739_35388139
Ppp1r3c,19,36731731,36736653,protein_coding,-1,4922,chr19_36731731_36736653
Ppp1r3d,2,178411206,178414472,protein_coding,-1,3266,chr2_178411206_178414472
Ppp1r3e,14,54872669,54877550,protein_coding,-1,4881,chr14_54872669_54877550
Ppp1r3f,X,7557296,7574283,protein_coding,-1,16987,chrX_7557296_7574283
Ppp1r3g,13,35958839,35970388,protein_coding,1,11549,chr13_35958839_35970388
Ppp1r42,1,9968624,10009136,protein_coding,-1,40512,chr1_9968624_10009136
Ppp1r7,1,93342854,93373489,protein_coding,1,30635,chr1_93342854_93373489
Ppp1r8,4,132826929,132843169,protein_coding,-1,16240,chr4_132826929_132843169
Ppp1r9a,6,4902917,5165661,protein_coding,1,262744,chr6_4902917_5165661
Ppp1r9b,11,94991035,95006899,protein_coding,1,15864,chr11_94991035_95006899
Ppp2ca,11,52098681,52127778,protein_coding,1,29097,chr11_52098681_52127778
Ppp2cb,8,33599625,33619441,protein_coding,1,19816,chr8_33599625_33619441
Ppp2r1a,17,20945311,20965916,protein_coding,1,20605,chr17_20945311_20965916
Ppp2r1b,9,50845301,50894229,protein_coding,1,48928,chr9_50845301_50894229
Ppp2r2a,14,67014056,67072444,protein_coding,-1,58388,chr14_67014056_67072444
Ppp2r2b,18,42637432,43083127,protein_coding,-1,445695,chr18_42637432_43083127
Ppp2r2c,5,36868513,36955078,protein_coding,1,86565,chr5_36868513_36955078
Ppp2r2cos,5,36873595,36876879,antisense,-1,3284,chr5_36873595_36876879
Ppp2r2d,7,138846079,138883057,protein_coding,1,36978,chr7_138846079_138883057
Ppp2r3a,9,101105084,101251795,protein_coding,-1,146711,chr9_101105084_101251795
Ppp2r3c,12,55278991,55302998,protein_coding,-1,24007,chr12_55278991_55302998
Ppp2r3d,9,124422622,124476898,protein_coding,-1,54276,chr9_124422622_124476898
Ppp2r5a,1,191351975,191403272,protein_coding,-1,51297,chr1_191351975_191403272
Ppp2r5b,19,6227765,6235872,protein_coding,-1,8107,chr19_6227765_6235872
Ppp2r5c,12,110447120,110583062,protein_coding,1,135942,chr12_110447120_110583062
Ppp2r5d,17,46682991,46705111,protein_coding,-1,22120,chr17_46682991_46705111
Ppp2r5e,12,75450881,75596245,protein_coding,-1,145364,chr12_75450881_75596245
Ppp3ca,3,136670124,136937727,protein_coding,1,267603,chr3_136670124_136937727
Ppp3cb,14,20499364,20546573,protein_coding,-1,47209,chr14_20499364_20546573
Ppp3cc,14,70217865,70289471,protein_coding,-1,71606,chr14_70217865_70289471
Ppp3r1,11,17159263,17200375,protein_coding,1,41112,chr11_17159263_17200375
Ppp3r2,4,49678747,49682024,protein_coding,-1,3277,chr4_49678747_49682024
Ppp4c,7,126785866,126792496,protein_coding,-1,6630,chr7_126785866_126792496
Ppp4r1,17,65782573,65841926,protein_coding,1,59353,chr17_65782573_65841926
Ppp4r1l-ps,2,173579320,173659640,transcribed_unprocessed_pseudogene,-1,80320,chr2_173579320_173659640
Ppp4r2,6,100833622,100869934,protein_coding,1,36312,chr6_100833622_100869934
Ppp4r4,12,103532283,103613831,protein_coding,1,81548,chr12_103532283_103613831
Ppp5c,7,17004640,17027924,protein_coding,-1,23284,chr7_17004640_17027924
Ppp6c,2,39194354,39226451,protein_coding,-1,32097,chr2_39194354_39226451
Ppp6r1,7,4631495,4659019,protein_coding,-1,27524,chr7_4631495_4659019
Ppp6r2,15,89211553,89287010,protein_coding,1,75457,chr15_89211553_89287010
Ppp6r3,19,3454928,3575749,protein_coding,-1,120821,chr19_3454928_3575749
Pprc1,19,46044886,46072915,protein_coding,1,28029,chr19_46044886_46072915
Ppt1,4,122836242,122859175,protein_coding,1,22933,chr4_122836242_122859175
Ppt2,17,34616662,34628510,protein_coding,-1,11848,chr17_34616662_34628510
Pptc7,5,122284365,122324281,protein_coding,1,39916,chr5_122284365_122324281
Ppwd1,13,104205124,104228843,protein_coding,-1,23719,chr13_104205124_104228843
Pqbp1,X,7894519,7899269,protein_coding,-1,4750,chrX_7894519_7899269
Pqlc2,4,139294029,139310708,protein_coding,-1,16679,chr4_139294029_139310708
Pqlc3,12,16988648,17000408,protein_coding,-1,11760,chr12_16988648_17000408
Pradc1,6,85446810,85451970,protein_coding,-1,5160,chr6_85446810_85451970
Praf2,X,7728439,7731064,protein_coding,1,2625,chrX_7728439_7731064
Pram1,17,33638056,33645706,protein_coding,1,7650,chr17_33638056_33645706
Prame,X,135613002,135627705,protein_coding,-1,14703,chrX_135613002_135627705
Pramef12,4,144391674,144408464,protein_coding,-1,16790,chr4_144391674_144408464
Pramef8,4,143412426,143421091,protein_coding,1,8665,chr4_143412426_143421091
Pramel4,4,144059126,144069327,protein_coding,1,10201,chr4_144059126_144069327
Pramel6,2,87506565,87510872,protein_coding,1,4307,chr2_87506565_87510872
Prap1,7,140093395,140097200,protein_coding,1,3805,chr7_140093395_140097200
Prc1,7,80294450,80316259,protein_coding,1,21809,chr7_80294450_80316259
Prcc,3,87858903,87885608,protein_coding,-1,26705,chr3_87858903_87885608
Prcp,7,92874470,92934583,protein_coding,1,60113,chr7_92874470_92934583
Prdm1,10,44437177,44528501,protein_coding,-1,91324,chr10_44437177_44528501
Prdm10,9,31280538,31381723,protein_coding,1,101185,chr9_31280538_31381723
Prdm11,2,92972018,93046167,protein_coding,-1,74149,chr2_92972018_93046167
Prdm12,2,31640037,31655795,protein_coding,1,15758,chr2_31640037_31655795
Prdm13,4,21677480,21685963,protein_coding,-1,8483,chr4_21677480_21685963
Prdm15,16,97791467,97851850,protein_coding,-1,60383,chr16_97791467_97851850
Prdm16,4,154316125,154636873,protein_coding,-1,320748,chr4_154316125_154636873
Prdm2,4,143107391,143212995,protein_coding,-1,105604,chr4_143107391_143212995
Prdm4,10,85891966,85917142,protein_coding,-1,25176,chr10_85891966_85917142
Prdm5,6,65778988,65937010,protein_coding,1,158022,chr6_65778988_65937010
Prdm6,18,53463583,53575907,protein_coding,1,112324,chr18_53463583_53575907
Prdm8,5,98167198,98188991,protein_coding,1,21793,chr5_98167198_98188991
Prdm9,17,15543079,15564354,protein_coding,-1,21275,chr17_15543079_15564354
Prdx1,4,116685544,116700822,protein_coding,1,15278,chr4_116685544_116700822
Prdx2,8,84969587,84974834,protein_coding,1,5247,chr8_84969587_84974834
Prdx3,19,60864051,60874556,protein_coding,-1,10505,chr19_60864051_60874556
Prdx4,X,155323918,155340754,protein_coding,-1,16836,chrX_155323918_155340754
Prdx5,19,6906697,6910106,protein_coding,-1,3409,chr19_6906697_6910106
Prdx6,1,161240112,161251219,protein_coding,-1,11107,chr1_161240112_161251219
Prdx6-ps2,4,25307830,25308523,processed_pseudogene,1,693,chr4_25307830_25308523
Prdx6b,2,80292472,80295356,protein_coding,1,2884,chr2_80292472_80295356
Preb,5,30950853,30960361,protein_coding,-1,9508,chr5_30950853_30960361
Prelid1,13,55320500,55325272,protein_coding,1,4772,chr13_55320500_55325272
Prelid2,18,41875600,41951242,protein_coding,-1,75642,chr18_41875600_41951242
Prelp,1,133910304,133921414,protein_coding,-1,11110,chr1_133910304_133921414
Prep,10,45067203,45167198,protein_coding,1,99995,chr10_45067203_45167198
Prepl,17,85063470,85090241,protein_coding,-1,26771,chr17_85063470_85090241
Prex1,2,166566342,166713832,protein_coding,-1,147490,chr2_166566342_166713832
Prex2,1,10993465,11303681,protein_coding,1,310216,chr1_10993465_11303681
Prf1,10,61297833,61304680,protein_coding,1,6847,chr10_61297833_61304680
Prg4,1,150449412,150466165,protein_coding,-1,16753,chr1_150449412_150466165
Prickle1,15,93499114,93595891,protein_coding,-1,96777,chr15_93499114_93595891
Prickle2,6,92370908,92706155,protein_coding,-1,335247,chr6_92370908_92706155
Prickle3,X,7657260,7668186,protein_coding,1,10926,chrX_7657260_7668186
Prickle4,17,47688517,47694736,protein_coding,-1,6219,chr17_47688517_47694736
Prim1,10,128015168,128030037,protein_coding,1,14869,chr10_128015168_128030037
Prim2,1,33453810,33669795,protein_coding,-1,215985,chr1_33453810_33669795
Prima1,12,103196908,103242150,protein_coding,-1,45242,chr12_103196908_103242150
Primpol,8,46575594,46617212,protein_coding,-1,41618,chr8_46575594_46617212
Prkaa1,15,5143861,5181899,protein_coding,1,38038,chr15_5143861_5181899
Prkaa2,4,105029874,105109890,protein_coding,-1,80016,chr4_105029874_105109890
Prkab1,5,116013586,116024508,protein_coding,-1,10922,chr5_116013586_116024508
Prkab2,3,97658193,97673812,protein_coding,1,15619,chr3_97658193_97673812
Prkaca,8,83972993,83996443,protein_coding,1,23450,chr8_83972993_83996443
Prkaca-ps1,X,161485567,161486485,processed_pseudogene,-1,918,chrX_161485567_161486485
Prkacb,3,146729574,146812990,protein_coding,-1,83416,chr3_146729574_146812990
Prkag1,15,98812797,98831521,protein_coding,-1,18724,chr15_98812797_98831521
Prkag2,5,24862744,25100642,protein_coding,-1,237898,chr5_24862744_25100642
Prkag2os1,5,24902569,24906850,antisense,1,4281,chr5_24902569_24906850
Prkag3,1,74738922,74749221,protein_coding,-1,10299,chr1_74738922_74749221
Prkar1a,11,109649405,109669656,protein_coding,1,20251,chr11_109649405_109669656
Prkar1b,5,139017306,139150001,protein_coding,-1,132695,chr5_139017306_139150001
Prkar2a,9,108689314,108750436,protein_coding,1,61122,chr9_108689314_108750436
Prkar2b,12,31958476,32061296,protein_coding,-1,102820,chr12_31958476_32061296
Prkca,11,107933387,108343928,protein_coding,-1,410541,chr11_107933387_108343928
Prkcb,7,122288751,122634402,protein_coding,1,345651,chr7_122288751_122634402
Prkcd,14,30595354,30626210,protein_coding,-1,30856,chr14_30595354_30626210
Prkce,17,86167785,86657919,protein_coding,1,490134,chr17_86167785_86657919
Prkcg,7,3289179,3331099,protein_coding,1,41920,chr7_3289179_3331099
Prkch,12,73584796,73778185,protein_coding,1,193389,chr12_73584796_73778185
Prkci,3,30995747,31052959,protein_coding,1,57212,chr3_30995747_31052959
Prkcq,2,11172108,11301222,protein_coding,1,129114,chr2_11172108_11301222
Prkcsh,9,22002806,22014222,protein_coding,1,11416,chr9_22002806_22014222
Prkcz,4,155260129,155361361,protein_coding,-1,101232,chr4_155260129_155361361
Prkcz2,7,27882755,27884510,processed_pseudogene,-1,1755,chr7_27882755_27884510
Prkd1,12,50341231,50649098,protein_coding,-1,307867,chr12_50341231_50649098
Prkd2,7,16842902,16870464,protein_coding,1,27562,chr7_16842902_16870464
Prkd3,17,78949405,79020816,protein_coding,-1,71411,chr17_78949405_79020816
Prkdc,16,15637866,15842235,protein_coding,1,204369,chr16_15637866_15842235
Prkg1,19,30564489,31765033,protein_coding,-1,1200544,chr19_30564489_31765033
Prkg2,5,98929773,99037351,protein_coding,-1,107578,chr5_98929773_99037351
Prkra,2,76629898,76648015,protein_coding,-1,18117,chr2_76629898_76648015
Prkrip1,5,136178127,136198963,protein_coding,-1,20836,chr5_136178127_136198963
Prkx,X,77761411,77796278,protein_coding,-1,34867,chrX_77761411_77796278
Prl8a2,13,27345673,27354216,protein_coding,1,8543,chr13_27345673_27354216
Prlhr,19,60466732,60468304,protein_coding,-1,1572,chr19_60466732_60468304
Prlr,15,10177238,10349180,protein_coding,1,171942,chr15_10177238_10349180
Prm1,16,10796326,10805839,protein_coding,-1,9513,chr16_10796326_10805839
Prmt1,7,44975989,44986568,protein_coding,-1,10579,chr7_44975989_44986568
Prmt2,10,76207222,76237865,protein_coding,-1,30643,chr10_76207222_76237865
Prmt3,7,49778346,49858265,protein_coding,1,79919,chr7_49778346_49858265
Prmt5,14,54507187,54517525,protein_coding,-1,10338,chr14_54507187_54517525
Prmt6,3,110246109,110250998,protein_coding,-1,4889,chr3_110246109_110250998
Prmt7,8,106210936,106252794,protein_coding,1,41858,chr8_106210936_106252794
Prmt8,6,127689011,127769472,protein_coding,-1,80461,chr6_127689011_127769472
Prn,2,131909957,131956130,protein_coding,1,46173,chr2_131909957_131956130
Prnp,2,131909928,131938429,protein_coding,1,28501,chr2_131909928_131938429
Prob1,18,35650351,35655238,protein_coding,-1,4887,chr18_35650351_35655238
Proca1,11,78193392,78205763,protein_coding,1,12371,chr11_78193392_78205763
Prodh,16,18060357,18090203,protein_coding,-1,29846,chr16_18060357_18090203
Prodh2,7,30493622,30513402,protein_coding,1,19780,chr7_30493622_30513402
Prok1,3,107232797,107239707,protein_coding,-1,6910,chr3_107232797_107239707
Prok2,6,99711299,99726392,protein_coding,-1,15093,chr6_99711299_99726392
Prokr1,6,87578591,87590743,protein_coding,-1,12152,chr6_87578591_87590743
Prokr2,2,132337733,132385447,protein_coding,-1,47714,chr2_132337733_132385447
Prom1,5,43993620,44102032,protein_coding,-1,108412,chr5_43993620_44102032
Prom2,2,127526473,127541467,protein_coding,-1,14994,chr2_127526473_127541467
Prorsd1,11,29511757,29515033,protein_coding,-1,3276,chr11_29511757_29515033
Pros1,16,62854307,62929346,protein_coding,1,75039,chr16_62854307_62929346
Proser1,3,53463666,53481755,protein_coding,1,18089,chr3_53463666_53481755
Proser2,2,6097607,6130211,protein_coding,-1,32604,chr2_6097607_6130211
Proser3,7,30539134,30552299,protein_coding,-1,13165,chr7_30539134_30552299
Prox1,1,190118035,190170714,protein_coding,-1,52679,chr1_190118035_190170714
Prox2,12,85086385,85110759,protein_coding,-1,24374,chr12_85086385_85110759
Proz,8,13060914,13076026,protein_coding,1,15112,chr8_13060914_13076026
Prpf18,2,4622058,4652113,protein_coding,-1,30055,chr2_4622058_4652113
Prpf19,19,10895231,10909559,protein_coding,1,14328,chr19_10895231_10909559
Prpf3,3,95830124,95855885,protein_coding,-1,25761,chr3_95830124_95855885
Prpf31,7,3629985,3642486,protein_coding,1,12501,chr7_3629985_3642486
Prpf38a,4,108563172,108579336,protein_coding,-1,16164,chr4_108563172_108579336
Prpf38b,3,108902805,108911727,protein_coding,-1,8922,chr3_108902805_108911727
Prpf39,12,65036333,65063386,protein_coding,1,27053,chr12_65036333_65063386
Prpf4,4,62408797,62426990,protein_coding,1,18193,chr4_62408797_62426990
Prpf40a,2,53134704,53191702,protein_coding,-1,56998,chr2_53134704_53191702
Prpf40b,15,99295087,99317018,protein_coding,1,21931,chr15_99295087_99317018
Prpf4b,13,34875302,34906064,protein_coding,1,30762,chr13_34875302_34906064
Prpf6,2,181591868,181655660,protein_coding,1,63792,chr2_181591868_181655660
Prpf8,11,75486816,75509449,protein_coding,1,22633,chr11_75486816_75509449
Prph,15,99055174,99058978,protein_coding,1,3804,chr15_99055174_99058978
Prph2,17,46910459,46924933,protein_coding,1,14474,chr17_46910459_46924933
Prps1,X,140456613,140476140,protein_coding,1,19527,chrX_140456613_140476140
Prps1l3,12,57230412,57239882,protein_coding,1,9470,chr12_57230412_57239882
Prps2,X,167346322,167382749,protein_coding,-1,36427,chrX_167346322_167382749
Prpsap1,11,116470845,116494202,protein_coding,-1,23357,chr11_116470845_116494202
Prpsap2,11,61729650,61762088,protein_coding,-1,32438,chr11_61729650_61762088
Prr11,11,87089153,87108708,protein_coding,-1,19555,chr11_87089153_87108708
Prr12,7,45027563,45052881,protein_coding,-1,25318,chr7_45027563_45052881
Prr13,15,102459028,102462806,protein_coding,1,3778,chr15_102459028_102462806
Prr14,7,127459611,127476759,protein_coding,1,17148,chr7_127459611_127476759
Prr14l,5,32789820,32854256,protein_coding,-1,64436,chr5_32789820_32854256
Prr15,6,54325835,54330201,protein_coding,1,4366,chr6_54325835_54330201
Prr15l,11,96928104,96937830,protein_coding,1,9726,chr11_96928104_96937830
Prr16,18,51117733,51420044,protein_coding,1,302311,chr18_51117733_51420044
Prr18,17,8337459,8344113,protein_coding,1,6654,chr17_8337459_8344113
Prr19,7,25301411,25304132,protein_coding,1,2721,chr7_25301411_25304132
Prr22,17,56770250,56772208,protein_coding,1,1958,chr17_56770250_56772208
Prr3,17,35972541,35980236,protein_coding,-1,7695,chr17_35972541_35980236
Prr33,7,142491074,142506771,protein_coding,-1,15697,chr7_142491074_142506771
Prr36,8,4209543,4217459,protein_coding,-1,7916,chr8_4209543_4217459
Prr5,15,84669620,84703673,protein_coding,1,34053,chr15_84669620_84703673
Prr5l,2,101714285,101883027,protein_coding,-1,168742,chr2_101714285_101883027
Prr7,13,55464267,55473154,protein_coding,1,8887,chr13_55464267_55473154
Prrc1,18,57354741,57392956,protein_coding,1,38215,chr18_57354741_57392956
Prrc2a,17,35149076,35164897,protein_coding,-1,15821,chr17_35149076_35164897
Prrc2b,2,32151082,32234537,protein_coding,1,83455,chr2_32151082_32234537
Prrc2c,1,162670725,162740556,protein_coding,-1,69831,chr1_162670725_162740556
Prrg1,X,78449613,78583896,protein_coding,-1,134283,chrX_78449613_78583896
Prrg2,7,45053584,45062677,protein_coding,-1,9093,chr7_45053584_45062677
Prrg3,X,71962624,71972722,protein_coding,1,10098,chrX_71962624_71972722
Prrg4,2,104830741,104849876,protein_coding,-1,19135,chr2_104830741_104849876
Prrt1,17,34629533,34633126,protein_coding,1,3593,chr17_34629533_34633126
Prrt2,7,127017531,127021211,protein_coding,-1,3680,chr7_127017531_127021211
Prrt3,6,113493639,113501931,protein_coding,-1,8292,chr6_113493639_113501931
Prrt4,6,29169232,29179584,protein_coding,-1,10352,chr6_29169232_29179584
Prrx1,1,163245119,163313710,protein_coding,-1,68591,chr1_163245119_163313710
Prrx2,2,30834972,30881251,protein_coding,1,46279,chr2_30834972_30881251
Prrxl1,14,32599407,32649246,protein_coding,1,49839,chr14_32599407_32649246
Prss12,3,123446913,123506597,protein_coding,1,59684,chr3_123446913_123506597
Prss16,13,22002173,22009742,protein_coding,-1,7569,chr13_22002173_22009742
Prss22,17,23993534,23998100,protein_coding,-1,4566,chr17_23993534_23998100
Prss23,7,89507783,89527187,protein_coding,-1,19404,chr7_89507783_89527187
Prss27,17,24038144,24045954,protein_coding,1,7810,chr17_24038144_24045954
Prss30,17,23972126,23980566,protein_coding,-1,8440,chr17_23972126_23980566
Prss33,17,23833347,23836056,protein_coding,-1,2709,chr17_23833347_23836056
Prss35,9,86743649,86758443,protein_coding,1,14794,chr9_86743649_86758443
Prss36,7,127932638,127946725,protein_coding,-1,14087,chr7_127932638_127946725
Prss38,11,59372669,59375657,protein_coding,-1,2988,chr11_59372669_59375657
Prss41,17,23836785,23844172,protein_coding,-1,7387,chr17_23836785_23844172
Prss43,9,110826690,110831839,protein_coding,1,5149,chr9_110826690_110831839
Prss45,9,110834588,110841313,protein_coding,1,6725,chr9_110834588_110841313
Prss48,3,85993810,86002491,protein_coding,-1,8681,chr3_85993810_86002491
Prss50,9,110857967,110864629,protein_coding,1,6662,chr9_110857967_110864629
Prss52,14,64104286,64113755,protein_coding,1,9469,chr14_64104286_64113755
Prss53,7,127885841,127890970,protein_coding,-1,5129,chr7_127885841_127890970
Prss54,8,95559069,95576340,protein_coding,-1,17271,chr8_95559069_95576340
Prss55,14,64075438,64090162,protein_coding,-1,14724,chr14_64075438_64090162
Prss56,1,87183313,87188405,protein_coding,1,5092,chr1_87183313_87188405
Prss57,10,79781474,79790961,protein_coding,-1,9487,chr10_79781474_79790961
Prss8,7,127925716,127930104,protein_coding,-1,4388,chr7_127925716_127930104
Prtg,9,72806874,72917291,protein_coding,1,110417,chr9_72806874_72917291
Prtn3,10,79874476,79883174,protein_coding,1,8698,chr10_79874476_79883174
Prune2,19,16956118,17223932,protein_coding,1,267814,chr19_16956118_17223932
Prx,7,27497388,27520214,protein_coding,1,22826,chr7_27497388_27520214
Psap,10,60277627,60302597,protein_coding,1,24970,chr10_60277627_60302597
Psapl1,5,36204021,36206568,protein_coding,1,2547,chr5_36204021_36206568
Psat1,19,15904678,15947337,protein_coding,-1,42659,chr19_15904678_15947337
Psd,19,46312087,46327156,protein_coding,-1,15069,chr19_46312087_46327156
Psd2,18,35964830,36014715,protein_coding,1,49885,chr18_35964830_36014715
Psd3,8,67689082,68212027,protein_coding,-1,522945,chr8_67689082_68212027
Psd4,2,24367580,24414954,protein_coding,1,47374,chr2_24367580_24414954
Psen1,12,83688152,83735199,protein_coding,1,47047,chr12_83688152_83735199
Psen2,1,180227004,180263438,protein_coding,-1,36434,chr1_180227004_180263438
Psenen,7,30561863,30563627,protein_coding,-1,1764,chr7_30561863_30563627
Psg16,7,17074040,17133450,protein_coding,1,59410,chr7_17074040_17133450
Psg17,7,18813937,18821607,protein_coding,-1,7670,chr7_18813937_18821607
Psg23,7,18606343,18616501,protein_coding,-1,10158,chr7_18606343_18616501
Psg29,7,17203477,17215760,protein_coding,1,12283,chr7_17203477_17215760
Psip1,4,83455680,83486459,protein_coding,-1,30779,chr4_83455680_83486459
Pskh1,8,105900441,105931778,protein_coding,1,31337,chr8_105900441_105931778
Psma1,7,114264606,114276118,protein_coding,-1,11512,chr7_114264606_114276118
Psma2,13,14613240,14674236,protein_coding,1,60996,chr13_14613240_14674236
Psma3,12,70974621,70996347,protein_coding,1,21726,chr12_70974621_70996347
Psma4,9,54950790,54958030,protein_coding,1,7240,chr9_54950790_54958030
Psma5,3,108256926,108279974,protein_coding,1,23048,chr3_108256926_108279974
Psma6,12,55384222,55418454,protein_coding,1,34232,chr12_55384222_55418454
Psma7,2,180036374,180042433,protein_coding,-1,6059,chr2_180036374_180042433
Psma8,18,14706151,14762301,protein_coding,1,56150,chr18_14706151_14762301
Psmb1,17,15475021,15499751,protein_coding,-1,24730,chr17_15475021_15499751
Psmb10,8,105935735,105938444,protein_coding,-1,2709,chr8_105935735_105938444
Psmb11,14,54621433,54629556,protein_coding,1,8123,chr14_54621433_54629556
Psmb2,4,126677630,126709714,protein_coding,1,32084,chr4_126677630_126709714
Psmb3,11,97703399,97713500,protein_coding,1,10101,chr11_97703399_97713500
Psmb4,3,94884093,94886961,protein_coding,-1,2868,chr3_94884093_94886961
Psmb5,14,54614119,54618022,protein_coding,-1,3903,chr14_54614119_54618022
Psmb5-ps,11,102659128,102659925,processed_pseudogene,-1,797,chr11_102659128_102659925
Psmb6,11,70525367,70527858,protein_coding,1,2491,chr11_70525367_70527858
Psmb6-ps,X,7950156,7950868,processed_pseudogene,-1,712,chrX_7950156_7950868
Psmb6-ps2,1,101385886,101386590,processed_pseudogene,1,704,chr1_101385886_101386590
Psmb7,2,38588036,38644087,protein_coding,-1,56051,chr2_38588036_38644087
Psmb7-ps2,X,8105294,8106113,transcribed_processed_pseudogene,1,819,chrX_8105294_8106113
Psmb8,17,34197721,34201454,protein_coding,1,3733,chr17_34197721_34201454
Psmb9,17,34181987,34187764,protein_coding,-1,5777,chr17_34181987_34187764
Psmc1,12,100110154,100123405,protein_coding,1,13251,chr12_100110154_100123405
Psmc2,5,21785283,21803787,protein_coding,1,18504,chr5_21785283_21803787
Psmc3,2,91054009,91066369,protein_coding,1,12360,chr2_91054009_91066369
Psmc3ip,11,101091823,101095436,protein_coding,-1,3613,chr11_101091823_101095436
Psmc4,7,28041707,28050101,protein_coding,-1,8394,chr7_28041707_28050101
Psmc5,11,106256154,106263120,protein_coding,1,6966,chr11_106256154_106263120
Psmc6,14,45329788,45349705,protein_coding,1,19917,chr14_45329788_45349705
Psmd1,1,86064387,86139151,protein_coding,1,74764,chr1_86064387_86139151
Psmd10,X,140948429,140956728,protein_coding,-1,8299,chrX_140948429_140956728
Psmd11,11,80428615,80473248,protein_coding,1,44633,chr11_80428615_80473248
Psmd12,11,107479484,107504362,protein_coding,1,24878,chr11_107479484_107504362
Psmd13,7,140881968,140898643,protein_coding,1,16675,chr7_140881968_140898643
Psmd14,2,61711694,61800376,protein_coding,1,88682,chr2_61711694_61800376
Psmd2,16,20651652,20663414,protein_coding,1,11762,chr16_20651652_20663414
Psmd3,11,98682554,98695979,protein_coding,1,13425,chr11_98682554_98695979
Psmd4,3,95032694,95042614,protein_coding,-1,9920,chr3_95032694_95042614
Psmd5,2,34849734,34874968,protein_coding,-1,25234,chr2_34849734_34874968
Psmd6,14,14112174,14120984,protein_coding,-1,8810,chr14_14112174_14120984
Psmd7,8,107580381,107588464,protein_coding,-1,8083,chr8_107580381_107588464
Psmd8,7,29174188,29180701,protein_coding,-1,6513,chr7_29174188_29180701
Psmd9,5,123169413,123250131,protein_coding,1,80718,chr5_123169413_123250131
Psme1,14,55578123,55581529,protein_coding,1,3406,chr14_55578123_55581529
Psme2,14,48960285,55591113,protein_coding,-1,6630828,chr14_48960285_55591113
Psme2b,11,48945354,48946190,protein_coding,-1,836,chr11_48945354_48946190
Psme3,11,101316213,101323537,protein_coding,1,7324,chr11_101316213_101323537
Psme4,11,30771726,30880361,protein_coding,1,108635,chr11_30771726_30880361
Psmf1,2,151715812,151744186,protein_coding,-1,28374,chr2_151715812_151744186
Psmg1,16,95979933,95990960,protein_coding,-1,11027,chr16_95979933_95990960
Psmg2,18,67641599,67654162,protein_coding,1,12563,chr18_67641599_67654162
Psmg3,5,139823592,139826885,protein_coding,-1,3293,chr5_139823592_139826885
Psmg4,13,34162964,34178173,protein_coding,1,15209,chr13_34162964_34178173
Psors1c2,17,35533201,35534647,protein_coding,1,1446,chr17_35533201_35534647
Pspc1,14,56720710,56778316,protein_coding,-1,57606,chr14_56720710_56778316
Psph,5,129765558,129787449,protein_coding,-1,21891,chr5_129765558_129787449
Pspn,17,56999457,57000018,protein_coding,-1,561,chr17_56999457_57000018
Psrc1,3,108383839,108388231,protein_coding,1,4392,chr3_108383839_108388231
Pstk,7,131371141,131394482,protein_coding,1,23341,chr7_131371141_131394482
Pstpip1,9,56089962,56128888,protein_coding,1,38926,chr9_56089962_56128888
Pstpip2,18,77789914,77882879,protein_coding,1,92965,chr18_77789914_77882879
Ptar1,19,23687429,23731668,protein_coding,1,44239,chr19_23687429_23731668
Ptbp1,10,79854427,79864771,protein_coding,1,10344,chr10_79854427_79864771
Ptbp2,3,119718742,119784466,protein_coding,-1,65724,chr3_119718742_119784466
Ptbp3,4,59471868,59549364,protein_coding,-1,77496,chr4_59471868_59549364
Ptcd1,5,145147514,145167108,protein_coding,-1,19594,chr5_145147514_145167108
Ptcd2,13,99319647,99344705,protein_coding,-1,25058,chr13_99319647_99344705
Ptcd3,6,71880638,71908750,protein_coding,-1,28112,chr6_71880638_71908750
Ptch1,13,63508328,63573598,protein_coding,-1,65270,chr13_63508328_63573598
Ptch2,4,117096075,117116101,protein_coding,1,20026,chr4_117096075_117116101
Ptchd1,X,155573455,155623814,protein_coding,-1,50359,chrX_155573455_155623814
Ptchd3,11,121830247,121843423,protein_coding,1,13176,chr11_121830247_121843423
Ptchd4,17,42315947,42505077,protein_coding,1,189130,chr17_42315947_42505077
Ptcra,17,46755663,46763712,protein_coding,-1,8049,chr17_46755663_46763712
Ptdss1,13,66932830,66998401,protein_coding,1,65571,chr13_66932830_66998401
Ptdss2,7,141122382,141157606,protein_coding,1,35224,chr7_141122382_141157606
Pten,19,32757497,32826160,protein_coding,1,68663,chr19_32757497_32826160
Pter,2,12924041,13003455,protein_coding,1,79414,chr2_12924041_13003455
Ptf1a,2,19445663,19447501,protein_coding,1,1838,chr2_19445663_19447501
Ptgdr,14,44851235,44859375,protein_coding,-1,8140,chr14_44851235_44859375
Ptgdr2,19,10937160,10942511,protein_coding,1,5351,chr19_10937160_10942511
Ptgds,2,25466709,25470046,protein_coding,-1,3337,chr2_25466709_25470046
Ptger1,8,83666678,83672753,protein_coding,1,6075,chr8_83666678_83672753
Ptger2,14,44988195,45003820,protein_coding,1,15625,chr14_44988195_45003820
Ptger3,3,157566892,157645888,protein_coding,1,78996,chr3_157566892_157645888
Ptger4,15,5206661,5244187,protein_coding,-1,37526,chr15_5206661_5244187
Ptges,2,30889471,30929863,protein_coding,-1,40392,chr2_30889471_30929863
Ptges2,2,32395896,32405772,protein_coding,1,9876,chr2_32395896_32405772
Ptges3,10,128058954,128077272,protein_coding,1,18318,chr10_128058954_128077272
Ptges3l,11,101418812,101425333,protein_coding,-1,6521,chr11_101418812_101425333
Ptgfr,3,151796502,151837630,protein_coding,-1,41128,chr3_151796502_151837630
Ptgfrn,3,101040232,101110278,protein_coding,-1,70046,chr3_101040232_101110278
Ptgir,7,16906490,16910905,protein_coding,1,4415,chr7_16906490_16910905
Ptgis,2,167191805,167240604,protein_coding,-1,48799,chr2_167191805_167240604
Ptgr1,4,58965439,58987119,protein_coding,-1,21680,chr4_58965439_58987119
Ptgr2,12,84285232,84315832,protein_coding,1,30600,chr12_84285232_84315832
Ptgs1,2,36230426,36252272,protein_coding,1,21846,chr2_36230426_36252272
Ptgs2,1,150100031,150108227,protein_coding,1,8196,chr1_150100031_150108227
Ptgs2os,1,150074873,150099963,processed_transcript,-1,25090,chr1_150074873_150099963
Ptgs2os2,1,150159043,150164948,lincRNA,-1,5905,chr1_150159043_150164948
Pth1r,9,110722085,110747145,protein_coding,-1,25060,chr9_110722085_110747145
Pth2,7,45180995,45181838,protein_coding,1,843,chr7_45180995_45181838
Pth2r,1,65282056,65389244,protein_coding,1,107188,chr1_65282056_65389244
Pthlh,6,147252101,147264183,protein_coding,-1,12082,chr6_147252101_147264183
Ptk2,15,73205102,73423280,protein_coding,-1,218178,chr15_73205102_73423280
Ptk2b,14,66153257,66281052,protein_coding,-1,127795,chr14_66153257_66281052
Ptk6,2,181193721,181202789,protein_coding,-1,9068,chr2_181193721_181202789
Ptk7,17,46564471,46629504,protein_coding,-1,65033,chr17_46564471_46629504
Ptma,1,86526726,86530712,protein_coding,1,3986,chr1_86526726_86530712
Ptms,6,124913681,124920103,protein_coding,-1,6422,chr6_124913681_124920103
Ptn,6,36714929,36810220,protein_coding,-1,95291,chr6_36714929_36810220
Ptov1,7,44863067,44869788,protein_coding,-1,6721,chr7_44863067_44869788
Ptp4a1,1,30940302,30949770,protein_coding,-1,9468,chr1_30940302_30949770
Ptp4a2,4,129811219,129850003,protein_coding,1,38784,chr4_129811219_129850003
Ptp4a3,15,73723145,73758766,protein_coding,1,35621,chr15_73723145_73758766
Ptpdc1,13,48577872,48625664,protein_coding,-1,47792,chr13_48577872_48625664
Ptpmt1,2,90908716,90918258,protein_coding,-1,9542,chr2_90908716_90918258
Ptpn1,2,167932057,167979385,protein_coding,1,47328,chr2_167932057_167979385
Ptpn11,5,121130533,121191397,protein_coding,-1,60864,chr5_121130533_121191397
Ptpn12,5,20986645,21055911,protein_coding,-1,69266,chr5_20986645_21055911
Ptpn13,5,103425192,103598303,protein_coding,1,173111,chr5_103425192_103598303
Ptpn14,1,189728268,189876695,protein_coding,1,148427,chr1_189728268_189876695
Ptpn18,1,34459762,34475733,protein_coding,1,15971,chr1_34459762_34475733
Ptpn2,18,67665511,67724595,protein_coding,-1,59084,chr18_67665511_67724595
Ptpn20,14,33589207,33640754,protein_coding,1,51547,chr14_33589207_33640754
Ptpn21,12,98676741,98737405,protein_coding,-1,60664,chr12_98676741_98737405
Ptpn22,3,103859795,103912247,protein_coding,1,52452,chr3_103859795_103912247
Ptpn23,9,110385082,110408213,protein_coding,-1,23131,chr9_110385082_110408213
Ptpn3,4,57190841,57301837,protein_coding,-1,110996,chr4_57190841_57301837
Ptpn4,1,119652467,119837613,protein_coding,-1,185146,chr1_119652467_119837613
Ptpn5,7,47077795,47133684,protein_coding,-1,55889,chr7_47077795_47133684
Ptpn6,6,124720707,124738714,protein_coding,-1,18007,chr6_124720707_124738714
Ptpn7,1,135132700,135145317,protein_coding,1,12617,chr1_135132700_135145317
Ptpn9,9,56994923,57062807,protein_coding,1,67884,chr9_56994923_57062807
Ptpra,2,130450278,130556124,protein_coding,1,105846,chr2_130450278_130556124
Ptprb,10,116275523,116389535,protein_coding,1,114012,chr10_116275523_116389535
Ptprc,1,138062861,138175708,protein_coding,-1,112847,chr1_138062861_138175708
Ptprcap,19,4153603,4156751,protein_coding,1,3148,chr19_4153603_4156751
Ptprd,4,75941238,78211961,protein_coding,-1,2270723,chr4_75941238_78211961
Ptpre,7,135537481,135686293,protein_coding,1,148812,chr7_135537481_135686293
Ptprf,4,118208213,118291405,protein_coding,-1,83192,chr4_118208213_118291405
Ptprg,14,11553532,12242041,protein_coding,1,688509,chr14_11553532_12242041
Ptprh,7,4548612,4604041,protein_coding,-1,55429,chr7_4548612_4604041
Ptprj,2,90429754,90580647,protein_coding,-1,150893,chr2_90429754_90580647
Ptprk,10,28074820,28597397,protein_coding,1,522577,chr10_28074820_28597397
Ptprm,17,66666947,67354457,protein_coding,-1,687510,chr17_66666947_67354457
Ptprn,1,75247027,75264502,protein_coding,-1,17475,chr1_75247027_75264502
Ptprn2,12,116485720,117276849,protein_coding,1,791129,chr12_116485720_117276849
Ptpro,6,137252319,137463233,protein_coding,1,210914,chr6_137252319_137463233
Ptprq,10,107517049,107720051,protein_coding,-1,203002,chr10_107517049_107720051
Ptprr,10,116018213,116274932,protein_coding,1,256719,chr10_116018213_116274932
Ptprs,17,56412426,56476483,protein_coding,-1,64057,chr17_56412426_56476483
Ptprt,2,161521990,162661147,protein_coding,-1,1139157,chr2_161521990_162661147
Ptprtos,2,162390813,162393945,antisense,1,3132,chr2_162390813_162393945
Ptpru,4,131768457,131838288,protein_coding,-1,69831,chr4_131768457_131838288
Ptprv,1,135108497,135132594,polymorphic_pseudogene,-1,24097,chr1_135108497_135132594
Ptprz1,6,22875502,23052916,protein_coding,1,177414,chr6_22875502_23052916
Ptrh1,2,32775786,32777597,protein_coding,1,1811,chr2_32775786_32777597
Ptrh2,11,86683985,86692457,protein_coding,1,8472,chr11_86683985_86692457
Ptrhd1,12,4234027,4239950,protein_coding,1,5923,chr12_4234027_4239950
Pts,9,50521617,50528724,protein_coding,-1,7107,chr9_50521617_50528724
Pttg1,11,43420250,43426251,protein_coding,-1,6001,chr11_43420250_43426251
Pttg1ip,10,77581720,77598732,protein_coding,1,17012,chr10_77581720_77598732
Ptx3,3,66219910,66225805,protein_coding,1,5895,chr3_66219910_66225805
Ptx4,17,25120760,25125292,protein_coding,1,4532,chr17_25120760_25125292
Puf60,15,76070182,76080924,protein_coding,-1,10742,chr15_76070182_76080924
Pum1,4,130615207,130781564,protein_coding,1,166357,chr4_130615207_130781564
Pum2,12,8674134,8752581,protein_coding,1,78447,chr12_8674134_8752581
Pura,18,36281097,36292535,protein_coding,1,11438,chr18_36281097_36292535
Purb,11,6467599,6475917,protein_coding,-1,8318,chr11_6467599_6475917
Purg,8,33386325,33417467,protein_coding,1,31142,chr8_33386325_33417467
Pus1,5,110773667,110780659,protein_coding,-1,6992,chr5_110773667_110780659
Pus10,11,23665674,23732876,protein_coding,1,67202,chr11_23665674_23732876
Pus3,9,35558595,35567401,protein_coding,1,8806,chr9_35558595_35567401
Pus7,5,23740648,23783711,protein_coding,-1,43063,chr5_23740648_23783711
Pus7l,15,94522688,94543547,protein_coding,-1,20859,chr15_94522688_94543547
Pusl1,4,155887879,155891781,protein_coding,-1,3902,chr4_155887879_155891781
Pvalb,15,78191114,78206400,protein_coding,-1,15286,chr15_78191114_78206400
Pvr,7,19903578,19921160,protein_coding,-1,17582,chr7_19903578_19921160
Pvrig-ps,5,138359838,138360041,processed_pseudogene,1,203,chr5_138359838_138360041
Pvt1,15,62037986,62378096,lincRNA,1,340110,chr15_62037986_62378096
Pwp1,10,85829494,85889096,protein_coding,1,59602,chr10_85829494_85889096
Pwp2,10,78170909,78185149,protein_coding,-1,14240,chr10_78170909_78185149
Pwwp2a,11,43681998,43721491,protein_coding,1,39493,chr11_43681998_43721491
Pwwp2b,7,139226669,139269903,protein_coding,1,43234,chr7_139226669_139269903
Pxdc1,13,34627834,34653486,protein_coding,-1,25652,chr13_34627834_34653486
Pxdn,12,29937608,30017658,protein_coding,1,80050,chr12_29937608_30017658
Pxk,14,8098211,8165117,protein_coding,1,66906,chr14_8098211_8165117
Pxmp2,5,110274282,110286186,protein_coding,-1,11904,chr5_110274282_110286186
Pxmp4,2,154585758,154603708,protein_coding,-1,17950,chr2_154585758_154603708
Pxn,5,115506676,115555987,protein_coding,1,49311,chr5_115506676_115555987
Pxt1,17,28933984,28943840,protein_coding,-1,9856,chr17_28933984_28943840
Pxylp1,9,96823336,96892669,protein_coding,-1,69333,chr9_96823336_96892669
Pycard,7,127989708,127993867,protein_coding,-1,4159,chr7_127989708_127993867
Pycr1,11,120635712,120643769,protein_coding,-1,8057,chr11_120635712_120643769
Pycr2,1,180904293,180908088,protein_coding,1,3795,chr1_180904293_180908088
Pycrl,15,75916477,75921560,protein_coding,-1,5083,chr15_75916477_75921560
Pygb,2,150786735,150831758,protein_coding,1,45023,chr2_150786735_150831758
Pygl,12,70190811,70231488,protein_coding,-1,40677,chr12_70190811_70231488
Pygm,19,6384399,6398459,protein_coding,1,14060,chr19_6384399_6398459
Pygo1,9,72925645,72952181,protein_coding,1,26536,chr9_72925645_72952181
Pygo2,3,89430214,89435128,protein_coding,1,4914,chr3_89430214_89435128
Pyroxd1,6,142345654,142363257,protein_coding,1,17603,chr6_142345654_142363257
Pyroxd2,19,42725858,42752775,protein_coding,-1,26917,chr19_42725858_42752775
Pyurf,6,57686576,57692078,protein_coding,-1,5502,chr6_57686576_57692078
Pzp,6,128483567,128526720,protein_coding,-1,43153,chr6_128483567_128526720
Qars,9,108507706,108515941,protein_coding,1,8235,chr9_108507706_108515941
Qdpr,5,45434021,45450236,protein_coding,-1,16215,chr5_45434021_45450236
Qk,17,10202601,10319854,protein_coding,-1,117253,chr17_10202601_10319854
Qpct,17,79051906,79090378,protein_coding,1,38472,chr17_79051906_79090378
Qpctl,7,19139702,19149291,protein_coding,-1,9589,chr7_19139702_19149291
Qrfp,2,31806166,31810580,protein_coding,-1,4414,chr2_31806166_31810580
Qrfpr,3,36179424,36222313,protein_coding,-1,42889,chr3_36179424_36222313
Qrich1,9,108516806,108560163,protein_coding,1,43357,chr9_108516806_108560163
Qrich2,11,116441325,116466241,protein_coding,-1,24916,chr11_116441325_116466241
Qrsl1,10,43874188,43901745,protein_coding,-1,27557,chr10_43874188_43901745
Qser1,2,104754795,104816760,protein_coding,-1,61965,chr2_104754795_104816760
Qsox1,1,155776029,155812889,protein_coding,-1,36860,chr1_155776029_155812889
Qsox2,2,26208637,26237525,protein_coding,-1,28888,chr2_26208637_26237525
Qtrt1,9,21411837,21420274,protein_coding,1,8437,chr9_21411837_21420274
R3hcc1,14,69697307,69707584,protein_coding,-1,10277,chr14_69697307_69707584
R3hcc1l,19,42518759,42592343,protein_coding,1,73584,chr19_42518759_42592343
R3hdm1,1,128103301,128237736,protein_coding,1,134435,chr1_128103301_128237736
R3hdm2,10,127380327,127499384,protein_coding,1,119057,chr10_127380327_127499384
R3hdm4,10,79910052,79921208,protein_coding,-1,11156,chr10_79910052_79921208
R3hdml,2,163492318,163502612,protein_coding,1,10294,chr2_163492318_163502612
R74862,7,143021784,143053686,processed_transcript,-1,31902,chr7_143021784_143053686
Rab10,12,3247428,3309969,protein_coding,-1,62541,chr12_3247428_3309969
Rab10os,12,3235504,3250377,antisense,1,14873,chr12_3235504_3250377
Rab11a,9,64715299,64737758,protein_coding,-1,22459,chr9_64715299_64737758
Rab11b,17,33742484,33760530,protein_coding,-1,18046,chr17_33742484_33760530
Rab11b-ps2,19,7398424,7399077,processed_pseudogene,-1,653,chr19_7398424_7399077
Rab11fip1,8,27138773,27174646,protein_coding,-1,35873,chr8_27138773_27174646
Rab11fip2,19,59902884,59943654,protein_coding,-1,40770,chr19_59902884_59943654
Rab11fip3,17,25989036,26069555,protein_coding,-1,80519,chr17_25989036_26069555
Rab11fip4,11,79591212,79698023,protein_coding,1,106811,chr11_79591212_79698023
Rab11fip4os1,11,79607079,79623163,antisense,-1,16084,chr11_79607079_79623163
Rab11fip4os2,11,79670372,79675128,antisense,-1,4756,chr11_79670372_79675128
Rab11fip5,6,85334962,85374634,protein_coding,-1,39672,chr6_85334962_85374634
Rab12,17,66494512,66519729,protein_coding,-1,25217,chr17_66494512_66519729
Rab13,3,90213695,90226385,protein_coding,1,12690,chr3_90213695_90226385
Rab14,2,35180205,35201120,protein_coding,-1,20915,chr2_35180205_35201120
Rab15,12,76797960,76822908,protein_coding,-1,24948,chr12_76797960_76822908
Rab18,18,6733905,6794429,protein_coding,1,60524,chr18_6733905_6794429
Rab19,6,39381175,39390380,protein_coding,1,9205,chr6_39381175_39390380
Rab1b,19,5099205,5107072,protein_coding,-1,7867,chr19_5099205_5107072
Rab21,10,115287084,115315594,protein_coding,-1,28510,chr10_115287084_115315594
Rab22a,2,173659760,173707343,protein_coding,1,47583,chr2_173659760_173707343
Rab23,1,33719887,33742564,protein_coding,1,22677,chr1_33719887_33742564
Rab24,13,55319743,55321946,protein_coding,-1,2203,chr13_55319743_55321946
Rab25,3,88542029,88548300,protein_coding,-1,6271,chr3_88542029_88548300
Rab26,17,24527241,24534210,protein_coding,-1,6969,chr17_24527241_24534210
Rab26os,17,24528248,24528744,antisense,1,496,chr17_24528248_24528744
Rab27a,9,73044854,73097629,protein_coding,1,52775,chr9_73044854_73097629
Rab27b,18,69979131,70141605,protein_coding,-1,162474,chr18_69979131_70141605
Rab28,5,41624976,41708157,protein_coding,-1,83181,chr5_41624976_41708157
Rab29,1,131867224,131872887,protein_coding,1,5663,chr1_131867224_131872887
Rab2a,4,8535644,8607778,protein_coding,1,72134,chr4_8535644_8607778
Rab2b,14,52261759,52279545,protein_coding,-1,17786,chr14_52261759_52279545
Rab30,7,92741603,92844535,protein_coding,1,102932,chr7_92741603_92844535
Rab31,17,65651729,65772752,protein_coding,-1,121023,chr17_65651729_65772752
Rab32,10,10545002,10558265,protein_coding,-1,13263,chr10_10545002_10558265
Rab33a,X,48519285,48530232,protein_coding,1,10947,chrX_48519285_48530232
Rab33b,3,51483920,51496232,protein_coding,1,12312,chr3_51483920_51496232
Rab34,11,78188430,78192193,protein_coding,1,3763,chr11_78188430_78192193
Rab35,5,115631908,115647736,protein_coding,1,15828,chr5_115631908_115647736
Rab36,10,75037058,75054748,protein_coding,1,17690,chr10_75037058_75054748
Rab37,11,115091431,115162236,protein_coding,1,70805,chr11_115091431_115162236
Rab38,7,88430273,88491572,protein_coding,1,61299,chr7_88430273_88491572
Rab39,9,53684110,53706232,protein_coding,-1,22122,chr9_53684110_53706232
Rab39b,X,75572046,75578231,protein_coding,-1,6185,chrX_75572046_75578231
Rab3a,8,70754679,70758677,protein_coding,1,3998,chr8_70754679_70758677
Rab3b,4,108879063,108943324,protein_coding,1,64261,chr4_108879063_108943324
Rab3c,13,110054187,110280996,protein_coding,-1,226809,chr13_110054187_110280996
Rab3d,9,21907491,21918192,protein_coding,-1,10701,chr9_21907491_21918192
Rab3gap1,1,127868773,127943868,protein_coding,1,75095,chr1_127868773_127943868
Rab3gap2,1,185204117,185286759,protein_coding,1,82642,chr1_185204117_185286759
Rab3il1,19,10001669,10038380,protein_coding,1,36711,chr19_10001669_10038380
Rab3ip,10,116905784,116950769,protein_coding,-1,44985,chr10_116905784_116950769
Rab40b,11,121356125,121388251,protein_coding,-1,32126,chr11_121356125_121388251
Rab40c,17,25882114,25919727,protein_coding,-1,37613,chr17_25882114_25919727
Rab42,4,132302197,132303385,protein_coding,-1,1188,chr4_132302197_132303385
Rab43,6,87788853,87812164,protein_coding,-1,23311,chr6_87788853_87812164
Rab44,17,29114145,29148980,protein_coding,1,34835,chr17_29114145_29148980
Rab4a,8,123805985,123835287,protein_coding,1,29302,chr8_123805985_123835287
Rab4b,7,27168424,27178896,protein_coding,-1,10472,chr7_27168424_27178896
Rab5a,17,53479234,53507680,protein_coding,1,28446,chr17_53479234_53507680
Rab5b,10,128677175,128696264,protein_coding,-1,19089,chr10_128677175_128696264
Rab5c,11,100715009,100738215,protein_coding,-1,23206,chr11_100715009_100738215
Rab6a,7,100607410,100641268,protein_coding,1,33858,chr7_100607410_100641268
Rab6b,9,103111787,103185276,protein_coding,1,73489,chr9_103111787_103185276
Rab7,6,87999106,88045270,protein_coding,-1,46164,chr6_87999106_88045270
Rab7-ps1,9,54824661,54825282,processed_pseudogene,-1,621,chr9_54824661_54825282
Rab8a,8,72161200,72183904,protein_coding,1,22704,chr8_72161200_72183904
Rab8b,9,66843664,66919687,protein_coding,-1,76023,chr9_66843664_66919687
Rab9,X,166457253,166479867,protein_coding,-1,22614,chrX_166457253_166479867
Rab9b,X,136858147,136868755,protein_coding,-1,10608,chrX_136858147_136868755
Rab9b-ps1,X,105482098,105482703,processed_pseudogene,1,605,chrX_105482098_105482703
Rabac1,7,24969752,24972754,protein_coding,-1,3002,chr7_24969752_24972754
Rabep1,11,70844778,70943105,protein_coding,1,98327,chr11_70844778_70943105
Rabep2,7,126428759,126449245,protein_coding,1,20486,chr7_126428759_126449245
Rabepk,2,34777556,34799912,protein_coding,-1,22356,chr2_34777556_34799912
Rabgap1,2,37443279,37566454,protein_coding,1,123175,chr2_37443279_37566454
Rabgap1l,1,160219174,160793211,protein_coding,-1,574037,chr1_160219174_160793211
Rabgef1,5,130171798,130214342,protein_coding,1,42544,chr5_130171798_130214342
Rabggta,14,55715416,55722263,protein_coding,-1,6847,chr14_55715416_55722263
Rabggtb,3,153907287,153913009,protein_coding,-1,5722,chr3_153907287_153913009
Rabif,1,134494648,134508774,protein_coding,1,14126,chr1_134494648_134508774
Rabl2,15,89582533,89591923,protein_coding,-1,9390,chr15_89582533_89591923
Rabl3,16,37539885,37572385,protein_coding,1,32500,chr16_37539885_37572385
Rabl6,2,25583018,25608521,protein_coding,-1,25503,chr2_25583018_25608521
Rac1,5,143503634,143528036,protein_coding,-1,24402,chr5_143503634_143528036
Rac2,15,78559167,78572783,protein_coding,-1,13616,chr15_78559167_78572783
Rac3,11,120721470,120723969,protein_coding,1,2499,chr11_120721470_120723969
Racgap1,15,99620496,99651656,protein_coding,-1,31160,chr15_99620496_99651656
Rad1,15,10486018,10499063,protein_coding,1,13045,chr15_10486018_10499063
Rad17,13,100617164,100651051,protein_coding,-1,33887,chr13_100617164_100651051
Rad18,6,112619850,112696686,protein_coding,-1,76836,chr6_112619850_112696686
Rad21,15,51962240,51991747,protein_coding,-1,29507,chr15_51962240_51991747
Rad21l,2,151645404,151668533,protein_coding,-1,23129,chr2_151645404_151668533
Rad23a,8,84834019,84840665,protein_coding,-1,6646,chr8_84834019_84840665
Rad23b,4,55350043,55392237,protein_coding,1,42194,chr4_55350043_55392237
Rad50,11,53649519,53707319,protein_coding,-1,57800,chr11_53649519_53707319
Rad51,2,119112793,119147445,protein_coding,1,34652,chr2_119112793_119147445
Rad51ap1,6,126923050,126939587,protein_coding,-1,16537,chr6_126923050_126939587
Rad51ap2,12,11456079,11462928,protein_coding,1,6849,chr12_11456079_11462928
Rad51b,12,79297282,79814690,protein_coding,1,517408,chr12_79297282_79814690
Rad51c,11,87376645,87404954,protein_coding,-1,28309,chr11_87376645_87404954
Rad51d,11,82876434,82890614,protein_coding,-1,14180,chr11_82876434_82890614
Rad52,6,119902698,119922828,protein_coding,1,20130,chr6_119902698_119922828
Rad54b,4,11558922,11615805,protein_coding,1,56883,chr4_11558922_11615805
Rad54l,4,116094264,116123690,protein_coding,-1,29426,chr4_116094264_116123690
Rad54l2,9,106688082,106789194,protein_coding,-1,101112,chr9_106688082_106789194
Rad9a,19,4195195,4201662,protein_coding,-1,6467,chr19_4195195_4201662
Rad9b,5,122323223,122354233,protein_coding,-1,31010,chr5_122323223_122354233
Radil,5,142484839,142551098,protein_coding,-1,66259,chr5_142484839_142551098
Rae1,2,173000117,173015739,protein_coding,1,15622,chr2_173000117_173015739
Raet1d,10,22360552,22374139,protein_coding,1,13587,chr10_22360552_22374139
Raet1e,10,22158569,22374139,protein_coding,1,215570,chr10_22158569_22374139
Raf1,6,115618067,115676635,protein_coding,-1,58568,chr6_115618067_115676635
Rag1,2,101638282,101649501,protein_coding,-1,11219,chr2_101638282_101649501
Rag2,2,101624718,101632529,protein_coding,1,7811,chr2_101624718_101632529
Rai1,11,60105013,60199197,protein_coding,1,94184,chr11_60105013_60199197
Rai14,15,10568969,10714624,protein_coding,-1,145655,chr15_10568969_10714624
Rai2,X,161717069,161779496,protein_coding,1,62427,chrX_161717069_161779496
Rala,13,17880571,17944239,protein_coding,-1,63668,chr13_17880571_17944239
Ralb,1,119470305,119504794,protein_coding,-1,34489,chr1_119470305_119504794
Ralbp1,17,65848418,65885798,protein_coding,-1,37380,chr17_65848418_65885798
Ralgapa1,12,55602896,55821167,protein_coding,-1,218271,chr12_55602896_55821167
Ralgapa2,2,146239879,146512344,protein_coding,-1,272465,chr2_146239879_146512344
Ralgapb,2,158409848,158499253,protein_coding,1,89405,chr2_158409848_158499253
Ralgds,2,28513125,28553081,protein_coding,1,39956,chr2_28513125_28553081
Ralgps1,2,33133417,33371486,protein_coding,-1,238069,chr2_33133417_33371486
Ralgps2,1,156804166,156939626,protein_coding,-1,135460,chr1_156804166_156939626
Raly,2,154791096,154867261,protein_coding,1,76165,chr2_154791096_154867261
Ralyl,3,13471655,14182287,protein_coding,1,710632,chr3_13471655_14182287
Ramp1,1,91179822,91225196,protein_coding,1,45374,chr1_91179822_91225196
Ramp2,11,101246028,101259546,protein_coding,1,13518,chr11_101246028_101259546
Ramp3,11,6658521,6677475,protein_coding,1,18954,chr11_6658521_6677475
Ran,5,129020069,129024323,protein_coding,1,4254,chr5_129020069_129024323
Ranbp1,16,18239784,18248732,protein_coding,-1,8948,chr16_18239784_18248732
Ranbp10,8,105768308,105827350,protein_coding,-1,59042,chr8_105768308_105827350
Ranbp17,11,33211795,33513746,protein_coding,-1,301951,chr11_33211795_33513746
Ranbp2,10,58446920,58494356,protein_coding,1,47436,chr10_58446920_58494356
Ranbp3,17,56673294,56711764,protein_coding,1,38470,chr17_56673294_56711764
Ranbp3l,15,8967949,9067335,protein_coding,1,99386,chr15_8967949_9067335
Ranbp6,19,29808400,29812974,protein_coding,-1,4574,chr19_29808400_29812974
Ranbp9,13,43402675,43481282,protein_coding,-1,78607,chr13_43402675_43481282
Rangap1,15,81704248,81745530,protein_coding,-1,41282,chr15_81704248_81745530
Rangrf,11,68972484,68975185,protein_coding,-1,2701,chr11_68972484_68975185
Rap1a,3,105727267,105801336,protein_coding,-1,74069,chr3_105727267_105801336
Rap1a-ps2,2,117240883,117241441,processed_pseudogene,1,558,chr2_117240883_117241441
Rap1b,10,117813871,117846035,protein_coding,-1,32164,chr10_117813871_117846035
Rap1gap,4,137664726,137729861,protein_coding,1,65135,chr4_137664726_137729861
Rap1gap2,11,74383356,74610915,protein_coding,-1,227559,chr11_74383356_74610915
Rap1gapos,4,137696979,137706606,antisense,-1,9627,chr4_137696979_137706606
Rap1gds1,3,138925902,139075201,protein_coding,-1,149299,chr3_138925902_139075201
Rap2a,14,120478444,120507194,protein_coding,1,28750,chr14_120478444_120507194
Rap2b,3,61361638,61368430,protein_coding,1,6792,chr3_61361638_61368430
Rap2c,X,51003912,51018018,protein_coding,-1,14106,chrX_51003912_51018018
Rapgef1,2,29619720,29740978,protein_coding,1,121258,chr2_29619720_29740978
Rapgef2,3,79062516,79286517,protein_coding,-1,224001,chr3_79062516_79286517
Rapgef3,15,97744770,97767972,protein_coding,-1,23202,chr15_97744770_97767972
Rapgef4,2,71981240,72257474,protein_coding,1,276234,chr2_71981240_72257474
Rapgef5,12,117516479,117759737,protein_coding,1,243258,chr12_117516479_117759737
Rapgef6,11,54522847,54699285,protein_coding,1,176438,chr11_54522847_54699285
Rapgefl1,11,98836785,98853697,protein_coding,1,16912,chr11_98836785_98853697
Raph1,1,60482292,60567104,protein_coding,-1,84812,chr1_60482292_60567104
Rapsn,2,91035620,91045730,protein_coding,1,10110,chr2_91035620_91045730
Rara,11,98927818,98974942,protein_coding,1,47124,chr11_98927818_98974942
Rarb,14,16430839,16819156,protein_coding,-1,388317,chr14_16430839_16819156
Rarg,15,102234938,102257517,protein_coding,-1,22579,chr15_102234938_102257517
Rarres1,3,67478972,67515523,protein_coding,-1,36551,chr3_67478972_67515523
Rarres2,6,48569696,48572789,protein_coding,-1,3093,chr6_48569696_48572789
Rars,11,35808381,35834506,protein_coding,-1,26125,chr11_35808381_35834506
Rars2,4,34614957,34660167,protein_coding,1,45210,chr4_34614957_34660167
Rasa1,13,85214780,85289130,protein_coding,-1,74350,chr13_85214780_85289130
Rasa2,9,96539300,96631617,protein_coding,-1,92317,chr9_96539300_96631617
Rasa3,8,13566948,13677603,protein_coding,-1,110655,chr8_13566948_13677603
Rasa4,5,136083916,136111860,protein_coding,1,27944,chr5_136083916_136111860
Rasal1,5,120648812,120679597,protein_coding,1,30785,chr5_120648812_120679597
Rasal2,1,157135182,157412595,protein_coding,-1,277413,chr1_157135182_157412595
Rasal3,17,32390659,32403583,protein_coding,-1,12924,chr17_32390659_32403583
Rasd1,11,59963181,59964944,protein_coding,-1,1763,chr11_59963181_59964944
Rasd2,8,75213944,75224113,protein_coding,1,10169,chr8_75213944_75224113
Rasef,4,73714579,73790994,protein_coding,-1,76415,chr4_73714579_73790994
Rasgef1a,6,118011438,118091546,protein_coding,1,80108,chr6_118011438_118091546
Rasgef1b,5,99217426,99729065,protein_coding,-1,511639,chr5_99217426_99729065
Rasgef1c,11,49901835,49980994,protein_coding,1,79159,chr11_49901835_49980994
Rasgrf1,9,89909908,90026977,protein_coding,1,117069,chr9_89909908_90026977
Rasgrf2,13,91880400,92131656,protein_coding,-1,251256,chr13_91880400_92131656
Rasgrp1,2,117279993,117343001,protein_coding,-1,63008,chr2_117279993_117343001
Rasgrp2,19,6399340,6415216,protein_coding,1,15876,chr19_6399340_6415216
Rasgrp3,17,75435896,75529054,protein_coding,1,93158,chr17_75435896_75529054
Rasgrp4,7,29134851,29153961,protein_coding,1,19110,chr7_29134851_29153961
Rasip1,7,45627488,45639093,protein_coding,1,11605,chr7_45627488_45639093
Rasl10a,11,5058128,5060385,protein_coding,1,2257,chr11_5058128_5060385
Rasl10b,11,83409137,83421039,protein_coding,1,11902,chr11_83409137_83421039
Rasl11a,5,146845071,146847726,protein_coding,1,2655,chr5_146845071_146847726
Rasl11b,5,74195286,74199481,protein_coding,1,4195,chr5_74195286_74199481
Rasl12,9,65398506,65414853,protein_coding,1,16347,chr9_65398506_65414853
Rasl2-9,7,5124938,5125950,protein_coding,-1,1012,chr7_5124938_5125950
Rassf1,9,107551555,107562267,protein_coding,1,10712,chr9_107551555_107562267
Rassf10,7,112953962,112957457,protein_coding,1,3495,chr7_112953962_112957457
Rassf2,2,131989415,132030258,protein_coding,-1,40843,chr2_131989415_132030258
Rassf3,10,121410350,121476347,protein_coding,-1,65997,chr10_121410350_121476347
Rassf4,6,116633008,116673952,protein_coding,-1,40944,chr6_116633008_116673952
Rassf5,1,131176410,131245258,protein_coding,-1,68848,chr1_131176410_131245258
Rassf6,5,90603076,90640657,protein_coding,-1,37581,chr5_90603076_90640657
Rassf7,7,141215860,141218658,protein_coding,1,2798,chr7_141215860_141218658
Rassf8,6,145746748,145821079,protein_coding,1,74331,chr6_145746748_145821079
Rassf9,10,102512222,102549736,protein_coding,1,37514,chr10_102512222_102549736
Raver1,9,21074158,21092008,protein_coding,-1,17850,chr9_21074158_21092008
Raver2,4,101068983,101152370,protein_coding,1,83387,chr4_101068983_101152370
Rb1,14,73183673,73325822,protein_coding,-1,142149,chr14_73183673_73325822
Rb1cc1,1,6206197,6276648,protein_coding,1,70451,chr1_6206197_6276648
Rbak,5,143172186,143180775,protein_coding,-1,8589,chr5_143172186_143180775
Rbbp4,4,129307100,129335370,protein_coding,-1,28270,chr4_129307100_129335370
Rbbp5,1,132477365,132505659,protein_coding,1,28294,chr1_132477365_132505659
Rbbp6,7,122965686,123002557,protein_coding,1,36871,chr7_122965686_123002557
Rbbp7,X,162760402,162779092,protein_coding,1,18690,chrX_162760402_162779092
Rbbp8,18,11633276,11745221,protein_coding,1,111945,chr18_11633276_11745221
Rbbp9,2,144542265,144550869,protein_coding,-1,8604,chr2_144542265_144550869
Rbck1,2,152316334,152332653,protein_coding,-1,16319,chr2_152316334_152332653
Rbfa,18,80192265,80200658,protein_coding,-1,8393,chr18_80192265_80200658
Rbfox1,16,5885355,7411526,protein_coding,1,1526171,chr16_5885355_7411526
Rbfox2,15,77078990,77307004,protein_coding,-1,228014,chr15_77078990_77307004
Rbfox3,11,118489762,118911597,protein_coding,-1,421835,chr11_118489762_118911597
Rbks,5,31624439,31697627,protein_coding,-1,73188,chr5_31624439_31697627
Rbl1,2,157145893,157204534,protein_coding,-1,58641,chr2_157145893_157204534
Rbl2,8,91070057,91123844,protein_coding,1,53787,chr8_91070057_91123844
Rbm10,X,20617503,20650901,protein_coding,1,33398,chrX_20617503_20650901
Rbm11,16,75592844,75602829,protein_coding,1,9985,chr16_75592844_75602829
Rbm12,2,156091958,156111978,protein_coding,-1,20020,chr2_156091958_156111978
Rbm12b1,4,12140264,12146731,protein_coding,1,6467,chr4_12140264_12146731
Rbm12b2,4,12089439,12096243,protein_coding,1,6804,chr4_12089439_12096243
Rbm14,19,4800569,4811634,protein_coding,-1,11065,chr19_4800569_4811634
Rbm15,3,107325421,107333673,protein_coding,-1,8252,chr3_107325421_107333673
Rbm15b,9,106880918,106887428,protein_coding,-1,6510,chr9_106880918_106887428
Rbm17,2,11585437,11604153,protein_coding,-1,18716,chr2_11585437_11604153
Rbm18,2,36116079,36136773,protein_coding,-1,20694,chr2_36116079_36136773
Rbm19,5,120116465,120198981,protein_coding,1,82516,chr5_120116465_120198981
Rbm20,19,53677306,53867080,protein_coding,1,189774,chr19_53677306_53867080
Rbm22,18,60560736,60572810,protein_coding,1,12074,chr18_60560736_60572810
Rbm24,13,46418434,46431095,protein_coding,1,12661,chr13_46418434_46431095
Rbm25,12,83631236,83683123,protein_coding,1,51887,chr12_83631236_83683123
Rbm26,14,105106751,105177327,protein_coding,-1,70576,chr14_105106751_105177327
Rbm27,18,42275353,42341542,protein_coding,1,66189,chr18_42275353_42341542
Rbm28,6,29123576,29165006,protein_coding,-1,41430,chr6_29123576_29165006
Rbm3,X,8138975,8145880,protein_coding,-1,6905,chrX_8138975_8145880
Rbm33,5,28317121,28419239,protein_coding,1,102118,chr5_28317121_28419239
Rbm34,8,126947172,126971071,protein_coding,-1,23899,chr8_126947172_126971071
Rbm38,2,173020498,173034734,protein_coding,1,14236,chr2_173020498_173034734
Rbm39,2,156147239,156180238,protein_coding,-1,32999,chr2_156147239_156180238
Rbm3os,X,8145429,8147964,antisense,1,2535,chrX_8145429_8147964
Rbm4,19,4784293,4793901,protein_coding,-1,9608,chr19_4784293_4793901
Rbm41,X,139889511,139998595,protein_coding,-1,109084,chrX_139889511_139998595
Rbm42,7,30640999,30650317,protein_coding,-1,9318,chr7_30640999_30650317
Rbm43,2,51924448,51935163,protein_coding,-1,10715,chr2_51924448_51935163
Rbm44,1,91145089,91170795,protein_coding,1,25706,chr1_91145089_91170795
Rbm45,2,76369984,76383768,protein_coding,1,13784,chr2_76369984_76383768
Rbm46,3,82837228,82876483,protein_coding,-1,39255,chr3_82837228_82876483
Rbm47,5,66016549,66173118,protein_coding,-1,156569,chr5_66016549_66173118
Rbm48,5,3583978,3596585,protein_coding,-1,12607,chr5_3583978_3596585
Rbm4b,19,4756497,4767065,protein_coding,1,10568,chr19_4756497_4767065
Rbm5,9,107740371,107770996,protein_coding,-1,30625,chr9_107740371_107770996
Rbm6,9,107773559,107873237,protein_coding,-1,99678,chr9_107773559_107873237
Rbm6-ps1,1,17397412,17400281,processed_pseudogene,-1,2869,chr1_17397412_17400281
Rbm6-ps2,1,144221979,144223650,processed_pseudogene,-1,1671,chr1_144221979_144223650
Rbm7,9,48488701,48495299,protein_coding,-1,6598,chr9_48488701_48495299
Rbm8a,3,96629933,96633791,protein_coding,1,3858,chr3_96629933_96633791
Rbms1,2,60750193,60963192,protein_coding,-1,212999,chr2_60750193_60963192
Rbms2,10,128131558,128180297,protein_coding,-1,48739,chr10_128131558_128180297
Rbms3,9,116572746,117872681,protein_coding,-1,1299935,chr9_116572746_117872681
Rbmx,X,57383530,57393036,protein_coding,-1,9506,chrX_57383530_57393036
Rbmx2,X,48695004,48710723,protein_coding,1,15719,chrX_48695004_48710723
Rbmx2-ps,2,142576928,142577857,processed_pseudogene,1,929,chr2_142576928_142577857
Rbmxl1,8,78505269,78508898,protein_coding,-1,3629,chr8_78505269_78508898
Rbp1,9,98422961,98446575,protein_coding,1,23614,chr9_98422961_98446575
Rbp4,19,38116629,38125281,protein_coding,-1,8652,chr19_38116629_38125281
Rbp7,4,149449687,149454978,protein_coding,-1,5291,chr4_149449687_149454978
Rbpj,5,53466152,53657362,protein_coding,1,191210,chr5_53466152_53657362
Rbpjl,2,164403141,164415448,protein_coding,1,12307,chr2_164403141_164415448
Rbpms,8,33782643,33929863,protein_coding,-1,147220,chr8_33782643_33929863
Rbpms2,9,65629648,65660528,protein_coding,1,30880,chr9_65629648_65660528
Rbsn,6,92186712,92214925,protein_coding,-1,28213,chr6_92186712_92214925
Rbx1,15,81466296,81476369,protein_coding,1,10073,chr15_81466296_81476369
Rc3h1,1,160906418,160974978,protein_coding,1,68560,chr1_160906418_160974978
Rc3h2,2,37370069,37422903,protein_coding,-1,52834,chr2_37370069_37422903
Rcan1,16,92391953,92470867,protein_coding,-1,78914,chr16_92391953_92470867
Rcan2,17,43801351,44039516,protein_coding,1,238165,chr17_43801351_44039516
Rcan3,4,135412308,135433853,protein_coding,-1,21545,chr4_135412308_135433853
Rcbtb1,14,59201209,59237265,protein_coding,1,36056,chr14_59201209_59237265
Rcbtb2,14,73123037,73207843,protein_coding,1,84806,chr14_73123037_73207843
Rcc1,4,132331919,132353605,protein_coding,-1,21686,chr4_132331919_132353605
Rcc2,4,140700541,140723220,protein_coding,1,22679,chr4_140700541_140723220
Rccd1,7,80293229,80324454,protein_coding,-1,31225,chr7_80293229_80324454
Rce1,19,4622591,4625641,protein_coding,-1,3050,chr19_4622591_4625641
Rchy1,5,91948904,91963068,protein_coding,-1,14164,chr5_91948904_91963068
Rcl1,19,29101375,29143929,protein_coding,1,42554,chr19_29101375_29143929
Rcn1,2,105386291,105399319,protein_coding,-1,13028,chr2_105386291_105399319
Rcn2,9,56041845,56061882,protein_coding,1,20037,chr9_56041845_56061882
Rcn3,7,45082913,45092221,protein_coding,-1,9308,chr7_45082913_45092221
Rcor1,12,111039351,111115901,protein_coding,1,76550,chr12_111039351_111115901
Rcor2,19,7267325,7275225,protein_coding,1,7900,chr19_7267325_7275225
Rcor3,1,192050849,192138062,protein_coding,-1,87213,chr1_192050849_192138062
Rcsd1,1,165646516,165709757,protein_coding,-1,63241,chr1_165646516_165709757
Rcvrn,11,67695326,67703333,protein_coding,1,8007,chr11_67695326_67703333
Rd3,1,191977219,191988283,protein_coding,1,11064,chr1_191977219_191988283
Rdh1,10,127759721,127768297,protein_coding,1,8576,chr10_127759721_127768297
Rdh10,1,16105774,16133734,protein_coding,1,27960,chr1_16105774_16133734
Rdh11,12,79174337,79192293,protein_coding,-1,17956,chr12_79174337_79192293
Rdh12,12,79208914,79222665,protein_coding,1,13751,chr12_79208914_79222665
Rdh13,7,4424770,4445649,protein_coding,-1,20879,chr7_4424770_4445649
Rdh14,12,10390772,10395562,protein_coding,1,4790,chr12_10390772_10395562
Rdh16,10,127801152,127846565,protein_coding,1,45413,chr10_127801152_127846565
Rdh18-ps,10,127824284,127843938,transcribed_unprocessed_pseudogene,1,19654,chr10_127824284_127843938
Rdh5,10,128913593,128922888,protein_coding,-1,9295,chr10_128913593_128922888
Rdh9,10,127776386,127792697,protein_coding,1,16311,chr10_127776386_127792697
Rdm1,11,101627195,101636100,protein_coding,1,8905,chr11_101627195_101636100
Rdx,9,52047173,52100463,protein_coding,1,53290,chr9_52047173_52100463
Rec114,9,58652850,58743964,protein_coding,-1,91114,chr9_58652850_58743964
Rec8,14,55618037,55625395,protein_coding,1,7358,chr14_55618037_55625395
Reck,4,43875530,43944806,protein_coding,1,69276,chr4_43875530_43944806
Recql,6,142350342,142387087,protein_coding,-1,36745,chr6_142350342_142387087
Recql4,15,76703553,76710548,protein_coding,-1,6995,chr15_76703553_76710548
Recql5,11,115892595,115933477,protein_coding,-1,40882,chr11_115892595_115933477
Redrum,18,54422295,54453294,lincRNA,1,30999,chr18_54422295_54453294
Reep1,6,71707561,71810710,protein_coding,1,103149,chr6_71707561_71810710
Reep2,18,34840589,34847463,protein_coding,1,6874,chr18_34840589_34847463
Reep3,10,67009189,67096945,protein_coding,-1,87756,chr10_67009189_67096945
Reep4,14,70545251,70548933,protein_coding,1,3682,chr14_70545251_70548933
Reep5,18,34344885,34374070,protein_coding,-1,29185,chr18_34344885_34374070
Reep6,10,80329953,80336441,protein_coding,1,6488,chr10_80329953_80336441
Reg3g,6,78466269,78468872,protein_coding,-1,2603,chr6_78466269_78468872
Rel,11,23736847,23770970,protein_coding,-1,34123,chr11_23736847_23770970
Rela,19,5637483,5648130,protein_coding,1,10647,chr19_5637483_5648130
Relb,7,19606217,19629438,protein_coding,-1,23221,chr7_19606217_19629438
Rell1,5,63908897,63968897,protein_coding,-1,60000,chr5_63908897_63968897
Rell2,18,37955079,37959179,protein_coding,1,4100,chr18_37955079_37959179
Reln,5,21884454,22344702,protein_coding,-1,460248,chr5_21884454_22344702
Relt,7,100845847,100863446,protein_coding,-1,17599,chr7_100845847_100863446
Rem1,2,152626951,152635198,protein_coding,1,8247,chr2_152626951_152635198
Rem2,14,54476100,54480431,protein_coding,1,4331,chr14_54476100_54480431
Renbp,X,73922121,73930850,protein_coding,-1,8729,chrX_73922121_73930850
Rep15,6,147032584,147034245,protein_coding,1,1661,chr6_147032584_147034245
Repin1,6,48593883,48599082,protein_coding,1,5199,chr6_48593883_48599082
Reps1,10,18055861,18125155,protein_coding,1,69294,chr10_18055861_18125155
Reps2,X,162411954,162643649,protein_coding,-1,231695,chrX_162411954_162643649
Rer1,4,155074110,155086382,protein_coding,-1,12272,chr4_155074110_155086382
Rere,4,150281646,150621966,protein_coding,1,340320,chr4_150281646_150621966
Rerg,6,137054825,137170497,protein_coding,-1,115672,chr6_137054825_137170497
Resp18,1,75272199,75278415,protein_coding,-1,6216,chr1_75272199_75278415
Rest,5,77265491,77286432,protein_coding,1,20941,chr5_77265491_77286432
Ret,6,118151745,118197718,protein_coding,-1,45973,chr6_118151745_118197718
Retn,8,3655770,3660110,protein_coding,1,4340,chr8_3655770_3660110
Retnla,16,48842551,48844461,protein_coding,1,1910,chr16_48842551_48844461
Retnlg,16,48872621,48874496,protein_coding,1,1875,chr16_48872621_48874496
Retsat,6,72598475,72608425,protein_coding,1,9950,chr6_72598475_72608425
Rev1,1,38052786,38129801,protein_coding,-1,77015,chr1_38052786_38129801
Rev3l,10,39732118,39875211,protein_coding,1,143093,chr10_39732118_39875211
Rex2,4,147021850,147060794,protein_coding,1,38944,chr4_147021850_147060794
Rexo1,10,80540922,80561560,protein_coding,-1,20638,chr10_80540922_80561560
Rexo2,9,48468512,48480623,protein_coding,-1,12111,chr9_48468512_48480623
Rexo4,2,26953563,26964386,protein_coding,-1,10823,chr2_26953563_26964386
Rfc1,5,65261850,65335670,protein_coding,-1,73820,chr5_65261850_65335670
Rfc2,5,134581366,134601805,protein_coding,1,20439,chr5_134581366_134601805
Rfc3,5,151642756,151651242,protein_coding,-1,8486,chr5_151642756_151651242
Rfc4,16,23113943,23127737,protein_coding,-1,13794,chr16_23113943_23127737
Rfc5,5,117378103,117389047,protein_coding,-1,10944,chr5_117378103_117389047
Rfesd,13,76001535,76018719,protein_coding,-1,17184,chr13_76001535_76018719
Rffl,11,82802449,82871210,protein_coding,-1,68761,chr11_82802449_82871210
Rfk,19,17394043,17401349,protein_coding,1,7306,chr19_17394043_17401349
Rfng,11,120780746,120784207,protein_coding,-1,3461,chr11_120780746_120784207
Rfpl4,7,5109787,5116950,protein_coding,-1,7163,chr7_5109787_5116950
Rft1,14,30654360,30691317,protein_coding,1,36957,chr14_30654360_30691317
Rftn1,17,49992257,50190674,protein_coding,-1,198417,chr17_49992257_50190674
Rftn2,1,55170159,55226782,protein_coding,-1,56623,chr1_55170159_55226782
Rfwd3,8,111270944,111300222,protein_coding,-1,29278,chr8_111270944_111300222
Rfx1,8,84066834,84096992,protein_coding,1,30158,chr8_84066834_84096992
Rfx2,17,56775897,56831013,protein_coding,-1,55116,chr17_56775897_56831013
Rfx3,19,27761721,28011166,protein_coding,-1,249445,chr19_27761721_28011166
Rfx4,10,84756062,84906538,protein_coding,1,150476,chr10_84756062_84906538
Rfx5,3,94954075,94961561,protein_coding,1,7486,chr3_94954075_94961561
Rfx6,10,51677756,51730432,protein_coding,1,52676,chr10_51677756_51730432
Rfx7,9,72532240,72622937,protein_coding,1,90697,chr9_72532240_72622937
Rfx8,1,39665301,39720997,protein_coding,-1,55696,chr1_39665301_39720997
Rfxank,8,70130794,70139154,protein_coding,-1,8360,chr8_70130794_70139154
Rfxap,3,54803115,54807791,protein_coding,-1,4676,chr3_54803115_54807791
Rgcc,14,79288756,79301645,protein_coding,-1,12889,chr14_79288756_79301645
Rgl1,1,152516760,152766351,protein_coding,-1,249591,chr1_152516760_152766351
Rgl2,17,33929543,33937687,protein_coding,1,8144,chr17_33929543_33937687
Rgl3,9,21968711,21989446,protein_coding,-1,20735,chr9_21968711_21989446
Rgma,7,73375509,73419899,protein_coding,1,44390,chr7_73375509_73419899
Rgmb,17,15803188,15831039,protein_coding,-1,27851,chr17_15803188_15831039
Rgn,X,20549787,20562089,protein_coding,1,12302,chrX_20549787_20562089
Rgp1,4,43578715,43587487,protein_coding,1,8772,chr4_43578715_43587487
Rgr,14,37034909,37048964,protein_coding,-1,14055,chr14_37034909_37048964
Rgs1,1,144242296,144249242,protein_coding,-1,6946,chr1_144242296_144249242
Rgs10,7,128373621,128418758,protein_coding,-1,45137,chr7_128373621_128418758
Rgs11,17,26202951,26211324,protein_coding,1,8373,chr17_26202951_26211324
Rgs12,5,34949445,35039644,protein_coding,1,90199,chr5_34949445_35039644
Rgs13,1,144138654,144177372,protein_coding,-1,38718,chr1_144138654_144177372
Rgs14,13,55369732,55384687,protein_coding,1,14955,chr13_55369732_55384687
Rgs16,1,153740349,153745468,protein_coding,1,5119,chr1_153740349_153745468
Rgs17,10,5825663,5922400,protein_coding,-1,96737,chr10_5825663_5922400
Rgs19,2,181688419,181693977,protein_coding,-1,5558,chr2_181688419_181693977
Rgs2,1,143999338,144004161,protein_coding,-1,4823,chr1_143999338_144004161
Rgs20,1,4909576,5070285,protein_coding,-1,160709,chr1_4909576_5070285
Rgs22,15,36009479,36140400,protein_coding,-1,130921,chr15_36009479_36140400
Rgs3,4,62559847,62704001,protein_coding,1,144154,chr4_62559847_62704001
Rgs4,1,169741477,169747642,protein_coding,-1,6165,chr1_169741477_169747642
Rgs5,1,169655501,169695813,protein_coding,1,40312,chr1_169655501_169695813
Rgs6,12,82588292,83162056,protein_coding,1,573764,chr12_82588292_83162056
Rgs7,1,175059087,175492500,protein_coding,-1,433413,chr1_175059087_175492500
Rgs7bp,13,104945904,105054930,protein_coding,-1,109026,chr13_104945904_105054930
Rgs8,1,153653025,153700323,protein_coding,1,47298,chr1_153653025_153700323
Rgs9,11,109225355,109298129,protein_coding,-1,72774,chr11_109225355_109298129
Rgs9bp,7,35578993,35585582,protein_coding,-1,6589,chr7_35578993_35585582
Rgsl1,1,153779381,153844142,protein_coding,-1,64761,chr1_153779381_153844142
Rhag,17,40811126,40840754,protein_coding,1,29628,chr17_40811126_40840754
Rhbdd1,1,82316452,82445366,protein_coding,1,128914,chr1_82316452_82445366
Rhbdd2,5,135632618,135646448,protein_coding,1,13830,chr5_135632618_135646448
Rhbdd3,11,5098926,5106093,protein_coding,1,7167,chr11_5098926_5106093
Rhbdf1,11,32209585,32222300,protein_coding,-1,12715,chr11_32209585_32222300
Rhbdf2,11,116598165,116627019,protein_coding,-1,28854,chr11_116598165_116627019
Rhbdl1,17,25834465,25837295,protein_coding,-1,2830,chr17_25834465_25837295
Rhbdl2,4,123787874,123829904,protein_coding,1,42030,chr4_123787874_123829904
Rhbdl3,11,80300912,80355955,protein_coding,1,55043,chr11_80300912_80355955
Rhcg,7,79593363,79617657,protein_coding,-1,24294,chr7_79593363_79617657
Rhd,4,134864536,134896172,protein_coding,1,31636,chr4_134864536_134896172
Rheb,5,24802823,24842624,protein_coding,-1,39801,chr5_24802823_24842624
Rhebl1,15,98877778,98894540,protein_coding,-1,16762,chr15_98877778_98894540
Rhno1,6,128357000,128362911,protein_coding,-1,5911,chr6_128357000_128362911
Rho,6,115931748,115940036,protein_coding,1,8288,chr6_115931748_115940036
Rhoa,9,108306129,108337934,protein_coding,1,31805,chr9_108306129_108337934
Rhoay-ps3,Y,873640,874215,processed_pseudogene,1,575,chrY_873640_874215
Rhob,12,8497661,8500009,protein_coding,-1,2348,chr12_8497661_8500009
Rhobtb1,10,69151434,69291791,protein_coding,1,140357,chr10_69151434_69291791
Rhobtb2,14,69784990,69805636,protein_coding,-1,20646,chr14_69784990_69805636
Rhobtb3,13,75869537,75943925,protein_coding,-1,74388,chr13_75869537_75943925
Rhoc,3,104788375,104794459,protein_coding,1,6084,chr3_104788375_104794459
Rhod,19,4425459,4439432,protein_coding,-1,13973,chr19_4425459_4439432
Rhof,5,123103044,123132692,protein_coding,-1,29648,chr5_123103044_123132692
Rhog,7,102239123,102256054,protein_coding,-1,16931,chr7_102239123_102256054
Rhoh,5,65861213,65896700,protein_coding,1,35487,chr5_65861213_65896700
Rhoj,12,75308322,75401456,protein_coding,1,93134,chr12_75308322_75401456
Rhoq,17,86963082,87000069,protein_coding,1,36987,chr17_86963082_87000069
Rhot1,11,80209019,80267907,protein_coding,1,58888,chr11_80209019_80267907
Rhot2,17,25838457,25844851,protein_coding,-1,6394,chr17_25838457_25844851
Rhou,8,123653929,123663884,protein_coding,1,9955,chr8_123653929_123663884
Rhov,2,119269201,119271272,protein_coding,-1,2071,chr2_119269201_119271272
Rhox8,X,37782002,37878944,protein_coding,-1,96942,chrX_37782002_37878944
Rhpn1,15,75704280,75715485,protein_coding,1,11205,chr15_75704280_75715485
Rhpn2,7,35334170,35392289,protein_coding,1,58119,chr7_35334170_35392289
Rian,CHR_MG4180_PATCH,109603808,109662224,lncRNA;processed_transcript,1,58416,chrCHR_MG4180_PATCH_109603808_109662224
Ribc1,X,152004582,152016295,protein_coding,-1,11713,chrX_152004582_152016295
Ribc2,15,85132078,85144570,protein_coding,1,12492,chr15_85132078_85144570
Ric1,19,29522282,29606829,protein_coding,1,84547,chr19_29522282_29606829
Ric3,7,109034312,109083331,protein_coding,-1,49019,chr7_109034312_109083331
Ric8b,10,84917616,85018337,protein_coding,1,100721,chr10_84917616_85018337
Rictor,15,6708379,6800401,protein_coding,1,92022,chr15_6708379_6800401
Rif1,2,52072832,52122383,protein_coding,1,49551,chr2_52072832_52122383
Riiad1,3,94464983,94480341,protein_coding,-1,15358,chr3_94464983_94480341
Rilp,11,75510094,75513168,protein_coding,1,3074,chr11_75510094_75513168
Rilpl1,5,124493080,124531391,protein_coding,-1,38311,chr5_124493080_124531391
Rilpl2,5,124463265,124478366,protein_coding,-1,15101,chr5_124463265_124478366
Rimbp2,5,128757791,128953486,protein_coding,-1,195695,chr5_128757791_128953486
Rimbp3,16,17208603,17213982,protein_coding,1,5379,chr16_17208603_17213982
Rimkla,4,119465283,119492628,protein_coding,-1,27345,chr4_119465283_119492628
Rimklb,6,122447296,122498761,protein_coding,-1,51465,chr6_122447296_122498761
Rims1,1,22286251,22805994,protein_coding,-1,519743,chr1_22286251_22805994
Rims2,15,39198261,39684372,protein_coding,1,486111,chr15_39198261_39684372
Rims3,4,120854816,120896579,protein_coding,1,41763,chr4_120854816_120896579
Rims4,2,163859751,163918683,protein_coding,-1,58932,chr2_163859751_163918683
Rin1,19,5050481,5057071,protein_coding,1,6590,chr19_5050481_5057071
Rin2,2,145675215,145887616,protein_coding,1,212401,chr2_145675215_145887616
Rin3,12,102283048,102390855,protein_coding,1,107807,chr12_102283048_102390855
Ring1,17,34020792,34024680,protein_coding,-1,3888,chr17_34020792_34024680
Rinl,7,28788969,28798963,protein_coding,1,9994,chr7_28788969_28798963
Rint1,5,23787711,23820369,protein_coding,1,32658,chr5_23787711_23820369
Riok1,13,38036995,38061433,protein_coding,1,24438,chr13_38036995_38061433
Riok2,17,17374309,17394899,protein_coding,1,20590,chr17_17374309_17394899
Riok3,18,12128741,12157387,protein_coding,1,28646,chr18_12128741_12157387
Ripk1,13,34002363,34037147,protein_coding,1,34784,chr13_34002363_34037147
Ripk2,4,16122733,16163647,protein_coding,-1,40914,chr4_16122733_16163647
Ripk3,14,55784995,55788865,protein_coding,-1,3870,chr14_55784995_55788865
Ripk4,16,97741933,97763787,protein_coding,-1,21854,chr16_97741933_97763787
Ripply2,9,87015537,87019917,protein_coding,1,4380,chr9_87015537_87019917
Ripply3,16,94328420,94336935,protein_coding,1,8515,chr16_94328420_94336935
Rit1,3,88716838,88731049,protein_coding,1,14211,chr3_88716838_88731049
Rit2,18,30973489,31317290,protein_coding,-1,343801,chr18_30973489_31317290
Rita1,5,120594305,120612589,protein_coding,-1,18284,chr5_120594305_120612589
Rlbp1,7,79374870,79387048,protein_coding,-1,12178,chr7_79374870_79387048
Rlf,4,121145373,121215084,protein_coding,-1,69711,chr4_121145373_121215084
Rlim,X,103957163,103981284,protein_coding,-1,24121,chrX_103957163_103981284
Rln1,19,29331170,29334670,protein_coding,-1,3500,chr19_29331170_29334670
Rln3,8,84042929,84045000,protein_coding,-1,2071,chr8_84042929_84045000
Rmdn1,4,19575162,19606932,protein_coding,1,31770,chr4_19575162_19606932
Rmdn2,17,79611863,79693192,protein_coding,1,81329,chr17_79611863_79693192
Rmdn3,2,119137001,119157034,protein_coding,-1,20033,chr2_119137001_119157034
Rmi1,13,58402248,58411148,protein_coding,1,8900,chr13_58402248_58411148
Rmi2,16,10835059,10892966,protein_coding,1,57907,chr16_10835059_10892966
Rmnd1,10,4401915,4432388,protein_coding,-1,30473,chr10_4401915_4432388
Rmnd5a,6,71388634,71440637,protein_coding,-1,52003,chr6_71388634_71440637
Rmnd5b,11,51623671,51635896,protein_coding,-1,12225,chr11_51623671_51635896
Rmrp,4,43492783,43493063,lincRNA;ribozyme,-1,280,chr4_43492783_43493063
Rmst,10,92071037,92165170,lincRNA,-1,94133,chr10_92071037_92165170
Rn7s1,12,69159295,69159594,misc_RNA,1,299,chr12_69159295_69159594
Rn7s2,12,69361182,69361481,misc_RNA,-1,299,chr12_69361182_69361481
Rn7sk,9,78175303,78175633,misc_RNA,-1,330,chr9_78175303_78175633
Rnase10,14,51007751,51010758,protein_coding,1,3007,chr14_51007751_51010758
Rnase13,14,51921362,51922773,protein_coding,-1,1411,chr14_51921362_51922773
Rnase4,14,51091077,51106151,protein_coding,1,15074,chr14_51091077_51106151
Rnaseh1,12,28649602,28659589,protein_coding,1,9987,chr12_28649602_28659589
Rnaseh2a,8,84956610,84969767,protein_coding,-1,13157,chr8_84956610_84969767
Rnaseh2b,14,62292589,62372992,protein_coding,1,80403,chr14_62292589_62372992
Rnaseh2c,19,5601873,5607019,protein_coding,1,5146,chr19_5601873_5607019
Rnasek,11,70238124,70239842,protein_coding,-1,1718,chr11_70238124_70239842
Rnasel,1,153749426,153764221,protein_coding,1,14795,chr1_153749426_153764221
Rnaset2a,17,8115445,8148097,protein_coding,-1,32652,chr17_8115445_8148097
Rnaset2b,17,6970634,7011299,protein_coding,1,40665,chr17_6970634_7011299
Rnd1,15,98663421,98677461,protein_coding,-1,14040,chr15_98663421_98677461
Rnd2,11,101464999,101471853,protein_coding,1,6854,chr11_101464999_101471853
Rnd3,2,51130438,51149111,protein_coding,-1,18673,chr2_51130438_51149111
Rnf10,5,115241412,115272898,protein_coding,-1,31486,chr5_115241412_115272898
Rnf103,6,71493894,71510881,protein_coding,1,16987,chr6_71493894_71510881
Rnf11,4,109451098,109484728,protein_coding,-1,33630,chr4_109451098_109484728
Rnf111,9,70425424,70503725,protein_coding,-1,78301,chr9_70425424_70503725
Rnf112,11,61448442,61454131,protein_coding,-1,5689,chr11_61448442_61454131
Rnf113a1,X,37191245,37192467,protein_coding,1,1222,chrX_37191245_37192467
Rnf113a2,12,84417196,84418578,protein_coding,1,1382,chr12_84417196_84418578
Rnf114,2,167492645,167516173,protein_coding,1,23528,chr2_167492645_167516173
Rnf115,3,96727664,96791638,protein_coding,1,63974,chr3_96727664_96791638
Rnf121,7,102019137,102065469,protein_coding,-1,46332,chr7_102019137_102065469
Rnf122,8,31111820,31131482,protein_coding,1,19662,chr8_31111820_31131482
Rnf123,9,108051534,108083346,protein_coding,-1,31812,chr9_108051534_108083346
Rnf125,18,20944625,20983862,protein_coding,1,39237,chr18_20944625_20983862
Rnf126,10,79758515,79766952,protein_coding,-1,8437,chr10_79758515_79766952
Rnf128,X,139563316,139673145,protein_coding,1,109829,chrX_139563316_139673145
Rnf13,3,57736062,57835233,protein_coding,1,99171,chr3_57736062_57835233
Rnf130,11,50025346,50125719,protein_coding,1,100373,chr11_50025346_50125719
Rnf133,6,23648869,23650305,protein_coding,-1,1436,chr6_23648869_23650305
Rnf135,11,80183851,80199757,protein_coding,1,15906,chr11_80183851_80199757
Rnf138,18,21001341,21028224,protein_coding,1,26883,chr18_21001341_21028224
Rnf138rt1,X,163760139,163761329,protein_coding,-1,1190,chrX_163760139_163761329
Rnf139,15,58889229,58907057,protein_coding,1,17828,chr15_58889229_58907057
Rnf14,18,38284537,38317849,protein_coding,1,33312,chr18_38284537_38317849
Rnf141,7,110800432,110844457,protein_coding,-1,44025,chr7_110800432_110844457
Rnf144a,12,26300964,26415254,protein_coding,-1,114290,chr12_26300964_26415254
Rnf144b,13,47122656,47247991,protein_coding,1,125335,chr13_47122656_47247991
Rnf145,11,44518964,44565520,protein_coding,1,46556,chr11_44518964_44565520
Rnf146,10,29344176,29362442,protein_coding,-1,18266,chr10_29344176_29362442
Rnf149,1,39551296,39577405,protein_coding,-1,26109,chr1_39551296_39577405
Rnf150,8,82863356,83091268,protein_coding,1,227912,chr8_82863356_83091268
Rnf151,17,24715839,24718063,protein_coding,-1,2224,chr17_24715839_24718063
Rnf152,1,105276914,105356710,protein_coding,-1,79796,chr1_105276914_105356710
Rnf157,11,116336353,116413032,protein_coding,-1,76679,chr11_116336353_116413032
Rnf165,18,77456110,77565161,protein_coding,-1,109051,chr18_77456110_77565161
Rnf166,8,122466147,122476064,protein_coding,-1,9917,chr8_122466147_122476064
Rnf167,11,70647235,70651421,protein_coding,1,4186,chr11_70647235_70651421
Rnf168,16,32277459,32301434,protein_coding,1,23975,chr16_32277459_32301434
Rnf169,7,99920254,99980448,protein_coding,-1,60194,chr7_99920254_99980448
Rnf17,14,56402581,56525032,protein_coding,1,122451,chr14_56402581_56525032
Rnf170,8,26119368,26151790,protein_coding,1,32422,chr8_26119368_26151790
Rnf170-ps,7,26072073,26072931,processed_pseudogene,1,858,chr7_26072073_26072931
Rnf180,13,105130001,105294815,protein_coding,-1,164814,chr13_105130001_105294815
Rnf181,6,72359713,72366956,protein_coding,-1,7243,chr6_72359713_72366956
Rnf182,13,43615710,43670945,protein_coding,1,55235,chr13_43615710_43670945
Rnf185,11,3415982,3452363,protein_coding,-1,36381,chr11_3415982_3452363
Rnf187,11,58932288,58938916,protein_coding,-1,6628,chr11_58932288_58938916
Rnf19a,15,36239933,36283147,protein_coding,-1,43214,chr15_36239933_36283147
Rnf19b,4,129058271,129085886,protein_coding,1,27615,chr4_129058271_129085886
Rnf2,1,151458004,151500955,protein_coding,-1,42951,chr1_151458004_151500955
Rnf20,4,49632006,49656887,protein_coding,1,24881,chr4_49632006_49656887
Rnf207,4,152307019,152318993,protein_coding,-1,11974,chr4_152307019_152318993
Rnf208,2,25242929,25244262,protein_coding,1,1333,chr2_25242929_25244262
Rnf212,5,108729290,108774982,protein_coding,-1,45692,chr5_108729290_108774982
Rnf212b,14,54814141,54854108,protein_coding,1,39967,chr14_54814141_54854108
Rnf213,11,119393100,119487418,protein_coding,1,94318,chr11_119393100_119487418
Rnf214,9,45863425,45906911,protein_coding,-1,43486,chr9_45863425_45906911
Rnf215,11,4135202,4141172,protein_coding,1,5970,chr11_4135202_4141172
Rnf216,5,142990893,143112994,protein_coding,-1,122101,chr5_142990893_143112994
Rnf217,10,31493193,31609184,protein_coding,-1,115991,chr10_31493193_31609184
Rnf219,14,104477536,104522645,protein_coding,-1,45109,chr14_104477536_104522645
Rnf220,4,117271463,117497052,protein_coding,-1,225589,chr4_117271463_117497052
Rnf222,11,68888553,68895777,protein_coding,1,7224,chr11_68888553_68895777
Rnf223,4,156130513,156133420,protein_coding,1,2907,chr4_156130513_156133420
Rnf24,2,131298064,131352892,protein_coding,-1,54828,chr2_131298064_131352892
Rnf25,1,74593748,74601397,protein_coding,-1,7649,chr1_74593748_74601397
Rnf26,9,44095631,44113517,protein_coding,-1,17886,chr9_44095631_44113517
Rnf31,14,55591708,55603693,protein_coding,1,11985,chr14_55591708_55603693
Rnf32,5,29195992,29228457,protein_coding,1,32465,chr5_29195992_29228457
Rnf34,5,122850048,122871291,protein_coding,1,21243,chr5_122850048_122871291
Rnf38,4,44126210,44233789,protein_coding,-1,107579,chr4_44126210_44233789
Rnf39,17,36942918,36947986,protein_coding,1,5068,chr17_36942918_36947986
Rnf4,5,34336289,34355629,protein_coding,1,19340,chr5_34336289_34355629
Rnf40,7,127588767,127604799,protein_coding,1,16032,chr7_127588767_127604799
Rnf41,10,128411657,128441441,protein_coding,1,29784,chr10_128411657_128441441
Rnf43,11,87662722,87735539,protein_coding,1,72817,chr11_87662722_87735539
Rnf44,13,54679399,54693907,protein_coding,-1,14508,chr13_54679399_54693907
Rnf5,17,34601091,34603690,protein_coding,-1,2599,chr17_34601091_34603690
Rnf6,5,146209192,146221555,protein_coding,-1,12363,chr5_146209192_146221555
Rnf7,9,96470937,96478675,protein_coding,-1,7738,chr9_96470937_96478675
Rnf8,17,29614790,29644991,protein_coding,1,30201,chr17_29614790_29644991
Rnft1,11,86484657,86499025,protein_coding,1,14368,chr11_86484657_86499025
Rnft2,5,118190736,118245116,protein_coding,-1,54380,chr5_118190736_118245116
Rngtt,4,33310311,33502614,protein_coding,1,192303,chr4_33310311_33502614
Rnh1,7,141160326,141172857,protein_coding,-1,12531,chr7_141160326_141172857
Rnls,19,33137747,33392295,polymorphic_pseudogene,-1,254548,chr19_33137747_33392295
Rnmt,18,68300355,68324852,protein_coding,1,24497,chr18_68300355_68324852
Rnpc3,3,113605067,113630149,protein_coding,-1,25082,chr3_113605067_113630149
Rnpep,1,135262712,135284084,protein_coding,-1,21372,chr1_135262712_135284084
Rnpepl1,1,92910783,92924384,protein_coding,1,13601,chr1_92910783_92924384
Rnps1,17,24414565,24425901,protein_coding,1,11336,chr17_24414565_24425901
Rnu11,4,132270080,132270213,snRNA,-1,133,chr4_132270080_132270213
Rnu12,15,83149644,83149794,snRNA,1,150,chr15_83149644_83149794
Rnu1a1,11,87422867,87423030,snRNA,1,163,chr11_87422867_87423030
Rnu2-10,11,101658238,101658428,snRNA,1,190,chr11_101658238_101658428
Rnu3a,10,40258467,40258680,snoRNA,1,213,chr10_40258467_40258680
Rnu3b2,11,87471368,87471583,snoRNA,1,215,chr11_87471368_87471583
Rnu3b3,11,87448627,87448842,snoRNA,1,215,chr11_87448627_87448842
Rnu3b4,11,87462286,87462501,snoRNA,1,215,chr11_87462286_87462501
Rnu5g,9,65201726,65201841,snRNA,-1,115,chr9_65201726_65201841
Rnu6,17,13432033,13432139,snRNA,-1,106,chr17_13432033_13432139
Rnu6-ps2,4,119528000,119528106,snRNA,1,106,chr4_119528000_119528106
Rnu7,6,124741225,124741286,snRNA,-1,61,chr6_124741225_124741286
Rnu73b,3,86140618,86140688,snoRNA,-1,70,chr3_86140618_86140688
Rny1,6,47788069,47788180,misc_RNA,-1,111,chr6_47788069_47788180
Rny3,6,47781624,47781725,misc_RNA,1,101,chr6_47781624_47781725
Robo1,16,72308306,73046095,protein_coding,1,737789,chr16_72308306_73046095
Robo2,16,73891839,74411825,protein_coding,-1,519986,chr16_73891839_74411825
Robo3,9,37415669,37433246,protein_coding,-1,17577,chr9_37415669_37433246
Robo4,9,37401897,37415115,protein_coding,1,13218,chr9_37401897_37415115
Rock1,18,10064401,10182045,protein_coding,-1,117644,chr18_10064401_10182045
Rock2,12,16894895,16987823,protein_coding,1,92928,chr12_16894895_16987823
Rogdi,16,5008730,5013553,protein_coding,-1,4823,chr16_5008730_5013553
Rom1,19,8927391,8929356,protein_coding,-1,1965,chr19_8927391_8929356
Romo1,2,156144039,156145797,protein_coding,1,1758,chr2_156144039_156145797
Ropn1,16,34649921,34678618,protein_coding,1,28697,chr16_34649921_34678618
Ropn1l,15,31441211,31453737,protein_coding,-1,12526,chr15_31441211_31453737
Ror1,4,100095791,100444765,protein_coding,1,348974,chr4_100095791_100444765
Ror2,13,53109312,53286124,protein_coding,-1,176812,chr13_53109312_53286124
Rora,9,68653786,69388246,protein_coding,1,734460,chr9_68653786_69388246
Rorb,19,18930605,19111196,protein_coding,-1,180591,chr19_18930605_19111196
Rorc,3,94372794,94398276,protein_coding,1,25482,chr3_94372794_94398276
Ros1,10,52045721,52195244,protein_coding,-1,149523,chr10_52045721_52195244
Rp1,1,3999557,4409241,protein_coding,-1,409684,chr1_3999557_4409241
Rp1l1,14,63992506,64035025,protein_coding,1,42519,chr14_63992506_64035025
Rp31-ps19,9,111071181,111071533,processed_pseudogene,-1,352,chr9_111071181_111071533
Rp9,9,22411047,22469743,protein_coding,-1,58696,chr9_22411047_22469743
Rpa1,11,75298166,75348324,protein_coding,-1,50158,chr11_75298166_75348324
Rpa2,4,132768332,132778752,protein_coding,1,10420,chr4_132768332_132778752
Rpa3,6,8255936,8259173,protein_coding,-1,3237,chr6_8255936_8259173
Rpain,11,70970213,70977833,protein_coding,1,7620,chr11_70970213_70977833
Rpap1,2,119763304,119787537,protein_coding,-1,24233,chr2_119763304_119787537
Rpap2,5,107597373,107661838,protein_coding,1,64465,chr5_107597373_107661838
Rpap3,15,97675097,97705825,protein_coding,-1,30728,chr15_97675097_97705825
Rpe,1,66700831,66719805,protein_coding,1,18974,chr1_66700831_66719805
Rpe65,3,159599175,159625321,protein_coding,1,26146,chr3_159599175_159625321
Rpf1,3,146505956,146521429,protein_coding,-1,15473,chr3_146505956_146521429
Rpf2,10,40223246,40247036,protein_coding,-1,23790,chr10_40223246_40247036
Rpgr,X,10073621,10216920,protein_coding,-1,143299,chrX_10073621_10216920
Rpgrip1,14,52110704,52163546,protein_coding,1,52842,chr14_52110704_52163546
Rpgrip1l,8,91217030,91313262,protein_coding,-1,96232,chr8_91217030_91313262
Rph3a,5,120940499,121010092,protein_coding,-1,69593,chr5_120940499_121010092
Rph3al,11,75830999,75938429,protein_coding,-1,107430,chr11_75830999_75938429
Rpia,6,70765720,70792232,protein_coding,-1,26512,chr6_70765720_70792232
Rpl10,X,74270812,74273135,protein_coding,1,2323,chrX_74270812_74273135
Rpl10-ps1,2,105554201,105554845,transcribed_processed_pseudogene,-1,644,chr2_105554201_105554845
Rpl10-ps2,8,106927769,106928413,processed_pseudogene,-1,644,chr8_106927769_106928413
Rpl10-ps3,9,50344201,50344968,protein_coding,-1,767,chr9_50344201_50344968
Rpl10-ps4,X,82400724,82401009,processed_pseudogene,-1,285,chrX_82400724_82401009
Rpl10-ps5,8,94222993,94223634,processed_pseudogene,1,641,chr8_94222993_94223634
Rpl10-ps6,19,37295155,37295796,processed_pseudogene,-1,641,chr19_37295155_37295796
Rpl10a,17,28328471,28331033,protein_coding,1,2562,chr17_28328471_28331033
Rpl10a-ps1,1,64993951,64994604,processed_pseudogene,-1,653,chr1_64993951_64994604
Rpl10a-ps2,13,8940336,8940977,processed_pseudogene,-1,641,chr13_8940336_8940977
Rpl10a-ps3,15,96922760,96923405,processed_pseudogene,-1,645,chr15_96922760_96923405
Rpl10l,12,66283379,66284401,protein_coding,-1,1022,chr12_66283379_66284401
Rpl11,4,136028265,136053428,protein_coding,-1,25163,chr4_136028265_136053428
Rpl12,2,32961559,32965345,protein_coding,1,3786,chr2_32961559_32965345
Rpl12-ps1,1,36957930,36958427,processed_pseudogene,-1,497,chr1_36957930_36958427
Rpl13,8,123102350,123105244,protein_coding,1,2894,chr8_123102350_123105244
Rpl13-ps2,13,58756551,58757164,processed_pseudogene,1,613,chr13_58756551_58757164
Rpl13-ps3,14,58893506,58894129,processed_pseudogene,1,623,chr14_58893506_58894129
Rpl13-ps5,X,94789717,94790346,processed_pseudogene,1,629,chrX_94789717_94790346
Rpl13a,7,45125558,45128761,protein_coding,-1,3203,chr7_45125558_45128761
Rpl13a-ps1,19,50030124,50030735,processed_pseudogene,-1,611,chr19_50030124_50030735
Rpl14,9,120571444,120574654,protein_coding,1,3210,chr9_120571444_120574654
Rpl14-ps1,7,45324965,45325617,processed_pseudogene,1,652,chr7_45324965_45325617
Rpl15,14,18267823,18271391,protein_coding,-1,3568,chr14_18267823_18271391
Rpl15-ps1,11,21953140,21953703,processed_pseudogene,1,563,chr11_21953140_21953703
Rpl15-ps2,9,72060937,72061549,processed_pseudogene,1,612,chr9_72060937_72061549
Rpl15-ps3,9,22185607,22186221,processed_pseudogene,-1,614,chr9_22185607_22186221
Rpl15-ps4,2,38777736,38778341,processed_pseudogene,1,605,chr2_38777736_38778341
Rpl15-ps5,7,97594837,97595441,processed_pseudogene,-1,604,chr7_97594837_97595441
Rpl17,18,74998558,75003381,protein_coding,1,4823,chr18_74998558_75003381
Rpl17-ps1,1,61075674,61110540,processed_pseudogene,1,34866,chr1_61075674_61110540
Rpl17-ps10,7,72648757,72649311,processed_pseudogene,-1,554,chr7_72648757_72649311
Rpl17-ps2,12,95684196,95684727,processed_pseudogene,1,531,chr12_95684196_95684727
Rpl17-ps3,12,67510756,67511311,processed_pseudogene,1,555,chr12_67510756_67511311
Rpl17-ps4,4,63895545,63896099,processed_pseudogene,-1,554,chr4_63895545_63896099
Rpl17-ps5,5,22612628,22613182,processed_pseudogene,-1,554,chr5_22612628_22613182
Rpl17-ps7,14,103010246,103010786,processed_pseudogene,1,540,chr14_103010246_103010786
Rpl17-ps8,X,96484859,96485479,processed_pseudogene,1,620,chrX_96484859_96485479
Rpl17-ps9,7,36118274,36118828,processed_pseudogene,1,554,chr7_36118274_36118828
Rpl18,7,45715457,45720836,protein_coding,1,5379,chr7_45715457_45720836
Rpl18-ps1,1,60900898,60927839,processed_pseudogene,1,26941,chr1_60900898_60927839
Rpl18-ps2,6,128313357,128313923,processed_pseudogene,1,566,chr6_128313357_128313923
Rpl18a,8,70894722,70897412,protein_coding,-1,2690,chr8_70894722_70897412
Rpl18a-ps1,12,55395707,55396229,processed_pseudogene,-1,522,chr12_55395707_55396229
Rpl18a-ps4,7,43082123,43082658,processed_pseudogene,-1,535,chr7_43082123_43082658
Rpl19,11,98026710,98030492,protein_coding,1,3782,chr11_98026710_98030492
Rpl19-ps1,1,85012114,85012704,processed_pseudogene,1,590,chr1_85012114_85012704
Rpl19-ps10,7,115172056,115172385,processed_pseudogene,1,329,chr7_115172056_115172385
Rpl19-ps11,8,19492936,19493526,processed_pseudogene,1,590,chr8_19492936_19493526
Rpl19-ps12,X,6071222,6071812,processed_pseudogene,1,590,chrX_6071222_6071812
Rpl19-ps2,10,71318766,71319355,processed_pseudogene,1,589,chr10_71318766_71319355
Rpl19-ps3,14,49103507,49122712,transcribed_processed_pseudogene,-1,19205,chr14_49103507_49122712
Rpl19-ps4,14,13777817,13778441,processed_pseudogene,-1,624,chr14_13777817_13778441
Rpl19-ps5,14,120713078,120713666,processed_pseudogene,1,588,chr14_120713078_120713666
Rpl19-ps6,15,7975075,7975660,processed_pseudogene,1,585,chr15_7975075_7975660
Rpl19-ps7,18,23944959,23945550,processed_pseudogene,1,591,chr18_23944959_23945550
Rpl19-ps9,6,71683298,71683885,processed_pseudogene,1,587,chr6_71683298_71683885
Rpl21,5,146832890,146837032,protein_coding,1,4142,chr5_146832890_146837032
Rpl21-ps1,1,184617248,184617727,processed_pseudogene,1,479,chr1_184617248_184617727
Rpl21-ps10,3,38107443,38107922,processed_pseudogene,-1,479,chr3_38107443_38107922
Rpl21-ps11,3,96666503,96666982,processed_pseudogene,-1,479,chr3_96666503_96666982
Rpl21-ps12,6,90844981,90845460,processed_pseudogene,-1,479,chr6_90844981_90845460
Rpl21-ps13,7,139719399,139719881,processed_pseudogene,1,482,chr7_139719399_139719881
Rpl21-ps14,8,4861169,4861651,processed_pseudogene,1,482,chr8_4861169_4861651
Rpl21-ps15,X,151215167,151215649,processed_pseudogene,-1,482,chrX_151215167_151215649
Rpl21-ps2,12,13149680,13150160,processed_pseudogene,-1,480,chr12_13149680_13150160
Rpl21-ps3,12,59094055,59094537,processed_pseudogene,-1,482,chr12_59094055_59094537
Rpl21-ps4,14,11227552,11227989,processed_pseudogene,1,437,chr14_11227552_11227989
Rpl21-ps5,16,83371254,83371733,processed_pseudogene,-1,479,chr16_83371254_83371733
Rpl21-ps6,17,55915403,55915870,processed_pseudogene,-1,467,chr17_55915403_55915870
Rpl21-ps7,17,83288546,83289060,processed_pseudogene,1,514,chr17_83288546_83289060
Rpl21-ps8,18,82523539,82524021,processed_pseudogene,-1,482,chr18_82523539_82524021
Rpl21-ps9,2,156386741,156387222,processed_pseudogene,1,481,chr2_156386741_156387222
Rpl22,4,152325742,152334071,protein_coding,1,8329,chr4_152325742_152334071
Rpl22-ps1,X,8038611,8038996,processed_pseudogene,-1,385,chrX_8038611_8038996
Rpl22l1,3,28805436,28807424,protein_coding,1,1988,chr3_28805436_28807424
Rpl23,11,97777527,97782437,protein_coding,-1,4910,chr11_97777527_97782437
Rpl23a,11,78180932,78183584,protein_coding,-1,2652,chr11_78180932_78183584
Rpl23a-ps1,1,45981548,45982012,processed_pseudogene,1,464,chr1_45981548_45982012
Rpl23a-ps2,11,70879428,70879901,processed_pseudogene,1,473,chr11_70879428_70879901
Rpl23a-ps3,14,34170655,34171122,processed_pseudogene,1,467,chr14_34170655_34171122
Rpl23a-ps4,2,132662242,132662696,processed_pseudogene,1,454,chr2_132662242_132662696
Rpl23a-ps5,3,47230538,47231003,processed_pseudogene,-1,465,chr3_47230538_47231003
Rpl24,16,55966275,55971435,protein_coding,1,5160,chr16_55966275_55971435
Rpl26,11,68901583,68906989,protein_coding,1,5406,chr11_68901583_68906989
Rpl26-ps2,12,57632581,57633015,processed_pseudogene,-1,434,chr12_57632581_57633015
Rpl26-ps4,16,17711668,17712105,processed_pseudogene,1,437,chr16_17711668_17712105
Rpl26-ps5,2,142570508,142570946,processed_pseudogene,1,438,chr2_142570508_142570946
Rpl26-ps6,9,43217122,43217555,processed_pseudogene,1,433,chr9_43217122_43217555
Rpl27,11,101442298,101445529,protein_coding,1,3231,chr11_101442298_101445529
Rpl27-ps1,1,171305087,171305494,processed_pseudogene,-1,407,chr1_171305087_171305494
Rpl27-ps2,11,101939501,101939899,processed_pseudogene,1,398,chr11_101939501_101939899
Rpl27-ps3,18,6332632,6333042,processed_pseudogene,1,410,chr18_6332632_6333042
Rpl27a,7,109519147,109522367,protein_coding,1,3220,chr7_109519147_109522367
Rpl27a-ps1,10,61309830,61310277,processed_pseudogene,1,447,chr10_61309830_61310277
Rpl27a-ps2,14,108692194,108692643,processed_pseudogene,-1,449,chr14_108692194_108692643
Rpl28,7,4792874,4795066,protein_coding,1,2192,chr7_4792874_4795066
Rpl28-ps1,1,128038569,128038982,processed_pseudogene,1,413,chr1_128038569_128038982
Rpl28-ps2,3,83686721,83687274,processed_pseudogene,1,553,chr3_83686721_83687274
Rpl28-ps3,4,126069867,126070259,processed_pseudogene,-1,392,chr4_126069867_126070259
Rpl28-ps4,6,117213690,117214066,processed_pseudogene,-1,376,chr6_117213690_117214066
Rpl29,9,106429454,106431568,protein_coding,1,2114,chr9_106429454_106431568
Rpl29-ps1,3,152780774,152782061,processed_pseudogene,-1,1287,chr3_152780774_152782061
Rpl29-ps2,13,4609334,4615025,transcribed_processed_pseudogene,1,5691,chr13_4609334_4615025
Rpl29-ps5,18,30459082,30459544,processed_pseudogene,-1,462,chr18_30459082_30459544
Rpl3,15,80077791,80091868,protein_coding,-1,14077,chr15_80077791_80091868
Rpl3-ps1,X,13202571,13203780,processed_pseudogene,1,1209,chrX_13202571_13203780
Rpl3-ps2,X,74170653,74171866,processed_pseudogene,1,1213,chrX_74170653_74171866
Rpl30,15,34440505,34443640,protein_coding,-1,3135,chr15_34440505_34443640
Rpl30-ps1,6,38376807,38377154,processed_pseudogene,1,347,chr6_38376807_38377154
Rpl30-ps10,X,71803688,71804034,processed_pseudogene,1,346,chrX_71803688_71804034
Rpl30-ps11,X,12456886,12457230,processed_pseudogene,-1,344,chrX_12456886_12457230
Rpl30-ps2,8,22230902,22231192,processed_pseudogene,-1,290,chr8_22230902_22231192
Rpl30-ps3,2,90747616,90747963,processed_pseudogene,-1,347,chr2_90747616_90747963
Rpl30-ps5,2,174440929,174441289,processed_pseudogene,-1,360,chr2_174440929_174441289
Rpl30-ps6,1,86473659,86474006,processed_pseudogene,1,347,chr1_86473659_86474006
Rpl30-ps8,12,99047230,99047574,processed_pseudogene,1,344,chr12_99047230_99047574
Rpl30-ps9,X,105278637,105278981,processed_pseudogene,-1,344,chrX_105278637_105278981
Rpl31,1,39367842,39371911,protein_coding,1,4069,chr1_39367842_39371911
Rpl31-ps1,12,91890896,91891273,processed_pseudogene,-1,377,chr12_91890896_91891273
Rpl31-ps10,4,137395299,137395676,processed_pseudogene,1,377,chr4_137395299_137395676
Rpl31-ps11,3,94604408,94604784,processed_pseudogene,-1,376,chr3_94604408_94604784
Rpl31-ps12,16,16819749,16820123,processed_pseudogene,-1,374,chr16_16819749_16820123
Rpl31-ps13,13,100415565,100415942,processed_pseudogene,1,377,chr13_100415565_100415942
Rpl31-ps14,1,66948563,66948940,processed_pseudogene,-1,377,chr1_66948563_66948940
Rpl31-ps15,3,37734730,37735104,processed_pseudogene,1,374,chr3_37734730_37735104
Rpl31-ps16,17,85498633,85499008,processed_pseudogene,1,375,chr17_85498633_85499008
Rpl31-ps17,12,54701329,54701706,processed_pseudogene,-1,377,chr12_54701329_54701706
Rpl31-ps18,19,51792226,51792602,processed_pseudogene,1,376,chr19_51792226_51792602
Rpl31-ps2,13,73233395,73233737,processed_pseudogene,1,342,chr13_73233395_73233737
Rpl31-ps20,19,30160620,30160997,processed_pseudogene,1,377,chr19_30160620_30160997
Rpl31-ps21,5,21119149,21119522,processed_pseudogene,-1,373,chr5_21119149_21119522
Rpl31-ps22,15,84030339,84030675,processed_pseudogene,1,336,chr15_84030339_84030675
Rpl31-ps23,8,35132995,35133532,processed_pseudogene,-1,537,chr8_35132995_35133532
Rpl31-ps24,1,64934402,64934780,processed_pseudogene,1,378,chr1_64934402_64934780
Rpl31-ps25,17,81791555,81791933,processed_pseudogene,-1,378,chr17_81791555_81791933
Rpl31-ps4,16,87549062,87549451,processed_pseudogene,-1,389,chr16_87549062_87549451
Rpl31-ps5,5,20806090,20806464,processed_pseudogene,1,374,chr5_20806090_20806464
Rpl31-ps6,5,123466509,123466886,processed_pseudogene,1,377,chr5_123466509_123466886
Rpl31-ps7,6,47785996,47786374,processed_pseudogene,-1,378,chr6_47785996_47786374
Rpl31-ps8,15,90764279,90764656,processed_pseudogene,-1,377,chr15_90764279_90764656
Rpl31-ps9,1,129801387,129801764,processed_pseudogene,-1,377,chr1_129801387_129801764
Rpl32,6,115805505,115808747,protein_coding,-1,3242,chr6_115805505_115808747
Rpl32-ps,3,69716986,69717393,processed_pseudogene,-1,407,chr3_69716986_69717393
Rpl34,3,130726831,130730398,protein_coding,-1,3567,chr3_130726831_130730398
Rpl34-ps1,6,71124610,71124963,processed_pseudogene,1,353,chr6_71124610_71124963
Rpl35,2,39001580,39005624,protein_coding,-1,4044,chr2_39001580_39005624
Rpl35-ps1,2,66447036,66447407,processed_pseudogene,-1,371,chr2_66447036_66447407
Rpl35a,16,33056453,33060189,protein_coding,1,3736,chr16_33056453_33060189
Rpl35a-ps2,1,181241988,181242320,processed_pseudogene,-1,332,chr1_181241988_181242320
Rpl35a-ps3,17,29136972,29137304,processed_pseudogene,-1,332,chr17_29136972_29137304
Rpl35a-ps4,2,108874926,108875258,processed_pseudogene,-1,332,chr2_108874926_108875258
Rpl35a-ps5,5,33076038,33076370,processed_pseudogene,1,332,chr5_33076038_33076370
Rpl35a-ps6,5,123255481,123255813,processed_pseudogene,-1,332,chr5_123255481_123255813
Rpl35a-ps7,6,47815300,47815632,processed_pseudogene,-1,332,chr6_47815300_47815632
Rpl36,17,56613416,56614243,protein_coding,1,827,chr17_56613416_56614243
Rpl36-ps10,X,19870824,19871039,processed_pseudogene,1,215,chrX_19870824_19871039
Rpl36-ps2,11,76601319,76601629,processed_pseudogene,1,310,chr11_76601319_76601629
Rpl36-ps3,12,12912022,12912336,processed_pseudogene,1,314,chr12_12912022_12912336
Rpl36-ps4,17,87920977,87921393,protein_coding,1,416,chr17_87920977_87921393
Rpl36-ps8,4,116839907,116840221,processed_pseudogene,-1,314,chr4_116839907_116840221
Rpl36-ps9,5,137432987,137433263,processed_pseudogene,1,276,chr5_137432987_137433263
Rpl36a,X,134585654,134588062,protein_coding,1,2408,chrX_134585654_134588062
Rpl36a-ps1,14,98993870,98994318,protein_coding,-1,448,chr14_98993870_98994318
Rpl36a-ps2,3,145879020,145879340,processed_pseudogene,1,320,chr3_145879020_145879340
Rpl36a-ps3,6,136488807,136489127,processed_pseudogene,1,320,chr6_136488807_136489127
Rpl36al,12,69182731,69184083,protein_coding,-1,1352,chr12_69182731_69184083
Rpl37,15,5116645,5119140,protein_coding,1,2495,chr15_5116645_5119140
Rpl37-ps1,19,16025451,16025717,processed_pseudogene,1,266,chr19_16025451_16025717
Rpl37a,1,72711290,72713813,protein_coding,1,2523,chr1_72711290_72713813
Rpl37rt,5,115102923,115110268,transcribed_processed_pseudogene,-1,7345,chr5_115102923_115110268
Rpl38,11,114668524,114672331,protein_coding,1,3807,chr11_114668524_114672331
Rpl38-ps1,4,138425788,138426002,processed_pseudogene,1,214,chr4_138425788_138426002
Rpl38-ps2,6,140746960,140747172,processed_pseudogene,-1,212,chr6_140746960_140747172
Rpl39,X,37082520,37085402,protein_coding,-1,2882,chrX_37082520_37085402
Rpl39-ps,15,102635038,102635188,processed_pseudogene,1,150,chr15_102635038_102635188
Rpl39l,16,10170226,10174911,protein_coding,1,4685,chr16_10170226_10174911
Rpl3l,17,24727820,24736143,protein_coding,1,8323,chr17_24727820_24736143
Rpl4,9,64173375,64178666,protein_coding,1,5291,chr9_64173375_64178666
Rpl41,10,128548114,128549305,protein_coding,-1,1191,chr10_128548114_128549305
Rpl48-ps1,10,57601393,57601948,processed_pseudogene,1,555,chr10_57601393_57601948
Rpl5,5,107900502,107909005,protein_coding,1,8503,chr5_107900502_107909005
Rpl5-ps1,1,14865072,14865965,processed_pseudogene,1,893,chr1_14865072_14865965
Rpl5-ps2,2,154703809,154704699,processed_pseudogene,1,890,chr2_154703809_154704699
Rpl6,5,121204481,121209241,protein_coding,1,4760,chr5_121204481_121209241
Rpl7,1,16101295,16104662,protein_coding,-1,3367,chr1_16101295_16104662
Rpl7-ps7,5,82336851,82337649,processed_pseudogene,1,798,chr5_82336851_82337649
Rpl7a,2,26910764,26913318,protein_coding,1,2554,chr2_26910764_26913318
Rpl7a-ps1,12,64876836,64877628,processed_pseudogene,-1,792,chr12_64876836_64877628
Rpl7a-ps10,9,97179179,97179976,processed_pseudogene,1,797,chr9_97179179_97179976
Rpl7a-ps12,X,152908778,152910296,processed_pseudogene,-1,1518,chrX_152908778_152910296
Rpl7a-ps13,X,67726244,67726806,processed_pseudogene,1,562,chrX_67726244_67726806
Rpl7a-ps3,15,36308149,36308944,processed_pseudogene,-1,795,chr15_36308149_36308944
Rpl7a-ps4,16,57896806,57897597,processed_pseudogene,-1,791,chr16_57896806_57897597
Rpl7a-ps5,17,57838430,57839221,processed_pseudogene,-1,791,chr17_57838430_57839221
Rpl7a-ps6,18,3857769,3858580,processed_pseudogene,-1,811,chr18_3857769_3858580
Rpl7a-ps7,3,129461972,129462747,processed_pseudogene,1,775,chr3_129461972_129462747
Rpl7a-ps8,7,19953783,19954583,processed_pseudogene,1,800,chr7_19953783_19954583
Rpl7a-ps9,7,81445920,81446696,processed_pseudogene,1,776,chr7_81445920_81446696
Rpl7l1,17,46773907,46782672,protein_coding,-1,8765,chr17_46773907_46782672
Rpl7l1-ps1,X,60971990,60972714,processed_pseudogene,-1,724,chrX_60971990_60972714
Rpl8,15,76904078,76906314,protein_coding,1,2236,chr15_76904078_76906314
Rpl9,5,65388364,65391444,protein_coding,-1,3080,chr5_65388364_65391444
Rpl9-ps1,11,83645046,83645621,protein_coding,-1,575,chr11_83645046_83645621
Rpl9-ps2,11,46562031,46562607,processed_pseudogene,1,576,chr11_46562031_46562607
Rpl9-ps3,11,53501184,53501759,processed_pseudogene,1,575,chr11_53501184_53501759
Rpl9-ps4,13,72454762,72455340,processed_pseudogene,-1,578,chr13_72454762_72455340
Rpl9-ps6,19,32465865,32466578,protein_coding,-1,713,chr19_32465865_32466578
Rpl9-ps7,2,70458982,70459560,processed_pseudogene,1,578,chr2_70458982_70459560
Rpl9-ps8,3,144625403,144625964,processed_pseudogene,-1,561,chr3_144625403_144625964
Rplp0,5,115559467,115563727,protein_coding,1,4260,chr5_115559467_115563727
Rplp0-ps1,3,93278141,93279073,processed_pseudogene,1,932,chr3_93278141_93279073
Rplp1,9,61913284,61914542,protein_coding,-1,1258,chr9_61913284_61914542
Rplp1-ps1,X,70653206,70653550,processed_pseudogene,-1,344,chrX_70653206_70653550
Rplp2,7,141447370,141451585,protein_coding,1,4215,chr7_141447370_141451585
Rpn1,6,88084482,88105304,protein_coding,1,20822,chr6_88084482_88105304
Rpn2,2,157279017,157326319,protein_coding,1,47302,chr2_157279017_157326319
Rpp14,14,8080367,8091834,protein_coding,1,11467,chr14_8080367_8091834
Rpp21,17,36255645,36258069,protein_coding,-1,2424,chr17_36255645_36258069
Rpp25,9,57504026,57505448,protein_coding,1,1422,chr9_57504026_57505448
Rpp25l,4,41712033,41713534,protein_coding,-1,1501,chr4_41712033_41713534
Rpp30,19,36083716,36104777,protein_coding,1,21061,chr19_36083716_36104777
Rpp38,2,3328949,3332643,protein_coding,-1,3694,chr2_3328949_3332643
Rpp40,13,35893472,35906359,protein_coding,-1,12887,chr13_35893472_35906359
Rpph1,14,50807449,50807767,ribozyme,-1,318,chr14_50807449_50807767
Rprd1a,18,24484960,24530204,protein_coding,-1,45244,chr18_24484960_24530204
Rprd1b,2,158028497,158132297,protein_coding,1,103800,chr2_158028497_158132297
Rprd2,3,95760341,95818863,protein_coding,-1,58522,chr3_95760341_95818863
Rprl2,3,22251374,22251663,ribozyme,1,289,chr3_22251374_22251663
Rprm,2,54084093,54085552,protein_coding,-1,1459,chr2_54084093_54085552
Rprml,11,103649570,103650579,protein_coding,1,1009,chr11_103649570_103650579
Rps10,17,27630418,27636669,protein_coding,-1,6251,chr17_27630418_27636669
Rps10-ps1,3,95622278,95622772,processed_pseudogene,1,494,chr3_95622278_95622772
Rps10-ps2,16,20822145,20822640,processed_pseudogene,-1,495,chr16_20822145_20822640
Rps10-ps3,4,3978251,3978750,processed_pseudogene,-1,499,chr4_3978251_3978750
Rps10-ps4,5,147100562,147101053,processed_pseudogene,-1,491,chr5_147100562_147101053
Rps11,7,45122379,45124439,protein_coding,-1,2060,chr7_45122379_45124439
Rps11-ps1,9,59471759,59472233,processed_pseudogene,-1,474,chr9_59471759_59472233
Rps11-ps2,11,116382750,116383205,processed_pseudogene,1,455,chr11_116382750_116383205
Rps11-ps3,4,10946608,10947093,processed_pseudogene,1,485,chr4_10946608_10947093
Rps11-ps4,12,51297487,51297960,processed_pseudogene,1,473,chr12_51297487_51297960
Rps12,10,23785183,23787275,protein_coding,-1,2092,chr10_23785183_23787275
Rps12-ps1,X,103489517,103489917,processed_pseudogene,1,400,chrX_103489517_103489917
Rps12-ps10,2,122219993,122220391,processed_pseudogene,1,398,chr2_122219993_122220391
Rps12-ps2,14,61466968,61467366,processed_pseudogene,-1,398,chr14_61466968_61467366
Rps12-ps3,19,59322371,59322766,processed_pseudogene,1,395,chr19_59322371_59322766
Rps12-ps4,7,30484701,30485097,processed_pseudogene,-1,396,chr7_30484701_30485097
Rps12-ps5,7,30263263,30263651,processed_pseudogene,1,388,chr7_30263263_30263651
Rps12-ps9,8,123206623,123207021,processed_pseudogene,1,398,chr8_123206623_123207021
Rps12l1,7,56014016,56014414,processed_pseudogene,1,398,chr7_56014016_56014414
Rps13,7,116331505,116334195,protein_coding,-1,2690,chr7_116331505_116334195
Rps13-ps1,8,87047689,87048226,processed_pseudogene,1,537,chr8_87047689_87048226
Rps13-ps2,7,88530446,88530898,processed_pseudogene,-1,452,chr7_88530446_88530898
Rps13-ps4,8,119602170,119602625,processed_pseudogene,-1,455,chr8_119602170_119602625
Rps13-ps5,11,61205720,61206175,processed_pseudogene,-1,455,chr11_61205720_61206175
Rps14,18,60747098,60778546,protein_coding,1,31448,chr18_60747098_60778546
Rps15,10,80292453,80294114,protein_coding,1,1661,chr10_80292453_80294114
Rps15-ps2,6,58017506,58017943,processed_pseudogene,1,437,chr6_58017506_58017943
Rps15-ps3,18,64288135,64291820,transcribed_processed_pseudogene,1,3685,chr18_64288135_64291820
Rps15a,7,118104372,118116188,protein_coding,-1,11816,chr7_118104372_118116188
Rps15a-ps1,10,106192378,106192770,processed_pseudogene,-1,392,chr10_106192378_106192770
Rps15a-ps2,19,28742159,28742551,processed_pseudogene,-1,392,chr19_28742159_28742551
Rps15a-ps4,4,132219988,132220489,transcribed_processed_pseudogene,-1,501,chr4_132219988_132220489
Rps15a-ps5,5,105797321,105797713,processed_pseudogene,-1,392,chr5_105797321_105797713
Rps15a-ps6,11,6172644,6173036,processed_pseudogene,-1,392,chr11_6172644_6173036
Rps15a-ps7,2,152185291,152185682,processed_pseudogene,-1,391,chr2_152185291_152185682
Rps15a-ps8,4,53791070,53791456,processed_pseudogene,-1,386,chr4_53791070_53791456
Rps16,7,28350652,28353155,protein_coding,1,2503,chr7_28350652_28353155
Rps16-ps2,5,129128077,129128517,processed_pseudogene,-1,440,chr5_129128077_129128517
Rps16-ps3,8,10808688,10809128,processed_pseudogene,-1,440,chr8_10808688_10809128
Rps17,7,81342732,81345254,protein_coding,-1,2522,chr7_81342732_81345254
Rps17-ps1,13,41234694,41235077,processed_pseudogene,-1,383,chr13_41234694_41235077
Rps18,17,33951999,33956001,protein_coding,-1,4002,chr17_33951999_33956001
Rps18-ps1,4,71370738,71371196,processed_pseudogene,-1,458,chr4_71370738_71371196
Rps18-ps3,8,107262793,107263248,processed_pseudogene,-1,455,chr8_107262793_107263248
Rps19,7,24884371,24889806,protein_coding,1,5435,chr7_24884371_24889806
Rps19-ps10,10,52384659,52385093,processed_pseudogene,-1,434,chr10_52384659_52385093
Rps19-ps11,10,43373488,43373920,processed_pseudogene,-1,432,chr10_43373488_43373920
Rps19-ps12,16,79914460,79914871,processed_pseudogene,-1,411,chr16_79914460_79914871
Rps19-ps13,18,40726269,40726709,processed_pseudogene,1,440,chr18_40726269_40726709
Rps19-ps3,4,147821777,147822202,processed_pseudogene,-1,425,chr4_147821777_147822202
Rps19-ps4,18,42252398,42252835,processed_pseudogene,1,437,chr18_42252398_42252835
Rps19-ps5,15,37868086,37868488,processed_pseudogene,1,402,chr15_37868086_37868488
Rps19-ps6,12,110898114,110898551,processed_pseudogene,1,437,chr12_110898114_110898551
Rps19-ps7,2,140073032,140073469,processed_pseudogene,-1,437,chr2_140073032_140073469
Rps19-ps8,5,108055495,108055916,processed_pseudogene,-1,421,chr5_108055495_108055916
Rps19-ps9,6,87948464,87948877,processed_pseudogene,-1,413,chr6_87948464_87948877
Rps19bp1,15,80260615,80264315,protein_coding,-1,3700,chr15_80260615_80264315
Rps2,17,24718116,24721929,protein_coding,1,3813,chr17_24718116_24721929
Rps2-ps10,18,61259008,61259972,transcribed_processed_pseudogene,-1,964,chr18_61259008_61259972
Rps2-ps11,9,108358202,108359069,processed_pseudogene,-1,867,chr9_108358202_108359069
Rps2-ps12,9,30512940,30513724,processed_pseudogene,1,784,chr9_30512940_30513724
Rps2-ps13,X,52898588,52899469,processed_pseudogene,1,881,chrX_52898588_52899469
Rps2-ps2,1,7664081,7664961,processed_pseudogene,1,880,chr1_7664081_7664961
Rps2-ps4,11,53645744,53646376,processed_pseudogene,1,632,chr11_53645744_53646376
Rps2-ps5,14,69158671,69159519,processed_pseudogene,1,848,chr14_69158671_69159519
Rps2-ps6,14,76236691,76237545,processed_pseudogene,-1,854,chr14_76236691_76237545
Rps2-ps7,16,18681337,18682216,processed_pseudogene,-1,879,chr16_18681337_18682216
Rps2-ps8,17,31643898,31644779,processed_pseudogene,-1,881,chr17_31643898_31644779
Rps2-ps9,17,27784379,27785246,transcribed_processed_pseudogene,1,867,chr17_27784379_27785246
Rps20,4,3831334,3835665,protein_coding,-1,4331,chr4_3831334_3835665
Rps21,2,180257377,180258445,protein_coding,1,1068,chr2_180257377_180258445
Rps23,13,90922958,90924950,protein_coding,1,1992,chr13_90922958_90924950
Rps23-ps1,3,37714740,37715164,processed_pseudogene,1,424,chr3_37714740_37715164
Rps23-ps2,8,3583799,3584230,processed_pseudogene,-1,431,chr8_3583799_3584230
Rps24,14,24487125,24496959,protein_coding,1,9834,chr14_24487125_24496959
Rps24-ps2,3,3791898,3792292,processed_pseudogene,1,394,chr3_3791898_3792292
Rps24-ps3,X,79195047,79195448,processed_pseudogene,1,401,chrX_79195047_79195448
Rps25,9,44407139,44410427,protein_coding,1,3288,chr9_44407139_44410427
Rps25-ps1,6,145266400,145266777,processed_pseudogene,1,377,chr6_145266400_145266777
Rps26,10,128624534,128626747,protein_coding,-1,2213,chr10_128624534_128626747
Rps26-ps1,8,107439131,107439579,transcribed_processed_pseudogene,-1,448,chr8_107439131_107439579
Rps27,3,90212522,90213651,protein_coding,-1,1129,chr3_90212522_90213651
Rps27-ps1,1,63073774,63074019,processed_pseudogene,1,245,chr1_63073774_63074019
Rps27a,11,29545846,29548109,protein_coding,-1,2263,chr11_29545846_29548109
Rps27a-ps1,1,52522239,52522701,processed_pseudogene,1,462,chr1_52522239_52522701
Rps27a-ps2,9,83409660,83410126,processed_pseudogene,1,466,chr9_83409660_83410126
Rps27l,9,66946086,66949516,protein_coding,1,3430,chr9_66946086_66949516
Rps27rt,9,114982366,114982739,protein_coding,-1,373,chr9_114982366_114982739
Rps28,17,33819027,33824562,protein_coding,-1,5535,chr17_33819027_33824562
Rps29,12,69157722,69159186,protein_coding,-1,1464,chr12_69157722_69159186
Rps3,7,99477896,99483738,protein_coding,-1,5842,chr7_99477896_99483738
Rps3a1,3,86137940,86142702,protein_coding,-1,4762,chr3_86137940_86142702
Rps3a2,14,88123017,88123808,processed_pseudogene,-1,791,chr14_88123017_88123808
Rps3a3,13,108670603,108671397,processed_pseudogene,1,794,chr13_108670603_108671397
Rps4l,6,148354656,148355598,transcribed_processed_pseudogene,1,942,chr6_148354656_148355598
Rps4l-ps,7,114926959,114927726,processed_pseudogene,-1,767,chr7_114926959_114927726
Rps4x,X,102184941,102189394,protein_coding,-1,4453,chrX_102184941_102189394
Rps4x-ps,5,3875362,3876154,processed_pseudogene,1,792,chr5_3875362_3876154
Rps5,7,12922290,12926686,protein_coding,1,4396,chr7_12922290_12926686
Rps6,4,86854660,86857412,protein_coding,-1,2752,chr4_86854660_86857412
Rps6-ps1,15,76337616,76338362,processed_pseudogene,1,746,chr15_76337616_76338362
Rps6-ps2,8,88806391,88807137,processed_pseudogene,1,746,chr8_88806391_88807137
Rps6-ps3,9,53689534,53690283,processed_pseudogene,-1,749,chr9_53689534_53690283
Rps6ka1,4,133847290,133887797,protein_coding,-1,40507,chr4_133847290_133887797
Rps6ka2,17,7170115,7303315,protein_coding,1,133200,chr17_7170115_7303315
Rps6ka3,X,159210307,159368244,protein_coding,1,157937,chrX_159210307_159368244
Rps6ka4,19,6829085,6840636,protein_coding,-1,11551,chr19_6829085_6840636
Rps6ka5,12,100548439,100726983,protein_coding,-1,178544,chr12_100548439_100726983
Rps6ka6,X,111254283,111537959,protein_coding,-1,283676,chrX_111254283_111537959
Rps6kb1,11,86498871,86544805,protein_coding,-1,45934,chr11_86498871_86544805
Rps6kb2,19,4153990,4163354,protein_coding,-1,9364,chr19_4153990_4163354
Rps6kc1,1,190700202,190911770,protein_coding,-1,211568,chr1_190700202_190911770
Rps6kl1,12,85135249,85151264,protein_coding,-1,16015,chr12_85135249_85151264
Rps7,12,28630854,28635953,protein_coding,-1,5099,chr12_28630854_28635953
Rps7-ps1,8,69540957,69541347,processed_pseudogene,1,390,chr8_69540957_69541347
Rps7-ps2,12,3521922,3523268,processed_pseudogene,-1,1346,chr12_3521922_3523268
Rps8,4,117153827,117156243,protein_coding,-1,2416,chr4_117153827_117156243
Rps8-ps1,10,56354451,56355074,processed_pseudogene,-1,623,chr10_56354451_56355074
Rps8-ps2,2,175804983,175805606,processed_pseudogene,-1,623,chr2_175804983_175805606
Rps8-ps3,6,52118242,52118891,processed_pseudogene,1,649,chr6_52118242_52118891
Rps9,7,3703993,3706897,protein_coding,1,2904,chr7_3703993_3706897
Rpsa,9,120127689,120132369,protein_coding,1,4680,chr9_120127689_120132369
Rpsa-ps1,1,163623793,163624678,processed_pseudogene,1,885,chr1_163623793_163624678
Rpsa-ps10,3,150072658,150073542,processed_pseudogene,-1,884,chr3_150072658_150073542
Rpsa-ps11,4,59162268,59163156,processed_pseudogene,-1,888,chr4_59162268_59163156
Rpsa-ps12,4,149142497,149143388,processed_pseudogene,-1,891,chr4_149142497_149143388
Rpsa-ps2,10,128776371,128777250,processed_pseudogene,-1,879,chr10_128776371_128777250
Rpsa-ps3,11,22386292,22388196,processed_pseudogene,1,1904,chr11_22386292_22388196
Rpsa-ps4,11,33038816,33039703,processed_pseudogene,-1,887,chr11_33038816_33039703
Rpsa-ps5,11,28956724,28957608,processed_pseudogene,1,884,chr11_28956724_28957608
Rpsa-ps7,17,82409935,82410819,processed_pseudogene,-1,884,chr17_82409935_82410819
Rpsa-ps8,17,77362353,77363210,processed_pseudogene,-1,857,chr17_77362353_77363210
Rpsa-ps9,2,28477166,28478050,processed_pseudogene,1,884,chr2_28477166_28478050
Rptor,11,119602905,119899576,protein_coding,1,296671,chr11_119602905_119899576
Rptoros,11,119820812,119834365,antisense,-1,13553,chr11_119820812_119834365
Rpusd1,17,25727670,25731464,protein_coding,1,3794,chr17_25727670_25731464
Rpusd2,2,119034790,119039769,protein_coding,1,4979,chr2_119034790_119039769
Rpusd3,6,113415319,113419340,protein_coding,-1,4021,chr6_113415319_113419340
Rpusd4,9,35267865,35277731,protein_coding,1,9866,chr9_35267865_35277731
Rrad,8,104628070,104631327,protein_coding,-1,3257,chr8_104628070_104631327
Rraga,4,86575668,86577285,protein_coding,1,1617,chr4_86575668_86577285
Rragb,X,153139981,153171943,protein_coding,1,31962,chrX_153139981_153171943
Rragc,4,123917446,123936997,protein_coding,1,19551,chr4_123917446_123936997
Rragd,4,32983037,33022180,protein_coding,1,39143,chr4_32983037_33022180
Rras,7,45017961,45021647,protein_coding,1,3686,chr7_45017961_45021647
Rras2,7,114046782,114117781,protein_coding,-1,70999,chr7_114046782_114117781
Rrbp1,2,143947395,144011263,protein_coding,-1,63868,chr2_143947395_144011263
Rreb1,13,37778400,37952005,protein_coding,1,173605,chr13_37778400_37952005
Rrh,3,129804408,129822587,protein_coding,-1,18179,chr3_129804408_129822587
Rrm1,7,102441695,102469771,protein_coding,1,28076,chr7_102441695_102469771
Rrm2,12,24708241,24714146,protein_coding,1,5905,chr12_24708241_24714146
Rrm2b,15,37923952,37961318,protein_coding,-1,37366,chr15_37923952_37961318
Rrn3,16,13780708,13814839,protein_coding,1,34131,chr16_13780708_13814839
Rrnad1,3,87922601,87930717,protein_coding,-1,8116,chr3_87922601_87930717
Rrp1,10,78400384,78413043,protein_coding,-1,12659,chr10_78400384_78413043
Rrp12,19,41862851,41896173,protein_coding,-1,33322,chr19_41862851_41896173
Rrp15,1,186720978,186749358,protein_coding,-1,28380,chr1_186720978_186749358
Rrp1b,17,32036100,32062865,protein_coding,1,26765,chr17_32036100_32062865
Rrp36,17,46666324,46674352,protein_coding,-1,8028,chr17_46666324_46674352
Rrp7a,15,83113433,83122801,protein_coding,-1,9368,chr15_83113433_83122801
Rrp8,7,105731730,105737385,protein_coding,-1,5655,chr7_105731730_105737385
Rrp9,9,106475963,106485424,protein_coding,1,9461,chr9_106475963_106485424
Rrs1,1,9545408,9547455,protein_coding,1,2047,chr1_9545408_9547455
Rs1,X,160768013,160799663,protein_coding,1,31650,chrX_160768013_160799663
Rsad1,11,94539798,94549255,protein_coding,-1,9457,chr11_94539798_94549255
Rsad2,12,26442746,26456452,protein_coding,-1,13706,chr12_26442746_26456452
Rsbn1,3,103914120,103966636,protein_coding,1,52516,chr3_103914120_103966636
Rsbn1l,5,20893028,20956398,protein_coding,-1,63370,chr5_20893028_20956398
Rsc1a1,4,141683851,141685599,protein_coding,-1,1748,chr4_141683851_141685599
Rsf1,7,97579889,97692778,protein_coding,1,112889,chr7_97579889_97692778
Rsf1os1,7,97598349,97645112,antisense,-1,46763,chr7_97598349_97645112
Rsl1,13,67173182,67184044,protein_coding,1,10862,chr13_67173182_67184044
Rsl1d1,16,11192970,11203331,protein_coding,-1,10361,chr16_11192970_11203331
Rsl24d1,9,73113426,73123333,protein_coding,1,9907,chr9_73113426_73123333
Rslcan18,13,67096613,67116263,protein_coding,-1,19650,chr13_67096613_67116263
Rsph1,17,31255019,31277383,protein_coding,-1,22364,chr17_31255019_31277383
Rsph14,10,74957477,75032586,protein_coding,-1,75109,chr10_74957477_75032586
Rsph3a,17,7945614,7979824,protein_coding,1,34210,chr17_7945614_7979824
Rsph3b,17,6904413,6948682,protein_coding,-1,44269,chr17_6904413_6948682
Rsph4a,10,33905111,33916021,protein_coding,1,10910,chr10_33905111_33916021
Rsph6a,7,19054690,19074447,protein_coding,1,19757,chr7_19054690_19074447
Rsph9,17,46122035,46144216,protein_coding,-1,22181,chr17_46122035_46144216
Rspo1,4,124986430,125009099,protein_coding,1,22669,chr4_124986430_125009099
Rspo2,15,43020794,43170826,protein_coding,-1,150032,chr15_43020794_43170826
Rspo3,10,29452416,29535867,protein_coding,-1,83451,chr10_29452416_29535867
Rspo4,2,151842927,151874668,protein_coding,1,31741,chr2_151842927_151874668
Rspry1,8,94601937,94660275,protein_coding,1,58338,chr8_94601937_94660275
Rsrc1,3,66981390,67358396,protein_coding,1,377006,chr3_66981390_67358396
Rsrc2,5,123728426,123749414,protein_coding,-1,20988,chr5_123728426_123749414
Rsrp1,4,134923592,134927671,protein_coding,1,4079,chr4_134923592_134927671
Rsu1,2,13076821,13271415,protein_coding,-1,194594,chr2_13076821_13271415
Rtbdn,8,84946991,84956603,protein_coding,1,9612,chr8_84946991_84956603
Rtca,3,116488963,116508208,protein_coding,-1,19245,chr3_116488963_116508208
Rtcb,10,85938637,85957823,protein_coding,-1,19186,chr10_85938637_85957823
Rtel1,2,181319739,181356616,protein_coding,1,36877,chr2_181319739_181356616
Rtf1,2,119675068,119735407,protein_coding,1,60339,chr2_119675068_119735407
Rtkn,6,83135463,83152579,protein_coding,1,17116,chr6_83135463_83152579
Rtkn2,10,67979570,68059740,protein_coding,1,80170,chr10_67979570_68059740
Rtl1,12,109589193,109600838,protein_coding,-1,11645,chr12_109589193_109600838
Rtn1,12,72211752,72409054,protein_coding,-1,197302,chr12_72211752_72409054
Rtn2,7,19282624,19296160,protein_coding,1,13536,chr7_19282624_19296160
Rtn3,19,7425901,7483281,protein_coding,-1,57380,chr19_7425901_7483281
Rtn4,11,29692947,29744331,protein_coding,1,51384,chr11_29692947_29744331
Rtn4ip1,10,43901807,43957201,protein_coding,1,55394,chr10_43901807_43957201
Rtn4r,16,18127642,18152408,protein_coding,1,24766,chr16_18127642_18152408
Rtn4rl1,11,75193783,75267769,protein_coding,1,73986,chr11_75193783_75267769
Rtn4rl2,2,84871924,84886710,protein_coding,-1,14786,chr2_84871924_84886710
Rtp3,9,110984935,110990583,protein_coding,-1,5648,chr9_110984935_110990583
Rtp4,16,23520291,23614222,protein_coding,1,93931,chr16_23520291_23614222
Rttn,18,88971790,89131016,protein_coding,1,159226,chr18_88971790_89131016
Rufy1,11,50389286,50431125,protein_coding,-1,41839,chr11_50389286_50431125
Rufy2,10,62980223,63017210,protein_coding,1,36987,chr10_62980223_63017210
Rufy3,5,88565040,88651392,protein_coding,1,86352,chr5_88565040_88651392
Rundc1,11,101425085,101435673,protein_coding,1,10588,chr11_101425085_101435673
Rundc3a,11,102393403,102402555,protein_coding,1,9152,chr11_102393403_102402555
Rundc3b,5,8490334,8622952,protein_coding,-1,132618,chr5_8490334_8622952
Runx1,16,92601466,92826149,protein_coding,-1,224683,chr16_92601466_92826149
Runx1t1,4,13743436,13893649,protein_coding,1,150213,chr4_13743436_13893649
Runx2,17,44495987,44814797,protein_coding,-1,318810,chr17_44495987_44814797
Runx2os2,17,44710222,44713925,antisense,1,3703,chr17_44710222_44713925
Runx3,4,135120652,135177990,protein_coding,1,57338,chr4_135120652_135177990
Rusc1,3,89083981,89093311,protein_coding,-1,9330,chr3_89083981_89093311
Rusc2,4,43381979,43427088,protein_coding,1,45109,chr4_43381979_43427088
Ruvbl1,6,88465409,88497572,protein_coding,1,32163,chr6_88465409_88497572
Ruvbl2,7,45421760,45438096,protein_coding,-1,16336,chr7_45421760_45438096
Rwdd1,10,33996555,34019624,protein_coding,-1,23069,chr10_33996555_34019624
Rwdd2a,9,86571991,86574899,protein_coding,1,2908,chr9_86571991_86574899
Rwdd2b,16,87433407,87440573,protein_coding,-1,7166,chr16_87433407_87440573
Rwdd3,3,121155398,121171695,protein_coding,-1,16297,chr3_121155398_121171695
Rwdd4a,8,47533664,47552955,protein_coding,1,19291,chr8_47533664_47552955
Rxfp1,3,79641611,79737880,protein_coding,-1,96269,chr3_79641611_79737880
Rxfp2,5,150018675,150082184,protein_coding,1,63509,chr5_150018675_150082184
Rxfp3,15,11033717,11037991,protein_coding,-1,4274,chr15_11033717_11037991
Rxra,2,27676440,27762957,protein_coding,1,86517,chr2_27676440_27762957
Rxrb,17,34031812,34038399,protein_coding,1,6587,chr17_34031812_34038399
Rxrg,1,167598384,167639623,protein_coding,1,41239,chr1_167598384_167639623
Rybp,6,100228565,100287485,protein_coding,-1,58920,chr6_100228565_100287485
Ryk,9,102834917,102908305,protein_coding,1,73388,chr9_102834917_102908305
Ryr1,7,29003344,29125179,protein_coding,-1,121835,chr7_29003344_29125179
Ryr2,13,11553102,12106945,protein_coding,-1,553843,chr13_11553102_12106945
Ryr3,2,112631355,113217096,protein_coding,-1,585741,chr2_112631355_113217096
S100a1,3,90511034,90514392,protein_coding,-1,3358,chr3_90511034_90514392
S100a10,3,93555080,93564643,protein_coding,1,9563,chr3_93555080_93564643
S100a11,3,93520488,93526287,protein_coding,1,5799,chr3_93520488_93526287
S100a13,3,90514435,90524581,protein_coding,1,10146,chr3_90514435_90524581
S100a16,3,90537254,90543151,protein_coding,1,5897,chr3_90537254_90543151
S100a2,3,90560363,90591531,protein_coding,1,31168,chr3_90560363_90591531
S100a3,3,90584659,90602702,protein_coding,1,18043,chr3_90584659_90602702
S100a4,3,90603771,90606045,protein_coding,1,2274,chr3_90603771_90606045
S100a5,3,90608523,90611780,protein_coding,1,3257,chr3_90608523_90611780
S100a6,3,90612882,90624181,protein_coding,1,11299,chr3_90612882_90624181
S100a7a,3,90654017,90658669,protein_coding,1,4652,chr3_90654017_90658669
S100a8,3,90668978,90670035,protein_coding,1,1057,chr3_90668978_90670035
S100b,10,76253853,76261159,protein_coding,1,7306,chr10_76253853_76261159
S100g,X,162961992,162964599,protein_coding,-1,2607,chrX_162961992_162964599
S100pbp,4,129148005,129189727,protein_coding,-1,41722,chr4_129148005_129189727
S1pr1,3,115710433,115715072,protein_coding,-1,4639,chr3_115710433_115715072
S1pr2,9,20962361,20976781,protein_coding,-1,14420,chr9_20962361_20976781
S1pr3,13,51408639,51422797,protein_coding,1,14158,chr13_51408639_51422797
S1pr4,10,81497747,81500132,protein_coding,-1,2385,chr10_81497747_81500132
S1pr5,9,21242912,21248443,protein_coding,-1,5531,chr9_21242912_21248443
Saal1,7,46686108,46710680,protein_coding,-1,24572,chr7_46686108_46710680
Sac3d1,19,6116000,6118650,protein_coding,-1,2650,chr19_6116000_6118650
Sacm1l,9,123529759,123592600,protein_coding,1,62841,chr9_123529759_123592600
Sacs,14,61138457,61240695,protein_coding,1,102238,chr14_61138457_61240695
Sae1,7,16320234,16387806,protein_coding,-1,67572,chr7_16320234_16387806
Safb,17,56584825,56606294,protein_coding,1,21469,chr17_56584825_56606294
Safb2,17,56560965,56584585,protein_coding,-1,23620,chr17_56560965_56584585
Sag,1,87803680,87845158,protein_coding,1,41478,chr1_87803680_87845158
Sall1,8,89027235,89044162,protein_coding,-1,16927,chr8_89027235_89044162
Sall2,14,52311172,52328762,protein_coding,-1,17590,chr14_52311172_52328762
Sall3,18,80966376,80986771,protein_coding,-1,20395,chr18_80966376_80986771
Sall4,2,168748332,168767943,protein_coding,-1,19611,chr2_168748332_168767943
Samd1,8,83997501,84000409,protein_coding,1,2908,chr8_83997501_84000409
Samd10,2,181595218,181599212,protein_coding,-1,3994,chr2_181595218_181599212
Samd11,4,156246966,156255657,protein_coding,-1,8691,chr4_156246966_156255657
Samd12,15,53453810,53902537,protein_coding,-1,448727,chr15_53453810_53902537
Samd14,11,95009879,95026087,protein_coding,1,16208,chr11_95009879_95026087
Samd15,12,87199723,87213541,protein_coding,1,13818,chr12_87199723_87213541
Samd3,10,26229707,26272172,protein_coding,1,42465,chr10_26229707_26272172
Samd4,14,46882854,47105815,protein_coding,1,222961,chr14_46882854_47105815
Samd4b,7,28399522,28598144,protein_coding,-1,198622,chr7_28399522_28598144
Samd5,10,9622936,9675208,protein_coding,-1,52272,chr10_9622936_9675208
Samd7,3,30746293,30767174,protein_coding,1,20881,chr3_30746293_30767174
Samd8,14,21750531,21798726,protein_coding,1,48195,chr14_21750531_21798726
Samd9l,6,3372257,3399572,protein_coding,-1,27315,chr6_3372257_3399572
Samhd1,2,157097533,157135265,protein_coding,-1,37732,chr2_157097533_157135265
Samm50,15,84192241,84217267,protein_coding,1,25026,chr15_84192241_84217267
Samsn1,16,75858793,76022281,protein_coding,-1,163488,chr16_75858793_76022281
Sap130,18,31634371,31723061,protein_coding,1,88690,chr18_31634371_31723061
Sap18,14,57798180,57806638,protein_coding,1,8458,chr14_57798180_57806638
Sap25,5,137641334,137642902,protein_coding,1,1568,chr5_137641334_137642902
Sap30,8,57482707,57487860,protein_coding,-1,5153,chr8_57482707_57487860
Sap30bp,11,115933282,115966725,protein_coding,1,33443,chr11_115933282_115966725
Sap30l,11,57801637,57810217,protein_coding,1,8580,chr11_57801637_57810217
Sapcd1,17,35025959,35028016,protein_coding,-1,2057,chr17_35025959_35028016
Sapcd2,2,25372321,25378213,protein_coding,1,5892,chr2_25372321_25378213
Sar1a,10,61680299,61693297,protein_coding,1,12998,chr10_61680299_61693297
Sar1b,11,51763687,51791925,protein_coding,1,28238,chr11_51763687_51791925
Saraf,8,34154563,34170845,protein_coding,1,16282,chr8_34154563_34170845
Sardh,2,27188393,27248337,protein_coding,-1,59944,chr2_27188393_27248337
Sarm1,11,78472330,78497754,protein_coding,-1,25424,chr11_78472330_78497754
Sarnp,10,128817333,128877629,protein_coding,1,60296,chr10_128817333_128877629
Sars,3,108424865,108445209,protein_coding,-1,20344,chr3_108424865_108445209
Sars2,7,28741992,28753871,protein_coding,1,11879,chr7_28741992_28753871
Sart1,19,5377523,5388703,protein_coding,-1,11180,chr19_5377523_5388703
Sart3,5,113742446,113772510,protein_coding,-1,30064,chr5_113742446_113772510
Sash1,10,8722219,8886070,protein_coding,-1,163851,chr10_8722219_8886070
Sash3,X,48146436,48161565,protein_coding,1,15129,chrX_48146436_48161565
Sass6,3,116594982,116631004,protein_coding,1,36022,chr3_116594982_116631004
Sat1,X,155213132,155216449,protein_coding,-1,3317,chrX_155213132_155216449
Sat2,11,69622024,69623870,protein_coding,1,1846,chr11_69622024_69623870
Satb1,17,51736187,51833290,protein_coding,-1,97103,chr17_51736187_51833290
Satb2,1,56793981,56978650,protein_coding,-1,184669,chr1_56793981_56978650
Satl1,X,112384303,112406779,protein_coding,-1,22476,chrX_112384303_112406779
Sav1,12,69965012,69987002,protein_coding,-1,21990,chr12_69965012_69987002
Saysd1,14,20075636,20138534,protein_coding,-1,62898,chr14_20075636_20138534
Sbds,5,130245731,130255530,protein_coding,-1,9799,chr5_130245731_130255530
Sbf1,15,89288236,89315311,protein_coding,-1,27075,chr15_89288236_89315311
Sbf2,7,110308013,110614922,protein_coding,-1,306909,chr7_110308013_110614922
Sbk1,7,126248862,126295016,protein_coding,1,46154,chr7_126248862_126295016
Sbk2,7,4940512,4964406,protein_coding,-1,23894,chr7_4940512_4964406
Sbk3,7,4965260,4971168,protein_coding,-1,5908,chr7_4965260_4971168
Sbno1,5,124368702,124426001,protein_coding,-1,57299,chr5_124368702_124426001
Sbno2,10,80056992,80105571,protein_coding,-1,48579,chr10_80056992_80105571
Sbsn,7,30751471,30756134,protein_coding,1,4663,chr7_30751471_30756134
Sbspon,1,15853862,15892722,protein_coding,-1,38860,chr1_15853862_15892722
Sc5d,9,42251595,42264256,protein_coding,-1,12661,chr9_42251595_42264256
Scaf1,7,45002948,45016363,protein_coding,-1,13415,chr7_45002948_45016363
Scaf11,15,96411699,96460843,protein_coding,-1,49144,chr15_96411699_96460843
Scaf4,16,90225680,90284503,protein_coding,-1,58823,chr16_90225680_90284503
Scaf8,17,3114972,3198859,protein_coding,1,83887,chr17_3114972_3198859
Scai,2,39066214,39190734,protein_coding,-1,124520,chr2_39066214_39190734
Scamp1,13,94201310,94285857,protein_coding,-1,84547,chr13_94201310_94285857
Scamp2,9,57560943,57588795,protein_coding,1,27852,chr9_57560943_57588795
Scamp3,3,89177473,89182765,protein_coding,1,5292,chr3_89177473_89182765
Scamp4,10,80602872,80615783,protein_coding,1,12911,chr10_80602872_80615783
Scamp5,9,57441327,57468060,protein_coding,-1,26733,chr9_57441327_57468060
Scand1,2,156311846,156312747,protein_coding,-1,901,chr2_156311846_156312747
Scap,9,110333288,110384950,protein_coding,1,51662,chr9_110333288_110384950
Scaper,9,55549879,55938119,protein_coding,-1,388240,chr9_55549879_55938119
Scara3,14,65919394,65953935,protein_coding,-1,34541,chr14_65919394_65953935
Scara5,14,65666403,65764826,protein_coding,1,98423,chr14_65666403_65764826
Scarb1,5,125277087,125341094,protein_coding,-1,64007,chr5_125277087_125341094
Scarb2,5,92441314,92506833,protein_coding,-1,65519,chr5_92441314_92506833
Scarf1,11,75513540,75526582,protein_coding,1,13042,chr11_75513540_75526582
Scarf2,16,17797282,17808293,protein_coding,1,11011,chr16_17797282_17808293
Scarna10,6,125186359,125186683,snoRNA,-1,324,chr6_125186359_125186683
Scarna13,12,105031075,105031349,scaRNA,-1,274,chr12_105031075_105031349
Scarna17,18,74778391,74778469,scaRNA,-1,78,chr18_74778391_74778469
Scarna2,3,108554338,108554751,scaRNA,-1,413,chr3_108554338_108554751
Scarna3a,1,159340283,159340422,scaRNA,1,139,chr1_159340283_159340422
Scarna3b,12,80391613,80391751,scaRNA,-1,138,chr12_80391613_80391751
Scarna6,1,87784556,87784820,scaRNA,1,264,chr1_87784556_87784820
Scarna8,4,86586453,86586583,scaRNA,-1,130,chr4_86586453_86586583
Scarna9,9,15326264,15326333,snoRNA,-1,69,chr9_15326264_15326333
Sccpdh,1,179668210,179687189,protein_coding,1,18979,chr1_179668210_179687189
Scd1,19,44394455,44407879,protein_coding,-1,13424,chr19_44394455_44407879
Scd2,19,44293674,44306864,protein_coding,1,13190,chr19_44293674_44306864
Scd3,19,44203269,44244016,protein_coding,1,40747,chr19_44203269_44244016
Scd4,19,44333092,44346743,protein_coding,1,13651,chr19_44333092_44346743
Scel,14,103513342,103612797,protein_coding,1,99455,chr14_103513342_103612797
Scfd1,12,51377510,51450101,protein_coding,1,72591,chr12_51377510_51450101
Scfd2,5,74204816,74531759,protein_coding,-1,326943,chr5_74204816_74531759
Scg2,1,79434669,79440120,protein_coding,-1,5451,chr1_79434669_79440120
Scg3,9,75643189,75684056,protein_coding,-1,40867,chr9_75643189_75684056
Scg5,2,113776362,113829121,protein_coding,-1,52759,chr2_113776362_113829121
Scgb1b30,7,34095431,34100837,protein_coding,1,5406,chr7_34095431_34100837
Scgb3a1,11,49663610,49665118,protein_coding,1,1508,chr11_49663610_49665118
Scgn,13,23953456,23991214,protein_coding,-1,37758,chr13_23953456_23991214
Schip1,3,68064802,68626481,protein_coding,1,561679,chr3_68064802_68626481
Scimp,11,70790932,70812586,protein_coding,-1,21654,chr11_70790932_70812586
Scin,12,40059769,40134228,protein_coding,-1,74459,chr12_40059769_40134228
Sclt1,3,41626720,41742514,protein_coding,-1,115794,chr3_41626720_41742514
Scly,1,91298338,91321075,protein_coding,1,22737,chr1_91298338_91321075
Scmh1,4,120405281,120530186,protein_coding,1,124905,chr4_120405281_120530186
Scml1,X,161814690,161832176,transcribed_unitary_pseudogene,-1,17486,chrX_161814690_161832176
Scml2,X,161082525,161258213,protein_coding,1,175688,chrX_161082525_161258213
Scml4,10,42860370,42960780,protein_coding,1,100410,chr10_42860370_42960780
Scn10a,9,119608456,119719322,protein_coding,-1,110866,chr9_119608456_119719322
Scn11a,9,119753759,119825456,protein_coding,-1,71697,chr9_119753759_119825456
Scn1a,2,66270778,66440840,protein_coding,-1,170062,chr2_66270778_66440840
Scn1b,7,31116524,31127003,protein_coding,-1,10479,chr7_31116524_31127003
Scn2b,9,45117782,45130070,protein_coding,1,12288,chr9_45117782_45130070
Scn3a,2,65457118,65567627,protein_coding,-1,110509,chr2_65457118_65567627
Scn3b,9,40269217,40291618,protein_coding,1,22401,chr9_40269217_40291618
Scn4a,11,106318592,106353288,protein_coding,-1,34696,chr11_106318592_106353288
Scn4b,9,45138395,45154152,protein_coding,1,15757,chr9_45138395_45154152
Scn5a,9,119483408,119579016,protein_coding,-1,95608,chr9_119483408_119579016
Scn7a,2,66673425,66784914,protein_coding,-1,111489,chr2_66673425_66784914
Scn8a,15,100869858,101045938,protein_coding,1,176080,chr15_100869858_101045938
Scn9a,2,66480080,66634962,protein_coding,-1,154882,chr2_66480080_66634962
Scnm1,3,95129536,95134011,protein_coding,-1,4475,chr3_95129536_95134011
Scnn1a,6,125320659,125344943,protein_coding,1,24284,chr6_125320659_125344943
Scnn1g,7,121734479,121768475,protein_coding,1,33996,chr7_121734479_121768475
Sco1,11,67052670,67067070,protein_coding,1,14400,chr11_67052670_67067070
Scoc,8,83430084,83458391,protein_coding,-1,28307,chr8_83430084_83458391
Scp2,4,108043839,108144998,protein_coding,-1,101159,chr4_108043839_108144998
Scp2-ps1,3,155514441,155515311,unprocessed_pseudogene,1,870,chr3_155514441_155515311
Scp2-ps2,9,123306600,123317998,transcribed_unprocessed_pseudogene,-1,11398,chr9_123306600_123317998
Scpep1,11,88924020,88955465,protein_coding,-1,31445,chr11_88924020_88955465
Scpep1os,11,88905928,88936061,antisense,1,30133,chr11_88905928_88936061
Scrg1,8,57455923,57477585,protein_coding,1,21662,chr8_57455923_57477585
Scrib,15,76047158,76069784,protein_coding,-1,22626,chr15_76047158_76069784
Scrn1,6,54501173,54566489,protein_coding,-1,65316,chr6_54501173_54566489
Scrn2,11,97029938,97033958,protein_coding,1,4020,chr11_97029938_97033958
Scrn3,2,73312601,73337818,protein_coding,1,25217,chr2_73312601_73337818
Scrt1,15,76516203,76522499,protein_coding,-1,6296,chr15_76516203_76522499
Scrt2,2,152081529,152095802,protein_coding,1,14273,chr2_152081529_152095802
Sct,7,141278330,141279133,protein_coding,-1,803,chr7_141278330_141279133
Sctr,1,120006894,120063536,protein_coding,1,56642,chr1_120006894_120063536
Scube1,15,83604999,83725021,protein_coding,-1,120022,chr15_83604999_83725021
Scube2,7,109798676,109865679,protein_coding,-1,67003,chr7_109798676_109865679
Scube3,17,28142141,28174854,protein_coding,1,32713,chr17_28142141_28174854
Scx,15,76457452,76459458,protein_coding,1,2006,chr15_76457452_76459458
Scyl1,19,5758351,5771419,protein_coding,-1,13068,chr19_5758351_5771419
Scyl2,10,89638721,89686285,protein_coding,-1,47564,chr10_89638721_89686285
Scyl3,1,163929100,163955126,protein_coding,1,26026,chr1_163929100_163955126
Sdad1,5,92284010,92310479,protein_coding,-1,26469,chr5_92284010_92310479
Sdc1,12,8771323,8793715,protein_coding,1,22392,chr12_8771323_8793715
Sdc2,15,32920723,33034935,protein_coding,1,114212,chr15_32920723_33034935
Sdc3,4,130792537,130826319,protein_coding,1,33782,chr4_130792537_130826319
Sdc4,2,164424247,164443887,protein_coding,-1,19640,chr2_164424247_164443887
Sdcbp,4,6365650,6408423,protein_coding,1,42773,chr4_6365650_6408423
Sdcbp2,2,151572622,151590005,protein_coding,1,17383,chr2_151572622_151590005
Sdccag8,1,176814660,177020437,protein_coding,1,205777,chr1_176814660_177020437
Sde2,1,180851127,180868113,protein_coding,1,16986,chr1_180851127_180868113
Sdf2,11,78245746,78255496,protein_coding,1,9750,chr11_78245746_78255496
Sdf2l1,16,17130138,17132383,protein_coding,-1,2245,chr16_17130138_17132383
Sdf4,4,155992872,156013610,protein_coding,1,20738,chr4_155992872_156013610
Sdha,13,74322254,74350280,protein_coding,-1,28026,chr13_74322254_74350280
Sdhaf1,7,30321406,30323895,protein_coding,-1,2489,chr7_30321406_30323895
Sdhaf2,19,10500534,10526142,protein_coding,-1,25608,chr19_10500534_10526142
Sdhb,4,140961203,140979193,protein_coding,1,17990,chr4_140961203_140979193
Sdhc,1,171127165,171150603,protein_coding,-1,23438,chr1_171127165_171150603
Sdhd,9,50596357,50603812,protein_coding,-1,7455,chr9_50596357_50603812
Sdk1,5,141241490,142215586,protein_coding,1,974096,chr5_141241490_142215586
Sdk2,11,113776374,114067046,protein_coding,-1,290672,chr11_113776374_114067046
Sdr39u1,14,55897283,55900293,protein_coding,-1,3010,chr14_55897283_55900293
Sdr42e1,8,117661399,117673689,protein_coding,-1,12290,chr8_117661399_117673689
Sdr9c7,10,127898518,127911761,protein_coding,1,13243,chr10_127898518_127911761
Sds,5,120476526,120483932,protein_coding,1,7406,chr5_120476526_120483932
Sdsl,5,120458186,120472810,protein_coding,-1,14624,chr5_120458186_120472810
Sebox,11,78503447,78505081,protein_coding,1,1634,chr11_78503447_78505081
Sec1,7,45677686,45694402,protein_coding,-1,16716,chr7_45677686_45694402
Sec11a,7,80904889,80947780,protein_coding,-1,42891,chr7_80904889_80947780
Sec11c,18,65800515,65817684,protein_coding,1,17169,chr18_65800515_65817684
Sec13,6,113728062,113740743,protein_coding,-1,12681,chr6_113728062_113740743
Sec14l1,11,117115168,117159268,protein_coding,1,44100,chr11_117115168_117159268
Sec14l2,11,4097039,4123415,protein_coding,-1,26376,chr11_4097039_4123415
Sec14l3,11,4064841,4077736,protein_coding,1,12895,chr11_4064841_4077736
Sec14l4,11,4031462,4048024,protein_coding,1,16562,chr11_4031462_4048024
Sec14l5,16,5147109,5187271,protein_coding,1,40162,chr16_5147109_5187271
Sec16a,2,26409431,26445216,protein_coding,-1,35785,chr2_26409431_26445216
Sec16b,1,157506728,157568425,protein_coding,1,61697,chr1_157506728_157568425
Sec22a,16,35311131,35363918,protein_coding,-1,52787,chr16_35311131_35363918
Sec22b,3,97901190,97923276,protein_coding,1,22086,chr3_97901190_97923276
Sec22c,9,121680045,121705490,protein_coding,-1,25445,chr9_121680045_121705490
Sec23a,12,58958383,59012017,protein_coding,-1,53634,chr12_58958383_59012017
Sec23b,2,144556229,144590749,protein_coding,1,34520,chr2_144556229_144590749
Sec23ip,7,128744943,128784836,protein_coding,1,39893,chr7_128744943_128784836
Sec24a,11,51692264,51763634,protein_coding,-1,71370,chr11_51692264_51763634
Sec24b,3,129982759,130061553,protein_coding,-1,78794,chr3_129982759_130061553
Sec24c,14,20674308,20694852,protein_coding,1,20544,chr14_20674308_20694852
Sec24d,3,123267455,123365641,protein_coding,1,98186,chr3_123267455_123365641
Sec31a,5,100361649,100416234,protein_coding,-1,54585,chr5_100361649_100416234
Sec31b,19,44516957,44545864,protein_coding,-1,28907,chr19_44516957_44545864
Sec61a1,6,88503579,88518905,protein_coding,-1,15326,chr6_88503579_88518905
Sec61a2,2,5870987,5895432,protein_coding,-1,24445,chr2_5870987_5895432
Sec61b,4,47474658,47483242,protein_coding,1,8584,chr4_47474658_47483242
Sec61g,11,16500530,16508484,protein_coding,-1,7954,chr11_16500530_16508484
Sec62,3,30792875,30821263,protein_coding,1,28388,chr3_30792875_30821263
Sec63,10,42761496,42832514,protein_coding,1,71018,chr10_42761496_42832514
Secisbp2,13,51651697,51684044,protein_coding,1,32347,chr13_51651697_51684044
Secisbp2l,2,125736986,125782870,protein_coding,-1,45884,chr2_125736986_125782870
Sectm1a,11,121067407,121081220,protein_coding,-1,13813,chr11_121067407_121081220
Seh1l,18,67774876,67795487,protein_coding,1,20611,chr18_67774876_67795487
Sel1l,12,91806043,91849157,protein_coding,-1,43114,chr12_91806043_91849157
Sel1l2,2,140229855,140389706,protein_coding,-1,159851,chr2_140229855_140389706
Sel1l3,5,53107083,53213927,protein_coding,-1,106844,chr5_53107083_53213927
Sele,1,164048234,164057677,protein_coding,1,9443,chr1_164048234_164057677
Selenbp1,3,94933056,94944758,protein_coding,1,11702,chr3_94933056_94944758
Selenbp2,3,94693556,94704413,protein_coding,1,10857,chr3_94693556_94704413
Sell,1,164061982,164084181,protein_coding,1,22199,chr1_164061982_164084181
Selp,1,164115264,164150026,protein_coding,1,34762,chr1_164115264_164150026
Selplg,5,113818536,113832644,protein_coding,-1,14108,chr5_113818536_113832644
Sema3a,5,13125414,13602565,protein_coding,1,477151,chr5_13125414_13602565
Sema3b,9,107597674,107609229,protein_coding,-1,11555,chr9_107597674_107609229
Sema3c,5,17574281,17730268,protein_coding,1,155987,chr5_17574281_17730268
Sema3d,5,12383385,12588948,protein_coding,1,205563,chr5_12383385_12588948
Sema3e,5,14025276,14256689,protein_coding,1,231413,chr5_14025276_14256689
Sema3f,9,107681500,107710475,protein_coding,-1,28975,chr9_107681500_107710475
Sema3g,14,31217860,31230352,protein_coding,1,12492,chr14_31217860_31230352
Sema4a,3,88435959,88461182,protein_coding,-1,25223,chr3_88435959_88461182
Sema4b,7,80186841,80226527,protein_coding,1,39686,chr7_80186841_80226527
Sema4c,1,36548639,36558349,protein_coding,-1,9710,chr1_36548639_36558349
Sema4d,13,51685529,51793747,protein_coding,-1,108218,chr13_51685529_51793747
Sema4f,6,82911885,82939769,protein_coding,-1,27884,chr6_82911885_82939769
Sema4g,19,44989101,45003397,protein_coding,1,14296,chr19_44989101_45003397
Sema5a,15,32244810,32696341,protein_coding,1,451531,chr15_32244810_32696341
Sema5b,16,35541145,35664732,protein_coding,1,123587,chr16_35541145_35664732
Sema6a,18,47235598,47368870,protein_coding,-1,133272,chr18_47235598_47368870
Sema6b,17,56123085,56140343,protein_coding,-1,17258,chr17_56123085_56140343
Sema6c,3,95160457,95174024,protein_coding,1,13567,chr3_95160457_95174024
Sema6d,2,124089969,124667770,protein_coding,1,577801,chr2_124089969_124667770
Sema7a,9,57940112,57962865,protein_coding,1,22753,chr9_57940112_57962865
Senp1,15,98038744,98093744,protein_coding,-1,55000,chr15_98038744_98093744
Senp2,16,22009484,22049269,protein_coding,1,39785,chr16_22009484_22049269
Senp3,11,69673115,69682084,protein_coding,-1,8969,chr11_69673115_69682084
Senp5,16,31959672,32003287,protein_coding,-1,43615,chr16_31959672_32003287
Senp6,9,80066903,80144953,protein_coding,1,78050,chr9_80066903_80144953
Senp7,16,56048338,56190012,protein_coding,1,141674,chr16_56048338_56190012
Senp8,9,59734259,59750710,protein_coding,-1,16451,chr9_59734259_59750710
Sephs1,2,4881564,4910557,protein_coding,1,28993,chr2_4881564_4910557
Sephs2,7,127271879,127274055,protein_coding,-1,2176,chr7_127271879_127274055
Sepsecs,5,52640087,52669708,protein_coding,-1,29621,chr5_52640087_52669708
Serac1,17,6042196,6079741,protein_coding,-1,37545,chr17_6042196_6079741
Serbp1,6,67238176,67297736,protein_coding,1,59560,chr6_67238176_67297736
Serf1,13,100108012,100114571,protein_coding,1,6559,chr13_100108012_100114571
Serf2,2,121449195,121458313,protein_coding,1,9118,chr2_121449195_121458313
Sergef,7,46443154,46639807,protein_coding,-1,196653,chr7_46443154_46639807
Serhl,15,83089506,83116674,protein_coding,1,27168,chr15_83089506_83116674
Serinc1,10,57515774,57532530,protein_coding,-1,16756,chr10_57515774_57532530
Serinc2,4,130253495,130279205,protein_coding,-1,25710,chr4_130253495_130279205
Serinc3,2,163623272,163645131,protein_coding,-1,21859,chr2_163623272_163645131
Serinc4,2,121439059,121456781,protein_coding,-1,17722,chr2_121439059_121456781
Serinc5,13,92611091,92711947,protein_coding,1,100856,chr13_92611091_92711947
Serp1,3,58519817,58525892,protein_coding,-1,6075,chr3_58519817_58525892
Serp2,14,76532814,76556889,protein_coding,-1,24075,chr14_76532814_76556889
Serpina10,12,103614786,103631444,protein_coding,-1,16658,chr12_103614786_103631444
Serpina11,12,103980243,103989957,protein_coding,-1,9714,chr12_103980243_103989957
Serpina12,12,104028769,104044443,protein_coding,-1,15674,chr12_104028769_104044443
Serpina3b,12,104127996,104139545,protein_coding,1,11549,chr12_104127996_104139545
Serpina3c,12,104146382,104153870,protein_coding,-1,7488,chr12_104146382_104153870
Serpina3e-ps,12,104189517,104192926,unprocessed_pseudogene,-1,3409,chr12_104189517_104192926
Serpina3f,12,104214544,104221129,protein_coding,1,6585,chr12_104214544_104221129
Serpina3g,12,104236245,104241939,protein_coding,1,5694,chr12_104236245_104241939
Serpina3h,12,104247905,104253669,transcribed_unprocessed_pseudogene,1,5764,chr12_104247905_104253669
Serpina3i,12,104263122,104269372,protein_coding,1,6250,chr12_104263122_104269372
Serpina3m,12,104338486,104394257,protein_coding,1,55771,chr12_104338486_104394257
Serpina3n,12,104406729,104414329,protein_coding,1,7600,chr12_104406729_104414329
Serpina4-ps1,12,104080649,104086724,unprocessed_pseudogene,1,6075,chr12_104080649_104086724
Serpina9,12,103994743,104013755,protein_coding,-1,19012,chr12_103994743_104013755
Serpinb1-ps1,13,32859959,32863170,unprocessed_pseudogene,-1,3211,chr13_32859959_32863170
Serpinb10,1,107529003,107549271,polymorphic_pseudogene,1,20268,chr1_107529003_107549271
Serpinb11,1,107361198,107380475,protein_coding,1,19277,chr1_107361198_107380475
Serpinb1a,13,32842092,32851185,protein_coding,-1,9093,chr13_32842092_32851185
Serpinb1b,13,33078575,33094380,protein_coding,1,15805,chr13_33078575_33094380
Serpinb1c,13,32881434,32898211,protein_coding,-1,16777,chr13_32881434_32898211
Serpinb5,1,106861173,106883348,protein_coding,1,22175,chr1_106861173_106883348
Serpinb6a,13,33917918,34002794,protein_coding,-1,84876,chr13_33917918_34002794
Serpinb6b,13,32965209,32979067,protein_coding,1,13858,chr13_32965209_32979067
Serpinb6c,13,33879816,33905708,protein_coding,-1,25892,chr13_33879816_33905708
Serpinb6e,13,33832345,33843408,protein_coding,-1,11063,chr13_33832345_33843408
Serpinb7,1,107399655,107452689,protein_coding,1,53034,chr1_107399655_107452689
Serpinb8,1,107590006,107610484,protein_coding,1,20478,chr1_107590006_107610484
Serpinb9,13,33003250,33017957,protein_coding,1,14707,chr13_33003250_33017957
Serpinc1,1,160978585,161005863,protein_coding,1,27278,chr1_160978585_161005863
Serpind1,16,17331371,17343575,protein_coding,1,12204,chr16_17331371_17343575
Serpine1,5,137061504,137072268,protein_coding,-1,10764,chr5_137061504_137072268
Serpine2,1,79794197,79861180,protein_coding,-1,66983,chr1_79794197_79861180
Serpine3,14,62663667,62692243,protein_coding,1,28576,chr14_62663667_62692243
Serpinf1,11,75409769,75422701,protein_coding,-1,12932,chr11_75409769_75422701
Serpinf2,11,75431732,75439591,protein_coding,-1,7859,chr11_75431732_75439591
Serping1,2,84765387,84775444,protein_coding,-1,10057,chr2_84765387_84775444
Serpinh1,7,99345376,99353239,protein_coding,-1,7863,chr7_99345376_99353239
Serpini1,3,75557547,75643495,protein_coding,1,85948,chr3_75557547_75643495
Serpini2,3,75242370,75270078,protein_coding,-1,27708,chr3_75242370_75270078
Sertad1,7,27486910,27490316,protein_coding,1,3406,chr7_27486910_27490316
Sertad2,11,20543253,20653021,protein_coding,1,109768,chr11_20543253_20653021
Sertad3,7,27473768,27477364,protein_coding,1,3596,chr7_27473768_27477364
Sertad4,1,192844488,192855756,protein_coding,-1,11268,chr1_192844488_192855756
Sertm1,3,54897068,54915887,protein_coding,-1,18819,chr3_54897068_54915887
Sesn1,10,41809935,41908424,protein_coding,1,98489,chr10_41809935_41908424
Sesn2,4,132492032,132510501,protein_coding,-1,18469,chr4_132492032_132510501
Sesn3,9,14275067,14333101,protein_coding,1,58034,chr9_14275067_14333101
Sestd1,2,77180340,77280592,protein_coding,-1,100252,chr2_77180340_77280592
Set,2,30057378,30072577,protein_coding,1,15199,chr2_30057378_30072577
Setbp1,18,78750380,79109391,protein_coding,-1,359011,chr18_78750380_79109391
Setd1a,7,127776670,127800122,protein_coding,1,23452,chr7_127776670_127800122
Setd1b,5,123142193,123168629,protein_coding,1,26436,chr5_123142193_123168629
Setd2,9,110532597,110618633,protein_coding,1,86036,chr9_110532597_110618633
Setd3,12,108106431,108179314,protein_coding,-1,72883,chr12_108106431_108179314
Setd4,16,93583457,93604063,protein_coding,-1,20606,chr16_93583457_93604063
Setd5,6,113077365,113153435,protein_coding,1,76070,chr6_113077365_113153435
Setd6,8,95715881,95719010,protein_coding,1,3129,chr8_95715881_95719010
Setd7,3,51515319,51560879,protein_coding,-1,45560,chr3_51515319_51560879
Setdb1,3,95323525,95357202,protein_coding,-1,33677,chr3_95323525_95357202
Setdb2,14,59402009,59440884,protein_coding,-1,38875,chr14_59402009_59440884
Setmar,6,108065045,108077122,protein_coding,1,12077,chr6_108065045_108077122
Setx,2,29124181,29182471,protein_coding,1,58290,chr2_29124181_29182471
Sez6,11,77930800,77979048,protein_coding,1,48248,chr11_77930800_77979048
Sez6l,5,112419151,112577185,protein_coding,-1,158034,chr5_112419151_112577185
Sez6l2,7,126950563,126970606,protein_coding,1,20043,chr7_126950563_126970606
Sf1,19,6363690,6378030,protein_coding,1,14340,chr19_6363690_6378030
Sf3a1,11,4160350,4182541,protein_coding,1,22191,chr11_4160350_4182541
Sf3a2,10,80798198,80804924,protein_coding,1,6726,chr10_80798198_80804924
Sf3a3,4,124714776,124732460,protein_coding,1,17684,chr4_124714776_124732460
Sf3b1,1,54985169,55027481,protein_coding,-1,42312,chr1_54985169_55027481
Sf3b2,19,5273932,5295455,protein_coding,-1,21523,chr19_5273932_5295455
Sf3b3,8,110810239,110846787,protein_coding,-1,36548,chr8_110810239_110846787
Sf3b4,3,96172332,96177564,protein_coding,1,5232,chr3_96172332_96177564
Sf3b5,10,13005343,13009183,protein_coding,1,3840,chr10_13005343_13009183
Sf3b6,12,4817544,4827659,protein_coding,1,10115,chr12_4817544_4827659
Sfi1,11,3131850,3193463,protein_coding,-1,61613,chr11_3131850_3193463
Sfmbt1,14,30714849,30822721,protein_coding,1,107872,chr14_30714849_30822721
Sfmbt2,2,10370510,10595253,protein_coding,1,224743,chr2_10370510_10595253
Sfn,4,133600556,133602168,protein_coding,-1,1612,chr4_133600556_133602168
Sfpq,4,127021324,127037013,protein_coding,1,15689,chr4_127021324_127037013
Sfr1,19,47731682,47735588,protein_coding,1,3906,chr19_47731682_47735588
Sfrp1,8,23411502,23449632,protein_coding,1,38130,chr8_23411502_23449632
Sfrp2,3,83766321,83774316,protein_coding,1,7995,chr3_83766321_83774316
Sfrp4,13,19623104,19632994,protein_coding,1,9890,chr13_19623104_19632994
Sfrp5,19,42197971,42202252,protein_coding,-1,4281,chr19_42197971_42202252
Sfswap,5,129501221,129571384,protein_coding,1,70163,chr5_129501221_129571384
Sft2d1,17,8311102,8327442,protein_coding,1,16340,chr17_8311102_8327442
Sft2d2,1,165174337,165194438,protein_coding,-1,20101,chr1_165174337_165194438
Sft2d3,18,31909098,31911824,protein_coding,-1,2726,chr18_31909098_31911824
Sfta2,17,35601549,35650571,protein_coding,1,49022,chr17_35601549_35650571
Sftpb,6,72304610,72314372,protein_coding,1,9762,chr6_72304610_72314372
Sftpc,14,70520949,70524081,protein_coding,-1,3132,chr14_70520949_70524081
Sftpd,14,41172214,41185149,protein_coding,-1,12935,chr14_41172214_41185149
Sfxn1,13,54071869,54108342,protein_coding,1,36473,chr13_54071869_54108342
Sfxn2,19,46573365,46598066,protein_coding,1,24701,chr19_46573365_46598066
Sfxn3,19,45047503,45056383,protein_coding,1,8880,chr19_45047503_45056383
Sfxn4,19,60837277,60861479,protein_coding,-1,24202,chr19_60837277_60861479
Sfxn5,6,85213049,85333422,protein_coding,-1,120373,chr6_85213049_85333422
Sgca,11,94962791,94976327,protein_coding,-1,13536,chr11_94962791_94976327
Sgcb,5,73632749,73647790,protein_coding,-1,15041,chr5_73632749_73647790
Sgcd,11,46896253,47988969,protein_coding,-1,1092716,chr11_46896253_47988969
Sgce,6,4674350,4747207,protein_coding,-1,72857,chr6_4674350_4747207
Sgcg,14,61219115,61258490,protein_coding,-1,39375,chr14_61219115_61258490
Sgcz,8,37522298,38661508,protein_coding,-1,1139210,chr8_37522298_38661508
Sgip1,4,102741297,102973628,protein_coding,1,232331,chr4_102741297_102973628
Sgk1,10,21882184,21999903,protein_coding,1,117719,chr10_21882184_21999903
Sgk2,2,162987330,163014127,protein_coding,1,26797,chr2_162987330_163014127
Sgk3,1,9798107,9900845,protein_coding,1,102738,chr1_9798107_9900845
Sgms1,19,32122727,32389714,protein_coding,-1,266987,chr19_32122727_32389714
Sgms2,3,131318985,131491411,protein_coding,-1,172426,chr3_131318985_131491411
Sgpl1,10,61098642,61147703,protein_coding,-1,49061,chr10_61098642_61147703
Sgpp1,12,75714249,75735729,protein_coding,-1,21480,chr12_75714249_75735729
Sgpp2,1,78310345,78420289,protein_coding,1,109944,chr1_78310345_78420289
Sgsh,11,119343425,119355536,protein_coding,-1,12111,chr11_119343425_119355536
Sgsm1,5,113243220,113310786,protein_coding,-1,67566,chr5_113243220_113310786
Sgsm2,11,74849261,74897060,protein_coding,-1,47799,chr11_74849261_74897060
Sgsm3,15,80977765,81012290,protein_coding,1,34525,chr15_80977765_81012290
Sgta,10,81044075,81060181,protein_coding,-1,16106,chr10_81044075_81060181
Sgtb,13,104109741,104141735,protein_coding,1,31994,chr13_104109741_104141735
Sh2b1,7,126466994,126475424,protein_coding,-1,8430,chr7_126466994_126475424
Sh2b2,5,136218147,136246556,protein_coding,-1,28409,chr5_136218147_136246556
Sh2b3,5,121815488,121837646,protein_coding,-1,22158,chr5_121815488_121837646
Sh2d1a,X,42502453,42529330,protein_coding,1,26877,chrX_42502453_42529330
Sh2d2a,3,87846755,87855722,protein_coding,1,8967,chr3_87846755_87855722
Sh2d3c,2,32721055,32755512,protein_coding,1,34457,chr2_32721055_32755512
Sh2d4a,8,68276567,68347699,protein_coding,1,71132,chr8_68276567_68347699
Sh2d4b,14,40813789,40893266,protein_coding,-1,79477,chr14_40813789_40893266
Sh2d5,4,138250403,138261332,protein_coding,1,10929,chr4_138250403_138261332
Sh2d6,6,72513641,72521707,protein_coding,-1,8066,chr6_72513641_72521707
Sh2d7,9,54534146,54545020,protein_coding,1,10874,chr9_54534146_54545020
Sh3bgr,16,96200450,96228935,protein_coding,1,28485,chr16_96200450_96228935
Sh3bgrl,X,109095365,109197873,protein_coding,1,102508,chrX_109095365_109197873
Sh3bgrl2,9,83548327,83638801,protein_coding,1,90474,chr9_83548327_83638801
Sh3bgrl3,4,134127406,134128789,protein_coding,-1,1383,chr4_134127406_134128789
Sh3bp1,15,78899768,78912051,protein_coding,1,12283,chr15_78899768_78912051
Sh3bp2,5,34525838,34563641,protein_coding,1,37803,chr5_34525838_34563641
Sh3bp4,1,89070415,89155068,protein_coding,1,84653,chr1_89070415_89155068
Sh3bp5,14,31359880,31436078,protein_coding,-1,76198,chr14_31359880_31436078
Sh3bp5l,11,58330724,58347728,protein_coding,1,17004,chr11_58330724_58347728
Sh3d19,3,85971109,86130526,protein_coding,1,159417,chr3_85971109_86130526
Sh3d21,4,126150602,126163491,protein_coding,-1,12889,chr4_126150602_126163491
Sh3d2c-ps1,2,23680218,23681121,processed_pseudogene,1,903,chr2_23680218_23681121
Sh3gl1,17,56016750,56036635,protein_coding,-1,19885,chr17_56016750_56036635
Sh3gl2,4,85205126,85639195,protein_coding,1,434069,chr4_85205126_85639195
Sh3gl3,7,82173840,82307419,protein_coding,1,133579,chr7_82173840_82307419
Sh3glb1,3,144683678,144720335,protein_coding,-1,36657,chr3_144683678_144720335
Sh3glb2,2,30344809,30359337,protein_coding,-1,14528,chr2_30344809_30359337
Sh3kbp1,X,159627272,159978069,protein_coding,1,350797,chrX_159627272_159978069
Sh3pxd2a,19,47260174,47464401,protein_coding,-1,204227,chr19_47260174_47464401
Sh3pxd2b,11,32347820,32428173,protein_coding,1,80353,chr11_32347820_32428173
Sh3rf1,8,61223872,61396071,protein_coding,1,172199,chr8_61223872_61396071
Sh3rf2,18,42053667,42158960,protein_coding,1,105293,chr18_42053667_42158960
Sh3rf3,10,58813359,59138916,protein_coding,1,325557,chr10_58813359_59138916
Sh3tc1,5,35697180,35739987,protein_coding,-1,42807,chr5_35697180_35739987
Sh3tc2,18,61953075,62024402,protein_coding,1,71327,chr18_61953075_62024402
Sh3yl1,12,30911668,30960162,protein_coding,1,48494,chr12_30911668_30960162
Shank1,7,44310253,44360572,protein_coding,1,50319,chr7_44310253_44360572
Shank2,7,144001928,144424494,protein_coding,1,422566,chr7_144001928_144424494
Shank3,15,89499623,89560261,protein_coding,1,60638,chr15_89499623_89560261
Sharpin,15,76347040,76351111,protein_coding,-1,4071,chr15_76347040_76351111
Shb,4,45423278,45532470,protein_coding,-1,109192,chr4_45423278_45532470
Shbg,11,69614804,69617905,protein_coding,-1,3101,chr11_69614804_69617905
Shc1,3,89418443,89430027,protein_coding,1,11584,chr3_89418443_89430027
Shc2,10,79618051,79637918,protein_coding,-1,19867,chr10_79618051_79637918
Shc3,13,51431041,51569487,protein_coding,-1,138446,chr13_51431041_51569487
Shc4,2,125627447,125724148,protein_coding,-1,96701,chr2_125627447_125724148
Shcbp1,8,4735976,4779567,protein_coding,-1,43591,chr8_4735976_4779567
Shcbp1l,1,153425162,153452574,protein_coding,1,27412,chr1_153425162_153452574
Shd,17,55970467,55976625,protein_coding,1,6158,chr17_55970467_55976625
She,3,89831370,89858834,protein_coding,1,27464,chr3_89831370_89858834
Shf,2,122348892,122369162,protein_coding,-1,20270,chr2_122348892_122369162
Shh,5,28456815,28467256,protein_coding,-1,10441,chr5_28456815_28467256
Shisa2,14,59625308,59631660,protein_coding,1,6352,chr14_59625308_59631660
Shisa3,5,67607882,67623552,protein_coding,1,15670,chr5_67607882_67623552
Shisa4,1,135371057,135375237,protein_coding,-1,4180,chr1_135371057_135375237
Shisa5,9,109038565,109057777,protein_coding,1,19212,chr9_109038565_109057777
Shisa6,11,66211725,66525964,protein_coding,-1,314239,chr11_66211725_66525964
Shisa7,7,4825552,4844696,protein_coding,-1,19144,chr7_4825552_4844696
Shisa8,15,82206168,82212815,protein_coding,-1,6647,chr15_82206168_82212815
Shisa9,16,11984113,12270902,protein_coding,1,286789,chr16_11984113_12270902
Shkbp1,7,27342133,27356019,protein_coding,-1,13886,chr7_27342133_27356019
Shmt1,11,60788104,60811718,protein_coding,-1,23614,chr11_60788104_60811718
Shmt2,10,127517123,127522444,protein_coding,-1,5321,chr10_127517123_127522444
Shoc2,19,53944306,54033133,protein_coding,1,88827,chr19_53944306_54033133
Shpk,11,73199460,73224511,protein_coding,1,25051,chr11_73199460_73224511
Shprh,10,11149427,11217595,protein_coding,1,68168,chr10_11149427_11217595
Shq1,6,100568256,100671157,protein_coding,-1,102901,chr6_100568256_100671157
Shroom1,11,53457205,53467766,protein_coding,1,10561,chr11_53457205_53467766
Shroom2,X,152609509,152769465,protein_coding,-1,159956,chrX_152609509_152769465
Shroom3,5,92683435,92965318,protein_coding,1,281883,chr5_92683435_92965318
Shroom4,X,6399854,6637448,protein_coding,1,237594,chrX_6399854_6637448
Siae,9,37555698,37649655,protein_coding,1,93957,chr9_37555698_37649655
Siah1-ps1,19,49868355,49869201,processed_pseudogene,1,846,chr19_49868355_49869201
Siah1-ps2,15,38575805,38576649,processed_pseudogene,-1,844,chr15_38575805_38576649
Siah1a,8,86724007,86745934,protein_coding,-1,21927,chr8_86724007_86745934
Siah1b,X,164070705,164076493,protein_coding,-1,5788,chrX_164070705_164076493
Siah2,3,58674938,58692400,protein_coding,-1,17462,chr3_58674938_58692400
Siah3,14,75455982,75529708,protein_coding,1,73726,chr14_75455982_75529708
Sidt1,16,44240180,44333196,protein_coding,-1,93016,chr16_44240180_44333196
Sidt2,9,45937857,45955258,protein_coding,-1,17401,chr9_45937857_45955258
Sigirr,7,141091175,141100572,protein_coding,-1,9397,chr7_141091175_141100572
Siglec1,2,131069220,131086765,protein_coding,-1,17545,chr2_131069220_131086765
Siglec15,18,77999129,78057395,protein_coding,-1,58266,chr18_77999129_78057395
Siglece,7,43651070,43660161,protein_coding,-1,9091,chr7_43651070_43660161
Siglecf,7,43351341,43359531,protein_coding,1,8190,chr7_43351341_43359531
Siglech,7,55768178,55778925,protein_coding,1,10747,chr7_55768178_55778925
Sigmar1,4,41738493,41756157,protein_coding,-1,17664,chr4_41738493_41756157
Sik1,17,31844250,31855804,protein_coding,-1,11554,chr17_31844250_31855804
Sik2,9,50892801,51009073,protein_coding,-1,116272,chr9_50892801_51009073
Sik3,9,46012820,46224194,protein_coding,1,211374,chr9_46012820_46224194
Sike1,3,102995708,103008459,protein_coding,1,12751,chr3_102995708_103008459
Sil1,18,35266396,35499780,protein_coding,-1,233384,chr18_35266396_35499780
Sim2,16,94084931,94127032,protein_coding,1,42101,chr16_94084931_94127032
Simc1,13,54503779,54551290,protein_coding,1,47511,chr13_54503779_54551290
Sin3a,9,57072040,57128366,protein_coding,1,56326,chr9_57072040_57128366
Sin3b,8,72723285,72758201,protein_coding,1,34916,chr8_72723285_72758201
Sipa1,19,5651185,5663707,protein_coding,-1,12522,chr19_5651185_5663707
Sipa1l1,12,82169320,82451786,protein_coding,1,282466,chr12_82169320_82451786
Sipa1l2,8,125418063,125569808,protein_coding,-1,151745,chr8_125418063_125569808
Sipa1l3,7,29320372,29518641,protein_coding,-1,198269,chr7_29320372_29518641
Sirpa,2,129592835,129632228,protein_coding,1,39393,chr2_129592835_129632228
Sirpb1a,3,15371653,15426520,protein_coding,-1,54867,chr3_15371653_15426520
Sirt1,10,63319005,63381704,protein_coding,-1,62699,chr10_63319005_63381704
Sirt2,7,28766735,28788661,protein_coding,1,21926,chr7_28766735_28788661
Sirt3,7,140863666,140882309,protein_coding,-1,18643,chr7_140863666_140882309
Sirt4,5,115478010,115484725,protein_coding,-1,6715,chr5_115478010_115484725
Sirt5,13,43365496,43395203,protein_coding,1,29707,chr13_43365496_43395203
Sirt6,10,81621785,81627797,protein_coding,-1,6012,chr10_81621785_81627797
Sirt7,11,120618372,120625240,protein_coding,-1,6868,chr11_120618372_120625240
Sis,3,72888557,72967863,protein_coding,-1,79306,chr3_72888557_72967863
Sit1,4,43482081,43483734,protein_coding,-1,1653,chr4_43482081_43483734
Siva1,12,112644679,112649149,protein_coding,1,4470,chr12_112644679_112649149
Six1,12,73040015,73053887,protein_coding,-1,13872,chr12_73040015_73053887
Six3,17,85613608,85629302,protein_coding,1,15694,chr17_85613608_85629302
Six3os1,17,85600651,85618398,processed_transcript,-1,17747,chr17_85600651_85618398
Six4,12,73099609,73113456,protein_coding,-1,13847,chr12_73099609_73113456
Six5,7,19094594,19098549,protein_coding,1,3955,chr7_19094594_19098549
Six6,12,72939892,72944899,protein_coding,1,5007,chr12_72939892_72944899
Ska1,18,74195299,74207818,protein_coding,-1,12519,chr18_74195299_74207818
Ska2,11,87109234,87124635,protein_coding,1,15401,chr11_87109234_87124635
Ska2l-ps,1,150549317,150549676,processed_pseudogene,1,359,chr1_150549317_150549676
Ska3,14,57806561,57826185,protein_coding,-1,19624,chr14_57806561_57826185
Skap1,11,96464593,96759130,protein_coding,1,294537,chr11_96464593_96759130
Skap2,6,51857422,52012549,protein_coding,-1,155127,chr6_51857422_52012549
Ski,4,155154075,155222592,protein_coding,-1,68517,chr4_155154075_155222592
Skida1,2,18040676,18049051,protein_coding,-1,8375,chr2_18040676_18049051
Skil,3,31095058,31122577,protein_coding,1,27519,chr3_31095058_31122577
Skint11,4,114163384,114245028,protein_coding,1,81644,chr4_114163384_114245028
Skint4,4,112072016,112168076,protein_coding,1,96060,chr4_112072016_112168076
Skint5,4,113477891,113999503,protein_coding,-1,521612,chr4_113477891_113999503
Skint8,4,111919392,111950358,protein_coding,1,30966,chr4_111919392_111950358
Skiv2l,17,34839228,34850210,protein_coding,-1,10982,chr17_34839228_34850210
Skiv2l-ps1,17,34769833,34771228,unprocessed_pseudogene,-1,1395,chr17_34769833_34771228
Skor1,9,63138170,63148961,protein_coding,-1,10791,chr9_63138170_63148961
Skor2,18,76856405,76900342,protein_coding,1,43937,chr18_76856405_76900342
Skp1a,11,52231995,52246858,protein_coding,1,14863,chr11_52231995_52246858
Skp2,15,9111985,9155425,protein_coding,-1,43440,chr15_9111985_9155425
Sla,15,66780819,66831829,protein_coding,-1,51010,chr15_66780819_66831829
Sla2,2,156872457,156887192,protein_coding,-1,14735,chr2_156872457_156887192
Slain1,14,103650228,103704907,protein_coding,1,54679,chr14_103650228_103704907
Slain1os,14,103692983,103699442,antisense,-1,6459,chr14_103692983_103699442
Slain2,5,72914304,72978829,protein_coding,1,64525,chr5_72914304_72978829
Slamf1,1,171767127,171801184,protein_coding,1,34057,chr1_171767127_171801184
Slamf6,1,171917515,171953170,protein_coding,1,35655,chr1_171917515_171953170
Slamf8,1,172581758,172590568,protein_coding,-1,8810,chr1_172581758_172590568
Slamf9,1,172475358,172478575,protein_coding,1,3217,chr1_172475358_172478575
Slbp,5,33634952,33652574,protein_coding,-1,17622,chr5_33634952_33652574
Slc10a1,12,80953183,80968705,protein_coding,-1,15522,chr12_80953183_80968705
Slc10a2,8,5083219,5105351,protein_coding,-1,22132,chr8_5083219_5105351
Slc10a3,X,74369217,74373349,protein_coding,-1,4132,chrX_74369217_74373349
Slc10a4,5,73006883,73012955,protein_coding,1,6072,chr5_73006883_73012955
Slc10a5,3,10331734,10335656,protein_coding,-1,3922,chr3_10331734_10335656
Slc10a6,5,103605711,103629403,protein_coding,-1,23692,chr5_103605711_103629403
Slc10a7,8,78509346,78734003,protein_coding,1,224657,chr8_78509346_78734003
Slc11a1,1,74375195,74386062,protein_coding,1,10867,chr1_74375195_74386062
Slc11a2,15,100387898,100425072,protein_coding,-1,37174,chr15_100387898_100425072
Slc12a1,2,125152505,125230002,protein_coding,1,77497,chr2_125152505_125230002
Slc12a2,18,57878678,57946821,protein_coding,1,68143,chr18_57878678_57946821
Slc12a3,8,94329201,94366214,protein_coding,1,37013,chr8_94329201_94366214
Slc12a4,8,105943590,105966097,protein_coding,-1,22507,chr8_105943590_105966097
Slc12a5,2,164960802,164999731,protein_coding,1,38929,chr2_164960802_164999731
Slc12a6,2,112265825,112363163,protein_coding,1,97338,chr2_112265825_112363163
Slc12a7,13,73733094,73816754,protein_coding,1,83660,chr13_73733094_73816754
Slc12a8,16,33517328,33664135,protein_coding,1,146807,chr16_33517328_33664135
Slc12a9,5,137314558,137333597,protein_coding,-1,19039,chr5_137314558_137333597
Slc13a1,6,24088283,24168092,protein_coding,-1,79809,chr6_24088283_24168092
Slc13a2os,11,78394485,78405657,antisense,1,11172,chr11_78394485_78405657
Slc13a3,2,165405028,165473230,protein_coding,-1,68202,chr2_165405028_165473230
Slc13a4,6,35267957,35308131,protein_coding,-1,40174,chr6_35267957_35308131
Slc13a5,11,72241989,72267222,protein_coding,-1,25233,chr11_72241989_72267222
Slc14a1,18,78055606,78142119,protein_coding,-1,86513,chr18_78055606_78142119
Slc14a2,18,78146148,78596942,protein_coding,-1,450794,chr18_78146148_78596942
Slc15a1,14,121459621,121505252,protein_coding,-1,45631,chr14_121459621_121505252
Slc15a2,16,36750177,36784962,protein_coding,-1,34785,chr16_36750177_36784962
Slc15a3,19,10839727,10859362,protein_coding,1,19635,chr19_10839727_10859362
Slc15a4,5,127595664,127632897,protein_coding,-1,37233,chr5_127595664_127632897
Slc15a5,6,137983586,138079916,protein_coding,-1,96330,chr6_137983586_138079916
Slc16a1,3,104638668,104658462,protein_coding,1,19794,chr3_104638668_104658462
Slc16a10,10,40033532,40142258,protein_coding,-1,108726,chr10_40033532_40142258
Slc16a11,11,70212752,70216417,protein_coding,1,3665,chr11_70212752_70216417
Slc16a12,19,34668403,34747289,protein_coding,-1,78886,chr19_34668403_34747289
Slc16a13,11,70216789,70221064,protein_coding,-1,4275,chr11_70216789_70221064
Slc16a14,1,84905898,84935134,protein_coding,-1,29236,chr1_84905898_84935134
Slc16a2,X,103697414,103821983,protein_coding,-1,124569,chrX_103697414_103821983
Slc16a3,11,120948480,120960868,protein_coding,1,12388,chr11_120948480_120960868
Slc16a4,3,107291230,107312115,protein_coding,1,20885,chr3_107291230_107312115
Slc16a5,11,115462474,115474398,protein_coding,1,11924,chr11_115462474_115474398
Slc16a6,11,109450855,109473598,protein_coding,-1,22743,chr11_109450855_109473598
Slc16a7,10,125219270,125389465,protein_coding,-1,170195,chr10_125219270_125389465
Slc16a8,15,79251014,79254761,protein_coding,-1,3747,chr15_79251014_79254761
Slc16a9,10,70245100,70285968,protein_coding,1,40868,chr10_70245100_70285968
Slc17a2,13,23806993,23825180,protein_coding,1,18187,chr13_23806993_23825180
Slc17a3,13,23839434,23860716,protein_coding,1,21282,chr13_23839434_23860716
Slc17a5,9,78536488,78588041,protein_coding,-1,51553,chr9_78536488_78588041
Slc17a6,7,51622006,51671119,protein_coding,1,49113,chr7_51622006_51671119
Slc17a7,7,45163949,45176142,protein_coding,1,12193,chr7_45163949_45176142
Slc17a8,10,89574020,89621253,protein_coding,-1,47233,chr10_89574020_89621253
Slc17a9,2,180725263,180742280,protein_coding,1,17017,chr2_180725263_180742280
Slc18a1,8,69037711,69089235,protein_coding,-1,51524,chr8_69037711_69089235
Slc18a2,19,59260896,59296012,protein_coding,1,35116,chr19_59260896_59296012
Slc18a3,14,32462438,32464850,protein_coding,-1,2412,chr14_32462438_32464850
Slc18b1,10,23796986,23827968,protein_coding,1,30982,chr10_23796986_23827968
Slc19a1,10,77032241,77061002,protein_coding,1,28761,chr10_77032241_77061002
Slc19a2,1,164249046,164265385,protein_coding,1,16339,chr1_164249046_164265385
Slc19a3,1,83012523,83038448,protein_coding,-1,25925,chr1_83012523_83038448
Slc1a1,19,28835049,28913960,protein_coding,1,78911,chr19_28835049_28913960
Slc1a2,2,102658659,102790784,protein_coding,1,132125,chr2_102658659_102790784
Slc1a3,15,8634124,8710764,protein_coding,-1,76640,chr15_8634124_8710764
Slc1a4,11,20302180,20332713,protein_coding,-1,30533,chr11_20302180_20332713
Slc1a5,7,16781340,16798274,protein_coding,1,16934,chr7_16781340_16798274
Slc1a6,10,78780496,78814765,protein_coding,1,34269,chr10_78780496_78814765
Slc1a7,4,107968332,108013532,protein_coding,1,45200,chr4_107968332_108013532
Slc20a1,2,129198764,129211616,protein_coding,1,12852,chr2_129198764_129211616
Slc20a2,8,22476788,22569612,protein_coding,1,92824,chr8_22476788_22569612
Slc22a1,17,12648869,12675829,protein_coding,-1,26960,chr17_12648869_12675829
Slc22a12,19,6535845,6543032,protein_coding,-1,7187,chr19_6535845_6543032
Slc22a13,9,119192974,119209098,protein_coding,-1,16124,chr9_119192974_119209098
Slc22a14,9,119169455,119365553,protein_coding,-1,196098,chr9_119169455_119365553
Slc22a15,3,101855776,101924453,protein_coding,-1,68677,chr3_101855776_101924453
Slc22a17,14,54906304,54913132,protein_coding,-1,6828,chr14_54906304_54913132
Slc22a18,7,143473736,143499334,protein_coding,1,25598,chr7_143473736_143499334
Slc22a20,19,5970234,5986143,protein_coding,-1,15909,chr19_5970234_5986143
Slc22a21,11,53949965,53980332,protein_coding,-1,30367,chr11_53949965_53980332
Slc22a22,15,57243767,57477625,protein_coding,-1,233858,chr15_57243767_57477625
Slc22a23,13,34179158,34345182,protein_coding,-1,166024,chr13_34179158_34345182
Slc22a29,19,8160165,8218900,protein_coding,-1,58735,chr19_8160165_8218900
Slc22a3,17,12418960,12507704,protein_coding,-1,88744,chr17_12418960_12507704
Slc22a30,19,8335371,8405111,protein_coding,-1,69740,chr19_8335371_8405111
Slc22a4,11,53983123,54028090,protein_coding,-1,44967,chr11_53983123_54028090
Slc22a5,11,53864542,53891660,protein_coding,-1,27118,chr11_53864542_53891660
Slc22a6,19,8618039,8628299,protein_coding,1,10260,chr19_8618039_8628299
Slc22a7,17,46432183,46438457,protein_coding,-1,6274,chr17_46432183_46438457
Slc22a8,19,8591254,8611835,protein_coding,1,20581,chr19_8591254_8611835
Slc23a1,18,35614604,35627244,protein_coding,-1,12640,chr18_35614604_35627244
Slc23a2,2,132052496,132145108,protein_coding,-1,92612,chr2_132052496_132145108
Slc23a3,1,75125541,75133890,protein_coding,-1,8349,chr1_75125541_75133890
Slc24a1,9,64922861,64951607,protein_coding,-1,28746,chr9_64922861_64951607
Slc24a2,4,86983124,87230477,protein_coding,-1,247353,chr4_86983124_87230477
Slc24a3,2,145167754,145642166,protein_coding,1,474412,chr2_145167754_145642166
Slc24a4,12,102128733,102267091,protein_coding,1,138358,chr12_102128733_102267091
Slc24a5,2,125068124,125088677,protein_coding,1,20553,chr2_125068124_125088677
Slc25a1,16,17925223,17928219,protein_coding,-1,2996,chr16_17925223_17928219
Slc25a10,11,120491840,120499187,protein_coding,1,7347,chr11_120491840_120499187
Slc25a11,11,70644196,70647479,protein_coding,-1,3283,chr11_70644196_70647479
Slc25a12,2,71271063,71367749,protein_coding,-1,96686,chr2_71271063_71367749
Slc25a13,6,6041218,6217173,protein_coding,-1,175955,chr6_6041218_6217173
Slc25a14,X,48623413,48662294,protein_coding,1,38881,chrX_48623413_48662294
Slc25a15,8,22375551,22398597,protein_coding,-1,23046,chr8_22375551_22398597
Slc25a16,10,62920633,62946498,protein_coding,1,25865,chr10_62920633_62946498
Slc25a17,15,81318911,81360812,protein_coding,-1,41901,chr15_81318911_81360812
Slc25a18,6,120773578,120794336,protein_coding,1,20758,chr6_120773578_120794336
Slc25a19,11,115614178,115628295,protein_coding,-1,14117,chr11_115614178_115628295
Slc25a2,18,37637378,37638723,protein_coding,-1,1345,chr18_37637378_37638723
Slc25a20,9,108662088,108684641,protein_coding,1,22553,chr9_108662088_108684641
Slc25a21,12,56712634,57197472,protein_coding,-1,484838,chr12_56712634_57197472
Slc25a22,7,141429744,141437892,protein_coding,-1,8148,chr7_141429744_141437892
Slc25a23,17,57043711,57059863,protein_coding,-1,16152,chr17_57043711_57059863
Slc25a24,3,109123149,109168457,protein_coding,1,45308,chr3_109123149_109168457
Slc25a25,2,32414487,32451445,protein_coding,-1,36958,chr2_32414487_32451445
Slc25a26,6,94500331,94604672,protein_coding,1,104341,chr6_94500331_94604672
Slc25a27,17,43641891,43667214,protein_coding,-1,25323,chr17_43641891_43667214
Slc25a28,19,43663801,43674881,protein_coding,-1,11080,chr19_43663801_43674881
Slc25a29,12,108825873,108835883,protein_coding,-1,10010,chr12_108825873_108835883
Slc25a3,10,91116574,91124059,protein_coding,-1,7485,chr10_91116574_91124059
Slc25a30,14,75760117,75787037,protein_coding,-1,26920,chr14_75760117_75787037
Slc25a31,3,40609136,40726096,protein_coding,1,116960,chr3_40609136_40726096
Slc25a32,15,38954382,39112716,protein_coding,-1,158334,chr15_38954382_39112716
Slc25a33,4,149744036,149774277,protein_coding,-1,30241,chr4_149744036_149774277
Slc25a34,4,141618824,141623821,protein_coding,-1,4997,chr4_141618824_141623821
Slc25a35,11,68968131,68974365,protein_coding,1,6234,chr11_68968131_68974365
Slc25a36,9,97074961,97111157,protein_coding,-1,36196,chr9_97074961_97111157
Slc25a37,14,69241848,69285112,protein_coding,-1,43264,chr14_69241848_69285112
Slc25a38,9,120110374,120124504,protein_coding,1,14130,chr9_120110374_120124504
Slc25a39,11,102402985,102407946,protein_coding,-1,4961,chr11_102402985_102407946
Slc25a4,8,46206797,46211284,protein_coding,-1,4487,chr8_46206797_46211284
Slc25a40,5,8422850,8454797,protein_coding,1,31947,chr5_8422850_8454797
Slc25a41,17,57032773,57041654,protein_coding,-1,8881,chr17_57032773_57041654
Slc25a42,8,70184340,70212305,protein_coding,-1,27965,chr8_70184340_70212305
Slc25a43,X,36743659,36777202,protein_coding,1,33543,chrX_36743659_36777202
Slc25a44,3,88410498,88425139,protein_coding,-1,14641,chr3_88410498_88425139
Slc25a45,19,5877808,5885878,protein_coding,1,8070,chr19_5877808_5885878
Slc25a46,18,31556111,31609911,protein_coding,-1,53800,chr18_31556111_31609911
Slc25a47,12,108836046,108856815,protein_coding,1,20769,chr12_108836046_108856815
Slc25a5,X,36795651,36798807,protein_coding,1,3156,chrX_36795651_36798807
Slc25a5-ps,14,11161529,11181110,transcribed_processed_pseudogene,1,19581,chr14_11161529_11181110
Slc25a51,4,45395923,45408766,protein_coding,-1,12843,chr4_45395923_45408766
Slc25a53,X,136981116,137038302,protein_coding,-1,57186,chrX_136981116_137038302
Slc25a54,3,109080469,109116687,protein_coding,1,36218,chr3_109080469_109116687
Slc26a1,5,108669878,108675569,protein_coding,-1,5691,chr5_108669878_108675569
Slc26a10,10,127171393,127180645,protein_coding,-1,9252,chr10_127171393_127180645
Slc26a11,11,119355557,119381079,protein_coding,1,25522,chr11_119355557_119381079
Slc26a2,18,61192919,61211612,protein_coding,-1,18693,chr18_61192919_61211612
Slc26a3,12,31390871,31473917,protein_coding,1,83046,chr12_31390871_31473917
Slc26a4,12,31519827,31559969,protein_coding,-1,40142,chr12_31519827_31559969
Slc26a5,5,21810655,21865604,protein_coding,-1,54949,chr5_21810655_21865604
Slc26a6,9,108853283,108913049,protein_coding,1,59766,chr9_108853283_108913049
Slc26a7,4,14502430,14621805,protein_coding,-1,119375,chr4_14502430_14621805
Slc26a8,17,28637783,28690233,protein_coding,-1,52450,chr17_28637783_28690233
Slc26a9,1,131744022,131771504,protein_coding,1,27482,chr1_131744022_131771504
Slc27a1,8,71568882,71587302,protein_coding,1,18420,chr8_71568882_71587302
Slc27a2,2,126552407,126588243,protein_coding,1,35836,chr2_126552407_126588243
Slc27a3,3,90385239,90389938,protein_coding,-1,4699,chr3_90385239_90389938
Slc27a4,2,29802634,29817522,protein_coding,1,14888,chr2_29802634_29817522
Slc27a5,7,12988346,12998192,protein_coding,-1,9846,chr7_12988346_12998192
Slc28a1,7,81114799,81170416,protein_coding,1,55617,chr7_81114799_81170416
Slc28a2,2,122426477,122461137,protein_coding,1,34660,chr2_122426477_122461137
Slc28a3,13,58545399,58610877,protein_coding,-1,65478,chr13_58545399_58610877
Slc29a1,17,45585200,45599606,protein_coding,-1,14406,chr17_45585200_45599606
Slc29a2,19,5023860,5031972,protein_coding,1,8112,chr19_5023860_5031972
Slc29a3,10,60712072,60752794,protein_coding,-1,40722,chr10_60712072_60752794
Slc29a4,5,142692512,142722490,protein_coding,1,29978,chr5_142692512_142722490
Slc2a1,4,119108711,119137983,protein_coding,1,29272,chr4_119108711_119137983
Slc2a10,2,165503787,165519917,protein_coding,1,16130,chr2_165503787_165519917
Slc2a12,10,22645011,22704285,protein_coding,1,59274,chr10_22645011_22704285
Slc2a13,15,91267696,91573261,protein_coding,-1,305565,chr15_91267696_91573261
Slc2a2,3,28697903,28731359,protein_coding,1,33456,chr3_28697903_28731359
Slc2a3,6,122727809,122801640,protein_coding,-1,73831,chr6_122727809_122801640
Slc2a4,11,69942539,69948188,protein_coding,-1,5649,chr11_69942539_69948188
Slc2a4rg-ps,2,181384250,181387586,transcribed_unitary_pseudogene,1,3336,chr2_181384250_181387586
Slc2a5,4,150119283,150144169,protein_coding,1,24886,chr4_150119283_150144169
Slc2a6,2,27021363,27027998,protein_coding,-1,6635,chr2_27021363_27027998
Slc2a7,4,150148972,150168482,protein_coding,1,19510,chr4_150148972_150168482
Slc2a8,2,32972990,32982083,protein_coding,-1,9093,chr2_32972990_32982083
Slc2a9,5,38349273,38503143,protein_coding,-1,153870,chr5_38349273_38503143
Slc30a1,1,191906767,191913247,protein_coding,1,6480,chr1_191906767_191913247
Slc30a10,1,185454848,185468762,protein_coding,1,13914,chr1_185454848_185468762
Slc30a2,4,134343181,134354484,protein_coding,1,11303,chr4_134343181_134354484
Slc30a3,5,31086106,31108237,protein_coding,-1,22131,chr5_31086106_31108237
Slc30a4,2,122681233,122714102,protein_coding,-1,32869,chr2_122681233_122714102
Slc30a5,13,100802648,100833427,protein_coding,-1,30779,chr13_100802648_100833427
Slc30a6,17,74395608,74424221,protein_coding,1,28613,chr17_74395608_74424221
Slc30a7,3,115938973,116007406,protein_coding,-1,68433,chr3_115938973_116007406
Slc30a8,15,52295553,52335798,protein_coding,1,40245,chr15_52295553_52335798
Slc30a9,5,67306955,67358443,protein_coding,1,51488,chr5_67306955_67358443
Slc31a1,4,62360727,62391769,protein_coding,1,31042,chr4_62360727_62391769
Slc31a2,4,62262562,62298411,protein_coding,1,35849,chr4_62262562_62298411
Slc32a1,2,158610767,158615748,protein_coding,1,4981,chr2_158610767_158615748
Slc33a1,3,63933507,63964768,protein_coding,-1,31261,chr3_63933507_63964768
Slc34a1,13,55398187,55415592,protein_coding,1,17405,chr13_55398187_55415592
Slc34a3,2,25228898,25234364,protein_coding,-1,5466,chr2_25228898_25234364
Slc35a1,4,34663257,34687438,protein_coding,-1,24181,chr4_34663257_34687438
Slc35a2,X,7884028,7894492,protein_coding,1,10464,chrX_7884028_7894492
Slc35a3,3,116669470,116712831,protein_coding,-1,43361,chr3_116669470_116712831
Slc35a4,18,36679215,36683861,protein_coding,1,4646,chr18_36679215_36683861
Slc35a5,16,45139573,45158706,protein_coding,-1,19133,chr16_45139573_45158706
Slc35b1,11,95384692,95391776,protein_coding,1,7084,chr11_95384692_95391776
Slc35b2,17,45563874,45567671,protein_coding,1,3797,chr17_45563874_45567671
Slc35b3,13,38932136,38960875,protein_coding,-1,28739,chr13_38932136_38960875
Slc35b4,6,34153380,34177111,protein_coding,-1,23731,chr6_34153380_34177111
Slc35c1,2,92452764,92460538,protein_coding,-1,7774,chr2_92452764_92460538
Slc35c2,2,165276554,165287869,protein_coding,-1,11315,chr2_165276554_165287869
Slc35d1,4,103170649,103215164,protein_coding,-1,44515,chr4_103170649_103215164
Slc35d2,13,64096308,64129368,protein_coding,-1,33060,chr13_64096308_64129368
Slc35d3,10,19847916,19851459,protein_coding,-1,3543,chr10_19847916_19851459
Slc35e1,8,72480641,72492614,protein_coding,-1,11973,chr8_72480641_72492614
Slc35e2,4,155601416,155623340,protein_coding,1,21924,chr4_155601416_155623340
Slc35e3,10,117733679,117746365,protein_coding,-1,12686,chr10_117733679_117746365
Slc35e4,11,3907021,3914664,protein_coding,-1,7643,chr11_3907021_3914664
Slc35f1,10,52690533,53111622,protein_coding,1,421089,chr10_52690533_53111622
Slc35f2,9,53771538,53818154,protein_coding,1,46616,chr9_53771538_53818154
Slc35f3,8,126138995,126395978,protein_coding,1,256983,chr8_126138995_126395978
Slc35f4,14,49298519,49526046,protein_coding,-1,227527,chr14_49298519_49526046
Slc35f5,1,125560595,125595820,protein_coding,1,35225,chr1_125560595_125595820
Slc35f6,5,30647933,30659729,protein_coding,1,11796,chr5_30647933_30659729
Slc35g1,19,38395980,38405610,protein_coding,1,9630,chr19_38395980_38405610
Slc35g2,9,100552188,100571090,protein_coding,-1,18902,chr9_100552188_100571090
Slc35g3,11,69759890,69761968,protein_coding,-1,2078,chr11_69759890_69761968
Slc36a1,11,55204350,55236330,protein_coding,1,31980,chr11_55204350_55236330
Slc36a1os,11,55191719,55197864,antisense,-1,6145,chr11_55191719_55197864
Slc36a4,9,15709738,15743361,protein_coding,1,33623,chr9_15709738_15743361
Slc37a1,17,31286792,31350739,protein_coding,1,63947,chr17_31286792_31350739
Slc37a2,9,37227585,37255738,protein_coding,-1,28153,chr9_37227585_37255738
Slc37a3,6,39334773,39377675,protein_coding,-1,42902,chr6_39334773_39377675
Slc37a4,9,44396852,44402968,protein_coding,1,6116,chr9_44396852_44402968
Slc38a1,15,96571418,96642913,protein_coding,-1,71495,chr15_96571418_96642913
Slc38a10,11,120103960,120151346,protein_coding,-1,47386,chr11_120103960_120151346
Slc38a11,2,65316430,65364034,protein_coding,-1,47604,chr2_65316430_65364034
Slc38a2,15,96687392,96699730,protein_coding,-1,12338,chr15_96687392_96699730
Slc38a3,9,107650634,107669530,protein_coding,-1,18896,chr9_107650634_107669530
Slc38a4,15,96994820,97055956,protein_coding,-1,61136,chr15_96994820_97055956
Slc38a5,X,8271133,8280179,protein_coding,1,9046,chrX_8271133_8280179
Slc38a6,12,73286779,73354049,protein_coding,1,67270,chr12_73286779_73354049
Slc38a7,8,95835920,95853539,protein_coding,-1,17619,chr8_95835920_95853539
Slc38a8,8,119479602,119501698,protein_coding,-1,22096,chr8_119479602_119501698
Slc38a9,13,112660751,112738749,protein_coding,1,77998,chr13_112660751_112738749
Slc39a1,3,90248172,90253612,protein_coding,1,5440,chr3_90248172_90253612
Slc39a1-ps,2,30159398,30160366,processed_pseudogene,1,968,chr2_30159398_30160366
Slc39a10,1,46807544,46892852,protein_coding,-1,85308,chr1_46807544_46892852
Slc39a11,11,113244853,113650079,protein_coding,-1,405226,chr11_113244853_113650079
Slc39a12,2,14388316,14494977,protein_coding,1,106661,chr2_14388316_14494977
Slc39a13,2,91061791,91070417,protein_coding,-1,8626,chr2_91061791_91070417
Slc39a14,14,70303469,70351425,protein_coding,-1,47956,chr14_70303469_70351425
Slc39a2,14,51892889,51896745,protein_coding,1,3856,chr14_51892889_51896745
Slc39a3,10,81028538,81037426,protein_coding,-1,8888,chr10_81028538_81037426
Slc39a4,15,76612383,76617384,protein_coding,-1,5001,chr15_76612383_76617384
Slc39a5,10,128395931,128401229,protein_coding,-1,5298,chr10_128395931_128401229
Slc39a6,18,24579881,24603817,protein_coding,-1,23936,chr18_24579881_24603817
Slc39a7,17,34028269,34031682,protein_coding,-1,3413,chr17_34028269_34031682
Slc39a8,3,135825279,135888572,protein_coding,1,63293,chr3_135825279_135888572
Slc39a9,12,80643883,80683342,protein_coding,1,39459,chr12_80643883_80683342
Slc3a1,17,85028376,85064236,protein_coding,1,35860,chr17_85028376_85064236
Slc3a2,19,8706882,8723369,protein_coding,-1,16487,chr19_8706882_8723369
Slc40a1,1,45908068,45926523,protein_coding,-1,18455,chr1_45908068_45926523
Slc41a1,1,131827493,131848865,protein_coding,1,21372,chr1_131827493_131848865
Slc41a2,10,83230848,83337882,protein_coding,-1,107034,chr10_83230848_83337882
Slc41a3,6,90604725,90646412,protein_coding,1,41687,chr6_90604725_90646412
Slc43a1,2,84838850,84863594,protein_coding,1,24744,chr2_84838850_84863594
Slc43a2,11,75531694,75577575,protein_coding,1,45881,chr11_75531694_75577575
Slc43a3,2,84936579,84958509,protein_coding,1,21930,chr2_84936579_84958509
Slc44a1,4,53440413,53622478,protein_coding,1,182065,chr4_53440413_53622478
Slc44a2,9,21320698,21355028,protein_coding,1,34330,chr9_21320698_21355028
Slc44a3,3,121459528,121532404,protein_coding,-1,72876,chr3_121459528_121532404
Slc44a4,17,34914466,34930436,protein_coding,1,15970,chr17_34914466_34930436
Slc44a5,3,153973436,154271722,protein_coding,1,298286,chr3_153973436_154271722
Slc45a1,4,150628572,150652174,protein_coding,-1,23602,chr4_150628572_150652174
Slc45a2,15,11000721,11029233,protein_coding,1,28512,chr15_11000721_11029233
Slc45a3,1,131962967,131982969,protein_coding,1,20002,chr1_131962967_131982969
Slc45a4,15,73577424,73645762,protein_coding,-1,68338,chr15_73577424_73645762
Slc46a1,11,78465697,78472059,protein_coding,1,6362,chr11_78465697_78472059
Slc46a2,4,59905126,59915056,protein_coding,-1,9930,chr4_59905126_59915056
Slc46a3,5,147878437,147894815,protein_coding,-1,16378,chr5_147878437_147894815
Slc47a1,11,61343401,61378345,protein_coding,-1,34944,chr11_61343401_61378345
Slc47a2,11,61301631,61342860,protein_coding,-1,41229,chr11_61301631_61342860
Slc48a1,15,97778520,97792692,protein_coding,1,14172,chr15_97778520_97792692
Slc4a1,11,102348824,102366203,protein_coding,-1,17379,chr11_102348824_102366203
Slc4a10,2,62046462,62326730,protein_coding,1,280268,chr2_62046462_62326730
Slc4a11,2,130684113,130697519,protein_coding,-1,13406,chr2_130684113_130697519
Slc4a1ap,5,31526995,31556932,protein_coding,1,29937,chr5_31526995_31556932
Slc4a2,5,24423837,24440950,protein_coding,1,17113,chr5_24423837_24440950
Slc4a3,1,75546266,75562172,protein_coding,1,15906,chr1_75546266_75562172
Slc4a4,5,88886486,89239653,protein_coding,1,353167,chr5_88886486_89239653
Slc4a5,6,83219828,83304945,protein_coding,1,85117,chr6_83219828_83304945
Slc4a7,14,14702279,14799940,protein_coding,1,97661,chr14_14702279_14799940
Slc4a8,15,100761747,100823968,protein_coding,1,62221,chr15_100761747_100823968
Slc4a9,18,36528147,36556273,protein_coding,1,28126,chr18_36528147_36556273
Slc50a1,3,89268246,89270570,protein_coding,-1,2324,chr3_89268246_89270570
Slc52a2,15,76538832,76544608,protein_coding,1,5776,chr15_76538832_76544608
Slc5a10,11,61672781,61720826,protein_coding,-1,48045,chr11_61672781_61720826
Slc5a11,7,123214780,123273253,protein_coding,1,58473,chr7_123214780_123273253
Slc5a12,2,110597298,110647779,protein_coding,1,50481,chr2_110597298_110647779
Slc5a2,7,128265657,128272430,protein_coding,1,6773,chr7_128265657_128272430
Slc5a3,16,92058322,92087473,protein_coding,1,29151,chr16_92058322_92087473
Slc5a4b,10,76057494,76110961,protein_coding,-1,53467,chr10_76057494_76110961
Slc5a5,8,70882889,70892757,protein_coding,-1,9868,chr8_70882889_70892757
Slc5a6,5,31036036,31048924,protein_coding,-1,12888,chr5_31036036_31048924
Slc5a7,17,54273590,54299034,protein_coding,-1,25444,chr17_54273590_54299034
Slc5a8,10,88885992,88929515,protein_coding,1,43523,chr10_88885992_88929515
Slc6a1,6,114282635,114317532,protein_coding,1,34897,chr6_114282635_114317532
Slc6a11,6,114131241,114249952,protein_coding,1,118711,chr6_114131241_114249952
Slc6a13,6,121300227,121337733,protein_coding,1,37506,chr6_121300227_121337733
Slc6a15,10,103367783,103419377,protein_coding,1,51594,chr10_103367783_103419377
Slc6a16,7,45241085,45273367,protein_coding,1,32282,chr7_45241085_45273367
Slc6a17,3,107467543,107518018,protein_coding,-1,50475,chr3_107467543_107518018
Slc6a2,8,92960079,93001667,protein_coding,1,41588,chr8_92960079_93001667
Slc6a20a,9,123634770,123678885,protein_coding,-1,44115,chr9_123634770_123678885
Slc6a20b,9,123590800,123632565,protein_coding,-1,41765,chr9_123590800_123632565
Slc6a4,11,76998603,77032340,protein_coding,1,33737,chr11_76998603_77032340
Slc6a5,7,49910146,49963856,protein_coding,1,53710,chr7_49910146_49963856
Slc6a6,6,91684053,91759066,protein_coding,1,75013,chr6_91684053_91759066
Slc6a7,18,60995380,61014222,protein_coding,-1,18842,chr18_60995380_61014222
Slc6a8,X,73673150,73682502,protein_coding,1,9352,chrX_73673150_73682502
Slc6a9,4,117834506,117875198,protein_coding,1,40692,chr4_117834506_117875198
Slc7a1,5,148327410,148399904,protein_coding,-1,72494,chr5_148327410_148399904
Slc7a10,7,35186385,35201114,protein_coding,1,14729,chr7_35186385_35201114
Slc7a11,3,49892526,50443614,protein_coding,-1,551088,chr3_49892526_50443614
Slc7a13,4,19818725,19842218,protein_coding,1,23493,chr4_19818725_19842218
Slc7a14,3,31202858,31310378,protein_coding,-1,107520,chr3_31202858_31310378
Slc7a15,12,8528483,8599066,protein_coding,-1,70583,chr12_8528483_8599066
Slc7a2,8,40862396,40922308,protein_coding,1,59912,chr8_40862396_40922308
Slc7a3,X,101079210,101086020,protein_coding,-1,6810,chrX_101079210_101086020
Slc7a4,16,17572018,17583214,protein_coding,-1,11196,chr16_17572018_17583214
Slc7a5,8,121881150,121907694,protein_coding,-1,26544,chr8_121881150_121907694
Slc7a6,8,106168857,106198706,protein_coding,1,29849,chr8_106168857_106198706
Slc7a6os,8,106200717,106210935,protein_coding,-1,10218,chr8_106200717_106210935
Slc7a7,14,54369442,54417780,protein_coding,-1,48338,chr14_54369442_54417780
Slc7a8,14,54722209,54781946,protein_coding,-1,59737,chr14_54722209_54781946
Slc7a9,7,35448796,35466036,protein_coding,1,17240,chr7_35448796_35466036
Slc8a1,17,81373105,81738377,protein_coding,-1,365272,chr17_81373105_81738377
Slc8a2,7,16129826,16161063,protein_coding,1,31237,chr7_16129826_16161063
Slc8a3,12,81197915,81333180,protein_coding,-1,135265,chr12_81197915_81333180
Slc8b1,5,120511168,120534024,protein_coding,1,22856,chr5_120511168_120534024
Slc9a1,4,133369706,133423702,protein_coding,1,53996,chr4_133369706_133423702
Slc9a2,1,40680574,40769273,protein_coding,1,88699,chr1_40680574_40769273
Slc9a3,13,74121457,74169442,protein_coding,1,47985,chr13_74121457_74169442
Slc9a3r1,11,115163341,115181181,protein_coding,1,17840,chr11_115163341_115181181
Slc9a3r2,17,24639286,24650327,protein_coding,-1,11041,chr17_24639286_24650327
Slc9a4,1,40580081,40630725,protein_coding,1,50644,chr1_40580081_40630725
Slc9a5,8,105348843,105369881,protein_coding,1,21038,chr8_105348843_105369881
Slc9a6,X,56609757,56664230,protein_coding,1,54473,chrX_56609757_56664230
Slc9a7,X,20105754,20291807,protein_coding,-1,186053,chrX_20105754_20291807
Slc9a8,2,167421712,167477000,protein_coding,1,55288,chr2_167421712_167477000
Slc9a9,9,94669909,95230445,protein_coding,1,560536,chr9_94669909_95230445
Slc9b1,3,135348029,135397827,protein_coding,1,49798,chr3_135348029_135397827
Slc9b2,3,135307700,135345387,protein_coding,1,37687,chr3_135307700_135345387
Slco1a4,6,141805440,141856199,protein_coding,-1,50759,chr6_141805440_141856199
Slco1b2,6,141629518,141686646,protein_coding,1,57128,chr6_141629518_141686646
Slco1c1,6,141524368,141570177,protein_coding,1,45809,chr6_141524368_141570177
Slco2a1,9,102988712,103096002,protein_coding,1,107290,chr9_102988712_103096002
Slco2b1,7,99657804,99711340,protein_coding,-1,53536,chr7_99657804_99711340
Slco3a1,7,74275419,74554780,protein_coding,-1,279361,chr7_74275419_74554780
Slco4a1,2,180456245,180474867,protein_coding,1,18622,chr2_180456245_180474867
Slco4c1,1,96816270,96872171,protein_coding,-1,55901,chr1_96816270_96872171
Slco5a1,1,12866549,12992650,protein_coding,-1,126101,chr1_12866549_12992650
Slco6b1,1,96906176,96997577,transcribed_unprocessed_pseudogene,-1,91401,chr1_96906176_96997577
Slco6c1,1,97059038,97128301,protein_coding,-1,69263,chr1_97059038_97128301
Slfn10-ps,CHR_PWK_PHJ_MMCHR11_CTG3,83028130,83040480,protein_coding;transcribed_unprocessed_pseudogene,-1,12350,chrCHR_PWK_PHJ_MMCHR11_CTG3_83028130_83040480
Slfn2,11,83057196,83070678,protein_coding,1,13482,chr11_83057196_83070678
Slfn3,11,83141602,83215154,protein_coding,1,73552,chr11_83141602_83215154
Slfn5,11,82951349,82964840,protein_coding,1,13491,chr11_82951349_82964840
Slfn8,11,83002158,83021265,protein_coding,-1,19107,chr11_83002158_83021265
Slfn9,11,82978390,82991830,protein_coding,-1,13440,chr11_82978390_82991830
Slfnl1,4,120532231,120536661,protein_coding,1,4430,chr4_120532231_120536661
Slirp,12,87443896,87452206,protein_coding,1,8310,chr12_87443896_87452206
Slit1,19,41600257,41743665,protein_coding,-1,143408,chr19_41600257_41743665
Slit2,5,47983138,48307733,protein_coding,1,324595,chr5_47983138_48307733
Slit3,11,35121224,35708507,protein_coding,1,587283,chr11_35121224_35708507
Slitrk1,14,108908800,108914158,protein_coding,-1,5358,chr14_108908800_108914158
Slitrk2,X,66649318,66661393,protein_coding,1,12075,chrX_66649318_66661393
Slitrk3,3,73047265,73057803,protein_coding,-1,10538,chr3_73047265_73057803
Slitrk4,X,64264885,64276996,protein_coding,-1,12111,chrX_64264885_64276996
Slitrk5,14,111675097,111683141,protein_coding,1,8044,chr14_111675097_111683141
Slitrk6,14,110748580,110755149,protein_coding,-1,6569,chr14_110748580_110755149
Slk,19,47579678,47645246,protein_coding,1,65568,chr19_47579678_47645246
Slmap,14,26413168,26534931,protein_coding,-1,121763,chr14_26413168_26534931
Sln,9,53850164,53854560,protein_coding,1,4396,chr9_53850164_53854560
Sltm,9,70542754,70592234,protein_coding,1,49480,chr9_70542754_70592234
Slu7,11,43433744,43447981,protein_coding,1,14237,chr11_43433744_43447981
Slx1b,7,126689468,126695784,protein_coding,-1,6316,chr7_126689468_126695784
Slx4,16,3979105,4003770,protein_coding,-1,24665,chr16_3979105_4003770
Slx4ip,2,136891218,137071950,protein_coding,1,180732,chr2_136891218_137071950
Smad1,8,79338395,79399518,protein_coding,-1,61123,chr8_79338395_79399518
Smad2,18,76241580,76310963,protein_coding,1,69383,chr18_76241580_76310963
Smad3,9,63646767,63757994,protein_coding,-1,111227,chr9_63646767_63757994
Smad4,18,73639009,73703780,protein_coding,-1,64771,chr18_73639009_73703780
Smad5,13,56703010,56742377,protein_coding,1,39367,chr13_56703010_56742377
Smad6,9,63953076,64022059,protein_coding,-1,68983,chr9_63953076_64022059
Smad7,18,75367529,75395935,protein_coding,1,28406,chr18_75367529_75395935
Smad9,3,54755582,54801257,protein_coding,1,45675,chr3_54755582_54801257
Smagp,15,100621339,100636940,protein_coding,-1,15601,chr15_100621339_100636940
Smap1,1,23844846,23922317,protein_coding,-1,77471,chr1_23844846_23922317
Smap2,4,120968317,121017247,protein_coding,-1,48930,chr4_120968317_121017247
Smarca1,X,47809368,47892974,protein_coding,-1,83606,chrX_47809368_47892974
Smarca2,19,26605050,26778322,protein_coding,1,173272,chr19_26605050_26778322
Smarca4,9,21616169,21704230,protein_coding,1,88061,chr9_21616169_21704230
Smarca5,8,80698507,80739497,protein_coding,-1,40990,chr8_80698507_80739497
Smarca5-ps,4,145464204,145467420,transcribed_processed_pseudogene,1,3216,chr4_145464204_145467420
Smarcad1,6,65042583,65116061,protein_coding,1,73478,chr6_65042583_65116061
Smarcal1,1,72583251,72633134,protein_coding,1,49883,chr1_72583251_72633134
Smarcb1,10,75896769,75921617,protein_coding,-1,24848,chr10_75896769_75921617
Smarcc1,9,110117708,110240178,protein_coding,1,122470,chr9_110117708_110240178
Smarcc2,10,128459248,128490482,protein_coding,1,31234,chr10_128459248_128490482
Smarcd1,15,99702129,99713991,protein_coding,1,11862,chr15_99702129_99713991
Smarcd2,11,106263179,106272972,protein_coding,-1,9793,chr11_106263179_106272972
Smarcd3,5,24590818,24624411,protein_coding,-1,33593,chr5_24590818_24624411
Smarce1,11,99209047,99231017,protein_coding,-1,21970,chr11_99209047_99231017
Smc1a,X,152016428,152062694,protein_coding,1,46266,chrX_152016428_152062694
Smc1b,15,85064689,85131964,protein_coding,-1,67275,chr15_85064689_85131964
Smc2,4,52439243,52488260,protein_coding,1,49017,chr4_52439243_52488260
Smc2os,4,52430285,52438965,antisense,-1,8680,chr4_52430285_52438965
Smc3,19,53600398,53645833,protein_coding,1,45435,chr19_53600398_53645833
Smc4,3,69004738,69034623,protein_coding,1,29885,chr3_69004738_69034623
Smc5,19,23206451,23273897,protein_coding,-1,67446,chr19_23206451_23273897
Smc6,12,11265886,11319785,protein_coding,1,53899,chr12_11265886_11319785
Smchd1,17,71344489,71475343,protein_coding,-1,130854,chr17_71344489_71475343
Smco1,16,32271468,32274781,protein_coding,1,3313,chr16_32271468_32274781
Smco2,6,146850104,146871406,protein_coding,1,21302,chr6_146850104_146871406
Smco3,6,136829927,136835452,protein_coding,-1,5525,chr6_136829927_136835452
Smco4,9,15493432,15545260,protein_coding,1,51828,chr9_15493432_15545260
Smcr8,11,60777524,60788287,protein_coding,1,10763,chr11_60777524_60788287
Smdt1,15,82338959,82349091,protein_coding,1,10132,chr15_82338959_82349091
Smg1,7,118131308,118243670,protein_coding,-1,112362,chr7_118131308_118243670
Smg5,3,88336260,88362338,protein_coding,1,26078,chr3_88336260_88362338
Smg6,11,74925823,75164448,protein_coding,1,238625,chr11_74925823_75164448
Smg7,1,152836995,152902646,protein_coding,-1,65651,chr1_152836995_152902646
Smg8,11,87077732,87086774,protein_coding,-1,9042,chr11_87077732_87086774
Smg9,7,24399619,24422778,protein_coding,1,23159,chr7_24399619_24422778
Smim1,4,154020470,154026230,protein_coding,-1,5760,chr4_154020470_154026230
Smim11,16,92301286,92313041,protein_coding,1,11755,chr16_92301286_92313041
Smim12,4,127243784,127247809,protein_coding,1,4025,chr4_127243784_127247809
Smim13,13,41249844,41276577,protein_coding,1,26733,chr13_41249844_41276577
Smim14,5,65446844,65537184,protein_coding,-1,90340,chr5_65446844_65537184
Smim15,13,108044446,108049172,protein_coding,1,4726,chr13_108044446_108049172
Smim18,8,33742112,33747770,protein_coding,-1,5658,chr8_33742112_33747770
Smim19,8,22462614,22476882,protein_coding,-1,14268,chr8_22462614_22476882
Smim20,5,53267083,53278540,protein_coding,1,11457,chr5_53267083_53278540
Smim22,16,5007288,5008309,protein_coding,1,1021,chr16_5007288_5008309
Smim24,10,81393051,81395392,protein_coding,1,2341,chr10_81393051_81395392
Smim3,18,60474191,60501987,protein_coding,-1,27796,chr18_60474191_60501987
Smim4,14,31088132,31128956,protein_coding,-1,40824,chr14_31088132_31128956
Smim5,11,115899966,115906269,protein_coding,1,6303,chr11_115899966_115906269
Smim6,11,115912017,115913920,protein_coding,1,1903,chr11_115912017_115913920
Smim7,8,72565188,72571088,protein_coding,-1,5900,chr8_72565188_72571088
Smim8,4,34768664,34778423,protein_coding,-1,9759,chr4_34768664_34778423
Smim9,X,75146056,75163770,protein_coding,-1,17714,chrX_75146056_75163770
Smn1,13,100124852,100137690,protein_coding,1,12838,chr13_100124852_100137690
Smndc1,19,53379390,53390578,protein_coding,-1,11188,chr19_53379390_53390578
Smo,6,29735503,29761365,protein_coding,1,25862,chr6_29735503_29761365
Smoc1,12,81026808,81186414,protein_coding,1,159606,chr12_81026808_81186414
Smoc2,17,14279506,14404790,protein_coding,1,125284,chr17_14279506_14404790
Smok2a,17,13221188,13227658,protein_coding,1,6470,chr17_13221188_13227658
Smok2b,17,13230257,13237184,protein_coding,1,6927,chr17_13230257_13237184
Smok4a,17,13521456,13528433,transcribed_unprocessed_pseudogene,1,6977,chr17_13521456_13528433
Smox,2,131491496,131525922,protein_coding,1,34426,chr2_131491496_131525922
Smpd1,7,105554360,105558389,protein_coding,1,4029,chr7_105554360_105558389
Smpd2,10,41485642,41490369,protein_coding,-1,4727,chr10_41485642_41490369
Smpd3,8,106252548,106337988,protein_coding,-1,85440,chr8_106252548_106337988
Smpd4,16,17619354,17644828,protein_coding,1,25474,chr16_17619354_17644828
Smpd5,15,76294348,76296896,protein_coding,1,2548,chr15_76294348_76296896
Smpdl3a,10,57794335,57811830,protein_coding,1,17495,chr10_57794335_57811830
Smpdl3b,4,132732966,132757252,protein_coding,-1,24286,chr4_132732966_132757252
Smpx,X,157698910,157752591,protein_coding,1,53681,chrX_157698910_157752591
Sms,X,157443855,157492287,protein_coding,-1,48432,chrX_157443855_157492287
Smt3h1-ps,X,153783340,153783619,processed_pseudogene,1,279,chrX_153783340_153783619
Smt3h2-ps,X,7752130,7752414,processed_pseudogene,1,284,chrX_7752130_7752414
Smt3h2-ps2,7,127397978,127398265,processed_pseudogene,1,287,chr7_127397978_127398265
Smt3h2-ps4,1,14839869,14840156,processed_pseudogene,-1,287,chr1_14839869_14840156
Smtn,11,3517523,3540612,protein_coding,-1,23089,chr11_3517523_3540612
Smtnl1,2,84811176,84822652,protein_coding,-1,11476,chr2_84811176_84822652
Smtnl2,11,72389164,72411713,protein_coding,-1,22549,chr11_72389164_72411713
Smu1,4,40736542,40757923,protein_coding,-1,21381,chr4_40736542_40757923
Smug1,15,103153290,103167092,protein_coding,-1,13802,chr15_103153290_103167092
Smurf1,5,144876495,144965847,protein_coding,-1,89352,chr5_144876495_144965847
Smurf2,11,106820066,106920715,protein_coding,-1,100649,chr11_106820066_106920715
Smyd1,6,71213940,71322233,protein_coding,-1,108293,chr6_71213940_71322233
Smyd2,1,189880492,189922363,protein_coding,-1,41871,chr1_189880492_189922363
Smyd3,1,178951960,179518041,protein_coding,-1,566081,chr1_178951960_179518041
Smyd4,11,75348433,75405705,protein_coding,1,57272,chr11_75348433_75405705
Smyd5,6,85431989,85446435,protein_coding,1,14446,chr6_85431989_85446435
Snai1,2,167538195,167542814,protein_coding,1,4619,chr2_167538195_167542814
Snai2,16,14705852,14709385,protein_coding,1,3533,chr16_14705852_14709385
Snai3,8,122454208,122460733,protein_coding,-1,6525,chr8_122454208_122460733
Snap23,2,120567671,120601255,protein_coding,1,33584,chr2_120567671_120601255
Snap25,2,136713453,136782428,protein_coding,1,68975,chr2_136713453_136782428
Snap29,16,17405986,17430827,protein_coding,1,24841,chr16_17405986_17430827
Snap47,11,59407134,59451186,protein_coding,-1,44052,chr11_59407134_59451186
Snap91,9,86765923,86880654,protein_coding,-1,114731,chr9_86765923_86880654
Snapc1,12,73964481,73988966,protein_coding,1,24485,chr12_73964481_73988966
Snapc2,8,4253080,4256220,protein_coding,1,3140,chr8_4253080_4256220
Snapc3,4,83417724,83467676,protein_coding,1,49952,chr4_83417724_83467676
Snapc4,2,26362765,26380653,protein_coding,-1,17888,chr2_26362765_26380653
Snapc5,9,64179274,64183132,protein_coding,1,3858,chr9_64179274_64183132
Snapin,3,90488026,90491033,protein_coding,-1,3007,chr3_90488026_90491033
Snca,6,60731575,60829855,protein_coding,-1,98280,chr6_60731575_60829855
Sncaip,18,52767709,52915935,protein_coding,1,148226,chr18_52767709_52915935
Sncb,13,54758860,54766595,protein_coding,-1,7735,chr13_54758860_54766595
Sncg,14,34370274,34374789,protein_coding,-1,4515,chr14_34370274_34374789
Snd1,6,28475139,28935162,protein_coding,1,460023,chr6_28475139_28935162
Sned1,1,93235841,93301065,protein_coding,1,65224,chr1_93235841_93301065
Snf8,11,96034885,96047430,protein_coding,1,12545,chr11_96034885_96047430
Snhg1,19,8723475,8726443,processed_transcript,1,2968,chr19_8723475_8726443
Snhg10,12,105030617,105032279,lincRNA,-1,1662,chr12_105030617_105032279
Snhg11,2,158375638,158386151,protein_coding,1,10513,chr2_158375638_158386151
Snhg12,4,132308623,132311024,lincRNA,1,2401,chr4_132308623_132311024
Snhg14,7,59307924,59975759,processed_transcript,-1,667835,chr7_59307924_59975759
Snhg18,15,32240565,32244662,lincRNA,-1,4097,chr15_32240565_32244662
Snhg3,4,132348014,132353686,processed_transcript,-1,5672,chr4_132348014_132353686
Snhg4,18,35553371,35587708,processed_transcript;protein_coding,1,34337,chr18_35553371_35587708
Snhg5,9,88495268,88523562,processed_transcript,-1,28294,chr9_88495268_88523562
Snhg6,1,9941959,9944118,lincRNA,-1,2159,chr1_9941959_9944118
Snhg7os,2,26640372,26645944,antisense,1,5572,chr2_26640372_26645944
Snhg8,3,123507552,123508404,processed_transcript,-1,852,chr3_123507552_123508404
Snhg9,17,24719531,24719965,antisense,-1,434,chr17_24719531_24719965
Snip1,4,125066672,125074042,protein_coding,1,7370,chr4_125066672_125074042
Snn,16,11060945,11074985,protein_coding,1,14040,chr16_11060945_11074985
Snora15,5,129794546,129794676,snoRNA,1,130,chr5_129794546_129794676
Snora16a,4,132309464,132309600,snoRNA,1,136,chr4_132309464_132309600
Snora17,2,26639190,26639321,snoRNA,-1,131,chr2_26639190_26639321
Snora20,17,12922790,12922917,snoRNA,1,127,chr17_12922790_12922917
Snora21,11,97781639,97781775,snoRNA,-1,136,chr11_97781639_97781775
Snora23,7,110046364,110046547,snoRNA,1,183,chr7_110046364_110046547
Snora28,12,111540941,111541067,snoRNA,1,126,chr12_111540941_111541067
Snora2b,15,98526346,98526482,snoRNA,-1,136,chr15_98526346_98526482
Snora3,7,109520120,109520251,snoRNA,1,131,chr7_109520120_109520251
Snora30,7,127527874,127528003,snoRNA,1,129,chr7_127527874_127528003
Snora31,14,75847905,75848034,snoRNA,1,129,chr14_75847905_75848034
Snora33,10,23785347,23785475,snoRNA,-1,128,chr10_23785347_23785475
Snora34,15,98519716,98519853,snoRNA,-1,137,chr15_98519716_98519853
Snora35,X,146994381,146994508,snoRNA,1,127,chrX_146994381_146994508
Snora36b,1,185242907,185243038,snoRNA,1,131,chr1_185242907_185243038
Snora41,1,63179004,63179135,snoRNA,1,131,chr1_63179004_63179135
Snora43,2,26637847,26637985,snoRNA,-1,138,chr2_26637847_26637985
Snora44,4,132309941,132310069,snoRNA,1,128,chr4_132309941_132310069
Snora47,13,95330600,95330737,snoRNA,1,137,chr13_95330600_95330737
Snora52,7,141448803,141448939,snoRNA,1,136,chr7_141448803_141448939
Snora5c,11,6620319,6620454,snoRNA,-1,135,chr11_6620319_6620454
Snora61,4,132310240,132310369,snoRNA,1,129,chr4_132310240_132310369
Snora62,9,120130415,120130563,snoRNA,1,148,chr9_120130415_120130563
Snora64,17,24720772,24720905,snoRNA,1,133,chr17_24720772_24720905
Snora65,2,32963291,32963420,snoRNA,1,129,chr2_32963291_32963420
Snora68,8,70895759,70895889,snoRNA,-1,130,chr8_70895759_70895889
Snora69,X,37082912,37083042,snoRNA,-1,130,chrX_37082912_37083042
Snora70,X,74272484,74272620,snoRNA,1,136,chrX_74272484_74272620
Snora73a,4,132352775,132352979,snoRNA,-1,204,chr4_132352775_132352979
Snora73b,4,132352322,132352526,snoRNA,-1,204,chr4_132352322_132352526
Snora74a,18,35557032,35557227,snoRNA,1,195,chr18_35557032_35557227
Snora75,1,86351169,86351301,snoRNA,-1,132,chr1_86351169_86351301
Snora78,17,24719676,24719803,snoRNA,-1,127,chr17_24719676_24719803
Snora7a,6,115807975,115808114,snoRNA,-1,139,chr6_115807975_115808114
Snora81,16,23110756,23110933,snoRNA,1,177,chr16_23110756_23110933
Snord100,10,23785750,23785823,snoRNA,-1,73,chr10_23785750_23785823
Snord104,11,106500993,106501062,snoRNA,1,69,chr11_106500993_106501062
Snord11,1,59704790,59704873,snoRNA,1,83,chr1_59704790_59704873
Snord110,2,130275506,130275573,snoRNA,1,67,chr2_130275506_130275573
Snord111,8,110838528,110838616,snoRNA,-1,88,chr8_110838528_110838616
Snord118,11,69073427,69073561,snoRNA,1,134,chr11_69073427_69073561
Snord12,2,167065276,167065365,snoRNA,1,89,chr2_167065276_167065365
Snord123,15,32241853,32241923,snoRNA,-1,70,chr15_32241853_32241923
Snord13,8,31149864,31149967,snoRNA,-1,103,chr8_31149864_31149967
Snord14a,7,116333171,116333257,snoRNA,-1,86,chr7_116333171_116333257
Snord14c,9,40803583,40803668,snoRNA,1,85,chr9_40803583_40803668
Snord14d,9,40803995,40804080,snoRNA,1,85,chr9_40803995_40804080
Snord14e,9,40804748,40804837,snoRNA,1,89,chr9_40804748_40804837
Snord15a,7,99482785,99482932,snoRNA,-1,147,chr7_99482785_99482932
Snord15b,7,99479563,99479707,snoRNA,-1,144,chr7_99479563_99479707
Snord16a,9,64175423,64175521,snoRNA,1,98,chr9_64175423_64175521
Snord17,2,144265979,144266216,snoRNA,-1,237,chr2_144265979_144266216
Snord19,14,31016206,31016281,snoRNA,-1,75,chr14_31016206_31016281
Snord1b,11,116674148,116674222,snoRNA,1,74,chr11_116674148_116674222
Snord1c,11,116672506,116672581,snoRNA,1,75,chr11_116672506_116672581
Snord2,16,23108953,23109021,snoRNA,1,68,chr16_23108953_23109021
Snord22,19,8725866,8725991,snoRNA,1,125,chr19_8725866_8725991
Snord23,7,15938762,15938870,snoRNA,-1,108,chr7_15938762_15938870
Snord32a,7,45127382,45127464,snoRNA,-1,82,chr7_45127382_45127464
Snord33,7,45126864,45126947,snoRNA,-1,83,chr7_45126864_45126947
Snord34,7,45126601,45126670,snoRNA,-1,69,chr7_45126601_45126670
Snord35a,7,45126346,45126435,snoRNA,-1,89,chr7_45126346_45126435
Snord35b,7,45123025,45123111,snoRNA,-1,86,chr7_45123025_45123111
Snord37,10,81178950,81179013,snoRNA,1,63,chr10_81178950_81179013
Snord38a,4,117154514,117154584,snoRNA,-1,70,chr4_117154514_117154584
Snord42a,11,78181299,78181363,snoRNA,-1,64,chr11_78181299_78181363
Snord42b,11,78183056,78183124,snoRNA,-1,68,chr11_78183056_78183124
Snord43,15,80082847,80082954,miRNA,-1,107,chr15_80082847_80082954
Snord45b,3,153910563,153910633,snoRNA,-1,70,chr3_153910563_153910633
Snord47,1,161038082,161038158,snoRNA,1,76,chr1_161038082_161038158
Snord49a,11,62603450,62603521,snoRNA,1,71,chr11_62603450_62603521
Snord49b,11,62603079,62603150,snoRNA,1,71,chr11_62603079_62603150
Snord4a,11,78181686,78181756,snoRNA,-1,70,chr11_78181686_78181756
Snord52,17,34950952,34951017,snoRNA,-1,65,chr17_34950952_34951017
Snord53,17,71640879,71640956,snoRNA,1,77,chr17_71640879_71640956
Snord55,4,117155770,117155848,snoRNA,-1,78,chr4_117155770_117155848
Snord57,2,130278016,130278087,snoRNA,1,71,chr2_130278016_130278087
Snord58b,18,75001058,75001123,snoRNA,1,65,chr18_75001058_75001123
Snord61,X,57391449,57391519,snoRNA,-1,70,chrX_57391449_57391519
Snord64,7,59978808,59978874,snoRNA,-1,66,chr7_59978808_59978874
Snord65,11,62604515,62604586,snoRNA,1,71,chr11_62604515_62604586
Snord66,16,20684239,20684313,snoRNA,1,74,chr16_20684239_20684313
Snord67,2,91596070,91596180,snoRNA,1,110,chr2_91596070_91596180
Snord68,8,123103038,123103123,snoRNA,1,85,chr8_123103038_123103123
Snord69,14,31014287,31014366,snoRNA,-1,79,chr14_31014287_31014366
Snord70,1,59691934,59692020,snoRNA,1,86,chr1_59691934_59692020
Snord71,8,109839295,109839379,snoRNA,1,84,chr8_109839295_109839379
Snord72,15,5118404,5118484,snoRNA,1,80,chr15_5118404_5118484
Snord73a,3,86138791,86138858,snoRNA,-1,67,chr3_86138791_86138858
Snord8,14,52209785,52209894,snoRNA,-1,109,chr14_52209785_52209894
Snord82,1,86356261,86356330,snoRNA,-1,69,chr1_86356261_86356330
Snord83b,15,80078498,80078591,snoRNA,-1,93,chr15_80078498_80078591
Snord87,1,9942463,9942549,snoRNA,-1,86,chr1_9942463_9942549
Snord88a,7,44250135,44250224,snoRNA,1,89,chr7_44250135_44250224
Snord88c,7,44249852,44249941,snoRNA,1,89,chr7_44249852_44249941
Snord89,1,39548745,39548854,snoRNA,-1,109,chr1_39548745_39548854
Snord90,2,37400047,37400157,snoRNA,-1,110,chr2_37400047_37400157
Snord92,17,71631281,71631365,snoRNA,1,84,chr17_71631281_71631365
Snord93,5,23852210,23852280,snoRNA,1,70,chr5_23852210_23852280
Snord95,11,48803139,48803206,snoRNA,1,67,chr11_48803139_48803206
Snord96a,11,48802032,48802112,snoRNA,1,80,chr11_48802032_48802112
Snord98,10,62765576,62765640,snoRNA,-1,64,chr10_62765576_62765640
Snord99,4,132310691,132310764,snoRNA,1,73,chr4_132310691_132310764
Snph,2,151590549,151632593,protein_coding,-1,42044,chr2_151590549_151632593
Snrk,9,122117266,122169702,protein_coding,1,52436,chr9_122117266_122169702
Snrnp200,2,127208386,127240451,protein_coding,1,32065,chr2_127208386_127240451
Snrnp25,11,32205415,32208984,protein_coding,1,3569,chr11_32205415_32208984
Snrnp27,6,86675151,86684522,protein_coding,-1,9371,chr6_86675151_86684522
Snrnp35,5,124483134,124491124,protein_coding,1,7990,chr5_124483134_124491124
Snrnp40,4,130360132,130390026,protein_coding,1,29894,chr4_130360132_130390026
Snrnp48,13,38204938,38227665,protein_coding,1,22727,chr13_38204938_38227665
Snrnp70,7,45376453,45395742,protein_coding,-1,19289,chr7_45376453_45395742
Snrp1c-ps1,7,126723936,126724409,processed_pseudogene,1,473,chr7_126723936_126724409
Snrp1c-ps2,13,23923800,23924164,processed_pseudogene,-1,364,chr13_23923800_23924164
Snrpa,7,27187005,27196271,protein_coding,-1,9266,chr7_27187005_27196271
Snrpa1,7,66059003,66074587,protein_coding,1,15584,chr7_66059003_66074587
Snrpb,2,130171414,130179403,protein_coding,-1,7989,chr2_130171414_130179403
Snrpb2,2,143063039,143072853,protein_coding,1,9814,chr2_143063039_143072853
Snrpc,17,27838150,27851968,protein_coding,1,13818,chr17_27838150_27851968
Snrpd1,18,10617775,10642079,protein_coding,1,24304,chr18_10617775_10642079
Snrpd2,7,19149722,19153542,protein_coding,1,3820,chr7_19149722_19153542
Snrpd3,10,75517551,75537381,protein_coding,1,19830,chr10_75517551_75537381
Snrpe,1,133603871,133610291,protein_coding,-1,6420,chr1_133603871_133610291
Snrpf,10,93583029,93589706,protein_coding,-1,6677,chr10_93583029_93589706
Snrpg,6,86371304,86379328,protein_coding,1,8024,chr6_86371304_86379328
Snrpn,7,59982495,60140219,protein_coding,-1,157724,chr7_59982495_60140219
Snta1,2,154376313,154408099,protein_coding,-1,31786,chr2_154376313_154408099
Sntb1,15,55636388,55906949,protein_coding,-1,270561,chr15_55636388_55906949
Sntb2,8,106935750,107019714,protein_coding,1,83964,chr8_106935750_107019714
Sntg1,1,8361475,9299878,protein_coding,-1,938403,chr1_8361475_9299878
Sntg2,12,30174482,30373375,protein_coding,-1,198893,chr12_30174482_30373375
Snupn,9,56950878,56983206,protein_coding,1,32328,chr9_56950878_56983206
Snurf,7,59995449,60005049,protein_coding,-1,9600,chr7_59995449_60005049
Snw1,12,87449075,87472274,protein_coding,-1,23199,chr12_87449075_87472274
Snx1,9,66088133,66126587,protein_coding,-1,38454,chr9_66088133_66126587
Snx10,6,51523901,51590679,protein_coding,1,66778,chr6_51523901_51590679
Snx11,11,96767555,96777559,protein_coding,-1,10004,chr11_96767555_96777559
Snx12,X,101097786,101222563,protein_coding,-1,124777,chrX_101097786_101222563
Snx13,12,35047186,35147479,protein_coding,1,100293,chr12_35047186_35147479
Snx14,9,88376747,88438958,protein_coding,-1,62211,chr9_88376747_88438958
Snx15,19,6119399,6128304,protein_coding,-1,8905,chr19_6119399_6128304
Snx16,3,10417817,10440102,protein_coding,-1,22285,chr3_10417817_10440102
Snx17,5,31193227,31199143,protein_coding,1,5916,chr5_31193227_31199143
Snx18,13,113592179,113618564,protein_coding,-1,26385,chr13_113592179_113618564
Snx19,9,30427108,30466733,protein_coding,1,39625,chr9_30427108_30466733
Snx2,18,53176316,53220865,protein_coding,1,44549,chr18_53176316_53220865
Snx20,8,88626563,88636128,protein_coding,-1,9565,chr8_88626563_88636128
Snx21,2,164785823,164793816,protein_coding,1,7993,chr2_164785823_164793816
Snx22,9,66065176,66069719,protein_coding,-1,4543,chr9_66065176_66069719
Snx24,18,53245662,53390920,protein_coding,1,145258,chr18_53245662_53390920
Snx25,8,46033261,46152159,protein_coding,-1,118898,chr8_46033261_46152159
Snx27,3,94497544,94582716,protein_coding,-1,85172,chr3_94497544_94582716
Snx29,16,11322908,11755472,protein_coding,1,432564,chr16_11322908_11755472
Snx3,10,42502030,42535381,protein_coding,1,33351,chr10_42502030_42535381
Snx30,4,59805840,59904737,protein_coding,1,98897,chr4_59805840_59904737
Snx31,15,36504062,36555573,protein_coding,-1,51511,chr15_36504062_36555573
Snx32,19,5492235,5510538,protein_coding,-1,18303,chr19_5492235_5510538
Snx33,9,56917193,56928371,protein_coding,-1,11178,chr9_56917193_56928371
Snx4,16,33251442,33300269,protein_coding,1,48827,chr16_33251442_33300269
Snx5,2,144250123,144270906,protein_coding,-1,20783,chr2_144250123_144270906
Snx6,12,54746349,54795703,protein_coding,-1,49354,chr12_54746349_54795703
Snx7,3,117781647,117868936,protein_coding,-1,87289,chr3_117781647_117868936
Snx8,5,140340299,140389262,protein_coding,-1,48963,chr5_140340299_140389262
Snx9,17,5841329,5931954,protein_coding,1,90625,chr17_5841329_5931954
Soat1,1,156424525,156474331,protein_coding,-1,49806,chr1_156424525_156474331
Soat2,15,102150526,102163469,protein_coding,1,12943,chr15_102150526_102163469
Sobp,10,43002500,43174530,protein_coding,-1,172030,chr10_43002500_43174530
Socs1,16,10782240,10785536,protein_coding,-1,3296,chr16_10782240_10785536
Socs2,10,95385362,95417180,protein_coding,-1,31818,chr10_95385362_95417180
Socs3,11,117966079,117970047,protein_coding,-1,3968,chr11_117966079_117970047
Socs4,14,47276931,47296102,protein_coding,1,19171,chr14_47276931_47296102
Socs5,17,87107679,87137839,protein_coding,1,30160,chr17_87107679_87137839
Socs6,18,88665224,88927481,protein_coding,-1,262257,chr18_88665224_88927481
Socs7,11,97362435,97398542,protein_coding,1,36107,chr11_97362435_97398542
Sod1,16,90220754,90226329,protein_coding,1,5575,chr16_90220754_90226329
Sod2,17,13006846,13040063,protein_coding,1,33217,chr17_13006846_13040063
Sod3,5,52363791,52371418,protein_coding,1,7627,chr5_52363791_52371418
Soga1,2,157015799,157079254,protein_coding,-1,63455,chr2_157015799_157079254
Soga3,10,29143839,29199630,protein_coding,1,55791,chr10_29143839_29199630
Sohlh2,3,55182028,55209957,protein_coding,1,27929,chr3_55182028_55209957
Son,16,91647506,91679221,protein_coding,1,31715,chr16_91647506_91679221
Sorbs1,19,40294753,40513779,protein_coding,-1,219026,chr19_40294753_40513779
Sorbs2,8,45507788,45827906,protein_coding,1,320118,chr8_45507788_45827906
Sorbs2os,8,45723325,45819297,antisense,-1,95972,chr8_45723325_45819297
Sorbs3,14,70180468,70211989,protein_coding,-1,31521,chr14_70180468_70211989
Sorcs1,19,50143299,50678646,protein_coding,-1,535347,chr19_50143299_50678646
Sorcs2,5,36017180,36398139,protein_coding,-1,380959,chr5_36017180_36398139
Sorcs3,19,48206025,48805505,protein_coding,1,599480,chr19_48206025_48805505
Sord,2,122234749,122265340,protein_coding,1,30591,chr2_122234749_122265340
Sorl1,9,41964720,42124297,protein_coding,-1,159577,chr9_41964720_42124297
Sort1,3,108284082,108361511,protein_coding,1,77429,chr3_108284082_108361511
Sos1,17,80393751,80480453,protein_coding,-1,86702,chr17_80393751_80480453
Sos2,12,69583762,69681852,protein_coding,-1,98090,chr12_69583762_69681852
Sost,11,101962458,101967015,protein_coding,-1,4557,chr11_101962458_101967015
Sostdc1,12,36314139,36318452,protein_coding,1,4313,chr12_36314139_36318452
Sowaha,11,53476573,53480274,protein_coding,-1,3701,chr11_53476573_53480274
Sowahb,5,93041123,93045022,protein_coding,-1,3899,chr5_93041123_93045022
Sowahc,10,59221953,59226434,protein_coding,1,4481,chr10_59221953_59226434
Sox1,8,12395295,12400126,protein_coding,1,4831,chr8_12395295_12400126
Sox10,15,79154908,79165240,protein_coding,-1,10332,chr15_79154908_79165240
Sox11,12,27334264,27342574,protein_coding,-1,8310,chr12_27334264_27342574
Sox12,2,152393611,152398063,protein_coding,-1,4452,chr2_152393611_152398063
Sox13,1,133382303,133424377,protein_coding,-1,42074,chr1_133382303_133424377
Sox15,11,69655314,69656727,protein_coding,1,1413,chr11_69655314_69656727
Sox17,1,4490931,4497354,protein_coding,-1,6423,chr1_4490931_4497354
Sox18,2,181669836,181671640,protein_coding,-1,1804,chr2_181669836_181671640
Sox2,3,34650405,34652461,protein_coding,1,2056,chr3_34650405_34652461
Sox21,14,118233232,118237030,protein_coding,-1,3798,chr14_118233232_118237030
Sox2ot,3,34104270,34682619,processed_transcript,1,578349,chr3_34104270_34682619
Sox3,X,60891366,60893430,protein_coding,-1,2064,chrX_60891366_60893430
Sox30,11,45980310,46017994,protein_coding,1,37684,chr11_45980310_46017994
Sox4,13,28948919,28953713,protein_coding,-1,4794,chr13_28948919_28953713
Sox5,6,143828425,144781977,protein_coding,-1,953552,chr6_143828425_144781977
Sox5os3,6,144672868,144693834,antisense,1,20966,chr6_144672868_144693834
Sox5os4,6,144720911,144759883,antisense,1,38972,chr6_144720911_144759883
Sox6,7,115470872,116038796,protein_coding,-1,567924,chr7_115470872_116038796
Sox6os,7,116031979,116032550,antisense,1,571,chr7_116031979_116032550
Sox7,14,63943673,63950732,protein_coding,1,7059,chr14_63943673_63950732
Sox8,17,25565892,25570686,protein_coding,-1,4794,chr17_25565892_25570686
Sox9,11,112782224,112787760,protein_coding,1,5536,chr11_112782224_112787760
Sp1,15,102406143,102436404,protein_coding,1,30261,chr15_102406143_102436404
Sp100,1,85649988,85709998,protein_coding,1,60010,chr1_85649988_85709998
Sp110,1,85576899,85598817,protein_coding,-1,21918,chr1_85576899_85598817
Sp140,1,85600378,85645037,protein_coding,1,44659,chr1_85600378_85645037
Sp2,11,96953341,96982959,protein_coding,-1,29618,chr11_96953341_96982959
Sp3,2,72936427,72980446,protein_coding,-1,44019,chr2_72936427_72980446
Sp3os,2,72979424,72988677,antisense,1,9253,chr2_72979424_72988677
Sp4,12,118234933,118301440,protein_coding,-1,66507,chr12_118234933_118301440
Sp5,2,70474923,70477729,protein_coding,1,2806,chr2_70474923_70477729
Sp6,11,97013394,97024734,protein_coding,1,11340,chr11_97013394_97024734
Sp7,15,102356606,102367182,protein_coding,-1,10576,chr15_102356606_102367182
Sp8,12,118846329,118852576,protein_coding,1,6247,chr12_118846329_118852576
Sp9,2,73271925,73284706,protein_coding,1,12781,chr2_73271925_73284706
Spa17,9,37603290,37613722,protein_coding,-1,10432,chr9_37603290_37613722
Spaca1,4,34024874,34050191,protein_coding,-1,25317,chr4_34024874_34050191
Spaca5,X,21068406,21077963,protein_coding,1,9557,chrX_21068406_21077963
Spaca6,17,17827158,17843009,protein_coding,1,15851,chr17_17827158_17843009
Spag1,15,36178099,36235621,protein_coding,1,57522,chr15_36178099_36235621
Spag11b,8,19140759,19143010,protein_coding,1,2251,chr8_19140759_19143010
Spag16,1,69826970,70725132,protein_coding,1,898162,chr1_69826970_70725132
Spag17,3,99885406,100143322,protein_coding,1,257916,chr3_99885406_100143322
Spag4,2,156065175,156070617,protein_coding,1,5442,chr2_156065175_156070617
Spag5,11,78301529,78322457,protein_coding,1,20928,chr11_78301529_78322457
Spag6,2,18694032,18750413,protein_coding,1,56381,chr2_18694032_18750413
Spag7,11,70663771,70669416,protein_coding,-1,5645,chr11_70663771_70669416
Spag8,4,43651335,43653594,protein_coding,-1,2259,chr4_43651335_43653594
Spag9,11,93996091,94126085,protein_coding,1,129994,chr11_93996091_94126085
Sparc,11,55394500,55423183,protein_coding,-1,28683,chr11_55394500_55423183
Sparcl1,5,104079111,104113733,protein_coding,-1,34622,chr5_104079111_104113733
Spast,17,74338987,74391115,protein_coding,1,52128,chr17_74338987_74391115
Spata1,3,146457196,146499753,protein_coding,-1,42557,chr3_146457196_146499753
Spata13,14,60634001,60764556,protein_coding,1,130555,chr14_60634001_60764556
Spata16,3,26637620,26983212,protein_coding,1,345592,chr3_26637620_26983212
Spata17,1,187044648,187215465,protein_coding,-1,170817,chr1_187044648_187215465
Spata18,5,73651379,73679512,protein_coding,1,28133,chr5_73651379_73679512
Spata19,9,27396800,27401785,protein_coding,1,4985,chr9_27396800_27401785
Spata2,2,167481133,167492887,protein_coding,-1,11754,chr2_167481133_167492887
Spata20,11,94478904,94486179,protein_coding,-1,7275,chr11_94478904_94486179
Spata21,4,141088333,141112760,protein_coding,1,24427,chr4_141088333_141112760
Spata22,11,73329741,73346044,protein_coding,1,16303,chr11_73329741_73346044
Spata24,18,35656689,35662186,protein_coding,-1,5497,chr18_35656689_35662186
Spata2l,8,123229801,123236233,protein_coding,-1,6432,chr8_123229801_123236233
Spata3,1,86016816,86029958,protein_coding,1,13142,chr1_86016816_86029958
Spata31d1a,13,59699806,59710330,protein_coding,-1,10524,chr13_59699806_59710330
Spata31d1d,13,59725925,59731752,protein_coding,-1,5827,chr13_59725925_59731752
Spata32,11,103208127,103218432,protein_coding,-1,10305,chr11_103208127_103218432
Spata33,8,123212832,123222046,protein_coding,1,9214,chr8_123212832_123222046
Spata4,8,54600781,54610098,protein_coding,1,9317,chr8_54600781_54610098
Spata45,1,191036639,191042942,protein_coding,1,6303,chr1_191036639_191042942
Spata5,3,37419896,37579096,protein_coding,1,159200,chr3_37419896_37579096
Spata5l1,2,122630646,122632930,processed_transcript,1,2284,chr2_122630646_122632930
Spata6,4,111719984,111829184,protein_coding,1,109200,chr4_111719984_111829184
Spata7,12,98628157,98669815,protein_coding,1,41658,chr12_98628157_98669815
Spata9,13,75967150,75998972,protein_coding,1,31822,chr13_75967150_75998972
Spatc1,15,76268089,76292572,protein_coding,1,24483,chr15_76268089_76292572
Spatc1l,10,76562272,76570201,protein_coding,1,7929,chr10_76562272_76570201
Spats1,17,45440578,45475415,protein_coding,-1,34837,chr17_45440578_45475415
Spats2,15,99125916,99213215,protein_coding,1,87299,chr15_99125916_99213215
Spats2l,1,57774162,57948394,protein_coding,1,174232,chr1_57774162_57948394
Spc24,9,21755442,21760303,protein_coding,-1,4861,chr9_21755442_21760303
Spc25,2,69193895,69206194,protein_coding,-1,12299,chr2_69193895_69206194
Spcs1,14,30999826,31001672,protein_coding,-1,1846,chr14_30999826_31001672
Spcs2,7,99837569,99863462,protein_coding,-1,25893,chr7_99837569_99863462
Spcs2-ps,2,129378271,129379396,unprocessed_pseudogene,-1,1125,chr2_129378271_129379396
Spcs3,8,54520433,54529998,protein_coding,-1,9565,chr8_54520433_54529998
Spdef,17,27714352,27728955,protein_coding,-1,14603,chr17_27714352_27728955
Spdl1,11,34809190,34833641,protein_coding,-1,24451,chr11_34809190_34833641
Spdya,17,71552061,71589533,protein_coding,1,37472,chr17_71552061_71589533
Specc1,11,61956763,62223013,protein_coding,1,266250,chr11_61956763_62223013
Specc1l,10,75212073,75312743,protein_coding,1,100670,chr10_75212073_75312743
Speer2,16,69856874,69863744,protein_coding,-1,6870,chr16_69856874_69863744
Speer4a,5,26032846,26039558,protein_coding,-1,6712,chr5_26032846_26039558
Speer4b,5,27495639,27501438,protein_coding,-1,5799,chr5_27495639_27501438
Speer5-ps1,10,44169911,44219583,transcribed_processed_pseudogene,1,49672,chr10_44169911_44219583
Speer6-ps1,13,3149475,3189678,transcribed_unprocessed_pseudogene,1,40203,chr13_3149475_3189678
Spef1,2,131170261,131187282,protein_coding,-1,17021,chr2_131170261_131187282
Spef2,15,9578193,9748868,protein_coding,-1,170675,chr15_9578193_9748868
Speg,1,75375297,75432320,protein_coding,1,57023,chr1_75375297_75432320
Spem1,11,69820876,69822180,protein_coding,-1,1304,chr11_69820876_69822180
Spen,4,141467890,141538597,protein_coding,-1,70707,chr4_141467890_141538597
Spesp1,9,62270729,62282208,protein_coding,-1,11479,chr9_62270729_62282208
Spg11,2,122053520,122118386,protein_coding,-1,64866,chr2_122053520_122118386
Spg20,3,55112108,55137322,protein_coding,1,25214,chr3_55112108_55137322
Spg21,9,65460947,65488470,protein_coding,1,27523,chr9_65460947_65488470
Spg7,8,123062942,123097760,protein_coding,1,34818,chr8_123062942_123097760
Sphk1,11,116530925,116536675,protein_coding,1,5750,chr11_116530925_116536675
Sphk2,7,45709467,45718002,protein_coding,-1,8535,chr7_45709467_45718002
Sphkap,1,83254139,83408200,protein_coding,-1,154061,chr1_83254139_83408200
Spi1,2,91082390,91115756,protein_coding,1,33366,chr2_91082390_91115756
Spib,7,44525993,44532071,protein_coding,-1,6078,chr7_44525993_44532071
Spice1,16,44347121,44388497,protein_coding,1,41376,chr16_44347121_44388497
Spidr,16,15889224,16146851,protein_coding,-1,257627,chr16_15889224_16146851
Spin1,13,51100880,51152546,protein_coding,1,51666,chr13_51100880_51152546
Spin2c,X,153832225,153834243,protein_coding,1,2018,chrX_153832225_153834243
Spin4,X,95022510,95026682,protein_coding,-1,4172,chrX_95022510_95026682
Spink10,18,62548911,62668070,protein_coding,1,119159,chr18_62548911_62668070
Spink13,18,62607535,62741387,protein_coding,-1,133852,chr18_62607535_62741387
Spink4,4,40920052,40931395,protein_coding,1,11343,chr4_40920052_40931395
Spink5,18,43963235,44022501,protein_coding,1,59266,chr18_43963235_44022501
Spink6,18,44071393,44083611,protein_coding,1,12218,chr18_44071393_44083611
Spink7,18,62592194,62596327,protein_coding,-1,4133,chr18_62592194_62596327
Spink8,9,109812280,109826633,protein_coding,1,14353,chr9_109812280_109826633
Spint1,2,119237362,119249527,protein_coding,1,12165,chr2_119237362_119249527
Spint2,7,29256323,29281912,protein_coding,-1,25589,chr7_29256323_29281912
Spire1,18,67488209,67610790,protein_coding,-1,122581,chr18_67488209_67610790
Spire2,8,123332713,123369515,protein_coding,1,36802,chr8_123332713_123369515
Spn,7,127132232,127137823,protein_coding,-1,5591,chr7_127132232_127137823
Spn-ps,15,90891402,90899022,transcribed_processed_pseudogene,-1,7620,chr15_90891402_90899022
Spns1,7,126370060,126377450,protein_coding,-1,7390,chr7_126370060_126377450
Spns2,11,72451638,72489904,protein_coding,-1,38266,chr11_72451638_72489904
Spns3,11,72494919,72550506,protein_coding,-1,55587,chr11_72494919_72550506
Spo11,2,172977700,172993576,protein_coding,1,15876,chr2_172977700_172993576
Spocd1,4,129929249,129957115,protein_coding,1,27866,chr4_129929249_129957115
Spock1,13,57421195,57908332,protein_coding,-1,487137,chr13_57421195_57908332
Spock2,10,60106219,60135198,protein_coding,1,28979,chr10_60106219_60135198
Spock3,8,62951009,63357103,protein_coding,1,406094,chr8_62951009_63357103
Spon1,7,113765998,114043370,protein_coding,1,277372,chr7_113765998_114043370
Spop,11,95414080,95493406,protein_coding,1,79326,chr11_95414080_95493406
Spopl,2,23506220,23572106,protein_coding,-1,65886,chr2_23506220_23572106
Spp1,5,104435118,104441050,protein_coding,1,5932,chr5_104435118_104441050
Spp2,1,88406961,88426438,protein_coding,1,19477,chr1_88406961_88426438
Sppl2a,2,126890391,126933235,protein_coding,-1,42844,chr2_126890391_126933235
Sppl2b,10,80855275,80868708,protein_coding,1,13433,chr10_80855275_80868708
Sppl2c,11,104186327,104191163,protein_coding,1,4836,chr11_104186327_104191163
Sppl3,5,115011137,115098790,protein_coding,1,87653,chr5_115011137_115098790
Spr,6,85130176,85137766,protein_coding,-1,7590,chr6_85130176_85137766
Spr-ps1,6,85152621,85156223,transcribed_unprocessed_pseudogene,1,3602,chr6_85152621_85156223
Spred1,2,117121374,117182279,protein_coding,1,60905,chr2_117121374_117182279
Spred2,11,19924375,20024026,protein_coding,1,99651,chr11_19924375_20024026
Spred3,7,29158829,29170411,protein_coding,-1,11582,chr7_29158829_29170411
Sprn,7,140150628,140154877,protein_coding,-1,4249,chr7_140150628_140154877
Sprtn,8,124897886,124906161,protein_coding,1,8275,chr8_124897886_124906161
Spry1,3,37639947,37644598,protein_coding,1,4651,chr3_37639947_37644598
Spry2,14,105891947,105896819,protein_coding,-1,4872,chr14_105891947_105896819
Spry4,18,38586247,38601415,protein_coding,-1,15168,chr18_38586247_38601415
Spryd3,15,102116528,102136234,protein_coding,-1,19706,chr15_102116528_102136234
Spryd4,10,128209908,128211807,protein_coding,-1,1899,chr10_128209908_128211807
Spryd7,14,61531993,61556886,protein_coding,-1,24893,chr14_61531993_61556886
Spsb1,4,149896283,149955043,protein_coding,-1,58760,chr4_149896283_149955043
Spsb2,6,124808661,124810619,protein_coding,1,1958,chr6_124808661_124810619
Spsb3,17,24886643,24892152,protein_coding,1,5509,chr17_24886643_24892152
Spsb4,9,96943482,97018843,protein_coding,-1,75361,chr9_96943482_97018843
Spta1,1,174172776,174248450,protein_coding,1,75674,chr1_174172776_174248450
Sptan1,2,29965560,30031451,protein_coding,1,65891,chr2_29965560_30031451
Sptb,12,76580488,76710547,protein_coding,-1,130059,chr12_76580488_76710547
Sptbn1,11,30099395,30268175,protein_coding,-1,168780,chr11_30099395_30268175
Sptbn2,19,4711167,4752360,protein_coding,1,41193,chr19_4711167_4752360
Sptbn4,7,27356383,27447686,protein_coding,-1,91303,chr7_27356383_27447686
Sptbn5,2,120041493,120085678,protein_coding,-1,44185,chr2_120041493_120085678
Sptlc1,13,53332748,53377397,protein_coding,-1,44649,chr13_53332748_53377397
Sptlc2,12,87305058,87388355,protein_coding,-1,83297,chr12_87305058_87388355
Sptssa,12,54645392,54656573,protein_coding,-1,11181,chr12_54645392_54656573
Sptssb,3,69819542,69859940,protein_coding,-1,40398,chr3_69819542_69859940
Spty2d1,7,46990396,47008411,protein_coding,-1,18015,chr7_46990396_47008411
Sqle,15,59315077,59331192,protein_coding,1,16115,chr15_59315077_59331192
Sqstm1,11,50199366,50210827,protein_coding,-1,11461,chr11_50199366_50210827
Sra1,18,36666681,36670815,protein_coding,-1,4134,chr18_36666681_36670815
Srbd1,17,85984665,86145175,protein_coding,-1,160510,chr17_85984665_86145175
Src,2,157418444,157471862,protein_coding,1,53418,chr2_157418444_157471862
Srcap,7,127511983,127561219,protein_coding,1,49236,chr7_127511983_127561219
Srcin1,11,97509340,97576186,protein_coding,-1,66846,chr11_97509340_97576186
Srd5a1,13,69573449,69611442,protein_coding,-1,37993,chr13_69573449_69611442
Srd5a3,5,76140271,76155504,protein_coding,1,15233,chr5_76140271_76155504
Srebf1,11,60199089,60222581,protein_coding,-1,23492,chr11_60199089_60222581
Srebf2,15,82147181,82205379,protein_coding,1,58198,chr15_82147181_82205379
Srek1,13,103739348,103774608,protein_coding,-1,35260,chr13_103739348_103774608
Srek1ip1,13,104792484,104839274,protein_coding,1,46790,chr13_104792484_104839274
Srf,17,46548329,46556175,protein_coding,-1,7846,chr17_46548329_46556175
Srfbp1,18,52465693,52491931,protein_coding,1,26238,chr18_52465693_52491931
Srgap1,10,121780991,122047315,protein_coding,-1,266324,chr10_121780991_122047315
Srgap2,1,131285251,131527352,protein_coding,-1,242101,chr1_131285251_131527352
Srgap3,6,112717971,112947266,protein_coding,-1,229295,chr6_112717971_112947266
Srgn,10,62493833,62527451,protein_coding,-1,33618,chr10_62493833_62527451
Sri,5,8046078,8069379,protein_coding,1,23301,chr5_8046078_8069379
Srl,16,4480216,4541816,protein_coding,-1,61600,chr16_4480216_4541816
Srm,4,148591503,148594993,protein_coding,1,3490,chr4_148591503_148594993
Srms,2,181205562,181213185,protein_coding,-1,7623,chr2_181205562_181213185
Srp14,2,118475850,118479711,protein_coding,-1,3861,chr2_118475850_118479711
Srp19,18,34330847,34336599,protein_coding,1,5752,chr18_34330847_34336599
Srp54a,12,55080262,55115367,protein_coding,1,35105,chr12_55080262_55115367
Srp54b,12,55155104,55189573,protein_coding,1,34469,chr12_55155104_55189573
Srp54c,12,55230168,55263836,protein_coding,1,33668,chr12_55230168_55263836
Srp68,11,116245166,116274217,protein_coding,-1,29051,chr11_116245166_116274217
Srp72,5,76974683,76999937,protein_coding,1,25254,chr5_76974683_76999937
Srp9,1,182124737,182132407,protein_coding,1,7670,chr1_182124737_182132407
Srpk1,17,28587648,28622709,protein_coding,-1,35061,chr17_28587648_28622709
Srpk2,5,23503264,23684617,protein_coding,-1,181353,chr5_23503264_23684617
Srpk3,X,73774405,73778925,protein_coding,1,4520,chrX_73774405_73778925
Srpr,9,35200175,35247973,protein_coding,1,47798,chr9_35200175_35247973
Srprb,9,103188032,103202137,protein_coding,-1,14105,chr9_103188032_103202137
Srpx,X,10037977,10117709,protein_coding,-1,79732,chrX_10037977_10117709
Srpx2,X,133908426,133932446,protein_coding,1,24020,chrX_133908426_133932446
Srr,11,74906359,74925948,protein_coding,-1,19589,chr11_74906359_74925948
Srrd,5,112337392,112343040,protein_coding,-1,5648,chr5_112337392_112343040
Srrm1,4,135320484,135353321,protein_coding,-1,32837,chr4_135320484_135353321
Srrm2,17,23790532,23824741,protein_coding,1,34209,chr17_23790532_23824741
Srrm3,5,135806890,135874772,protein_coding,1,67882,chr5_135806890_135874772
Srrm4,5,116439275,116591817,protein_coding,-1,152542,chr5_116439275_116591817
Srrm4os,5,116438720,116465487,antisense,1,26767,chr5_116438720_116465487
Srrt,5,137295704,137307674,protein_coding,-1,11970,chr5_137295704_137307674
Srsf1,11,88047373,88053755,protein_coding,1,6382,chr11_88047373_88053755
Srsf10,4,135855747,135869908,protein_coding,1,14161,chr4_135855747_135869908
Srsf11,3,158010473,158036639,protein_coding,-1,26166,chr3_158010473_158036639
Srsf12,4,33208991,33233340,protein_coding,1,24349,chr4_33208991_33233340
Srsf2,11,116849901,116853094,protein_coding,-1,3193,chr11_116849901_116853094
Srsf3,17,29032628,29043373,protein_coding,1,10745,chr17_29032628_29043373
Srsf4,4,131873617,131901706,protein_coding,1,28089,chr4_131873617_131901706
Srsf5,12,80945504,80950507,protein_coding,1,5003,chr12_80945504_80950507
Srsf6,2,162931528,162937121,protein_coding,1,5593,chr2_162931528_162937121
Srsf7,17,80200080,80207307,protein_coding,-1,7227,chr17_80200080_80207307
Srsf9,5,115327177,115333080,protein_coding,1,5903,chr5_115327177_115333080
Srxn1,2,152105516,152111376,protein_coding,1,5860,chr2_152105516_152111376
Sry,Y,2662471,2663658,protein_coding,-1,1187,chrY_2662471_2663658
Ss18,18,14624198,14682914,protein_coding,-1,58716,chr18_14624198_14682914
Ss18l1,2,180042509,180070201,protein_coding,1,27692,chr2_180042509_180070201
Ssb,2,69861562,69871846,protein_coding,1,10284,chr2_69861562_69871846
Ssbp1,6,40471352,40484700,protein_coding,1,13348,chr6_40471352_40484700
Ssbp2,13,91460283,91703429,protein_coding,1,243146,chr13_91460283_91703429
Ssbp3,4,106910701,107049694,protein_coding,1,138993,chr4_106910701_107049694
Ssbp4,8,70597490,70608872,protein_coding,-1,11382,chr8_70597490_70608872
Ssc4d,5,135960211,135974531,protein_coding,-1,14320,chr5_135960211_135974531
Ssc5d,7,4925785,4944826,protein_coding,1,19041,chr7_4925785_4944826
Ssh1,5,113937094,113993894,protein_coding,-1,56800,chr5_113937094_113993894
Ssh2,11,77216287,77460220,protein_coding,1,243933,chr11_77216287_77460220
Ssh3,19,4261668,4269180,protein_coding,-1,7512,chr19_4261668_4269180
Ssmem1,6,30509849,30520254,protein_coding,1,10405,chr6_30509849_30520254
Ssna1,2,25271039,25272438,protein_coding,-1,1399,chr2_25271039_25272438
Sspn,6,145931641,145965223,protein_coding,1,33582,chr6_145931641_145965223
Sspo,6,48448229,48501250,protein_coding,1,53021,chr6_48448229_48501250
Ssr1,13,37966605,37994217,protein_coding,-1,27612,chr13_37966605_37994217
Ssr2,3,88575876,88588419,protein_coding,1,12543,chr3_88575876_88588419
Ssr3,3,65379655,65392623,protein_coding,-1,12968,chr3_65379655_65392623
Ssr4,X,73787028,73790830,protein_coding,1,3802,chrX_73787028_73790830
Ssrp1,2,85037234,85047109,protein_coding,1,9875,chr2_85037234_85047109
Sst,16,23889573,23890958,protein_coding,-1,1385,chr16_23889573_23890958
Sstr1,12,58211772,58214444,protein_coding,1,2672,chr12_58211772_58214444
Sstr2,11,113619342,113626028,protein_coding,1,6686,chr11_113619342_113626028
Sstr3,15,78537008,78544685,protein_coding,-1,7677,chr15_78537008_78544685
Sstr4,2,148395344,148396767,protein_coding,1,1423,chr2_148395344_148396767
Sstr5,17,25489875,25497288,protein_coding,-1,7413,chr17_25489875_25497288
Ssu2,6,112359324,112388023,protein_coding,-1,28699,chr6_112359324_112388023
Ssu72,4,155704800,155733879,protein_coding,1,29079,chr4_155704800_155733879
Ssx2ip,3,146404642,146440144,protein_coding,1,35502,chr3_146404642_146440144
Ssx9,X,8748432,8754587,protein_coding,1,6155,chrX_8748432_8754587
Ssxb10,X,8327424,8336237,protein_coding,1,8813,chrX_8327424_8336237
Ssxb3,X,8583404,8591816,protein_coding,-1,8412,chrX_8583404_8591816
Ssxb5,X,8803691,8809386,protein_coding,1,5695,chrX_8803691_8809386
Ssxb6,X,8542608,8548255,protein_coding,-1,5647,chrX_8542608_8548255
St13,15,81363669,81400077,protein_coding,-1,36408,chr15_81363669_81400077
St14,9,31089402,31131853,protein_coding,-1,42451,chr9_31089402_31131853
St18,1,6487231,6860940,protein_coding,1,373709,chr1_6487231_6860940
St3gal1,15,67102875,67176830,protein_coding,-1,73955,chr15_67102875_67176830
St3gal2,8,110919922,110972480,protein_coding,1,52558,chr8_110919922_110972480
St3gal3,4,117932154,118134914,protein_coding,-1,202760,chr4_117932154_118134914
St3gal4,9,35046576,35119268,protein_coding,-1,72692,chr9_35046576_35119268
St3gal5,6,72097592,72154571,protein_coding,1,56979,chr6_72097592_72154571
St3gal6,16,58468125,58524243,protein_coding,-1,56118,chr16_58468125_58524243
St6gal1,16,23224740,23360350,protein_coding,1,135610,chr16_23224740_23360350
St6gal2,17,55445355,55514581,protein_coding,1,69226,chr17_55445355_55514581
St6galnac1,11,116765025,116775507,protein_coding,-1,10482,chr11_116765025_116775507
St6galnac2,11,116675303,116694868,protein_coding,-1,19565,chr11_116675303_116694868
St6galnac3,3,153198266,153725174,protein_coding,-1,526908,chr3_153198266_153725174
St6galnac4,2,32587095,32599698,protein_coding,1,12603,chr2_32587095_32599698
St6galnac5,3,152817081,152982246,protein_coding,-1,165165,chr3_152817081_152982246
St6galnac6,2,32599709,32620806,protein_coding,1,21097,chr2_32599709_32620806
St7,6,17692933,17943025,protein_coding,1,250092,chr6_17692933_17943025
St7l,3,104864005,104930064,protein_coding,1,66059,chr3_104864005_104930064
St8sia1,6,142821545,142964452,protein_coding,-1,142907,chr6_142821545_142964452
St8sia2,7,73939119,74013690,protein_coding,-1,74571,chr7_73939119_74013690
St8sia3,18,64254359,64279611,protein_coding,1,25252,chr18_64254359_64279611
St8sia3os,18,64157721,64333706,antisense,-1,175985,chr18_64157721_64333706
St8sia4,1,95587682,95667571,protein_coding,-1,79889,chr1_95587682_95667571
St8sia5,18,77185839,77258771,protein_coding,1,72932,chr18_77185839_77258771
St8sia6,2,13651021,13794064,protein_coding,-1,143043,chr2_13651021_13794064
Stab1,14,31139013,31168641,protein_coding,-1,29628,chr14_31139013_31168641
Stab2,10,86841198,87008025,protein_coding,-1,166827,chr10_86841198_87008025
Stac,9,111561437,111690348,protein_coding,-1,128911,chr9_111561437_111690348
Stac2,11,98036623,98053462,protein_coding,-1,16839,chr11_98036623_98053462
Stac3,10,127501686,127508823,protein_coding,1,7137,chr10_127501686_127508823
Stag1,9,100597798,100959375,protein_coding,1,361577,chr9_100597798_100959375
Stag2,X,42149317,42277185,protein_coding,1,127868,chrX_42149317_42277185
Stag3,5,138280240,138312393,protein_coding,1,32153,chr5_138280240_138312393
Stam,2,14074098,14149634,protein_coding,1,75536,chr2_14074098_14149634
Stam2,2,52691664,52742281,protein_coding,-1,50617,chr2_52691664_52742281
Stambp,6,83543211,83572729,protein_coding,-1,29518,chr6_83543211_83572729
Stambpl1,19,34192229,34240333,protein_coding,1,48104,chr19_34192229_34240333
Stamos,2,14070332,14073934,processed_transcript,-1,3602,chr2_14070332_14073934
Stap1,5,86071746,86106125,protein_coding,1,34379,chr5_86071746_86106125
Stap2,17,55997077,56005584,protein_coding,-1,8507,chr17_55997077_56005584
Star,8,25806555,25815982,protein_coding,1,9427,chr8_25806555_25815982
Stard10,7,101317086,101346626,protein_coding,1,29540,chr7_101317086_101346626
Stard13,5,151037510,151233836,protein_coding,-1,196326,chr5_151037510_151233836
Stard3,11,98358368,98381112,protein_coding,1,22744,chr11_98358368_98381112
Stard3nl,13,19357676,19395795,protein_coding,-1,38119,chr13_19357676_19395795
Stard4,18,33199355,33213862,protein_coding,-1,14507,chr18_33199355_33213862
Stard5,7,83631959,83653127,protein_coding,1,21168,chr7_83631959_83653127
Stard6,18,70472454,70501066,protein_coding,1,28612,chr18_70472454_70501066
Stard7,2,127270218,127298932,protein_coding,1,28714,chr2_127270218_127298932
Stard8,X,99003248,99074728,protein_coding,1,71480,chrX_99003248_99074728
Stard9,2,120629121,120731895,protein_coding,1,102774,chr2_120629121_120731895
Stat1,1,52119440,52161865,protein_coding,1,42425,chr1_52119440_52161865
Stat2,10,128270559,128292849,protein_coding,1,22290,chr10_128270559_128292849
Stat3,11,100885098,100939540,protein_coding,-1,54442,chr11_100885098_100939540
Stat4,1,51987148,52107189,protein_coding,1,120041,chr1_51987148_52107189
Stat5a,11,100859351,100885169,protein_coding,1,25818,chr11_100859351_100885169
Stat5b,11,100780731,100850724,protein_coding,-1,69993,chr11_100780731_100850724
Stat6,10,127642986,127660957,protein_coding,1,17971,chr10_127642986_127660957
Stau1,2,166947549,166996299,protein_coding,-1,48750,chr2_166947549_166996299
Stau2,1,16228674,16520112,protein_coding,-1,291438,chr1_16228674_16520112
Stbd1,5,92603041,92606579,protein_coding,1,3538,chr5_92603041_92606579
Stc1,14,69029238,69041804,protein_coding,1,12566,chr14_69029238_69041804
Stc2,11,31357307,31370074,protein_coding,-1,12767,chr11_31357307_31370074
Steap1,5,5736317,5749326,protein_coding,-1,13009,chr5_5736317_5749326
Steap2,5,5664829,5694578,protein_coding,-1,29749,chr5_5664829_5694578
Steap3,1,120190757,120272705,protein_coding,-1,81948,chr1_120190757_120272705
Stil,4,115000159,115043196,protein_coding,1,43037,chr4_115000159_115043196
Stim1,7,102267806,102437319,protein_coding,1,169513,chr7_102267806_102437319
Stim2,5,53998499,54121057,protein_coding,1,122558,chr5_53998499_54121057
Stip1,19,7020702,7039967,protein_coding,-1,19265,chr19_7020702_7039967
Stk10,11,32533305,32624587,protein_coding,1,91282,chr11_32533305_32624587
Stk11,10,80115803,80130682,protein_coding,1,14879,chr10_80115803_80130682
Stk11ip,1,75521529,75537335,protein_coding,1,15806,chr1_75521529_75537335
Stk16,1,75210838,75215606,protein_coding,1,4768,chr1_75210838_75215606
Stk17b,1,53755506,53785224,protein_coding,-1,29718,chr1_53755506_53785224
Stk19,17,34823993,34836945,protein_coding,-1,12952,chr17_34823993_34836945
Stk19-ps1,17,34744753,34747154,unprocessed_pseudogene,-1,2401,chr17_34744753_34747154
Stk24,14,121286343,121380011,protein_coding,-1,93668,chr14_121286343_121380011
Stk25,1,93619751,93658659,protein_coding,-1,38908,chr1_93619751_93658659
Stk26,X,50841047,50893097,protein_coding,1,52050,chrX_50841047_50893097
Stk3,15,34875496,35178921,protein_coding,-1,303425,chr15_34875496_35178921
Stk31,6,49395604,49469501,protein_coding,1,73897,chr6_49395604_49469501
Stk32a,18,43207583,43318682,protein_coding,1,111099,chr18_43207583_43318682
Stk32b,5,37446825,37717171,protein_coding,-1,270346,chr5_37446825_37717171
Stk32c,7,139081825,139213307,protein_coding,-1,131482,chr7_139081825_139213307
Stk33,7,109279223,109439081,protein_coding,-1,159858,chr7_109279223_109439081
Stk35,2,129800517,129832287,protein_coding,1,31770,chr2_129800517_129832287
Stk36,1,74601445,74636894,protein_coding,1,35449,chr1_74601445_74636894
Stk38,17,28970880,29007995,protein_coding,-1,37115,chr17_28970880_29007995
Stk38l,6,146724995,146778812,protein_coding,1,53817,chr6_146724995_146778812
Stk39,2,68210445,68472268,protein_coding,-1,261823,chr2_68210445_68472268
Stk4,2,164070322,164155524,protein_coding,1,85202,chr2_164070322_164155524
Stk40,4,126103957,126141029,protein_coding,1,37072,chr4_126103957_126141029
Stkld1,2,26934047,26953496,protein_coding,1,19449,chr2_26934047_26953496
Stmn1,4,134468320,134473843,protein_coding,1,5523,chr4_134468320_134473843
Stmn1-rs1,9,115281520,115281981,processed_pseudogene,-1,461,chr9_115281520_115281981
Stmn2,3,8509360,8561606,protein_coding,1,52246,chr3_8509360_8561606
Stmn3,2,181306459,181314500,protein_coding,-1,8041,chr2_181306459_181314500
Stmn4,14,66344296,66361680,protein_coding,1,17384,chr14_66344296_66361680
Stmnd1,13,46273721,46300115,protein_coding,1,26394,chr13_46273721_46300115
Stom,2,35313986,35336976,protein_coding,-1,22990,chr2_35313986_35336976
Stoml1,9,58253164,58262520,protein_coding,1,9356,chr9_58253164_58262520
Stoml2,4,43027690,43031710,protein_coding,-1,4020,chr4_43027690_43031710
Ston1,17,88597684,88662586,protein_coding,1,64902,chr17_88597684_88662586
Ston2,12,91633009,91788387,protein_coding,-1,155378,chr12_91633009_91788387
Stox1,10,62659043,62726128,protein_coding,-1,67085,chr10_62659043_62726128
Stox2,8,47180048,47446362,protein_coding,-1,266314,chr8_47180048_47446362
Stpg1,4,135494790,135537803,protein_coding,1,43013,chr4_135494790_135537803
Stpg2,3,139205694,139710299,protein_coding,1,504605,chr3_139205694_139710299
Stra6,9,58063788,58153996,protein_coding,1,90208,chr9_58063788_58153996
Strada,11,106163330,106202168,protein_coding,-1,38838,chr11_106163330_106202168
Stradb,1,58973522,58995715,protein_coding,1,22193,chr1_58973522_58995715
Strap,6,137735078,137751932,protein_coding,1,16854,chr6_137735078_137751932
Strbp,2,37483228,37703859,protein_coding,-1,220631,chr2_37483228_37703859
Strc,2,121363728,121387168,protein_coding,-1,23440,chr2_121363728_121387168
Strip1,3,107612532,107631694,protein_coding,-1,19162,chr3_107612532_107631694
Strip2,6,29917012,29959681,protein_coding,1,42669,chr6_29917012_29959681
Strn,17,78649913,78737196,protein_coding,-1,87283,chr17_78649913_78737196
Strn3,12,51609632,51691897,protein_coding,-1,82265,chr12_51609632_51691897
Strn4,7,16815889,16840931,protein_coding,1,25042,chr7_16815889_16840931
Stt3a,9,36729344,36767679,protein_coding,-1,38335,chr9_36729344_36767679
Stt3b,9,115242581,115310421,protein_coding,-1,67840,chr9_115242581_115310421
Stub1,17,25830505,25833404,protein_coding,-1,2899,chr17_25830505_25833404
Stx11,10,12938209,12964298,protein_coding,-1,26089,chr10_12938209_12964298
Stx12,4,132853501,132884509,protein_coding,-1,31008,chr4_132853501_132884509
Stx16,2,174076308,174099771,protein_coding,1,23463,chr2_174076308_174099771
Stx17,4,48124915,48186507,protein_coding,1,61592,chr4_48124915_48186507
Stx18,5,38038742,38137765,protein_coding,1,99023,chr5_38038742_38137765
Stx19,16,62814676,62824346,protein_coding,1,9670,chr16_62814676_62824346
Stx1a,5,135023482,135051100,protein_coding,1,27618,chr5_135023482_135051100
Stx1b,7,127803900,127824549,protein_coding,-1,20649,chr7_127803900_127824549
Stx2,5,128984557,129008574,protein_coding,-1,24017,chr5_128984557_129008574
Stx3,19,11775118,11819403,protein_coding,-1,44285,chr19_11775118_11819403
Stx4a,7,127824294,127849019,protein_coding,1,24725,chr7_127824294_127849019
Stx5a,19,8741413,8756069,protein_coding,1,14656,chr19_8741413_8756069
Stx6,1,155158715,155208256,protein_coding,1,49541,chr1_155158715_155208256
Stx7,10,24149302,24190222,protein_coding,1,40920,chr10_24149302_24190222
Stx8,11,67966193,68207148,protein_coding,1,240955,chr11_67966193_68207148
Stxbp1,2,32787602,32847245,protein_coding,-1,59643,chr2_32787602_32847245
Stxbp2,8,3630955,3643644,protein_coding,1,12689,chr8_3630955_3643644
Stxbp4,11,90476492,90638084,protein_coding,-1,161592,chr11_90476492_90638084
Stxbp5,10,9755547,9901079,protein_coding,-1,145532,chr10_9755547_9901079
Stxbp5l,16,37114942,37384962,protein_coding,-1,270020,chr16_37114942_37384962
Stxbp6,12,44852484,45074709,protein_coding,-1,222225,chr12_44852484_45074709
Styk1,6,131299142,131353597,protein_coding,-1,54455,chr6_131299142_131353597
Styx,14,45351093,45422820,protein_coding,1,71727,chr14_45351093_45422820
Styxl1,5,135747220,135778385,protein_coding,-1,31165,chr5_135747220_135778385
Sub1,15,11981339,11996983,protein_coding,-1,15644,chr15_11981339_11996983
Sucla2,14,73525319,73596142,protein_coding,1,70823,chr14_73525319_73596142
Suclg1,6,73248382,73276911,protein_coding,1,28529,chr6_73248382_73276911
Suclg2,6,95473009,95718800,protein_coding,-1,245791,chr6_95473009_95718800
Suco,1,161816114,161876682,protein_coding,-1,60568,chr1_161816114_161876682
Suds3,5,117091680,117116113,protein_coding,-1,24433,chr5_117091680_117116113
Sufu,19,46396896,46488804,protein_coding,1,91908,chr19_46396896_46488804
Sugct,13,16857472,17695553,protein_coding,-1,838081,chr13_16857472_17695553
Sugp1,8,70042813,70072347,protein_coding,1,29534,chr8_70042813_70072347
Sugp2,8,70234226,70279915,protein_coding,1,45689,chr8_70234226_70279915
Sugt1,14,79587691,79635196,protein_coding,1,47505,chr14_79587691_79635196
Sulf1,1,12692277,12861192,protein_coding,1,168915,chr1_12692277_12861192
Sulf2,2,166073089,166155663,protein_coding,-1,82574,chr2_166073089_166155663
Sult1a1,7,126672865,126676432,protein_coding,-1,3567,chr7_126672865_126676432
Sult2a5,7,13623967,13670807,protein_coding,1,46840,chr7_13623967_13670807
Sult2b1,7,45729983,45784669,protein_coding,-1,54686,chr7_45729983_45784669
Sult3a1,10,33857721,33879532,protein_coding,1,21811,chr10_33857721_33879532
Sult4a1,15,84076097,84105754,protein_coding,-1,29657,chr15_84076097_84105754
Sult6b1,17,78883938,78906992,protein_coding,-1,23054,chr17_78883938_78906992
Sumf1,6,108107028,108185582,protein_coding,-1,78554,chr6_108107028_108185582
Sumf2,5,129846986,129864050,protein_coding,1,17064,chr5_129846986_129864050
Sumo1,1,59586558,59670834,protein_coding,-1,84276,chr1_59586558_59670834
Sumo2,11,115523102,115536276,protein_coding,-1,13174,chr11_115523102_115536276
Sumo3,10,77606097,77618331,protein_coding,1,12234,chr10_77606097_77618331
Sun1,5,139200637,139249840,protein_coding,1,49203,chr5_139200637_139249840
Sun2,15,79724070,79742536,protein_coding,-1,18466,chr15_79724070_79742536
Sun3,11,9016054,9048991,protein_coding,-1,32937,chr11_9016054_9048991
Suox,10,128669894,128674073,protein_coding,-1,4179,chr10_128669894_128674073
Supt16,14,52160414,52197416,protein_coding,-1,37002,chr14_52160414_52197416
Supt20,3,54692807,54728766,protein_coding,1,35959,chr3_54692807_54728766
Supt3,17,44777152,45119290,protein_coding,1,342138,chr17_44777152_45119290
Supt4a,11,87737552,87743623,protein_coding,1,6071,chr11_87737552_87743623
Supt5,7,28314891,28338746,protein_coding,-1,23855,chr7_28314891_28338746
Supt6,11,78206746,78245987,protein_coding,-1,39241,chr11_78206746_78245987
Supt7l,5,31514564,31527807,protein_coding,-1,13243,chr5_31514564_31527807
Supv3l1,10,62429209,62449738,protein_coding,-1,20529,chr10_62429209_62449738
Surf1,2,26913381,26916530,protein_coding,-1,3149,chr2_26913381_26916530
Surf2,2,26916367,26920183,protein_coding,1,3816,chr2_26916367_26920183
Surf4,2,26920040,26933928,protein_coding,-1,13888,chr2_26920040_26933928
Surf6,2,26888628,26902879,protein_coding,-1,14251,chr2_26888628_26902879
Susd1,4,59314683,59438633,protein_coding,-1,123950,chr4_59314683_59438633
Susd2,10,75636706,75644008,protein_coding,-1,7302,chr10_75636706_75644008
Susd3,13,49230690,49248706,protein_coding,-1,18016,chr13_49230690_49248706
Susd4,1,182763860,182896591,protein_coding,1,132731,chr1_182763860_182896591
Susd5,9,114057140,114098728,protein_coding,1,41588,chr9_114057140_114098728
Susd6,12,80790510,80880835,protein_coding,1,90325,chr12_80790510_80880835
Suv39h1,X,8061171,8074760,protein_coding,-1,13589,chrX_8061171_8074760
Suv39h2,2,3455815,3475031,protein_coding,-1,19216,chr2_3455815_3475031
Suz12,11,79993106,80034123,protein_coding,1,41017,chr11_79993106_80034123
Sv2a,3,96181151,96195521,protein_coding,1,14370,chr3_96181151_96195521
Sv2b,7,75114894,75309262,protein_coding,-1,194368,chr7_75114894_75309262
Sv2c,13,95954594,96132577,protein_coding,-1,177983,chr13_95954594_96132577
Svep1,4,58042442,58206859,protein_coding,-1,164417,chr4_58042442_58206859
Svil,18,4920540,5119299,protein_coding,1,198759,chr18_4920540_5119299
Svip,7,51997171,52006018,protein_coding,-1,8847,chr7_51997171_52006018
Svop,5,114026910,114091570,protein_coding,-1,64660,chr5_114026910_114091570
Svopl,6,37983739,38046996,protein_coding,-1,63257,chr6_37983739_38046996
Swap70,7,110221711,110283506,protein_coding,1,61795,chr7_110221711_110283506
Swi5,2,32278816,32288075,protein_coding,-1,9259,chr2_32278816_32288075
Swsap1,9,21955755,21958264,protein_coding,1,2509,chr9_21955755_21958264
Swt1,1,151367699,151428455,protein_coding,-1,60756,chr1_151367699_151428455
Syap1,X,162857057,162888447,protein_coding,-1,31390,chrX_162857057_162888447
Sybu,15,44671856,44788063,protein_coding,-1,116207,chr15_44671856_44788063
Syce1,7,140777229,140787852,protein_coding,-1,10623,chr7_140777229_140787852
Syce1l,8,113643213,113655533,protein_coding,1,12320,chr8_113643213_113655533
Syce2,8,84872111,84888221,protein_coding,1,16110,chr8_84872111_84888221
Sycp1,3,102818499,102936100,protein_coding,-1,117601,chr3_102818499_102936100
Sycp1-ps1,7,18786332,18789099,processed_pseudogene,1,2767,chr7_18786332_18789099
Sycp2,2,178345293,178407685,protein_coding,-1,62392,chr2_178345293_178407685
Sycp2l,13,41114307,41174351,protein_coding,1,60044,chr13_41114307_41174351
Sycp3,10,88459569,88473236,protein_coding,1,13667,chr10_88459569_88473236
Syde1,10,78584503,78591964,protein_coding,-1,7461,chr10_78584503_78591964
Syde2,3,145987870,146021720,protein_coding,1,33850,chr3_145987870_146021720
Syf2,4,134930898,134937548,protein_coding,1,6650,chr4_134930898_134937548
Syk,13,52583173,52648792,protein_coding,1,65619,chr13_52583173_52648792
Sympk,7,19024377,19054618,protein_coding,1,30241,chr7_19024377_19054618
Syn1,X,20860511,20921004,protein_coding,-1,60493,chrX_20860511_20921004
Syn2,6,115134902,115282006,protein_coding,1,147104,chr6_115134902_115282006
Syn3,10,86055125,86498896,protein_coding,-1,443771,chr10_86055125_86498896
Syna,5,134558146,134560171,protein_coding,-1,2025,chr5_134558146_134560171
Synb,14,69289344,69294299,protein_coding,-1,4955,chr14_69289344_69294299
Sync,4,129287617,129308559,protein_coding,1,20942,chr4_129287617_129308559
Syncrip,9,88447009,88482574,protein_coding,-1,35565,chr9_88447009_88482574
Syndig1,2,149829211,150004392,protein_coding,1,175181,chr2_149829211_150004392
Syndig1l,12,84677277,84698831,protein_coding,-1,21554,chr12_84677277_84698831
Syne1,10,5020917,5551482,protein_coding,-1,530565,chr10_5020917_5551482
Syne2,12,75818134,76110926,protein_coding,1,292792,chr12_75818134_76110926
Syne3,12,104929933,105009809,protein_coding,-1,79876,chr12_104929933_105009809
Syne4,7,30314807,30319046,protein_coding,1,4239,chr7_30314807_30319046
Syngap1,17,26941253,26972434,protein_coding,1,31181,chr17_26941253_26972434
Syngr1,15,80091334,80119501,protein_coding,1,28167,chr15_80091334_80119501
Syngr2,11,117809668,117814283,protein_coding,1,4615,chr11_117809668_117814283
Syngr3,17,24685092,24689955,protein_coding,-1,4863,chr17_24685092_24689955
Syngr4,7,45885222,45896714,protein_coding,-1,11492,chr7_45885222_45896714
Synj1,16,90936092,91011308,protein_coding,-1,75216,chr16_90936092_91011308
Synj2,17,5941280,6044290,protein_coding,1,103010,chr17_5941280_6044290
Synj2bp,12,81497941,81532911,protein_coding,-1,34970,chr12_81497941_81532911
Synm,7,67730160,67759742,protein_coding,-1,29582,chr7_67730160_67759742
Synpo,18,60593973,60660142,protein_coding,-1,66169,chr18_60593973_60660142
Synpo2,3,123076519,123236149,protein_coding,-1,159630,chr3_123076519_123236149
Synpo2l,14,20658946,20668354,protein_coding,-1,9408,chr14_20658946_20668354
Synpr,14,13284780,13616340,protein_coding,1,331560,chr14_13284780_13616340
Synrg,11,83964428,84044578,protein_coding,1,80150,chr11_83964428_84044578
Syp,X,7638471,7653256,protein_coding,1,14785,chrX_7638471_7653256
Sypl,12,32953891,32979860,protein_coding,1,25969,chr12_32953891_32979860
Sypl2,3,108211472,108226648,protein_coding,-1,15176,chr3_108211472_108226648
Sys1,2,164456964,164479638,protein_coding,1,22674,chr2_164456964_164479638
Syt1,10,108497650,109010982,protein_coding,-1,513332,chr10_108497650_109010982
Syt10,15,89782393,89841860,protein_coding,-1,59467,chr15_89782393_89841860
Syt11,3,88744700,88775164,protein_coding,-1,30464,chr3_88744700_88775164
Syt12,19,4445908,4477447,protein_coding,-1,31539,chr19_4445908_4477447
Syt13,2,92915098,92956058,protein_coding,1,40960,chr2_92915098_92956058
Syt14,1,192891233,193035775,protein_coding,-1,144542,chr1_192891233_193035775
Syt15,14,34219595,34230420,protein_coding,1,10825,chr14_34219595_34230420
Syt16,12,73997661,74273267,protein_coding,1,275606,chr12_73997661_74273267
Syt17,7,118380717,118448222,protein_coding,-1,67505,chr7_118380717_118448222
Syt2,1,134646677,134762593,protein_coding,1,115916,chr1_134646677_134762593
Syt3,7,44384102,44400187,protein_coding,1,16085,chr7_44384102_44400187
Syt4,18,31437808,31447406,protein_coding,-1,9598,chr18_31437808_31447406
Syt5,7,4539765,4547541,protein_coding,-1,7776,chr7_4539765_4547541
Syt6,3,103575231,103645569,protein_coding,1,70338,chr3_103575231_103645569
Syt7,19,10389090,10453180,protein_coding,1,64090,chr19_10389090_10453180
Syt9,7,107370728,107548656,protein_coding,1,177928,chr7_107370728_107548656
Sytl1,4,133253090,133263113,protein_coding,-1,10023,chr4_133253090_133263113
Sytl2,7,90302252,90410719,protein_coding,1,108467,chr7_90302252_90410719
Sytl3,17,6659093,6738044,protein_coding,1,78951,chr17_6659093_6738044
Sytl4,X,133936385,133981812,protein_coding,-1,45427,chrX_133936385_133981812
Sytl5,X,9885622,9994543,protein_coding,1,108921,chrX_9885622_9994543
Syvn1,19,6046576,6053712,protein_coding,1,7136,chr19_6046576_6053712
Szrd1,4,141113001,141139775,protein_coding,-1,26774,chr4_141113001_141139775
Szt2,4,118362743,118409273,protein_coding,-1,46530,chr4_118362743_118409273
T,17,8434423,8442496,protein_coding,1,8073,chr17_8434423_8442496
T2,17,8355992,8423513,protein_coding,1,67521,chr17_8355992_8423513
Taar3,10,23949558,23950589,protein_coding,1,1031,chr10_23949558_23950589
Tab1,15,80133127,80161707,protein_coding,1,28580,chr15_80133127_80161707
Tab2,10,7905653,7956230,protein_coding,-1,50577,chr10_7905653_7956230
Tab3,X,85574022,85634469,protein_coding,1,60447,chrX_85574022_85634469
Tac1,6,7554879,7565834,protein_coding,1,10955,chr6_7554879_7565834
Tac2,10,127724478,127731768,protein_coding,1,7290,chr10_127724478_127731768
Tac4,11,95261529,95269265,protein_coding,1,7736,chr11_95261529_95269265
Tacc1,8,25154552,25256588,protein_coding,-1,102036,chr8_25154552_25256588
Tacc2,7,130577438,130764785,protein_coding,1,187347,chr7_130577438_130764785
Tacc3,5,33658128,33678995,protein_coding,1,20867,chr5_33658128_33678995
Taco1,11,106066061,106073612,protein_coding,1,7551,chr11_106066061_106073612
Tacr1,6,82402334,82560104,protein_coding,1,157770,chr6_82402334_82560104
Tacr2,10,62252438,62265990,protein_coding,1,13552,chr10_62252438_62265990
Tacr3,3,134829007,134934579,protein_coding,1,105572,chr3_134829007_134934579
Tacstd2,6,67534062,67535796,protein_coding,-1,1734,chr6_67534062_67535796
Tada1,1,166379097,166393621,protein_coding,1,14524,chr1_166379097_166393621
Tada2a,11,84078920,84129600,protein_coding,-1,50680,chr11_84078920_84129600
Tada2b,5,36473670,36484285,protein_coding,-1,10615,chr5_36473670_36484285
Tada3,6,113366025,113377883,protein_coding,-1,11858,chr6_113366025_113377883
Taf1,X,101532734,101601789,protein_coding,1,69055,chrX_101532734_101601789
Taf10,7,105739393,105744361,protein_coding,-1,4968,chr7_105739393_105744361
Taf11,17,27901122,27909844,protein_coding,-1,8722,chr17_27901122_27909844
Taf12,4,132274375,132295766,protein_coding,1,21391,chr4_132274375_132295766
Taf13,3,108571698,108583222,protein_coding,1,11524,chr3_108571698_108583222
Taf15,11,83473086,83506743,protein_coding,1,33657,chr11_83473086_83506743
Taf1a,1,183388981,183410198,protein_coding,1,21217,chr1_183388981_183410198
Taf1b,12,24498359,24558539,protein_coding,1,60180,chr12_24498359_24558539
Taf1c,8,119597871,119605222,protein_coding,-1,7351,chr8_119597871_119605222
Taf1d,9,15306214,15316991,protein_coding,1,10777,chr9_15306214_15316991
Taf2,15,55015131,55072152,protein_coding,-1,57021,chr15_55015131_55072152
Taf3,2,9914552,10048596,protein_coding,-1,134044,chr2_9914552_10048596
Taf4b,18,14783245,14900359,protein_coding,1,117114,chr18_14783245_14900359
Taf5,19,47067746,47083479,protein_coding,1,15733,chr19_47067746_47083479
Taf5l,8,123996318,124021397,protein_coding,-1,25079,chr8_123996318_124021397
Taf6,5,138178617,138187451,protein_coding,-1,8834,chr5_138178617_138187451
Taf6l,19,8774487,8786417,protein_coding,-1,11930,chr19_8774487_8786417
Taf7,18,37640491,37644204,protein_coding,-1,3713,chr18_37640491_37644204
Taf7l,X,134460118,134476490,protein_coding,-1,16372,chrX_134460118_134476490
Taf8,17,47483364,47502292,protein_coding,-1,18928,chr17_47483364_47502292
Taf9,13,100651579,100656060,protein_coding,1,4481,chr13_100651579_100656060
Taf9b,X,106206883,106221158,protein_coding,-1,14275,chrX_106206883_106221158
Tagap,17,7926000,7934897,protein_coding,1,8897,chr17_7926000_7934897
Tagap1,17,6955011,6961156,protein_coding,-1,6145,chr17_6955011_6961156
Tagln,9,45929619,45936058,protein_coding,-1,6439,chr9_45929619_45936058
Tagln2,1,172500047,172507380,protein_coding,1,7333,chr1_172500047_172507380
Tagln3,16,45711230,45724608,protein_coding,-1,13378,chr16_45711230_45724608
Tal1,4,115056426,115071755,protein_coding,1,15329,chr4_115056426_115071755
Tal2,4,53779705,53788712,protein_coding,1,9007,chr4_53779705_53788712
Taldo1,7,141392199,141402968,protein_coding,1,10769,chr7_141392199_141402968
Tamm41,6,115004381,115037876,protein_coding,-1,33495,chr6_115004381_115037876
Tanc1,2,59612042,59846149,protein_coding,1,234107,chr2_59612042_59846149
Tanc2,11,105589986,105929304,protein_coding,1,339318,chr11_105589986_105929304
Tango2,16,18300825,18348103,protein_coding,-1,47278,chr16_18300825_18348103
Tango6,8,106683068,106851439,protein_coding,1,168371,chr8_106683068_106851439
Tank,2,61578585,61654171,protein_coding,1,75586,chr2_61578585_61654171
Taok1,11,77529162,77607815,protein_coding,-1,78653,chr11_77529162_77607815
Taok2,7,126865678,126884703,protein_coding,-1,19025,chr7_126865678_126884703
Taok3,5,117120129,117275219,protein_coding,1,155090,chr5_117120129_117275219
Tap1,17,34187553,34197225,protein_coding,1,9672,chr17_34187553_34197225
Tap2,17,34203527,34216321,protein_coding,1,12794,chr17_34203527_34216321
Tapbp,17,33915899,33929292,protein_coding,1,13393,chr17_33915899_33929292
Tapbpl,6,125223933,125231860,protein_coding,-1,7927,chr6_125223933_125231860
Tapt1,5,44175154,44226626,protein_coding,-1,51472,chr5_44175154_44226626
Tarbp2,15,102518192,102523676,protein_coding,1,5484,chr15_102518192_102523676
Tardbp,4,148612382,148627019,protein_coding,-1,14637,chr4_148612382_148627019
Tarm1,7,3486500,3502624,protein_coding,-1,16124,chr7_3486500_3502624
Tars,15,11382301,11399665,protein_coding,-1,17364,chr15_11382301_11399665
Tars2,3,95739976,95760206,protein_coding,-1,20230,chr3_95739976_95760206
Tarsl2,7,65644898,65692091,protein_coding,1,47193,chr7_65644898_65692091
Tas1r1,4,152027914,152038568,protein_coding,-1,10654,chr4_152027914_152038568
Tas1r3,4,155859268,155863362,protein_coding,-1,4094,chr4_155859268_155863362
Tas2r108,6,40493529,40494541,protein_coding,1,1012,chr6_40493529_40494541
Tas2r126,6,42434535,42435464,protein_coding,1,929,chr6_42434535_42435464
Tas2r137,6,40491233,40492305,protein_coding,1,1072,chr6_40491233_40492305
Tas2r141-ps4,6,133095070,133096015,unprocessed_pseudogene,-1,945,chr6_133095070_133096015
Tasp1,2,139833480,140066805,protein_coding,-1,233325,chr2_139833480_140066805
Tatdn1,15,58890155,58933738,protein_coding,-1,43583,chr15_58890155_58933738
Tatdn2,6,113697050,113711069,protein_coding,1,14019,chr6_113697050_113711069
Tatdn3,1,191045826,191062932,protein_coding,-1,17106,chr1_191045826_191062932
Tax1bp1,6,52713729,52766780,protein_coding,1,53051,chr6_52713729_52766780
Tax1bp3,11,73177083,73183162,protein_coding,1,6079,chr11_73177083_73183162
Taz,X,74281912,74290151,protein_coding,1,8239,chrX_74281912_74290151
Tbata,10,61171954,61188841,protein_coding,1,16887,chr10_61171954_61188841
Tbc1d1,5,64156305,64351486,protein_coding,1,195181,chr5_64156305_64351486
Tbc1d10a,11,4186789,4215505,protein_coding,1,28716,chr11_4186789_4215505
Tbc1d10b,7,127197459,127208468,protein_coding,-1,11009,chr7_127197459_127208468
Tbc1d10c,19,4183410,4191284,protein_coding,-1,7874,chr19_4183410_4191284
Tbc1d12,19,38836579,38919923,protein_coding,1,83344,chr19_38836579_38919923
Tbc1d13,2,30133746,30152013,protein_coding,1,18267,chr2_30133746_30152013
Tbc1d14,5,36490604,36593276,protein_coding,-1,102672,chr5_36490604_36593276
Tbc1d15,10,115197872,115251467,protein_coding,-1,53595,chr10_115197872_115251467
Tbc1d16,11,119143045,119228499,protein_coding,-1,85454,chr11_119143045_119228499
Tbc1d17,7,44834623,44849079,protein_coding,-1,14456,chr7_44834623_44849079
Tbc1d19,5,53809606,53903965,protein_coding,1,94359,chr5_53809606_53903965
Tbc1d2,4,46604390,46650209,protein_coding,-1,45819,chr4_46604390_46650209
Tbc1d20,2,152293828,152313996,protein_coding,1,20168,chr2_152293828_152313996
Tbc1d22a,15,86214459,86498503,protein_coding,1,284044,chr15_86214459_86498503
Tbc1d22b,17,29549785,29606898,protein_coding,1,57113,chr17_29549785_29606898
Tbc1d22bos,17,29578816,29596305,antisense,-1,17489,chr17_29578816_29596305
Tbc1d23,16,57168862,57231504,protein_coding,-1,62642,chr16_57168862_57231504
Tbc1d24,17,24175431,24205562,protein_coding,-1,30131,chr17_24175431_24205562
Tbc1d25,X,8154472,8176181,protein_coding,-1,21709,chrX_8154472_8176181
Tbc1d2b,9,90202027,90270804,protein_coding,-1,68777,chr9_90202027_90270804
Tbc1d30,10,121263820,121351278,protein_coding,-1,87458,chr10_121263820_121351278
Tbc1d31,15,57912199,57970067,protein_coding,1,57868,chr15_57912199_57970067
Tbc1d32,10,56014293,56228689,protein_coding,-1,214396,chr10_56014293_56228689
Tbc1d4,14,101442360,101609191,protein_coding,-1,166831,chr14_101442360_101609191
Tbc1d5,17,50733124,51179352,protein_coding,-1,446228,chr17_50733124_51179352
Tbc1d7,13,43151740,43171501,protein_coding,-1,19761,chr13_43151740_43171501
Tbc1d8,1,39371492,39478755,protein_coding,-1,107263,chr1_39371492_39478755
Tbc1d8b,X,139684996,139753405,protein_coding,1,68409,chrX_139684996_139753405
Tbc1d9,8,83165352,83272934,protein_coding,1,107582,chr8_83165352_83272934
Tbc1d9b,11,50131396,50172785,protein_coding,1,41389,chr11_50131396_50172785
Tbca,13,94788910,94842922,protein_coding,1,54012,chr13_94788910_94842922
Tbcb,7,30224131,30232272,protein_coding,-1,8141,chr7_30224131_30232272
Tbcc,17,46890684,46891847,protein_coding,1,1163,chr17_46890684_46891847
Tbccd1,16,22813214,22857669,protein_coding,-1,44455,chr16_22813214_22857669
Tbcd,11,121451949,121617164,protein_coding,1,165215,chr11_121451949_121617164
Tbce,13,13997949,14039638,protein_coding,-1,41689,chr13_13997949_14039638
Tbcel,9,42412316,42507809,protein_coding,-1,95493,chr9_42412316_42507809
Tbck,3,132684144,132841688,protein_coding,1,157544,chr3_132684144_132841688
Tbk1,10,121546455,121586787,protein_coding,-1,40332,chr10_121546455_121586787
Tbkbp1,11,97136171,97151495,protein_coding,-1,15324,chr11_97136171_97151495
Tbl1x,X,77511013,77662983,protein_coding,1,151970,chrX_77511013_77662983
Tbl1xr1,3,22076652,22216594,protein_coding,1,139942,chr3_22076652_22216594
Tbl2,5,135149657,135165760,protein_coding,1,16103,chr5_135149657_135165760
Tbl3,17,24697949,24707660,protein_coding,-1,9711,chr17_24697949_24707660
Tbp,17,15499888,15528379,protein_coding,1,28491,chr17_15499888_15528379
Tbpl1,10,22703879,22731938,protein_coding,-1,28059,chr10_22703879_22731938
Tbpl2,2,24071721,24096595,protein_coding,-1,24874,chr2_24071721_24096595
Tbr1,2,61802930,61814114,protein_coding,1,11184,chr2_61802930_61814114
Tbrg1,9,37648763,37657312,protein_coding,-1,8549,chr9_37648763_37657312
Tbrg4,11,6615598,6626067,protein_coding,-1,10469,chr11_6615598_6626067
Tbx1,16,18580979,18590671,protein_coding,-1,9692,chr16_18580979_18590671
Tbx15,3,99240381,99354259,protein_coding,1,113878,chr3_99240381_99354259
Tbx18,9,87702800,87731260,protein_coding,-1,28460,chr9_87702800_87731260
Tbx19,1,165137855,165160773,protein_coding,-1,22918,chr1_165137855_165160773
Tbx2,11,85832551,85841948,protein_coding,1,9397,chr11_85832551_85841948
Tbx20,9,24718138,24774303,protein_coding,-1,56165,chr9_24718138_24774303
Tbx21,11,97098071,97115331,protein_coding,-1,17260,chr11_97098071_97115331
Tbx22,X,107667964,107688978,protein_coding,1,21014,chrX_107667964_107688978
Tbx3,5,119670669,119684724,protein_coding,1,14055,chr5_119670669_119684724
Tbx4,11,85886422,85916097,protein_coding,1,29675,chr11_85886422_85916097
Tbx6,7,126781483,126785560,protein_coding,1,4077,chr7_126781483_126785560
Tbxa2r,10,81328731,81335172,protein_coding,1,6441,chr10_81328731_81335172
Tbxas1,6,38875404,39084585,protein_coding,1,209181,chr6_38875404_39084585
Tc2n,12,101645443,101718523,protein_coding,-1,73080,chr12_101645443_101718523
Tcaf1,6,42668002,42710088,protein_coding,-1,42086,chr6_42668002_42710088
Tcaf2,6,42623016,42645254,protein_coding,-1,22238,chr6_42623016_42645254
Tcaf3,6,42584866,42597692,protein_coding,-1,12826,chr6_42584866_42597692
Tcaim,9,122805539,122836334,protein_coding,1,30795,chr9_122805539_122836334
Tcam1,11,106276672,106288745,protein_coding,1,12073,chr11_106276672_106288745
Tcap,11,98383811,98384953,protein_coding,1,1142,chr11_98383811_98384953
Tcea1,1,4857814,4897909,protein_coding,1,40095,chr1_4857814_4897909
Tcea1-ps1,15,90882615,90883518,processed_pseudogene,1,903,chr15_90882615_90883518
Tcea2,2,181680310,181688071,protein_coding,1,7761,chr2_181680310_181688071
Tcea3,4,136247729,136274898,protein_coding,1,27169,chr4_136247729_136274898
Tceal1,X,136707982,136711478,protein_coding,1,3496,chrX_136707982_136711478
Tceal3,X,136590842,136668378,protein_coding,1,77536,chrX_136590842_136668378
Tceal5,X,136200948,136203876,protein_coding,-1,2928,chrX_136200948_136203876
Tceal6,X,135208687,135210687,protein_coding,-1,2000,chrX_135208687_135210687
Tceal7,X,136214779,136226100,protein_coding,1,11321,chrX_136214779_136226100
Tceal8,X,136168984,136172342,protein_coding,-1,3358,chrX_136168984_136172342
Tceanc,X,166499812,166518567,protein_coding,-1,18755,chrX_166499812_166518567
Tceanc2,4,107134155,107179116,protein_coding,-1,44961,chr4_107134155_107179116
Tcerg1,18,42511487,42575793,protein_coding,1,64306,chr18_42511487_42575793
Tcerg1l,7,138208974,138397730,protein_coding,-1,188756,chr7_138208974_138397730
Tcf12,9,71842688,72111871,protein_coding,-1,269183,chr9_71842688_72111871
Tcf15,2,152143561,152149097,protein_coding,1,5536,chr2_152143561_152149097
Tcf19,17,35512734,35516824,protein_coding,-1,4090,chr17_35512734_35516824
Tcf20,15,82808436,82987872,protein_coding,-1,179436,chr15_82808436_82987872
Tcf23,5,30968662,30977018,protein_coding,1,8356,chr5_30968662_30977018
Tcf24,1,9960163,9967932,protein_coding,-1,7769,chr1_9960163_9967932
Tcf25,8,123373753,123403835,protein_coding,1,30082,chr8_123373753_123403835
Tcf3,10,80409514,80433647,protein_coding,-1,24133,chr10_80409514_80433647
Tcf4,18,69343356,69689079,protein_coding,1,345723,chr18_69343356_69689079
Tcf7,11,52252371,52283331,protein_coding,-1,30960,chr11_52252371_52283331
Tcf7l1,6,72626378,72789254,protein_coding,-1,162876,chr6_72626378_72789254
Tcf7l2,19,55741820,55933654,protein_coding,1,191834,chr19_55741820_55933654
Tcfl5,2,180621956,180642708,protein_coding,-1,20752,chr2_180621956_180642708
Tchh,3,93442330,93449077,protein_coding,1,6747,chr3_93442330_93449077
Tchp,5,114707760,114722327,protein_coding,1,14567,chr5_114707760_114722327
Tcirg1,19,3896050,3907133,protein_coding,-1,11083,chr19_3896050_3907133
Tcn2,11,3917192,3932159,protein_coding,-1,14967,chr11_3917192_3932159
Tcof1,18,60813755,60848971,protein_coding,-1,35216,chr18_60813755_60848971
Tcp1,17,12915701,12925067,protein_coding,1,9366,chr17_12915701_12925067
Tcp1-ps1,4,68301246,68303290,processed_pseudogene,-1,2044,chr4_68301246_68303290
Tcp10a,17,7324646,7345974,protein_coding,1,21328,chr17_7324646_7345974
Tcp10b,17,13061104,13082481,protein_coding,1,21377,chr17_13061104_13082481
Tcp10c,17,13354572,13377223,protein_coding,1,22651,chr17_13354572_13377223
Tcp11,17,28066745,28080639,protein_coding,-1,13894,chr17_28066745_28080639
Tcp11l1,2,104657288,104712169,protein_coding,-1,54881,chr2_104657288_104712169
Tcp11l2,10,84576626,84614359,protein_coding,1,37733,chr10_84576626_84614359
Tcta,9,108302958,108306160,protein_coding,-1,3202,chr9_108302958_108306160
Tcte1,17,45523434,45542680,protein_coding,1,19246,chr17_45523434_45542680
Tcte2,17,13712444,13761825,protein_coding,-1,49381,chr17_13712444_13761825
Tctex1d1,4,102978606,103005594,protein_coding,1,26988,chr4_102978606_103005594
Tctex1d2,16,32419702,32429099,protein_coding,1,9397,chr16_32419702_32429099
Tctex1d4,4,117126794,117128738,protein_coding,1,1944,chr4_117126794_117128738
Tctn1,5,122237848,122264460,protein_coding,-1,26612,chr5_122237848_122264460
Tctn2,5,124598749,124627738,protein_coding,1,28989,chr5_124598749_124627738
Tctn3,19,40596446,40612233,protein_coding,-1,15787,chr19_40596446_40612233
Tdg,10,82629828,82650799,protein_coding,1,20971,chr10_82629828_82650799
Tdgf1-ps2,17,12189921,12190456,processed_pseudogene,1,535,chr17_12189921_12190456
Tdh,14,63492347,63509092,protein_coding,-1,16745,chr14_63492347_63509092
Tdo2,3,81957090,81976202,protein_coding,-1,19112,chr3_81957090_81976202
Tdp1,12,99884517,99955219,protein_coding,1,70702,chr12_99884517_99955219
Tdp2,13,24831679,24842153,protein_coding,1,10474,chr13_24831679_24842153
Tdrd1,19,56826209,56870012,protein_coding,1,43803,chr19_56826209_56870012
Tdrd12,7,35469098,35537745,protein_coding,-1,68647,chr7_35469098_35537745
Tdrd3,14,87416639,87545504,protein_coding,1,128865,chr14_87416639_87545504
Tdrd5,1,156255296,156303664,protein_coding,-1,48368,chr1_156255296_156303664
Tdrd6,17,43615335,43630299,protein_coding,-1,14964,chr17_43615335_43630299
Tdrd7,4,45965334,46034761,protein_coding,1,69427,chr4_45965334_46034761
Tdrd9,12,111971559,112068854,protein_coding,1,97295,chr12_111971559_112068854
Tdrkh,3,94413273,94434668,protein_coding,1,21395,chr3_94413273_94434668
Tdrp,8,13952008,13975032,protein_coding,-1,23024,chr8_13952008_13975032
Tead1,7,112679318,112906807,protein_coding,1,227489,chr7_112679318_112906807
Tead2,7,45215753,45233644,protein_coding,1,17891,chr7_45215753_45233644
Tead3,17,28331671,28350817,protein_coding,-1,19146,chr17_28331671_28350817
Tead4,6,128224288,128300823,protein_coding,-1,76535,chr6_128224288_128300823
Tec,5,72755716,72868483,protein_coding,-1,112767,chr5_72755716_72868483
Tecpr1,5,144194442,144223615,protein_coding,-1,29173,chr5_144194442_144223615
Tecpr2,12,110889264,110972394,protein_coding,1,83130,chr12_110889264_110972394
Tecr,8,83571698,83607971,protein_coding,-1,36273,chr8_83571698_83607971
Tecrl,5,83278145,83355195,protein_coding,-1,77050,chr5_83278145_83355195
Tecta,9,42329619,42399929,protein_coding,-1,70310,chr9_42329619_42399929
Tectb,19,55180733,55196313,protein_coding,1,15580,chr19_55180733_55196313
Teddm1a,1,153891742,153893058,protein_coding,1,1316,chr1_153891742_153893058
Teddm1b,1,153874345,153876871,protein_coding,1,2526,chr1_153874345_153876871
Teddm2,1,153849542,153900228,protein_coding,-1,50686,chr1_153849542_153900228
Teddm3,16,21152655,21154000,protein_coding,-1,1345,chr16_21152655_21154000
Tef,15,81802421,81826863,protein_coding,1,24442,chr15_81802421_81826863
Tefm,11,80136678,80142175,protein_coding,-1,5497,chr11_80136678_80142175
Tek,4,94739289,94874976,protein_coding,1,135687,chr4_94739289_94874976
Tekt1,11,72344722,72362442,protein_coding,-1,17720,chr11_72344722_72362442
Tekt2,4,126322121,126325688,protein_coding,-1,3567,chr4_126322121_126325688
Tekt3,11,63061654,63094964,protein_coding,1,33310,chr11_63061654_63094964
Tekt4,17,25454615,25476602,protein_coding,1,21987,chr17_25454615_25476602
Tekt5,16,10357948,10395490,protein_coding,-1,37542,chr16_10357948_10395490
Telo2,17,25099570,25115967,protein_coding,-1,16397,chr17_25099570_25115967
Ten1,11,116198855,116215318,protein_coding,1,16463,chr11_116198855_116215318
Tenm1,X,42527866,43429126,protein_coding,-1,901260,chrX_42527866_43429126
Tenm2,11,36006656,37235964,protein_coding,-1,1229308,chr11_36006656_37235964
Tenm3,8,48227682,48843951,protein_coding,-1,616269,chr8_48227682_48843951
Tenm4,7,96171246,96911093,protein_coding,1,739847,chr7_96171246_96911093
Tep1,14,50824059,50870560,protein_coding,-1,46501,chr14_50824059_50870560
Tepp,8,95310566,95326323,protein_coding,1,15757,chr8_95310566_95326323
Terc,3,96414437,96414859,lincRNA;misc_RNA,-1,422,chr3_96414437_96414859
Terf1,1,15805646,15844052,protein_coding,1,38406,chr1_15805646_15844052
Terf2,8,107069400,107096547,protein_coding,-1,27147,chr8_107069400_107096547
Terf2ip,8,112011398,112020528,protein_coding,1,9130,chr8_112011398_112020528
Tert,13,73626911,73649843,protein_coding,1,22932,chr13_73626911_73649843
Tes,6,17065149,17105828,protein_coding,1,40679,chr6_17065149_17105828
Tes3-ps,13,49493318,49496589,protein_coding,1,3271,chr13_49493318_49496589
Tesc,5,118027743,118061878,protein_coding,1,34135,chr5_118027743_118061878
Tesk1,4,43441939,43448064,protein_coding,1,6125,chr4_43441939_43448064
Tesk2,4,116720948,116805956,protein_coding,1,85008,chr4_116720948_116805956
Tespa1,10,130322870,130364111,protein_coding,1,41241,chr10_130322870_130364111
Tet1,10,62804570,62908996,protein_coding,-1,104426,chr10_62804570_62908996
Tet2,3,133463679,133545139,protein_coding,-1,81460,chr3_133463679_133545139
Tet3,6,83362373,83459084,protein_coding,-1,96711,chr6_83362373_83459084
Tex10,4,48430858,48473459,protein_coding,-1,42601,chr4_48430858_48473459
Tex12,9,50556819,50561325,protein_coding,-1,4506,chr9_50556819_50561325
Tex13a,X,138208165,138209580,protein_coding,-1,1415,chrX_138208165_138209580
Tex14,11,87405065,87555823,protein_coding,1,150758,chr11_87405065_87555823
Tex15,8,33516738,33585582,protein_coding,1,68844,chr8_33516738_33585582
Tex2,11,106502147,106613423,protein_coding,-1,111276,chr11_106502147_106613423
Tex22,12,113074502,113088917,protein_coding,1,14415,chr12_113074502_113088917
Tex26,5,149439660,149470979,protein_coding,1,31319,chr5_149439660_149470979
Tex261,6,83768885,83775813,protein_coding,-1,6928,chr6_83768885_83775813
Tex264,9,106658746,106685927,protein_coding,-1,27181,chr9_106658746_106685927
Tex29,8,11840474,11855761,protein_coding,1,15287,chr8_11840474_11855761
Tex30,1,44086613,44102441,protein_coding,-1,15828,chr1_44086613_44102441
Tex35,1,157099139,157108680,protein_coding,-1,9541,chr1_157099139_157108680
Tex38,4,115779834,115781018,protein_coding,-1,1184,chr4_115779834_115781018
Tex43,18,56588350,56594782,protein_coding,1,6432,chr18_56588350_56594782
Tex9,9,72450394,72492212,protein_coding,-1,41818,chr9_72450394_72492212
Tfam,10,71225464,71238280,protein_coding,-1,12816,chr10_71225464_71238280
Tfap2a,13,40715302,40738376,protein_coding,-1,23074,chr13_40715302_40738376
Tfap2b,1,19208914,19238576,protein_coding,1,29662,chr1_19208914_19238576
Tfap2d,1,19103022,19166346,protein_coding,1,63324,chr1_19103022_19166346
Tfap2e,4,126716006,126736240,protein_coding,-1,20234,chr4_126716006_126736240
Tfap4,16,4544661,4559854,protein_coding,-1,15193,chr16_4544661_4559854
Tfb1m,17,3519256,3557781,protein_coding,-1,38525,chr17_3519256_3557781
Tfb2m,1,179528055,179546267,protein_coding,-1,18212,chr1_179528055_179546267
Tfcp2,15,100498012,100552008,protein_coding,-1,53996,chr15_100498012_100552008
Tfcp2l1,1,118627945,118685168,protein_coding,1,57223,chr1_118627945_118685168
Tfdp1,8,13338751,13378448,protein_coding,1,39697,chr8_13338751_13378448
Tfdp2,9,96196275,96323646,protein_coding,1,127371,chr9_96196275_96323646
Tfe3,X,7762560,7775202,protein_coding,1,12642,chrX_7762560_7775202
Tfeb,17,47737030,47792419,protein_coding,1,55389,chr17_47737030_47792419
Tfg,16,56690332,56717450,protein_coding,-1,27118,chr16_56690332_56717450
Tfip11,5,112326358,112338073,protein_coding,1,11715,chr5_112326358_112338073
Tfpi,2,84432855,84476775,protein_coding,-1,43920,chr2_84432855_84476775
Tfpt,7,3620324,3629929,protein_coding,-1,9605,chr7_3620324_3629929
Tfr2,5,137569840,137587481,protein_coding,1,17641,chr5_137569840_137587481
Tfrc,16,32608920,32632794,protein_coding,1,23874,chr16_32608920_32632794
Tg,15,66670753,66850721,protein_coding,1,179968,chr15_66670753_66850721
Tgds,14,118111911,118132755,protein_coding,-1,20844,chr14_118111911_118132755
Tgfa,6,86195223,86275719,protein_coding,1,80496,chr6_86195223_86275719
Tgfb1,7,25687002,25705077,protein_coding,1,18075,chr7_25687002_25705077
Tgfb1i1,7,128246812,128255699,protein_coding,1,8887,chr7_128246812_128255699
Tgfb2,1,186622792,186705989,protein_coding,-1,83197,chr1_186622792_186705989
Tgfb3,12,86056745,86079041,protein_coding,-1,22296,chr12_86056745_86079041
Tgfbi,13,56609523,56639562,protein_coding,1,30039,chr13_56609523_56639562
Tgfbr1,4,47353222,47414931,protein_coding,1,61709,chr4_47353222_47414931
Tgfbr2,9,116084293,116175360,protein_coding,-1,91067,chr9_116084293_116175360
Tgfbr3,5,107106570,107289629,protein_coding,-1,183059,chr5_107106570_107289629
Tgfbr3l,8,4248214,4251423,protein_coding,1,3209,chr8_4248214_4251423
Tgfbrap1,1,43047200,43098637,protein_coding,-1,51437,chr1_43047200_43098637
Tgif1,17,70844205,70853546,protein_coding,-1,9341,chr17_70844205_70853546
Tgif2,2,156840007,156855570,protein_coding,1,15563,chr2_156840007_156855570
Tgm1,14,55700009,55713926,protein_coding,-1,13917,chr14_55700009_55713926
Tgm2,2,158116402,158146436,protein_coding,-1,30034,chr2_158116402_158146436
Tgm3,2,130012349,130050399,protein_coding,1,38050,chr2_130012349_130050399
Tgm4,9,123034726,123067561,protein_coding,1,32835,chr9_123034726_123067561
Tgm5,2,121046111,121085841,protein_coding,-1,39730,chr2_121046111_121085841
Tgm6,2,130112416,130154232,protein_coding,1,41816,chr2_130112416_130154232
Tgm7,2,121093565,121116396,protein_coding,-1,22831,chr2_121093565_121116396
Tgoln1,6,72608432,72617000,protein_coding,-1,8568,chr6_72608432_72617000
Tgs1,4,3574875,3616619,protein_coding,1,41744,chr4_3574875_3616619
Th,7,142892752,142931128,protein_coding,-1,38376,chr7_142892752_142931128
Tha1,11,117867952,117873481,protein_coding,-1,5529,chr11_117867952_117873481
Thada,17,84190076,84466205,protein_coding,-1,276129,chr17_84190076_84466205
Thap1,8,26158141,26164151,protein_coding,1,6010,chr8_26158141_26164151
Thap11,8,105855132,105856950,protein_coding,1,1818,chr8_105855132_105856950
Thap2,10,115368404,115384443,protein_coding,-1,16039,chr10_115368404_115384443
Thap3,4,151982639,151988997,protein_coding,-1,6358,chr4_151982639_151988997
Thap4,1,93701935,93754864,protein_coding,-1,52929,chr1_93701935_93754864
Thap6,5,91962389,91972066,transcribed_unitary_pseudogene,1,9677,chr5_91962389_91972066
Thap7,16,17527982,17531136,protein_coding,-1,3154,chr16_17527982_17531136
Thbd,2,148404466,148408188,protein_coding,-1,3722,chr2_148404466_148408188
Thbs1,2,118111876,118127133,protein_coding,1,15257,chr2_118111876_118127133
Thbs2,17,14665500,14694235,protein_coding,-1,28735,chr17_14665500_14694235
Thbs3,3,89215180,89226837,protein_coding,1,11657,chr3_89215180_89226837
Thbs4,13,92751590,92794818,protein_coding,-1,43228,chr13_92751590_92794818
Theg,10,79576379,79587331,protein_coding,-1,10952,chr10_79576379_79587331
Them4,3,94310089,94332540,protein_coding,1,22451,chr3_94310089_94332540
Them5,3,94342099,94347352,protein_coding,1,5253,chr3_94342099_94347352
Them6,15,74721204,74724639,protein_coding,1,3435,chr15_74721204_74724639
Themis,10,28668360,28883818,protein_coding,1,215458,chr10_28668360_28883818
Themis2,4,132781843,132796387,protein_coding,-1,14544,chr4_132781843_132796387
Thg1l,11,45946843,45955494,protein_coding,-1,8651,chr11_45946843_45955494
Thnsl1,2,21205724,21215009,protein_coding,1,9285,chr2_21205724_21215009
Thnsl2,6,71128166,71144439,protein_coding,-1,16273,chr6_71128166_71144439
Thoc1,18,9957906,9995489,protein_coding,1,37583,chr18_9957906_9995489
Thoc2,X,41794991,41920674,protein_coding,-1,125683,chrX_41794991_41920674
Thoc3,13,54458837,54468849,protein_coding,-1,10012,chr13_54458837_54468849
Thoc5,11,4895320,4928867,protein_coding,1,33547,chr11_4895320_4928867
Thoc6,17,23668614,23673882,protein_coding,-1,5268,chr17_23668614_23673882
Thoc7,14,13949012,13961852,protein_coding,-1,12840,chr14_13949012_13961852
Thop1,10,81070035,81082559,protein_coding,1,12524,chr10_81070035_81082559
Thpo,16,20724454,20734511,protein_coding,-1,10057,chr16_20724454_20734511
Thra,11,98740638,98769006,protein_coding,1,28368,chr11_98740638_98769006
Thrap3,4,126164082,126202760,protein_coding,-1,38678,chr4_126164082_126202760
Thrb,14,17660261,18038090,protein_coding,1,377829,chr14_17660261_18038090
Thrsp,7,97412938,97417730,protein_coding,-1,4792,chr7_97412938_97417730
Thsd1,8,22227313,22261334,protein_coding,1,34021,chr8_22227313_22261334
Thsd4,9,59966931,60522046,protein_coding,-1,555115,chr9_59966931_60522046
Thsd7a,6,12311610,12749410,protein_coding,-1,437800,chr6_12311610_12749410
Thsd7b,1,129273302,130219278,protein_coding,1,945976,chr1_129273302_130219278
Thtpa,14,55094784,55098986,protein_coding,1,4202,chr14_55094784_55098986
Thumpd1,7,119715093,119720798,protein_coding,-1,5705,chr7_119715093_119720798
Thumpd2,17,81026332,81065082,protein_coding,-1,38750,chr17_81026332_81065082
Thumpd3,6,113046225,113068273,protein_coding,1,22048,chr6_113046225_113068273
Thy1,9,44043384,44048579,protein_coding,1,5195,chr9_44043384_44048579
Thyn1,9,26999710,27007336,protein_coding,1,7626,chr9_26999710_27007336
Tia1,6,86404219,86433405,protein_coding,1,29186,chr6_86404219_86433405
Tial1,7,128439777,128461717,protein_coding,-1,21940,chr7_128439777_128461717
Tiam1,16,89787111,90143769,protein_coding,-1,356658,chr16_89787111_90143769
Tiam2,17,3326573,3531344,protein_coding,1,204771,chr17_3326573_3531344
Ticam1,17,56269319,56276786,protein_coding,-1,7467,chr17_56269319_56276786
Ticrr,7,79660196,79698148,protein_coding,1,37952,chr7_79660196_79698148
Tie1,4,118471191,118490061,protein_coding,-1,18870,chr4_118471191_118490061
Tifa,3,127789805,127832164,protein_coding,1,42359,chr3_127789805_127832164
Tifab,13,56173704,56178885,protein_coding,-1,5181,chr13_56173704_56178885
Tigd2,6,59208870,59212033,protein_coding,1,3163,chr6_59208870_59212033
Tigd3,19,5891138,5894149,protein_coding,-1,3011,chr19_5891138_5894149
Tigd4,3,84593574,84597032,protein_coding,1,3458,chr3_84593574_84597032
Tigd5,15,75909735,75914535,protein_coding,1,4800,chr15_75909735_75914535
Tigit,16,43648867,43664146,protein_coding,-1,15279,chr16_43648867_43664146
Timd4,11,46810800,46844332,protein_coding,1,33532,chr11_46810800_46844332
Timeless,10,128232065,128252941,protein_coding,1,20876,chr10_128232065_128252941
Timm10,2,84826997,84830213,protein_coding,1,3216,chr2_84826997_84830213
Timm10b,7,105640056,105643637,protein_coding,1,3581,chr7_105640056_105643637
Timm13,10,80899450,80900969,protein_coding,-1,1519,chr10_80899450_80900969
Timm17a,1,135295213,135313778,protein_coding,-1,18565,chr1_135295213_135313778
Timm17b,X,7899357,7908351,protein_coding,1,8994,chrX_7899357_7908351
Timm21,18,84946191,84951524,protein_coding,-1,5333,chr18_84946191_84951524
Timm22,11,76406952,76416292,protein_coding,1,9340,chr11_76406952_76416292
Timm23,14,32180162,32201898,protein_coding,-1,21736,chr14_32180162_32201898
Timm44,8,4259731,4275913,protein_coding,-1,16182,chr8_4259731_4275913
Timm50,7,28305516,28312072,protein_coding,-1,6556,chr7_28305516_28312072
Timm8a1,X,134537256,134541865,protein_coding,-1,4609,chrX_134537256_134541865
Timm8a2,14,122034674,122038420,protein_coding,1,3746,chr14_122034674_122038420
Timm8b,9,50603910,50605320,protein_coding,1,1410,chr9_50603910_50605320
Timm9,12,71123173,71136684,protein_coding,-1,13511,chr12_71123173_71136684
Timmdc1,16,38498347,38522663,protein_coding,-1,24316,chr16_38498347_38522663
Timp1,X,20870166,20874735,protein_coding,1,4569,chrX_20870166_20874735
Timp2,11,118301069,118355740,protein_coding,-1,54671,chr11_118301069_118355740
Timp3,10,86300372,86349506,protein_coding,1,49134,chr10_86300372_86349506
Timp4,6,115241892,115252205,protein_coding,-1,10313,chr6_115241892_115252205
Tinag,9,76951693,77045794,protein_coding,-1,94101,chr9_76951693_77045794
Tinagl1,4,130164454,130175122,protein_coding,-1,10668,chr4_130164454_130175122
Tinf2,14,55674689,55681820,protein_coding,-1,7131,chr14_55674689_55681820
Tiparp,3,65528410,65555518,protein_coding,1,27108,chr3_65528410_65555518
Tipin,9,64281581,64305424,protein_coding,1,23843,chr9_64281581_64305424
Tiprl,1,165212286,165236996,protein_coding,-1,24710,chr1_165212286_165236996
Tirap,9,35184551,35200291,protein_coding,-1,15740,chr9_35184551_35200291
Tjap1,17,46257851,46283026,protein_coding,-1,25175,chr17_46257851_46283026
Tjp1,7,65296165,65527781,protein_coding,-1,231616,chr7_65296165_65527781
Tjp2,19,24094505,24225030,protein_coding,-1,130525,chr19_24094505_24225030
Tjp3,10,81273207,81291581,protein_coding,-1,18374,chr10_81273207_81291581
Tk1,11,117815526,117826092,protein_coding,-1,10566,chr11_117815526_117826092
Tk2,8,104226685,104248558,protein_coding,-1,21873,chr8_104226685_104248558
Tkt,14,30548359,30574720,protein_coding,1,26361,chr14_30548359_30574720
Tktl1,X,74177259,74208500,protein_coding,1,31241,chrX_74177259_74208500
Tktl2,8,66511756,66518335,protein_coding,1,6579,chr8_66511756_66518335
Tlcd1,11,78176711,78181909,protein_coding,1,5198,chr11_78176711_78181909
Tlcd2,11,75461715,75470899,protein_coding,1,9184,chr11_75461715_75470899
Tldc2,2,157087055,157096482,protein_coding,1,9427,chr2_157087055_157096482
Tle1,4,72117142,72200919,protein_coding,-1,83777,chr4_72117142_72200919
Tle2,10,81574561,81590845,protein_coding,1,16284,chr10_81574561_81590845
Tle3,9,61372366,61418497,protein_coding,1,46131,chr9_61372366_61418497
Tle4,19,14448150,14598051,protein_coding,-1,149901,chr19_14448150_14598051
Tle6,10,81590904,81601073,protein_coding,-1,10169,chr10_81590904_81601073
Tlk1,2,70712407,70825728,protein_coding,-1,113321,chr2_70712407_70825728
Tlk2,11,105178807,105283959,protein_coding,1,105152,chr11_105178807_105283959
Tll1,8,64014931,64206271,protein_coding,-1,191340,chr8_64014931_64206271
Tll2,19,41082753,41206835,protein_coding,-1,124082,chr19_41082753_41206835
Tln1,4,43531519,43562691,protein_coding,-1,31172,chr4_43531519_43562691
Tln2,9,67217087,67559703,protein_coding,-1,342616,chr9_67217087_67559703
Tlr1,5,64924679,64933563,protein_coding,-1,8884,chr5_64924679_64933563
Tlr12,4,128615443,128618619,protein_coding,-1,3176,chr4_128615443_128618619
Tlr13,X,106143204,106160493,protein_coding,1,17289,chrX_106143204_106160493
Tlr2,3,83836272,83841767,protein_coding,-1,5495,chr3_83836272_83841767
Tlr3,8,45395665,45411080,protein_coding,-1,15415,chr8_45395665_45411080
Tlr4,4,66827584,66930284,protein_coding,1,102700,chr4_66827584_66930284
Tlr6,5,64952031,64960097,protein_coding,-1,8066,chr5_64952031_64960097
Tlr7,X,167304929,167330558,protein_coding,-1,25629,chrX_167304929_167330558
Tlr9,9,106222598,106226883,protein_coding,1,4285,chr9_106222598_106226883
Tlx2,6,83068324,83070293,protein_coding,-1,1969,chr6_83068324_83070293
Tm2d1,4,98355370,98383306,protein_coding,-1,27936,chr4_98355370_98383306
Tm2d2,8,25017211,25023260,protein_coding,1,6049,chr8_25017211_25023260
Tm2d3,7,65691169,65701913,protein_coding,1,10744,chr7_65691169_65701913
Tm4sf1,3,57285611,57301988,protein_coding,-1,16377,chr3_57285611_57301988
Tm4sf19,16,32400506,32408227,protein_coding,1,7721,chr16_32400506_32408227
Tm4sf20,1,82756649,82768461,protein_coding,-1,11812,chr1_82756649_82768461
Tm4sf5,11,70505244,70511178,protein_coding,1,5934,chr11_70505244_70511178
Tm6sf1,7,81859001,81884434,protein_coding,1,25433,chr7_81859001_81884434
Tm6sf2,8,70072924,70080066,protein_coding,1,7142,chr8_70072924_70080066
Tm7sf2,19,6062821,6068373,protein_coding,-1,5552,chr19_6062821_6068373
Tm7sf3,6,146602352,146642824,protein_coding,-1,40472,chr6_146602352_146642824
Tm9sf1,14,55635965,55643806,protein_coding,-1,7841,chr14_55635965_55643806
Tm9sf2,14,122107038,122159604,protein_coding,1,52566,chr14_122107038_122159604
Tm9sf3,19,41210844,41263997,protein_coding,-1,53153,chr19_41210844_41263997
Tm9sf4,2,153161303,153210466,protein_coding,1,49163,chr2_153161303_153210466
Tma16,8,66473118,66486530,protein_coding,-1,13412,chr8_66473118_66486530
Tma7,9,109074568,109082587,protein_coding,-1,8019,chr9_109074568_109082587
Tmbim1,1,74288247,74305622,protein_coding,-1,17375,chr1_74288247_74305622
Tmbim4,10,120201590,120224917,protein_coding,1,23327,chr10_120201590_120224917
Tmbim6,15,99392882,99410049,protein_coding,1,17167,chr15_99392882_99410049
Tmbim7,5,3651181,3680325,protein_coding,1,29144,chr5_3651181_3680325
Tmc1,19,20783458,20954202,protein_coding,-1,170744,chr19_20783458_20954202
Tmc2,2,130195194,130264445,protein_coding,1,69251,chr2_130195194_130264445
Tmc3,7,83584927,83625614,protein_coding,1,40687,chr7_83584927_83625614
Tmc4,7,3665790,3677553,protein_coding,-1,11763,chr7_3665790_3677553
Tmc4-ps,4,52443915,52444172,processed_pseudogene,-1,257,chr4_52443915_52444172
Tmc5,7,118597297,118675086,protein_coding,1,77789,chr7_118597297_118675086
Tmc6,11,117765988,117782198,protein_coding,-1,16210,chr11_117765988_117782198
Tmc7,7,118535841,118584736,protein_coding,-1,48895,chr7_118535841_118584736
Tmc8,11,117782076,117793110,protein_coding,1,11034,chr11_117782076_117793110
Tmcc1,6,116018611,116193486,protein_coding,-1,174875,chr6_116018611_116193486
Tmcc2,1,132356315,132391281,protein_coding,-1,34966,chr1_132356315_132391281
Tmcc3,10,94311949,94590956,protein_coding,1,279007,chr10_94311949_94590956
Tmco1,1,167308378,167333978,protein_coding,1,25600,chr1_167308378_167333978
Tmco3,8,13288190,13322924,protein_coding,1,34734,chr8_13288190_13322924
Tmco4,4,138972888,139059171,protein_coding,1,86283,chr4_138972888_139059171
Tmco5,2,116878691,116892494,protein_coding,1,13803,chr2_116878691_116892494
Tmco5b,2,113285732,113297190,protein_coding,1,11458,chr2_113285732_113297190
Tmco6,18,36735039,36742397,protein_coding,1,7358,chr18_36735039_36742397
Tmed1,9,21507553,21510252,protein_coding,-1,2699,chr9_21507553_21510252
Tmed10,12,85340614,85374847,protein_coding,-1,34233,chr12_85340614_85374847
Tmed2,5,124540695,124550506,protein_coding,1,9811,chr5_124540695_124550506
Tmed3,9,89699206,89705068,protein_coding,-1,5862,chr9_89699206_89705068
Tmed4,11,6270369,6274870,protein_coding,-1,4501,chr11_6270369_6274870
Tmed5,5,108106366,108132620,protein_coding,-1,26254,chr5_108106366_108132620
Tmed6,8,107061476,107065644,protein_coding,-1,4168,chr8_107061476_107065644
Tmed7,18,46560235,46597535,protein_coding,-1,37300,chr18_46560235_46597535
Tmed8,12,87166237,87200454,protein_coding,-1,34217,chr12_87166237_87200454
Tmed9,13,55573732,55597697,protein_coding,1,23965,chr13_55573732_55597697
Tmeff1,4,48585174,48663131,protein_coding,1,77957,chr4_48585174_48663131
Tmeff2,1,50900647,51187270,protein_coding,1,286623,chr1_50900647_51187270
Tmem100,11,90030348,90036508,protein_coding,1,6160,chr11_90030348_90036508
Tmem101,11,102152546,102156404,protein_coding,-1,3858,chr11_102152546_102156404
Tmem102,11,69803603,69805624,protein_coding,-1,2021,chr11_69803603_69805624
Tmem104,11,115187487,115247023,protein_coding,1,59536,chr11_115187487_115247023
Tmem106a,11,101582242,101591788,protein_coding,1,9546,chr11_101582242_101591788
Tmem106b,6,13069759,13089269,protein_coding,1,19510,chr6_13069759_13089269
Tmem106c,15,97964200,97970275,protein_coding,1,6075,chr15_97964200_97970275
Tmem107,11,69070806,69073293,protein_coding,1,2487,chr11_69070806_69073293
Tmem108,9,103482947,103761837,protein_coding,-1,278890,chr9_103482947_103761837
Tmem109,19,10870660,10882001,protein_coding,-1,11341,chr19_10870660_10882001
Tmem11,11,60864452,60879272,protein_coding,-1,14820,chr11_60864452_60879272
Tmem114,16,8409275,8425136,protein_coding,-1,15861,chr16_8409275_8425136
Tmem115,9,107533945,107538673,protein_coding,1,4728,chr9_107533945_107538673
Tmem116,5,121451893,121524183,protein_coding,1,72290,chr5_121451893_121524183
Tmem117,15,94629232,95096098,protein_coding,1,466866,chr15_94629232_95096098
Tmem119,5,113793729,113800516,protein_coding,-1,6787,chr5_113793729_113800516
Tmem120a,5,135735485,135744448,protein_coding,-1,8963,chr5_135735485_135744448
Tmem120b,5,123068415,123117749,protein_coding,1,49334,chr5_123068415_123117749
Tmem121,12,113185930,113189523,protein_coding,1,3593,chr12_113185930_113189523
Tmem123,9,7764041,7794333,protein_coding,1,30292,chr9_7764041_7794333
Tmem125,4,118540941,118544044,protein_coding,-1,3103,chr4_118540941_118544044
Tmem126a,7,90450700,90457229,protein_coding,-1,6529,chr7_90450700_90457229
Tmem126b,7,90467438,90476001,protein_coding,-1,8563,chr7_90467438_90476001
Tmem127,2,127247908,127261107,protein_coding,1,13199,chr2_127247908_127261107
Tmem128,5,38260185,38269634,protein_coding,1,9449,chr5_38260185_38269634
Tmem129,5,33653216,33658416,protein_coding,-1,5200,chr5_33653216_33658416
Tmem130,5,144735915,144761818,protein_coding,-1,25903,chr5_144735915_144761818
Tmem131,1,36792191,36943666,protein_coding,-1,151475,chr1_36792191_36943666
Tmem132a,19,10857822,10869940,protein_coding,-1,12118,chr19_10857822_10869940
Tmem132b,5,125531774,125792583,protein_coding,1,260809,chr5_125531774_125792583
Tmem132c,5,127241808,127565793,protein_coding,1,323985,chr5_127241808_127565793
Tmem132cos,5,127256858,127281634,antisense,-1,24776,chr5_127256858_127281634
Tmem132d,5,127781630,128433077,protein_coding,-1,651447,chr5_127781630_128433077
Tmem132e,11,82388900,82446332,protein_coding,1,57432,chr11_82388900_82446332
Tmem134,19,4125934,4132307,protein_coding,1,6373,chr19_4125934_4132307
Tmem135,7,89139714,89404222,protein_coding,-1,264508,chr7_89139714_89404222
Tmem138,19,10570478,10577362,protein_coding,-1,6884,chr19_10570478_10577362
Tmem140,6,34863146,34874946,protein_coding,1,11800,chr6_34863146_34874946
Tmem141,2,25620067,25622005,protein_coding,-1,1938,chr2_25620067_25622005
Tmem143,7,45896941,45917413,protein_coding,1,20472,chr7_45896941_45917413
Tmem144,3,79812564,79852773,protein_coding,-1,40209,chr3_79812564_79852773
Tmem145,7,25306106,25316195,protein_coding,1,10089,chr7_25306106_25316195
Tmem147,7,30727701,30729540,protein_coding,-1,1839,chr7_30727701_30729540
Tmem147os,7,30729579,30756126,antisense;processed_transcript,1,26547,chr7_30729579_30756126
Tmem14a,1,21218575,21230167,protein_coding,1,11592,chr1_21218575_21230167
Tmem14c,13,41016292,41022586,protein_coding,1,6294,chr13_41016292_41022586
Tmem150a,6,72355446,72359762,protein_coding,1,4316,chr6_72355446_72359762
Tmem150b,7,4706832,4725249,protein_coding,-1,18417,chr7_4706832_4725249
Tmem150c,5,100077872,100159808,protein_coding,-1,81936,chr5_100077872_100159808
Tmem150cos,5,100077962,100095273,antisense,1,17311,chr5_100077962_100095273
Tmem151a,19,5070859,5085531,protein_coding,-1,14672,chr19_5070859_5085531
Tmem151b,17,45541952,45549677,protein_coding,-1,7725,chr17_45541952_45549677
Tmem154,3,84666192,84704575,protein_coding,1,38383,chr3_84666192_84704575
Tmem156,5,65054346,65092132,protein_coding,-1,37786,chr5_65054346_65092132
Tmem158,9,123259053,123260764,protein_coding,-1,1711,chr9_123259053_123260764
Tmem159,7,120102353,120120992,protein_coding,1,18639,chr7_120102353_120120992
Tmem160,7,16452779,16455494,protein_coding,1,2715,chr7_16452779_16455494
Tmem161a,8,70172356,70183681,protein_coding,1,11325,chr8_70172356_70183681
Tmem161b,13,84222296,84296141,protein_coding,1,73845,chr13_84222296_84296141
Tmem163,1,127486546,127679548,protein_coding,-1,193002,chr1_127486546_127679548
Tmem164,X,142681406,142843494,protein_coding,1,162088,chrX_142681406_142843494
Tmem165,5,76183880,76209245,protein_coding,1,25365,chr5_76183880_76209245
Tmem167,13,90089123,90143907,protein_coding,1,54784,chr13_90089123_90143907
Tmem167b,3,108556425,108562466,protein_coding,-1,6041,chr3_108556425_108562466
Tmem168,6,13580687,13608100,protein_coding,-1,27413,chr6_13580687_13608100
Tmem169,1,72284369,72303104,protein_coding,1,18735,chr1_72284369_72303104
Tmem17,11,22512088,22519234,protein_coding,1,7146,chr11_22512088_22519234
Tmem170,8,111863038,111876750,protein_coding,-1,13712,chr8_111863038_111876750
Tmem170b,13,41605907,41641355,protein_coding,1,35448,chr13_41605907_41641355
Tmem171,13,98686235,98694834,protein_coding,-1,8599,chr13_98686235_98694834
Tmem174,13,98634978,98637410,protein_coding,-1,2432,chr13_98634978_98637410
Tmem175,5,108629770,108648782,protein_coding,1,19012,chr5_108629770_108648782
Tmem176a,6,48840919,48847071,protein_coding,1,6152,chr6_48840919_48847071
Tmem176b,6,48833818,48841496,protein_coding,-1,7678,chr6_48833818_48841496
Tmem177,1,119907890,119913208,protein_coding,-1,5318,chr1_119907890_119913208
Tmem178,17,80944632,81001816,protein_coding,1,57184,chr17_80944632_81001816
Tmem178b,6,39871461,40255150,protein_coding,1,383689,chr6_39871461_40255150
Tmem179,12,112500189,112516747,protein_coding,-1,16558,chr12_112500189_112516747
Tmem179b,19,8772525,8774467,protein_coding,-1,1942,chr19_8772525_8774467
Tmem18,12,30584426,30591215,protein_coding,1,6789,chr12_30584426_30591215
Tmem181a,17,6256860,6308314,protein_coding,1,51454,chr17_6256860_6308314
Tmem181b-ps,17,6438524,6467022,transcribed_unprocessed_pseudogene,-1,28498,chr17_6438524_6467022
Tmem181c-ps,17,6613753,6639790,unprocessed_pseudogene,-1,26037,chr17_6613753_6639790
Tmem182,1,40805601,40856887,protein_coding,1,51286,chr1_40805601_40856887
Tmem183a,1,134346097,134361979,protein_coding,-1,15882,chr1_134346097_134361979
Tmem184a,5,139802485,139819917,protein_coding,-1,17432,chr5_139802485_139819917
Tmem184b,15,79360684,79403569,protein_coding,-1,42885,chr15_79360684_79403569
Tmem184c,8,77595982,77610698,protein_coding,-1,14716,chr8_77595982_77610698
Tmem185b,1,119526160,119528983,protein_coding,1,2823,chr1_119526160_119528983
Tmem186,16,8633229,8637712,protein_coding,-1,4483,chr16_8633229_8637712
Tmem189,2,167642608,167689822,protein_coding,-1,47214,chr2_167642608_167689822
Tmem19,10,115339674,115362501,protein_coding,-1,22827,chr10_115339674_115362501
Tmem190,7,4782937,4784341,protein_coding,1,1404,chr7_4782937_4784341
Tmem191c,16,17276077,17283229,protein_coding,1,7152,chr16_17276077_17283229
Tmem192,8,64947185,64969033,protein_coding,1,21848,chr8_64947185_64969033
Tmem196,12,119945822,120021246,protein_coding,1,75424,chr12_119945822_120021246
Tmem198,1,75479532,75485705,protein_coding,1,6173,chr1_75479532_75485705
Tmem198b,10,128800036,128804370,protein_coding,-1,4334,chr10_128800036_128804370
Tmem199,11,78507055,78512172,protein_coding,-1,5117,chr11_78507055_78512172
Tmem200a,10,25912331,26079052,protein_coding,-1,166721,chr10_25912331_26079052
Tmem200b,4,131921200,131923140,protein_coding,1,1940,chr4_131921200_131923140
Tmem200c,17,68826623,68843139,protein_coding,1,16516,chr17_68826623_68843139
Tmem201,4,149715375,149738044,protein_coding,-1,22669,chr4_149715375_149738044
Tmem202,9,59518685,59539847,protein_coding,-1,21162,chr9_59518685_59539847
Tmem203,2,25255439,25256292,protein_coding,1,853,chr2_25255439_25256292
Tmem204,17,25057702,25083591,protein_coding,-1,25889,chr17_25057702_25083591
Tmem205,9,21921008,21927556,protein_coding,-1,6548,chr9_21921008_21927556
Tmem207,16,26503656,26526769,protein_coding,-1,23113,chr16_26503656_26526769
Tmem208,8,105326354,105335219,protein_coding,1,8865,chr8_105326354_105335219
Tmem209,6,30479053,30509783,protein_coding,-1,30730,chr6_30479053_30509783
Tmem210,2,25288145,25289189,protein_coding,1,1044,chr2_25288145_25289189
Tmem211,5,113226909,113239263,protein_coding,1,12354,chr5_113226909_113239263
Tmem213,6,38109255,38115809,protein_coding,1,6554,chr6_38109255_38115809
Tmem214,5,30868012,30879180,protein_coding,1,11168,chr5_30868012_30879180
Tmem215,4,40472180,40477168,protein_coding,1,4988,chr4_40472180_40477168
Tmem216,19,10533865,10556238,protein_coding,-1,22373,chr19_10533865_10556238
Tmem217,17,29526007,29552385,protein_coding,-1,26378,chr17_29526007_29552385
Tmem218,9,37208223,37224700,protein_coding,1,16477,chr9_37208223_37224700
Tmem219,7,126886171,126922917,protein_coding,-1,36746,chr7_126886171_126922917
Tmem220,11,67025154,67035312,protein_coding,1,10158,chr11_67025154_67035312
Tmem221,8,71554238,71558871,protein_coding,-1,4633,chr8_71554238_71558871
Tmem222,4,133266045,133277792,protein_coding,-1,11747,chr4_133266045_133277792
Tmem223,19,8770996,8772475,protein_coding,1,1479,chr19_8770996_8772475
Tmem229a,6,24951141,24956297,protein_coding,-1,5156,chr6_24951141_24956297
Tmem229b,12,78961795,79007627,protein_coding,-1,45832,chr12_78961795_79007627
Tmem230,2,132239492,132247807,protein_coding,-1,8315,chr2_132239492_132247807
Tmem231,8,111912011,111933881,protein_coding,-1,21870,chr8_111912011_111933881
Tmem232,17,65255999,65540782,protein_coding,-1,284783,chr17_65255999_65540782
Tmem234,4,129600668,129624059,protein_coding,1,23391,chr4_129600668_129624059
Tmem236,2,14174523,14221993,protein_coding,1,47470,chr2_14174523_14221993
Tmem237,1,59100590,59120408,protein_coding,-1,19818,chr1_59100590_59120408
Tmem238,7,4784557,4789656,protein_coding,-1,5099,chr7_4784557_4789656
Tmem239,2,130406478,130407902,protein_coding,1,1424,chr2_130406478_130407902
Tmem240,4,155734800,155740564,protein_coding,1,5764,chr4_155734800_155740564
Tmem241,18,11964450,12121537,protein_coding,-1,157087,chr18_11964450_12121537
Tmem242,17,5410870,5440259,protein_coding,-1,29389,chr17_5410870_5440259
Tmem243,5,9100668,9160986,protein_coding,1,60318,chr5_9100668_9160986
Tmem245,4,56866923,56947437,protein_coding,-1,80514,chr4_56866923_56947437
Tmem246,4,49584506,49597876,protein_coding,-1,13370,chr4_49584506_49597876
Tmem248,5,130217081,130243765,protein_coding,1,26684,chr5_130217081_130243765
Tmem25,9,44793769,44799307,protein_coding,-1,5538,chr9_44793769_44799307
Tmem251,12,102743762,102747561,protein_coding,1,3799,chr12_102743762_102747561
Tmem252,19,24674008,24682233,protein_coding,1,8225,chr19_24674008_24682233
Tmem253,14,52015658,52019794,protein_coding,1,4136,chr14_52015658_52019794
Tmem255a,X,38196573,38252439,protein_coding,-1,55866,chrX_38196573_38252439
Tmem255b,8,13435189,13468473,protein_coding,1,33284,chr8_13435189_13468473
Tmem256,11,69838514,69839618,protein_coding,1,1104,chr11_69838514_69839618
Tmem258,19,10204014,10207824,protein_coding,1,3810,chr19_10204014_10207824
Tmem259,10,79974948,79984330,protein_coding,-1,9382,chr10_79974948_79984330
Tmem26,10,68723646,68782650,protein_coding,1,59004,chr10_68723646_68782650
Tmem260,14,48446124,48524246,protein_coding,1,78122,chr14_48446124_48524246
Tmem263,10,85102627,85120618,protein_coding,1,17991,chr10_85102627_85120618
Tmem265,7,127561390,127566940,protein_coding,1,5550,chr7_127561390_127566940
Tmem28,X,99821021,99848790,protein_coding,1,27769,chrX_99821021_99848790
Tmem29,X,150397773,150459154,protein_coding,-1,61381,chrX_150397773_150459154
Tmem30a,9,79768943,79793507,protein_coding,-1,24564,chr9_79768943_79793507
Tmem30c,16,57266139,57292865,protein_coding,-1,26726,chr16_57266139_57292865
Tmem33,5,67260565,67291461,protein_coding,1,30896,chr5_67260565_67291461
Tmem37,1,120067377,120074074,protein_coding,-1,6697,chr1_120067377_120074074
Tmem38a,8,72572055,72587282,protein_coding,1,15227,chr8_72572055_72587282
Tmem38b,4,53826045,53862019,protein_coding,1,35974,chr4_53826045_53862019
Tmem39a,16,38558698,38592162,protein_coding,1,33464,chr16_38558698_38592162
Tmem39b,4,129676355,129696838,protein_coding,-1,20483,chr4_129676355_129696838
Tmem40,6,115729131,115762410,protein_coding,-1,33279,chr6_115729131_115762410
Tmem41a,16,21934326,21947552,protein_coding,-1,13226,chr16_21934326_21947552
Tmem41b,7,109972187,109986929,protein_coding,-1,14742,chr7_109972187_109986929
Tmem42,9,123021326,123023705,protein_coding,1,2379,chr9_123021326_123023705
Tmem43,6,91473703,91488463,protein_coding,1,14760,chr6_91473703_91488463
Tmem44,16,30511855,30550842,protein_coding,-1,38987,chr16_30511855_30550842
Tmem45a,16,56805161,56886166,protein_coding,-1,81005,chr16_56805161_56886166
Tmem45a2,16,57036967,57071372,protein_coding,-1,34405,chr16_57036967_57071372
Tmem45b,9,31426196,31464462,protein_coding,-1,38266,chr9_31426196_31464462
Tmem47,X,81070698,81097872,protein_coding,1,27174,chrX_81070698_81097872
Tmem50a,4,134897849,134915024,protein_coding,-1,17175,chr4_134897849_134915024
Tmem50b,16,91574503,91597800,protein_coding,-1,23297,chr16_91574503_91597800
Tmem51,4,142030992,142084304,protein_coding,-1,53312,chr4_142030992_142084304
Tmem51os1,CHR_MG51_PATCH,142083972,142088099,antisense;lncRNA,1,4127,chrCHR_MG51_PATCH_142083972_142088099
Tmem52,4,155469114,155470858,protein_coding,1,1744,chr4_155469114_155470858
Tmem53,4,117251951,117268582,protein_coding,1,16631,chr4_117251951_117268582
Tmem54,4,129105548,129111626,protein_coding,1,6078,chr4_129105548_129111626
Tmem59,4,107178399,107200996,protein_coding,1,22597,chr4_107178399_107200996
Tmem59l,8,70483867,70487358,protein_coding,-1,3491,chr8_70483867_70487358
Tmem60,5,20882191,20886870,protein_coding,1,4679,chr5_20882191_20886870
Tmem61,4,106498813,106540546,protein_coding,-1,41733,chr4_106498813_106540546
Tmem62,2,120977017,121007852,protein_coding,1,30835,chr2_120977017_121007852
Tmem63a,1,180942344,180975112,protein_coding,1,32768,chr1_180942344_180975112
Tmem63b,17,45660171,45686905,protein_coding,-1,26734,chr17_45660171_45686905
Tmem63c,12,87021340,87090043,protein_coding,1,68703,chr12_87021340_87090043
Tmem64,4,15265831,15286753,protein_coding,1,20922,chr4_15265831_15286753
Tmem65,15,58782269,58823638,protein_coding,-1,41369,chr15_58782269_58823638
Tmem67,4,12039355,12090020,protein_coding,-1,50665,chr4_12039355_12090020
Tmem68,4,3549041,3574853,protein_coding,-1,25812,chr4_3549041_3574853
Tmem69,4,116551633,116555936,protein_coding,-1,4303,chr4_116551633_116555936
Tmem70,1,16665207,16678275,protein_coding,1,13068,chr1_16665207_16678275
Tmem71,15,66526212,66561103,protein_coding,-1,34891,chr15_66526212_66561103
Tmem74,15,43864646,43870036,protein_coding,-1,5390,chr15_43864646_43870036
Tmem74b,2,151702008,151712157,protein_coding,1,10149,chr2_151702008_151712157
Tmem74bos,2,151679361,151686339,protein_coding,-1,6978,chr2_151679361_151686339
Tmem79,3,88328655,88336148,protein_coding,-1,7493,chr3_88328655_88336148
Tmem8,17,26113299,26123254,protein_coding,1,9955,chr17_26113299_26123254
Tmem80,7,141327739,141337156,protein_coding,1,9417,chr7_141327739_141337156
Tmem81,1,132506230,132508639,protein_coding,1,2409,chr1_132506230_132508639
Tmem82,4,141613376,141618633,protein_coding,-1,5257,chr4_141613376_141618633
Tmem86a,7,47050601,47054777,protein_coding,1,4176,chr7_47050601_47054777
Tmem86b,7,4628040,4631422,protein_coding,-1,3382,chr7_4628040_4631422
Tmem87a,2,120355312,120404113,protein_coding,-1,48801,chr2_120355312_120404113
Tmem87b,2,128818118,128854261,protein_coding,1,36143,chr2_128818118_128854261
Tmem88,11,69396519,69398234,protein_coding,-1,1715,chr11_69396519_69398234
Tmem88b,4,155781591,155785874,protein_coding,-1,4283,chr4_155781591_155785874
Tmem8b,4,43668971,43692668,protein_coding,1,23697,chr4_43668971_43692668
Tmem9,1,136008150,136035342,protein_coding,1,27192,chr1_136008150_136035342
Tmem91,7,25669139,25675166,protein_coding,-1,6027,chr7_25669139_25675166
Tmem95,11,69876057,69878053,protein_coding,-1,1996,chr11_69876057_69878053
Tmem97,11,78541817,78550777,protein_coding,-1,8960,chr11_78541817_78550777
Tmem98,11,80810175,80822033,protein_coding,1,11858,chr11_80810175_80822033
Tmem9b,7,109735834,109752875,protein_coding,-1,17041,chr7_109735834_109752875
Tmf1,6,97152997,97179122,protein_coding,-1,26125,chr6_97152997_97179122
Tmie,9,110865711,110880113,protein_coding,-1,14402,chr9_110865711_110880113
Tmigd3,3,105870903,105924042,protein_coding,1,53139,chr3_105870903_105924042
Tmod1,4,46038935,46116032,protein_coding,1,77097,chr4_46038935_46116032
Tmod2,9,75565621,75611325,protein_coding,-1,45704,chr9_75565621_75611325
Tmod3,9,75497707,75559657,protein_coding,-1,61950,chr9_75497707_75559657
Tmod4,3,95124476,95129209,protein_coding,1,4733,chr3_95124476_95129209
Tmpo,10,91147571,91181315,protein_coding,-1,33744,chr10_91147571_91181315
Tmppe,9,114401105,114407276,protein_coding,1,6171,chr9_114401105_114407276
Tmprss11a,5,86410410,86468990,protein_coding,-1,58580,chr5_86410410_86468990
Tmprss11d,5,86302217,86373420,protein_coding,-1,71203,chr5_86302217_86373420
Tmprss11e,5,86705186,86745815,protein_coding,-1,40629,chr5_86705186_86745815
Tmprss3,17,31179265,31198977,protein_coding,-1,19712,chr17_31179265_31198977
Tmprss4,9,45172726,45204092,protein_coding,-1,31366,chr9_45172726_45204092
Tmprss5,9,49081260,49117587,protein_coding,1,36327,chr9_49081260_49117587
Tmprss6,15,78439667,78468634,protein_coding,-1,28967,chr15_78439667_78468634
Tmprss7,16,45656315,45693658,protein_coding,-1,37343,chr16_45656315_45693658
Tmprss9,10,80871848,80899492,protein_coding,1,27644,chr10_80871848_80899492
Tmsb10,6,72957347,72958748,protein_coding,-1,1401,chr6_72957347_72958748
Tmsb15b1,X,136974022,136976874,protein_coding,-1,2852,chrX_136974022_136976874
Tmsb15b2,X,136955265,136975497,protein_coding,-1,20232,chrX_136955265_136975497
Tmsb4x,X,167207093,167209315,protein_coding,-1,2222,chrX_167207093_167209315
Tmtc1,6,148232430,148444389,protein_coding,-1,211959,chr6_148232430_148444389
Tmtc2,10,105187663,105574451,protein_coding,-1,386788,chr10_105187663_105574451
Tmtc3,10,100443902,100487350,protein_coding,-1,43448,chr10_100443902_100487350
Tmtc4,14,122918971,122984035,protein_coding,-1,65064,chr14_122918971_122984035
Tmub1,5,24445458,24447854,protein_coding,-1,2396,chr5_24445458_24447854
Tmub2,11,102284931,102289237,protein_coding,1,4306,chr11_102284931_102289237
Tmx1,12,70453095,70468040,protein_coding,1,14945,chr12_70453095_70468040
Tmx2,2,84671316,84679140,protein_coding,-1,7824,chr2_84671316_84679140
Tmx3,18,90510154,90543267,protein_coding,1,33113,chr18_90510154_90543267
Tmx4,2,134594185,134644145,protein_coding,-1,49960,chr2_134594185_134644145
Tnc,4,63959785,64047015,protein_coding,-1,87230,chr4_63959785_64047015
Tnf,17,35199381,35202007,protein_coding,-1,2626,chr17_35199381_35202007
Tnfaip1,11,78522850,78536332,protein_coding,-1,13482,chr11_78522850_78536332
Tnfaip2,12,111442469,111455018,protein_coding,1,12549,chr12_111442469_111455018
Tnfaip3,10,19000910,19015657,protein_coding,-1,14747,chr10_19000910_19015657
Tnfaip6,2,52038009,52056686,protein_coding,1,18677,chr2_52038009_52056686
Tnfaip8,18,49979427,50107173,protein_coding,1,127746,chr18_49979427_50107173
Tnfaip8l1,17,56162477,56173955,protein_coding,1,11478,chr17_56162477_56173955
Tnfaip8l2,3,95139521,95142360,protein_coding,-1,2839,chr3_95139521_95142360
Tnfaip8l3,9,54023405,54068388,protein_coding,-1,44983,chr9_54023405_54068388
Tnfrsf10b,14,69767472,69784411,protein_coding,1,16939,chr14_69767472_69784411
Tnfrsf11a,1,105780718,105847981,protein_coding,1,67263,chr1_105780718_105847981
Tnfrsf11b,15,54250619,54278484,protein_coding,-1,27865,chr15_54250619_54278484
Tnfrsf12a,17,23675445,23677468,protein_coding,-1,2023,chr17_23675445_23677468
Tnfrsf13b,11,61126755,61149372,protein_coding,1,22617,chr11_61126755_61149372
Tnfrsf13c,15,82221743,82224369,protein_coding,-1,2626,chr15_82221743_82224369
Tnfrsf14,4,154921933,154928563,protein_coding,-1,6630,chr4_154921933_154928563
Tnfrsf17,16,11313812,11320074,protein_coding,1,6262,chr16_11313812_11320074
Tnfrsf18,4,156026164,156028895,protein_coding,1,2731,chr4_156026164_156028895
Tnfrsf19,14,60963875,61046490,protein_coding,-1,82615,chr14_60963875_61046490
Tnfrsf1a,6,125349362,125362484,protein_coding,1,13122,chr6_125349362_125362484
Tnfrsf1b,4,145213463,145246870,protein_coding,-1,33407,chr4_145213463_145246870
Tnfrsf21,17,43016555,43089189,protein_coding,1,72634,chr17_43016555_43089189
Tnfrsf22,7,143634806,143649661,protein_coding,-1,14855,chr7_143634806_143649661
Tnfrsf23,7,143665809,143685872,protein_coding,-1,20063,chr7_143665809_143685872
Tnfrsf25,4,152115934,152120119,protein_coding,1,4185,chr4_152115934_152120119
Tnfrsf26,7,143607659,143628722,protein_coding,-1,21063,chr7_143607659_143628722
Tnfrsf4,4,156013843,156016612,protein_coding,1,2769,chr4_156013843_156016612
Tnfrsf8,4,145267137,145315164,protein_coding,-1,48027,chr4_145267137_145315164
Tnfrsf9,4,150914562,150946102,protein_coding,1,31540,chr4_150914562_150946102
Tnfsf10,3,27317028,27342427,protein_coding,1,25399,chr3_27317028_27342427
Tnfsf11,14,78277445,78308043,protein_coding,-1,30598,chr14_78277445_78308043
Tnfsf12,11,69686250,69695849,protein_coding,-1,9599,chr11_69686250_69695849
Tnfsf13,11,69682846,69685784,protein_coding,-1,2938,chr11_69682846_69685784
Tnfsf13b,8,10006467,10039072,protein_coding,1,32605,chr8_10006467_10039072
Tnfsf13os,11,69682138,69691141,antisense,1,9003,chr11_69682138_69691141
Tnfsf15,4,63724603,63745113,protein_coding,-1,20510,chr4_63724603_63745113
Tnfsf9,17,57105325,57107757,protein_coding,1,2432,chr17_57105325_57107757
Tnfsfm13,11,69682577,69696098,protein_coding,-1,13521,chr11_69682577_69696098
Tnik,3,28263214,28675858,protein_coding,1,412644,chr3_28263214_28675858
Tnip1,11,54910785,54962917,protein_coding,-1,52132,chr11_54910785_54962917
Tnip2,5,34496087,34513991,protein_coding,-1,17904,chr5_34496087_34513991
Tnip3,6,65525313,65634040,protein_coding,1,108727,chr6_65525313_65634040
Tnk1,11,69851005,69858730,protein_coding,-1,7725,chr11_69851005_69858730
Tnk2,16,32643874,32683493,protein_coding,1,39619,chr16_32643874_32683493
Tnk2os,16,32665223,32668197,antisense,-1,2974,chr16_32665223_32668197
Tnks,8,34826460,34965690,protein_coding,-1,139230,chr8_34826460_34965690
Tnks1bp1,2,85048022,85073048,protein_coding,1,25026,chr2_85048022_85073048
Tnks2,19,36834232,36893477,protein_coding,1,59245,chr19_36834232_36893477
Tnmd,X,133850980,133865577,protein_coding,1,14597,chrX_133850980_133865577
Tnn,1,160085029,160153580,protein_coding,-1,68551,chr1_160085029_160153580
Tnnc1,14,31208312,31211729,protein_coding,1,3417,chr14_31208312_31211729
Tnnc2,2,164777161,164779967,protein_coding,-1,2806,chr2_164777161_164779967
Tnni1,1,135779434,135810989,protein_coding,1,31555,chr1_135779434_135810989
Tnni3,7,4518305,4524229,protein_coding,-1,5924,chr7_4518305_4524229
Tnni3k,3,154786291,155055407,protein_coding,-1,269116,chr3_154786291_155055407
Tnnt1,7,4504570,4516382,protein_coding,-1,11812,chr7_4504570_4516382
Tnnt2,1,135836354,135852260,protein_coding,1,15906,chr1_135836354_135852260
Tnnt3,7,142498836,142516009,protein_coding,1,17173,chr7_142498836_142516009
Tnp1,1,73015074,73015909,protein_coding,-1,835,chr1_73015074_73015909
Tnp2,16,10787936,10788660,protein_coding,-1,724,chr16_10787936_10788660
Tnpo1,13,98839019,98926384,protein_coding,-1,87365,chr13_98839019_98926384
Tnpo2,8,85036915,85057583,protein_coding,1,20668,chr8_85036915_85057583
Tnpo3,6,29540827,29609887,protein_coding,-1,69060,chr6_29540827_29609887
Tnr,1,159523769,159931729,protein_coding,1,407960,chr1_159523769_159931729
Tnrc18,5,142724661,142817662,protein_coding,-1,93001,chr5_142724661_142817662
Tnrc6a,7,123123885,123195296,protein_coding,1,71411,chr7_123123885_123195296
Tnrc6b,15,80711313,80941085,protein_coding,1,229772,chr15_80711313_80941085
Tnrc6c,11,117654289,117763439,protein_coding,1,109150,chr11_117654289_117763439
Tns1,1,73910231,74124449,protein_coding,-1,214218,chr1_73910231_74124449
Tns3,11,8431652,8664681,protein_coding,-1,233029,chr11_8431652_8664681
Tns4,11,99065678,99089306,protein_coding,-1,23628,chr11_99065678_99089306
Tnxa,17,34771395,34801623,unprocessed_pseudogene,1,30228,chr17_34771395_34801623
Tnxb,17,34660457,34719815,protein_coding,1,59358,chr17_34660457_34719815
Tob1,11,94211454,94215495,protein_coding,1,4041,chr11_94211454_94215495
Tob2,15,81848272,81858796,protein_coding,-1,10524,chr15_81848272_81858796
Toe1,4,116794310,116807640,protein_coding,-1,13330,chr4_116794310_116807640
Tollip,7,141874813,141918507,protein_coding,-1,43694,chr7_141874813_141918507
Tom1,8,75033705,75070121,protein_coding,1,36416,chr8_75033705_75070121
Tom1l1,11,90643465,90688366,protein_coding,-1,44901,chr11_90643465_90688366
Tom1l2,11,60226714,60352905,protein_coding,-1,126191,chr11_60226714_60352905
Tomm20,8,126930667,126945844,protein_coding,-1,15177,chr8_126930667_126945844
Tomm20l,12,71111428,71123221,protein_coding,1,11793,chr12_71111428_71123221
Tomm22,15,79670861,79673400,protein_coding,1,2539,chr15_79670861_79673400
Tomm34,2,164053540,164071169,protein_coding,-1,17629,chr2_164053540_164071169
Tomm40,7,19701313,19715438,protein_coding,-1,14125,chr7_19701313_19715438
Tomm40l,1,171216011,171222514,protein_coding,-1,6503,chr1_171216011_171222514
Tomm5,4,45105208,45108114,protein_coding,-1,2906,chr4_45105208_45108114
Tomm6,17,47686646,47688386,protein_coding,-1,1740,chr17_47686646_47688386
Tomm6os,17,47687610,47691083,antisense,1,3473,chr17_47687610_47691083
Tomm7,5,23838944,23844161,protein_coding,-1,5217,chr5_23838944_23844161
Tomm70a,16,57121703,57156705,protein_coding,1,35002,chr16_57121703_57156705
Tomt,7,101898370,101906359,protein_coding,-1,7989,chr7_101898370_101906359
Tonsl,15,76626002,76639958,protein_coding,-1,13956,chr15_76626002_76639958
Top1,2,160645888,160722764,protein_coding,1,76876,chr2_160645888_160722764
Top1mt,15,75657035,75678800,protein_coding,-1,21765,chr15_75657035_75678800
Top2a,11,98992943,99024189,protein_coding,-1,31246,chr11_98992943_99024189
Top2b,14,16365179,16435462,protein_coding,1,70283,chr14_16365179_16435462
Top3a,11,60740058,60777365,protein_coding,-1,37307,chr11_60740058_60777365
Top3b,16,16870736,16892990,protein_coding,1,22254,chr16_16870736_16892990
Topaz1,9,122747346,122802135,protein_coding,1,54789,chr9_122747346_122802135
Topbp1,9,103305215,103350428,protein_coding,1,45213,chr9_103305215_103350428
Topors,4,40259601,40269850,protein_coding,-1,10249,chr4_40259601_40269850
Tor1a,2,30960627,30967933,protein_coding,-1,7306,chr2_30960627_30967933
Tor1aip1,1,156004599,156036480,protein_coding,-1,31881,chr1_156004599_156036480
Tor1aip2,1,156035403,156068861,protein_coding,1,33458,chr1_156035403_156068861
Tor1b,2,30952959,30959015,protein_coding,1,6056,chr2_30952959_30959015
Tor2a,2,32757234,32762244,protein_coding,1,5010,chr2_32757234_32762244
Tor3a,1,156653617,156674356,protein_coding,-1,20739,chr1_156653617_156674356
Tor4a,2,25192966,25196886,protein_coding,-1,3920,chr2_25192966_25196886
Tox,4,6686353,6991557,protein_coding,-1,305204,chr4_6686353_6991557
Tox2,2,163203125,163324170,protein_coding,1,121045,chr2_163203125_163324170
Tox3,8,90247040,90348343,protein_coding,-1,101303,chr8_90247040_90348343
Tox4,14,52279146,52296401,protein_coding,1,17255,chr14_52279146_52296401
Tpbg,9,85842380,85847040,protein_coding,1,4660,chr9_85842380_85847040
Tpcn1,5,120534153,120588673,protein_coding,-1,54520,chr5_120534153_120588673
Tpcn2,7,145186524,145284011,protein_coding,-1,97487,chr7_145186524_145284011
Tpd52,3,8925593,9004723,protein_coding,-1,79130,chr3_8925593_9004723
Tpd52-ps,8,79680284,79680806,processed_pseudogene,-1,522,chr8_79680284_79680806
Tpd52l1,10,31332376,31445958,protein_coding,-1,113582,chr10_31332376_31445958
Tpd52l2,2,181497142,181517966,protein_coding,1,20824,chr2_181497142_181517966
Tpgs1,10,79669369,79676127,protein_coding,1,6758,chr10_79669369_79676127
Tpgs2,18,25127223,25169007,protein_coding,-1,41784,chr18_25127223_25169007
Tph1,7,46644641,46672537,protein_coding,-1,27896,chr7_46644641_46672537
Tph2,10,115078641,115185022,protein_coding,-1,106381,chr10_115078641_115185022
Tpi-rs10,18,20548587,20549364,processed_pseudogene,-1,777,chr18_20548587_20549364
Tpi-rs11,6,127183409,127183718,processed_pseudogene,-1,309,chr6_127183409_127183718
Tpi-rs2,3,66128968,66129723,processed_pseudogene,-1,755,chr3_66128968_66129723
Tpi-rs4,9,31948346,31949065,processed_pseudogene,1,719,chr9_31948346_31949065
Tpi-rs5,10,19101545,19102318,processed_pseudogene,1,773,chr10_19101545_19102318
Tpi-rs8,13,25455722,25456429,processed_pseudogene,1,707,chr13_25455722_25456429
Tpi-rs9,14,16946659,16947433,processed_pseudogene,1,774,chr14_16946659_16947433
Tpi1,6,124810586,124814296,protein_coding,-1,3710,chr6_124810586_124814296
Tpk1,6,43345001,43666278,protein_coding,-1,321277,chr6_43345001_43666278
Tpm1,9,67022590,67049406,protein_coding,-1,26816,chr9_67022590_67049406
Tpm2,4,43514711,43523765,protein_coding,-1,9054,chr4_43514711_43523765
Tpm3,3,90072649,90100902,protein_coding,1,28253,chr3_90072649_90100902
Tpm3-rs2,4,27996583,27996905,processed_pseudogene,-1,322,chr4_27996583_27996905
Tpm3-rs7,14,113314608,113316754,protein_coding,1,2146,chr14_113314608_113316754
Tpm4,8,72130174,72153142,protein_coding,1,22968,chr8_72130174_72153142
Tpmt,13,47022482,47044737,protein_coding,-1,22255,chr13_47022482_47044737
Tpo,12,30054659,30132624,protein_coding,-1,77965,chr12_30054659_30132624
Tpp1,7,105744811,105752235,protein_coding,-1,7424,chr7_105744811_105752235
Tpp2,1,43933647,44003000,protein_coding,1,69353,chr1_43933647_44003000
Tppp,13,74009407,74035753,protein_coding,1,26346,chr13_74009407_74035753
Tppp3,8,105467493,105471526,protein_coding,-1,4033,chr8_105467493_105471526
Tpr,1,150392838,150449935,protein_coding,1,57097,chr1_150392838_150449935
Tpra1,6,88902251,88912238,protein_coding,1,9987,chr6_88902251_88912238
Tprgl,4,154157485,154160666,protein_coding,-1,3181,chr4_154157485_154160666
Tprkb,6,85911865,85930284,protein_coding,1,18419,chr6_85911865_85930284
Tprn,2,25262618,25269885,protein_coding,1,7267,chr2_25262618_25269885
Tpsg1,17,25369273,25374442,protein_coding,1,5169,chr17_25369273_25374442
Tpst1,5,130073326,130135729,protein_coding,1,62403,chr5_130073326_130135729
Tpst2,5,112276691,112315361,protein_coding,1,38670,chr5_112276691_112315361
Tpt1,14,75845093,75848525,protein_coding,1,3432,chr14_75845093_75848525
Tpt1-ps1,3,101233460,101233895,processed_pseudogene,1,435,chr3_101233460_101233895
Tpt1-ps2,4,54564623,54565143,processed_pseudogene,1,520,chr4_54564623_54565143
Tpt1-ps3,6,99877816,99878334,processed_pseudogene,-1,518,chr6_99877816_99878334
Tpt1-ps4,7,11915871,11916492,processed_pseudogene,1,621,chr7_11915871_11916492
Tpt1-ps5,9,37696515,37697030,processed_pseudogene,1,515,chr9_37696515_37697030
Tpt1-ps6,X,101768535,101769057,processed_pseudogene,1,522,chrX_101768535_101769057
Tpt1-ps7,17,53466649,53467315,processed_pseudogene,-1,666,chr17_53466649_53467315
Tpte,8,22283441,22371418,protein_coding,1,87977,chr8_22283441_22371418
Tpx2,2,152847964,152895321,protein_coding,1,47357,chr2_152847964_152895321
Tra2a,6,49243924,49264033,protein_coding,-1,20109,chr6_49243924_49264033
Tra2b,16,22244549,22266005,protein_coding,-1,21456,chr16_22244549_22266005
Trabd,15,89075124,89087077,protein_coding,1,11953,chr15_89075124_89087077
Trabd2b,4,114406724,114615098,protein_coding,1,208374,chr4_114406724_114615098
Tradd,8,105258286,105264609,protein_coding,-1,6323,chr8_105258286_105264609
Traf1,2,34941750,34961772,protein_coding,-1,20022,chr2_34941750_34961772
Traf2,2,25517982,25546940,protein_coding,-1,28958,chr2_25517982_25546940
Traf3,12,111166370,111267153,protein_coding,1,100783,chr12_111166370_111267153
Traf3ip1,1,91494647,91529307,protein_coding,1,34660,chr1_91494647_91529307
Traf3ip2,10,39612934,39655307,protein_coding,1,42373,chr10_39612934_39655307
Traf3ip3,1,193175453,193201703,protein_coding,-1,26250,chr1_193175453_193201703
Traf4,11,78158499,78165589,protein_coding,-1,7090,chr11_78158499_78165589
Traf5,1,191997054,192092559,protein_coding,-1,95505,chr1_191997054_192092559
Traf6,2,101678429,101701669,protein_coding,1,23240,chr2_101678429_101701669
Traf7,17,24508562,24527938,protein_coding,-1,19376,chr17_24508562_24527938
Trafd1,5,121371725,121385632,protein_coding,-1,13907,chr5_121371725_121385632
Traip,9,107950136,107972270,protein_coding,1,22134,chr9_107950136_107972270
Trak1,9,121297502,121474918,protein_coding,1,177416,chr9_121297502_121474918
Trak2,1,58900449,58973430,protein_coding,-1,72981,chr1_58900449_58973430
Tram1,1,13564698,13589910,protein_coding,-1,25212,chr1_13564698_13589910
Tram1l1,3,124320855,124324743,protein_coding,1,3888,chr3_124320855_124324743
Tram2,1,20996299,21079229,protein_coding,-1,82930,chr1_20996299_21079229
Trank1,9,111311739,111395775,protein_coding,1,84036,chr9_111311739_111395775
Trap1,16,4039971,4077827,protein_coding,-1,37856,chr16_4039971_4077827
Trappc1,11,69323980,69325793,protein_coding,1,1813,chr11_69323980_69325793
Trappc10,10,78186725,78244641,protein_coding,-1,57916,chr10_78186725_78244641
Trappc11,8,47490115,47533470,protein_coding,-1,43355,chr8_47490115_47533470
Trappc12,12,28690628,28750472,protein_coding,-1,59844,chr12_28690628_28750472
Trappc13,13,104142149,104178469,protein_coding,-1,36320,chr13_104142149_104178469
Trappc2,X,166440574,166453140,protein_coding,1,12566,chrX_166440574_166453140
Trappc2l,8,122611640,122616660,protein_coding,1,5020,chr8_122611640_122616660
Trappc3,4,126262325,126275883,protein_coding,1,13558,chr4_126262325_126275883
Trappc3l,10,34037597,34109815,protein_coding,1,72218,chr10_34037597_34109815
Trappc4,9,44403698,44407600,protein_coding,-1,3902,chr9_44403698_44407600
Trappc5,8,3676299,3681255,protein_coding,1,4956,chr8_3676299_3681255
Trappc6a,7,19508395,19516145,protein_coding,1,7750,chr7_19508395_19516145
Trappc6b,12,59043092,59061472,protein_coding,-1,18380,chr12_59043092_59061472
Trappc8,18,20817223,20896093,protein_coding,-1,78870,chr18_20817223_20896093
Trappc9,15,72589620,73061204,protein_coding,-1,471584,chr15_72589620_73061204
Trat1,16,48730774,48772021,protein_coding,-1,41247,chr16_48730774_48772021
Trcg1,9,57236556,57249864,protein_coding,1,13308,chr9_57236556_57249864
Trdmt1,2,13509014,13544668,protein_coding,-1,35654,chr2_13509014_13544668
Trdn,10,33080554,33476709,protein_coding,1,396155,chr10_33080554_33476709
Treh,9,44673233,44686305,protein_coding,1,13072,chr9_44673233_44686305
Trem2,17,48342504,48354147,protein_coding,1,11643,chr17_48342504_48354147
Treml1,17,48356019,48367176,protein_coding,1,11157,chr17_48356019_48367176
Treml2,17,48295601,48312533,protein_coding,1,16932,chr17_48295601_48312533
Treml4,17,48260398,48275360,protein_coding,1,14962,chr17_48260398_48275360
Trerf1,CHR_MG209_PATCH,47140875,47361958,processed_transcript;protein_coding,1,221083,chrCHR_MG209_PATCH_47140875_47361958
Trex1,9,109057933,109059734,protein_coding,-1,1801,chr9_109057933_109059734
Trf,9,103204001,103230444,protein_coding,-1,26443,chr9_103204001_103230444
Trh,6,92242061,92244650,protein_coding,-1,2589,chr6_92242061_92244650
Trhde,10,114398821,114802307,protein_coding,-1,403486,chr10_114398821_114802307
Trhr,15,44196135,44235912,protein_coding,1,39777,chr15_44196135_44235912
Trhr2,8,122356967,122360746,protein_coding,-1,3779,chr8_122356967_122360746
Triap1,5,115341225,115343569,protein_coding,1,2344,chr5_115341225_115343569
Trib1,15,59648350,59657099,protein_coding,1,8749,chr15_59648350_59657099
Trib2,12,15791727,15816922,protein_coding,-1,25195,chr12_15791727_15816922
Trib3,2,152337422,152344032,protein_coding,-1,6610,chr2_152337422_152344032
Tril,6,53815468,53820830,protein_coding,-1,5362,chr6_53815468_53820830
Trim11,11,58978093,58991458,protein_coding,1,13365,chr11_58978093_58991458
Trim12a,7,104299894,104315466,protein_coding,-1,15572,chr7_104299894_104315466
Trim12c,7,104338754,104353362,protein_coding,-1,14608,chr7_104338754_104353362
Trim13,14,61598247,61605946,protein_coding,1,7699,chr14_61598247_61605946
Trim14,4,46493781,46536141,protein_coding,-1,42360,chr4_46493781_46536141
Trim15,17,36860691,36867210,protein_coding,-1,6519,chr17_36860691_36867210
Trim16,11,62820231,62850808,protein_coding,1,30577,chr11_62820231_62850808
Trim17,11,58954685,58973098,protein_coding,1,18413,chr11_58954685_58973098
Trim2,3,84160439,84306877,protein_coding,-1,146438,chr3_84160439_84306877
Trim21,7,102557921,102565486,protein_coding,-1,7565,chr7_102557921_102565486
Trim23,13,104178797,104203372,protein_coding,1,24575,chr13_104178797_104203372
Trim24,6,37870811,37966296,protein_coding,1,95485,chr6_37870811_37966296
Trim25,11,88999376,89020293,protein_coding,1,20917,chr11_88999376_89020293
Trim26,17,36837134,36859398,protein_coding,1,22264,chr17_36837134_36859398
Trim27,13,21179445,21194724,protein_coding,1,15279,chr13_21179445_21194724
Trim28,7,12999114,13031035,protein_coding,1,31921,chr7_12999114_13031035
Trim29,9,43310848,43336115,protein_coding,1,25267,chr9_43310848_43336115
Trim3,7,105604463,105633571,protein_coding,-1,29108,chr7_105604463_105633571
Trim30a,7,104409025,104465193,protein_coding,-1,56168,chr7_104409025_104465193
Trim30b,7,104355382,104369884,protein_coding,-1,14502,chr7_104355382_104369884
Trim30d,7,104470014,104507849,protein_coding,-1,37835,chr7_104470014_104507849
Trim30e-ps1,7,104532959,104535361,transcribed_unprocessed_pseudogene,-1,2402,chr7_104532959_104535361
Trim31,17,36898118,36910214,protein_coding,1,12096,chr17_36898118_36910214
Trim32,4,65604986,65616238,protein_coding,1,11252,chr4_65604986_65616238
Trim33,3,103279293,103358775,protein_coding,1,79482,chr3_103279293_103358775
Trim34a,7,104244457,104262234,protein_coding,1,17777,chr7_104244457_104262234
Trim35,14,66297031,66311424,protein_coding,1,14393,chr14_66297031_66311424
Trim36,18,46165300,46212607,protein_coding,-1,47307,chr18_46165300_46212607
Trim37,11,87127077,87220683,protein_coding,1,93606,chr11_87127077_87220683
Trim38,13,23769913,23791528,protein_coding,1,21615,chr13_23769913_23791528
Trim39,17,36258873,36272247,protein_coding,-1,13374,chr17_36258873_36272247
Trim40,17,36881598,36890123,protein_coding,-1,8525,chr17_36881598_36890123
Trim41,11,48806404,48817353,protein_coding,-1,10949,chr11_48806404_48817353
Trim43a,9,88580891,88588819,protein_coding,1,7928,chr9_88580891_88588819
Trim43b,9,89084624,89092835,protein_coding,-1,8211,chr9_89084624_89092835
Trim43c,9,88839164,88848190,protein_coding,1,9026,chr9_88839164_88848190
Trim44,2,102300119,102407828,protein_coding,-1,107709,chr2_102300119_102407828
Trim45,3,100922202,100936920,protein_coding,1,14718,chr3_100922202_100936920
Trim46,3,89234177,89246309,protein_coding,-1,12132,chr3_89234177_89246309
Trim47,11,116105752,116127210,protein_coding,-1,21458,chr11_116105752_116127210
Trim5,7,104263386,104288094,protein_coding,-1,24708,chr7_104263386_104288094
Trim54,5,31116712,31137630,protein_coding,1,20918,chr5_31116712_31137630
Trim56,5,137105644,137116209,protein_coding,-1,10565,chr5_137105644_137116209
Trim59,3,69035288,69044755,protein_coding,-1,9467,chr3_69035288_69044755
Trim60,8,64999307,65018584,protein_coding,-1,19277,chr8_64999307_65018584
Trim61,8,65012987,65018523,protein_coding,-1,5536,chr8_65012987_65018523
Trim62,4,128883580,128911328,protein_coding,1,27748,chr4_128883580_128911328
Trim63,4,134315120,134329629,protein_coding,1,14509,chr4_134315120_134329629
Trim65,11,116121846,116131128,protein_coding,-1,9282,chr11_116121846_116131128
Trim66,7,109449006,109508134,protein_coding,-1,59128,chr7_109449006_109508134
Trim67,8,124793092,124834713,protein_coding,1,41621,chr8_124793092_124834713
Trim68,7,102677582,102687327,protein_coding,-1,9745,chr7_102677582_102687327
Trim69,2,122160700,122179027,protein_coding,1,18327,chr2_122160700_122179027
Trim7,11,48826140,48852209,protein_coding,1,26069,chr11_48826140_48852209
Trim71,9,114507133,114564369,protein_coding,-1,57236,chr9_114507133_114564369
Trim72,7,128003949,128011033,protein_coding,1,7084,chr7_128003949_128011033
Trim75,8,64980884,64987831,protein_coding,-1,6947,chr8_64980884_64987831
Trim8,19,46501702,46516848,protein_coding,1,15146,chr19_46501702_46516848
Trim80,11,115440545,115448270,protein_coding,1,7725,chr11_115440545_115448270
Trim9,12,70244533,70347614,protein_coding,-1,103081,chr12_70244533_70347614
Triml1,8,43129807,43141486,protein_coding,-1,11679,chr8_43129807_43141486
Triml2,8,43180541,43193881,protein_coding,1,13340,chr8_43180541_43193881
Trio,15,27730651,28025848,protein_coding,-1,295197,chr15_27730651_28025848
Triobp,15,78947724,79005869,protein_coding,1,58145,chr15_78947724_79005869
Trip10,17,57249455,57263665,protein_coding,1,14210,chr17_57249455_57263665
Trip11,12,101834043,101913267,protein_coding,-1,79224,chr12_101834043_101913267
Trip12,1,84721189,84840516,protein_coding,-1,119327,chr1_84721189_84840516
Trip13,13,73911347,73937784,protein_coding,-1,26437,chr13_73911347_73937784
Trip4,9,65828930,65908794,protein_coding,-1,79864,chr9_65828930_65908794
Trip6,5,137309654,137314404,protein_coding,-1,4750,chr5_137309654_137314404
Triqk,4,12906838,12983553,protein_coding,1,76715,chr4_12906838_12983553
Trit1,4,123016597,123054949,protein_coding,1,38352,chr4_123016597_123054949
Trmt1,8,84686307,84699808,protein_coding,1,13501,chr8_84686307_84699808
Trmt10a,3,138143448,138159821,protein_coding,1,16373,chr3_138143448_138159821
Trmt10b,4,45297127,45316131,protein_coding,1,19004,chr4_45297127_45316131
Trmt10c,16,56032609,56037819,protein_coding,-1,5210,chr16_56032609_56037819
Trmt11,10,30534225,30600749,protein_coding,-1,66524,chr10_30534225_30600749
Trmt112,19,6909698,6911049,protein_coding,1,1351,chr19_6909698_6911049
Trmt112-ps1,5,91737705,91738079,processed_pseudogene,-1,374,chr5_91737705_91738079
Trmt112-ps2,4,149457329,149457706,processed_pseudogene,1,377,chr4_149457329_149457706
Trmt12,15,58872674,58877127,protein_coding,1,4453,chr15_58872674_58877127
Trmt13,3,116581093,116614587,protein_coding,-1,33494,chr3_116581093_116614587
Trmt1l,1,151428542,151458161,protein_coding,1,29619,chr1_151428542_151458161
Trmt2a,16,18248679,18254772,protein_coding,1,6093,chr16_18248679_18254772
Trmt2b,X,134222339,134276984,protein_coding,-1,54645,chrX_134222339_134276984
Trmt44,5,35556203,35575070,protein_coding,-1,18867,chr5_35556203_35575070
Trmt5,12,73280011,73286710,protein_coding,-1,6699,chr12_73280011_73286710
Trmt6,2,132804207,132816055,protein_coding,-1,11848,chr2_132804207_132816055
Trmt61a,12,111678105,111683902,protein_coding,1,5797,chr12_111678105_111683902
Trmt61b,17,71557027,71598755,antisense,-1,41728,chr17_71557027_71598755
Trmu,15,85879312,85897394,protein_coding,1,18082,chr15_85879312_85897394
Trnau1ap,4,132311763,132329538,protein_coding,-1,17775,chr4_132311763_132329538
Trnp1,4,133491100,133498550,protein_coding,-1,7450,chr4_133491100_133498550
Trnt1,6,106769120,106782474,protein_coding,1,13354,chr6_106769120_106782474
Tro,X,150645304,150657583,protein_coding,-1,12279,chrX_150645304_150657583
Troap,15,99074575,99083409,protein_coding,1,8834,chr15_99074575_99083409
Trp53,11,69580359,69591873,protein_coding,1,11514,chr11_69580359_69591873
Trp53-ps,17,54419680,54420841,processed_pseudogene,1,1161,chr17_54419680_54420841
Trp53bp1,2,121193281,121271407,protein_coding,-1,78126,chr2_121193281_121271407
Trp53bp2,1,182409172,182462432,protein_coding,1,53260,chr1_182409172_182462432
Trp53cor1,17,29057430,29079179,lincRNA,-1,21749,chr17_29057430_29079179
Trp53i11,2,93187548,93201759,protein_coding,1,14211,chr2_93187548_93201759
Trp53i13,11,77508099,77515980,protein_coding,-1,7881,chr11_77508099_77515980
Trp53inp1,4,11156431,11174379,protein_coding,1,17948,chr4_11156431_11174379
Trp53inp2,2,155381059,155389850,protein_coding,1,8791,chr2_155381059_155389850
Trp53tg5,2,164470301,164473724,protein_coding,-1,3423,chr2_164470301_164473724
Trp63,16,25683763,25892102,protein_coding,1,208339,chr16_25683763_25892102
Trp73,4,154056249,154140208,protein_coding,-1,83959,chr4_154056249_154140208
Trpa1,1,14872648,14918862,protein_coding,-1,46214,chr1_14872648_14918862
Trpc1,9,95705082,95750375,protein_coding,-1,45293,chr9_95705082_95750375
Trpc3,3,36620482,36690167,protein_coding,-1,69685,chr3_36620482_36690167
Trpc4,3,54156035,54318471,protein_coding,1,162436,chr3_54156035_54318471
Trpc4ap,2,155634271,155692384,protein_coding,-1,58113,chr2_155634271_155692384
Trpc5,X,144381671,144688180,protein_coding,-1,306509,chrX_144381671_144688180
Trpc5os,X,144456581,144477066,protein_coding,1,20485,chrX_144456581_144477066
Trpc6,9,8544142,8680741,protein_coding,1,136599,chr9_8544142_8680741
Trpc7,13,56773113,56895993,protein_coding,-1,122880,chr13_56773113_56895993
Trpm1,7,64153835,64269775,protein_coding,1,115940,chr7_64153835_64269775
Trpm2,10,77907722,77970563,protein_coding,-1,62841,chr10_77907722_77970563
Trpm3,19,22139046,22995410,protein_coding,1,856364,chr19_22139046_22995410
Trpm4,7,45302632,45333780,protein_coding,-1,31148,chr7_45302632_45333780
Trpm6,19,18749983,18892511,protein_coding,1,142528,chr19_18749983_18892511
Trpm7,2,126791565,126876230,protein_coding,-1,84665,chr2_126791565_126876230
Trpm8,1,88277661,88389293,protein_coding,1,111632,chr1_88277661_88389293
Trps1,15,50654752,50890463,protein_coding,-1,235711,chr15_50654752_50890463
Trpt1,19,6996131,6999046,protein_coding,1,2915,chr19_6996131_6999046
Trpv1,11,73234292,73261242,protein_coding,1,26950,chr11_73234292_73261242
Trpv2,11,62574486,62600515,protein_coding,1,26029,chr11_62574486_62600515
Trpv3,11,73267388,73300363,protein_coding,1,32975,chr11_73267388_73300363
Trpv4,5,114622152,114658421,protein_coding,-1,36269,chr5_114622152_114658421
Trpv5,6,41652173,41680769,protein_coding,-1,28596,chr6_41652173_41680769
Trpv6,6,41620624,41636405,protein_coding,-1,15781,chr6_41620624_41636405
Trrap,5,144767732,144859778,protein_coding,1,92046,chr5_144767732_144859778
Trub1,19,57452912,57491005,protein_coding,1,38093,chr19_57452912_57491005
Trub2,2,29761224,29788502,protein_coding,-1,27278,chr2_29761224_29788502
Tsacc,3,88282757,88296999,protein_coding,-1,14242,chr3_88282757_88296999
Tsc1,2,28641228,28691167,protein_coding,1,49939,chr2_28641228_28691167
Tsc2,17,24595816,24632630,protein_coding,-1,36814,chr17_24595816_24632630
Tsc22d1,14,76414961,76507765,protein_coding,1,92804,chr14_76414961_76507765
Tsc22d2,3,58414715,58466783,protein_coding,1,52068,chr3_58414715_58466783
Tsc22d3,X,140539528,140600659,protein_coding,-1,61131,chrX_140539528_140600659
Tsc22d4,5,137745730,137768450,protein_coding,1,22720,chr5_137745730_137768450
Tsen15,1,152370735,152386688,protein_coding,-1,15953,chr1_152370735_152386688
Tsen2,6,115544664,115578628,protein_coding,1,33964,chr6_115544664_115578628
Tsen34,7,3692863,3701024,protein_coding,1,8161,chr7_3692863_3701024
Tsen54,11,115814724,115823094,protein_coding,1,8370,chr11_115814724_115823094
Tsfm,10,127011572,127030840,protein_coding,-1,19268,chr10_127011572_127030840
Tsg101,7,46888949,46919969,protein_coding,-1,31020,chr7_46888949_46919969
Tsg101-ps,15,62980648,62981817,processed_pseudogene,1,1169,chr15_62980648_62981817
Tsga10,1,37754776,37866429,protein_coding,-1,111653,chr1_37754776_37866429
Tsga10ip,19,5390049,5402526,protein_coding,-1,12477,chr19_5390049_5402526
Tsga13,6,30896981,30915573,protein_coding,-1,18592,chr6_30896981_30915573
Tshb,3,102775465,102782718,protein_coding,-1,7253,chr3_102775465_102782718
Tshr,12,91384563,91549808,protein_coding,1,165245,chr12_91384563_91549808
Tshz1,18,84011627,84087706,protein_coding,-1,76079,chr18_84011627_84087706
Tshz2,2,169633013,170071816,protein_coding,1,438803,chr2_169633013_170071816
Tshz3,7,36698118,36773553,protein_coding,1,75435,chr7_36698118_36773553
Tsix,X,103431517,103484957,antisense,1,53440,chrX_103431517_103484957
Tsks,7,44943204,44958035,protein_coding,1,14831,chr7_44943204_44958035
Tsku,7,98350668,98361328,protein_coding,-1,10660,chr7_98350668_98361328
Tslp,18,32815383,32819797,protein_coding,1,4414,chr18_32815383_32819797
Tsn,1,118294778,118311739,protein_coding,-1,16961,chr1_118294778_118311739
Tsnax,8,125012997,125034192,protein_coding,1,21195,chr8_125012997_125034192
Tsnaxip1,8,105827731,105844680,protein_coding,1,16949,chr8_105827731_105844680
Tspan1,4,116161869,116167601,protein_coding,-1,5732,chr4_116161869_116167601
Tspan10,11,120442644,120446950,protein_coding,1,4306,chr11_120442644_120446950
Tspan11,6,127887589,127953977,protein_coding,1,66388,chr6_127887589_127953977
Tspan12,6,21771395,21852515,protein_coding,-1,81120,chr6_21771395_21852515
Tspan13,12,36014557,36042500,protein_coding,-1,27943,chr12_36014557_36042500
Tspan14,14,40906445,40966807,protein_coding,-1,60362,chr14_40906445_40966807
Tspan15,10,62185396,62231251,protein_coding,-1,45855,chr10_62185396_62231251
Tspan17,13,54789377,54796776,protein_coding,1,7399,chr13_54789377_54796776
Tspan18,2,93201760,93334505,protein_coding,-1,132745,chr2_93201760_93334505
Tspan2,3,102734529,102801513,protein_coding,1,66984,chr3_102734529_102801513
Tspan2os,3,102720231,102735417,antisense,-1,15186,chr3_102720231_102735417
Tspan3,9,56131725,56165477,protein_coding,-1,33752,chr9_56131725_56165477
Tspan31,10,127067280,127070264,protein_coding,-1,2984,chr10_127067280_127070264
Tspan33,6,29694222,29718559,protein_coding,1,24337,chr6_29694222_29718559
Tspan4,7,141475240,141493427,protein_coding,1,18187,chr7_141475240_141493427
Tspan5,3,138742195,138907905,protein_coding,1,165710,chr3_138742195_138907905
Tspan6,X,133891068,133898429,protein_coding,-1,7361,chrX_133891068_133898429
Tspan7,X,10485158,10596605,protein_coding,1,111447,chrX_10485158_10596605
Tspan8,10,115816832,115849893,protein_coding,1,33061,chr10_115816832_115849893
Tspan9,6,127961396,128143594,protein_coding,-1,182198,chr6_127961396_128143594
Tspear,10,77686569,77887021,protein_coding,1,200452,chr10_77686569_77887021
Tspo,15,83563592,83574203,protein_coding,1,10611,chr15_83563592_83574203
Tspyl-ps,12,62703160,62704276,processed_pseudogene,-1,1116,chr12_62703160_62704276
Tspyl1,10,34282190,34285275,protein_coding,1,3085,chr10_34282190_34285275
Tspyl2,X,152336852,152342425,protein_coding,-1,5573,chrX_152336852_152342425
Tspyl3,2,153222370,153225441,protein_coding,-1,3071,chr2_153222370_153225441
Tspyl4,10,34297442,34301320,protein_coding,1,3878,chr10_34297442_34301320
Tspyl5,15,33683875,33687884,protein_coding,-1,4009,chr15_33683875_33687884
Tsr1,11,74898071,74909342,protein_coding,1,11271,chr11_74898071_74909342
Tsr2,X,151087094,151096543,protein_coding,-1,9449,chrX_151087094_151096543
Tsr3,17,25240170,25242798,protein_coding,1,2628,chr17_25240170_25242798
Tssc4,7,143069249,143071093,protein_coding,1,1844,chr7_143069249_143071093
Tssk2,16,17898637,17900024,protein_coding,1,1387,chr16_17898637_17900024
Tssk3,4,129489014,129491022,protein_coding,-1,2008,chr4_129489014_129491022
Tssk4,14,55650184,55652539,protein_coding,1,2355,chr14_55650184_55652539
Tssk5,15,76371952,76374938,protein_coding,-1,2986,chr15_76371952_76374938
Tssk6,8,69902184,69903518,protein_coding,1,1334,chr8_69902184_69903518
Tst,15,78399556,78405907,protein_coding,-1,6351,chr15_78399556_78405907
Tsta3,15,75924676,75929832,protein_coding,-1,5156,chr15_75924676_75929832
Tstd1,1,171418872,171420352,protein_coding,1,1480,chr1_171418872_171420352
Tstd2,4,46114746,46138694,protein_coding,-1,23948,chr4_46114746_46138694
Tstd3,4,21757382,21767212,protein_coding,-1,9830,chr4_21757382_21767212
Tsx,X,103414467,103424580,protein_coding,1,10113,chrX_103414467_103424580
Ttbk1,17,46442448,46487675,protein_coding,-1,45227,chr17_46442448_46487675
Ttbk2,2,120732816,120850604,protein_coding,-1,117788,chr2_120732816_120850604
Ttc1,11,43729512,43748008,protein_coding,-1,18496,chr11_43729512_43748008
Ttc12,9,49436963,49486225,protein_coding,-1,49262,chr9_49436963_49486225
Ttc13,8,124671332,124721983,protein_coding,-1,50651,chr8_124671332_124721983
Ttc14,3,33799832,33814860,protein_coding,1,15028,chr3_33799832_33814860
Ttc16,2,32757026,32775633,protein_coding,-1,18607,chr2_32757026_32775633
Ttc17,2,94300767,94406689,protein_coding,-1,105922,chr2_94300767_94406689
Ttc19,11,62281473,62328451,protein_coding,1,46978,chr11_62281473_62328451
Ttc21a,9,119937606,119967793,protein_coding,1,30187,chr9_119937606_119967793
Ttc21b,2,66184327,66256617,protein_coding,-1,72290,chr2_66184327_66256617
Ttc22,4,106622432,106640189,protein_coding,1,17757,chr4_106622432_106640189
Ttc23,7,67647410,67762912,protein_coding,1,115502,chr7_67647410_67762912
Ttc23l,15,10500102,10558668,protein_coding,-1,58566,chr15_10500102_10558668
Ttc25,11,100545607,100572568,protein_coding,1,26961,chr11_100545607_100572568
Ttc26,6,38381469,38427647,protein_coding,1,46178,chr6_38381469_38427647
Ttc27,17,74717732,74863570,protein_coding,1,145838,chr17_74717732_74863570
Ttc28,5,110879803,111289780,protein_coding,1,409977,chr5_110879803_111289780
Ttc3,16,94370618,94469343,protein_coding,1,98725,chr16_94370618_94469343
Ttc30a1,2,75978247,75981967,protein_coding,-1,3720,chr2_75978247_75981967
Ttc30a2,2,75975740,75978170,protein_coding,-1,2430,chr2_75975740_75978170
Ttc30b,2,75935849,75938585,protein_coding,-1,2736,chr2_75935849_75938585
Ttc32,12,9029997,9041988,protein_coding,1,11991,chr12_9029997_9041988
Ttc33,15,5185525,5218336,protein_coding,1,32811,chr15_5185525_5218336
Ttc34,4,154837459,154867127,protein_coding,1,29668,chr4_154837459_154867127
Ttc36,9,44799397,44803072,protein_coding,-1,3675,chr9_44799397_44803072
Ttc37,13,76098734,76190316,protein_coding,1,91582,chr13_76098734_76190316
Ttc38,15,85832306,85858822,protein_coding,1,26516,chr15_85832306_85858822
Ttc39a,4,109406623,109444745,protein_coding,1,38122,chr4_109406623_109444745
Ttc39b,4,83220300,83324255,protein_coding,-1,103955,chr4_83220300_83324255
Ttc39c,18,12599896,12738863,protein_coding,1,138967,chr18_12599896_12738863
Ttc4,4,106662256,106678944,protein_coding,-1,16688,chr4_106662256_106678944
Ttc5,14,50765415,50785519,protein_coding,-1,20104,chr14_50765415_50785519
Ttc7,17,87282886,87381769,protein_coding,1,98883,chr17_87282886_87381769
Ttc7b,12,100300770,100520826,protein_coding,-1,220056,chr12_100300770_100520826
Ttc8,12,98920574,98983238,protein_coding,1,62664,chr12_98920574_98983238
Ttc9,12,81631249,81667557,protein_coding,1,36308,chr12_81631249_81667557
Ttc9b,7,27653915,27657346,protein_coding,1,3431,chr7_27653915_27657346
Ttc9c,19,8809075,8819333,protein_coding,-1,10258,chr19_8809075_8819333
Ttf1,2,29060262,29087656,protein_coding,1,27394,chr2_29060262_29087656
Ttf2,3,100938860,100969663,protein_coding,-1,30803,chr3_100938860_100969663
Tti1,2,157981803,158028433,protein_coding,-1,46630,chr2_157981803_158028433
Tti2,8,31150315,31164702,protein_coding,1,14387,chr8_31150315_31164702
Ttk,9,83834689,83872389,protein_coding,1,37700,chr9_83834689_83872389
Ttl,2,129065942,129096283,protein_coding,1,30341,chr2_129065942_129096283
Ttll1,15,83483769,83510893,protein_coding,-1,27124,chr15_83483769_83510893
Ttll10,4,156034840,156059414,protein_coding,-1,24574,chr4_156034840_156059414
Ttll11,2,35751241,35979913,protein_coding,-1,228672,chr2_35751241_35979913
Ttll12,15,83575090,83595157,protein_coding,-1,20067,chr15_83575090_83595157
Ttll13,7,80246376,80260821,protein_coding,1,14445,chr7_80246376_80260821
Ttll3,6,113389260,113414587,protein_coding,1,25327,chr6_113389260_113414587
Ttll4,1,74661745,74703730,protein_coding,1,41985,chr1_74661745_74703730
Ttll5,12,85824659,86061893,protein_coding,1,237234,chr12_85824659_86061893
Ttll6,11,96133786,96165451,protein_coding,1,31665,chr11_96133786_96165451
Ttll7,3,146852367,146984009,protein_coding,1,131642,chr3_146852367_146984009
Ttll8,15,88890633,88954418,protein_coding,-1,63785,chr15_88890633_88954418
Ttll9,2,152962485,153008482,protein_coding,1,45997,chr2_152962485_153008482
Ttn,2,76703980,76982547,protein_coding,-1,278567,chr2_76703980_76982547
Ttpa,4,20007938,20030785,protein_coding,1,22847,chr4_20007938_20030785
Ttpal,2,163602314,163619013,protein_coding,1,16699,chr2_163602314_163619013
Ttr,18,20665280,20674321,protein_coding,1,9041,chr18_20665280_20674321
Ttyh1,7,4119408,4136708,protein_coding,1,17300,chr7_4119408_4136708
Ttyh2,11,114675431,114720977,protein_coding,1,45546,chr11_114675431_114720977
Ttyh3,5,140620578,140649031,protein_coding,-1,28453,chr5_140620578_140649031
Tub,7,108950338,109034460,protein_coding,1,84122,chr7_108950338_109034460
Tuba-rs1,17,30177475,30178919,transcribed_processed_pseudogene,1,1444,chr17_30177475_30178919
Tuba1a,15,98949837,98953703,protein_coding,-1,3866,chr15_98949837_98953703
Tuba1b,15,98931425,98934565,protein_coding,-1,3140,chr15_98931425_98934565
Tuba1c,15,99029891,99038110,protein_coding,1,8219,chr15_99029891_99038110
Tuba3a,6,125278274,125286042,protein_coding,-1,7768,chr6_125278274_125286042
Tuba3b,6,145615757,145621479,protein_coding,1,5722,chr6_145615757_145621479
Tuba4a,1,75214228,75219865,protein_coding,-1,5637,chr1_75214228_75219865
Tuba8,6,121210696,121226854,protein_coding,1,16158,chr6_121210696_121226854
Tubal3,13,3918274,3935277,protein_coding,1,17003,chr13_3918274_3935277
Tubb2a,13,34074274,34078007,protein_coding,-1,3733,chr13_34074274_34078007
Tubb2a-ps2,12,11881325,11882663,processed_pseudogene,-1,1338,chr12_11881325_11882663
Tubb2b,13,34126748,34130466,protein_coding,-1,3718,chr13_34126748_34130466
Tubb3,8,123411424,123422015,protein_coding,1,10591,chr8_123411424_123422015
Tubb4a,17,57080066,57087782,protein_coding,-1,7716,chr17_57080066_57087782
Tubb4b,2,25222160,25224702,protein_coding,-1,2542,chr2_25222160_25224702
Tubb4b-ps1,5,7179365,7180700,processed_pseudogene,1,1335,chr5_7179365_7180700
Tubb4b-ps2,1,24594087,24595423,processed_pseudogene,-1,1336,chr1_24594087_24595423
Tubb5,17,35833921,35838306,protein_coding,-1,4385,chr17_35833921_35838306
Tubb6,18,67390717,67402749,protein_coding,1,12032,chr18_67390717_67402749
Tubd1,11,86544991,86567360,protein_coding,1,22369,chr11_86544991_86567360
Tube1,10,39133976,39152542,protein_coding,1,18566,chr10_39133976_39152542
Tubg1,11,101119938,101126419,protein_coding,1,6481,chr11_101119938_101126419
Tubg2,11,101155907,101161787,protein_coding,1,5880,chr11_101155907_101161787
Tubgcp2,7,139995955,140036669,protein_coding,-1,40714,chr7_139995955_140036669
Tubgcp3,8,12614277,12672248,protein_coding,-1,57971,chr8_12614277_12672248
Tubgcp4,2,121170654,121198770,protein_coding,1,28116,chr2_121170654_121198770
Tubgcp5,7,55794154,55831677,protein_coding,1,37523,chr7_55794154_55831677
Tubgcp6,15,89098357,89123112,protein_coding,-1,24755,chr15_89098357_89123112
Tufm,7,126487361,126490731,protein_coding,1,3370,chr7_126487361_126490731
Tuft1,3,94612757,94658872,protein_coding,-1,46115,chr3_94612757_94658872
Tug1,11,3639785,3649673,protein_coding,-1,9888,chr11_3639785_3649673
Tulp2,7,45481877,45523632,protein_coding,1,41755,chr7_45481877_45523632
Tulp3,6,128321161,128355851,protein_coding,-1,34690,chr6_128321161_128355851
Tulp4,17,6106437,6251128,protein_coding,1,144691,chr17_6106437_6251128
Tunar,12,105333870,105383932,protein_coding,1,50062,chr12_105333870_105383932
Tusc1,4,93334138,93335511,protein_coding,-1,1373,chr4_93334138_93335511
Tusc2,9,107563255,107566112,protein_coding,1,2857,chr9_107563255_107566112
Tusc3,8,39005845,39165114,protein_coding,1,159269,chr8_39005845_39165114
Tut1,19,8953847,8966210,protein_coding,1,12363,chr19_8953847_8966210
Tvp23a,16,10420557,10447362,protein_coding,-1,26805,chr16_10420557_10447362
Tvp23b,11,62879455,62916780,protein_coding,1,37325,chr11_62879455_62916780
Tvp23bos,11,62919079,62921592,antisense,-1,2513,chr11_62919079_62921592
Twf1,15,94577951,94589889,protein_coding,-1,11938,chr15_94577951_94589889
Twf2,9,106203108,106215389,protein_coding,1,12281,chr9_106203108_106215389
Twist1,12,33957671,33959829,protein_coding,1,2158,chr12_33957671_33959829
Twist2,1,91801461,91848028,protein_coding,1,46567,chr1_91801461_91848028
Twistnb,12,33429635,33441392,protein_coding,1,11757,chr12_33429635_33441392
Twsg1,17,65921972,65951226,protein_coding,-1,29254,chr17_65921972_65951226
Txk,5,72695978,72752777,protein_coding,-1,56799,chr5_72695978_72752777
Txlna,4,129626078,129641065,protein_coding,-1,14987,chr4_129626078_129641065
Txlnb,10,17796226,17845665,protein_coding,1,49439,chr10_17796226_17845665
Txlng,X,162778919,162829454,protein_coding,-1,50535,chrX_162778919_162829454
Txn-ps1,1,44463923,44464231,processed_pseudogene,-1,308,chr1_44463923_44464231
Txn1,4,57943373,57956411,protein_coding,-1,13038,chr4_57943373_57956411
Txn2,15,77915047,77929006,protein_coding,-1,13959,chr15_77915047_77929006
Txndc11,16,11074911,11134650,protein_coding,-1,59739,chr16_11074911_11134650
Txndc12,4,108834601,108862127,protein_coding,1,27526,chr4_108834601_108862127
Txndc15,13,55714650,55726227,protein_coding,1,11577,chr13_55714650_55726227
Txndc16,14,45133465,45220328,protein_coding,-1,86863,chr14_45133465_45220328
Txndc17,11,72207547,72210015,protein_coding,1,2468,chr11_72207547_72210015
Txndc2,17,65637507,65642168,protein_coding,-1,4661,chr17_65637507_65642168
Txndc5,13,38500079,38528824,protein_coding,-1,28745,chr13_38500079_38528824
Txndc9,1,37985189,37997893,protein_coding,-1,12704,chr1_37985189_37997893
Txnip,3,96557957,96561883,protein_coding,1,3926,chr3_96557957_96561883
Txnl1,18,63661094,63708801,protein_coding,-1,47707,chr18_63661094_63708801
Txnl4a,18,80206795,80225855,protein_coding,1,19060,chr18_80206795_80225855
Txnl4b,8,109565892,109574051,protein_coding,1,8159,chr8_109565892_109574051
Txnrd1,10,82833951,82897712,protein_coding,1,63761,chr10_82833951_82897712
Txnrd2,16,18426384,18479959,protein_coding,1,53575,chr16_18426384_18479959
Txnrd3,6,89643988,89675529,protein_coding,1,31541,chr6_89643988_89675529
Tyk2,9,21104068,21131243,protein_coding,-1,27175,chr9_21104068_21131243
Tymp,15,89371931,89377039,protein_coding,-1,5108,chr15_89371931_89377039
Tyms,5,30058202,30073617,protein_coding,-1,15415,chr5_30058202_30073617
Tyms-ps,10,87966847,87967761,processed_pseudogene,1,914,chr10_87966847_87967761
Tyr,7,87424771,87493512,protein_coding,-1,68741,chr7_87424771_87493512
Tyro3,2,119797733,119818104,protein_coding,1,20371,chr2_119797733_119818104
Tyrobp,7,30413760,30417585,protein_coding,1,3825,chr7_30413760_30417585
Tyrp1,4,80834123,80851719,protein_coding,1,17596,chr4_80834123_80851719
Tysnd1,10,61695514,61702773,protein_coding,1,7259,chr10_61695514_61702773
Tyw1,5,130255619,130341563,protein_coding,1,85944,chr5_130255619_130341563
Tyw3,3,154576431,154597104,protein_coding,-1,20673,chr3_154576431_154597104
Tyw5,1,57388237,57407101,protein_coding,-1,18864,chr1_57388237_57407101
U2af1,17,31647081,31658892,protein_coding,-1,11811,chr17_31647081_31658892
U2af1l4,7,30563301,30565365,protein_coding,1,2064,chr7_30563301_30565365
U2af2,7,5062143,5079938,protein_coding,1,17795,chr7_5062143_5079938
U2surp,9,95456898,95511996,protein_coding,-1,55098,chr9_95456898_95511996
U90926,5,92209893,92215408,processed_transcript,-1,5515,chr5_92209893_92215408
Uaca,9,60794542,60880370,protein_coding,1,85828,chr9_60794542_60880370
Uap1,1,170141938,170174957,protein_coding,-1,33019,chr1_170141938_170174957
Uap1l1,2,25359889,25365682,protein_coding,-1,5793,chr2_25359889_25365682
Uba1,X,20658326,20683179,protein_coding,1,24853,chrX_20658326_20683179
Uba1y,Y,818649,844224,protein_coding,1,25575,chrY_818649_844224
Uba1y-ps1,Y,2637211,2647300,unprocessed_pseudogene,-1,10089,chrY_2637211_2647300
Uba1y-ps2,Y,2264257,2278687,unprocessed_pseudogene,1,14430,chrY_2264257_2278687
Uba2,7,34140688,34169599,protein_coding,-1,28911,chr7_34140688_34169599
Uba3,6,97183670,97205647,protein_coding,-1,21977,chr6_97183670_97205647
Uba5,9,104046599,104063134,protein_coding,-1,16535,chr9_104046599_104063134
Uba52,8,70508263,70510801,protein_coding,-1,2538,chr8_70508263_70510801
Uba6,5,86109287,86172803,protein_coding,-1,63516,chr5_86109287_86172803
Uba7,9,107975505,107984060,protein_coding,1,8555,chr9_107975505_107984060
Ubac1,2,25998543,26021747,protein_coding,-1,23204,chr2_25998543_26021747
Ubac2,14,121878620,122021034,protein_coding,1,142414,chr14_121878620_122021034
Ubald1,16,4874778,4880315,protein_coding,-1,5537,chr16_4874778_4880315
Ubald2,11,116434094,116439077,protein_coding,1,4983,chr11_116434094_116439077
Ubap1,4,41348996,41390525,protein_coding,1,41529,chr4_41348996_41390525
Ubap1l,9,65361041,65380377,protein_coding,1,19336,chr9_65361041_65380377
Ubap2,4,41194313,41275144,protein_coding,-1,80831,chr4_41194313_41275144
Ubap2l,3,90000140,90052628,protein_coding,-1,52488,chr3_90000140_90052628
Ubash3a,17,31207873,31246892,protein_coding,1,39019,chr17_31207873_31246892
Ubash3b,9,41011098,41161697,protein_coding,-1,150599,chr9_41011098_41161697
Ubb,11,62551171,62553213,protein_coding,1,2042,chr11_62551171_62553213
Ubc,5,125385965,125390202,protein_coding,-1,4237,chr5_125385965_125390202
Ube2a,X,36873900,36884222,protein_coding,1,10322,chrX_36873900_36884222
Ube2b,11,51985497,52000762,protein_coding,-1,15265,chr11_51985497_52000762
Ube2c,2,164769898,164778822,protein_coding,1,8924,chr2_164769898_164778822
Ube2cbp,9,86307306,86464950,protein_coding,-1,157644,chr9_86307306_86464950
Ube2d1,10,71254980,71285262,protein_coding,-1,30282,chr10_71254980_71285262
Ube2d2a,18,35771558,35809494,protein_coding,1,37936,chr18_35771558_35809494
Ube2d2b,5,107830099,107831776,protein_coding,1,1677,chr5_107830099_107831776
Ube2d3,3,135438149,135468198,protein_coding,1,30049,chr3_135438149_135468198
Ube2e1,14,18282722,18331859,protein_coding,-1,49137,chr14_18282722_18331859
Ube2e2,14,18573575,18894267,protein_coding,-1,320692,chr14_18573575_18894267
Ube2e3,2,78868124,78921293,protein_coding,1,53169,chr2_78868124_78921293
Ube2f,1,91250304,91290337,protein_coding,1,40033,chr1_91250304_91290337
Ube2g1,11,72607283,72686481,protein_coding,1,79198,chr11_72607283_72686481
Ube2g2,10,77622275,77645993,protein_coding,1,23718,chr10_77622275_77645993
Ube2h,6,30211289,30304539,protein_coding,-1,93250,chr6_30211289_30304539
Ube2i,17,25261916,25274622,protein_coding,-1,12706,chr17_25261916_25274622
Ube2j1,4,33031416,33052363,protein_coding,1,20947,chr4_33031416_33052363
Ube2j2,4,155943831,155959604,protein_coding,1,15773,chr4_155943831_155959604
Ube2k,5,65537233,65598988,protein_coding,1,61755,chr5_65537233_65598988
Ube2l3,16,17152013,17202649,protein_coding,-1,50636,chr16_17152013_17202649
Ube2l6,2,84798828,84810335,protein_coding,1,11507,chr2_84798828_84810335
Ube2m,7,13035120,13038275,protein_coding,-1,3155,chr7_13035120_13038275
Ube2n,10,95515145,95545657,protein_coding,1,30512,chr10_95515145_95545657
Ube2n-ps1,5,76232612,76233070,processed_pseudogene,-1,458,chr5_76232612_76233070
Ube2nl,7,61549246,61549701,processed_pseudogene,-1,455,chr7_61549246_61549701
Ube2o,11,116537740,116581447,protein_coding,-1,43707,chr11_116537740_116581447
Ube2q1,3,89773616,89784000,protein_coding,1,10384,chr3_89773616_89784000
Ube2q2,9,55148854,55207529,protein_coding,1,58675,chr9_55148854_55207529
Ube2ql1,13,69702832,69739889,protein_coding,-1,37057,chr13_69702832_69739889
Ube2r2,4,41135743,41193380,protein_coding,1,57637,chr4_41135743_41193380
Ube2s,7,4794546,4812590,protein_coding,-1,18044,chr7_4794546_4812590
Ube2t,1,134962565,134974162,protein_coding,1,11597,chr1_134962565_134974162
Ube2u,4,100478849,100550147,protein_coding,1,71298,chr4_100478849_100550147
Ube2v1,2,167607638,167632095,protein_coding,-1,24457,chr2_167607638_167632095
Ube2v2,16,15552077,15595773,protein_coding,-1,43696,chr16_15552077_15595773
Ube2w,1,16540790,16619489,protein_coding,-1,78699,chr1_16540790_16619489
Ube2z,11,96047432,96065388,protein_coding,-1,17956,chr11_96047432_96065388
Ube3a,7,59228750,59311536,protein_coding,1,82786,chr7_59228750_59311536
Ube3b,5,114380607,114421169,protein_coding,1,40562,chr5_114380607_114421169
Ube3c,5,29569242,29676092,protein_coding,1,106850,chr5_29569242_29676092
Ube4a,9,44923127,44965600,protein_coding,-1,42473,chr9_44923127_44965600
Ube4b,4,149328416,149426749,protein_coding,-1,98333,chr4_149328416_149426749
Ube4bos1,4,149347885,149365277,antisense,1,17392,chr4_149347885_149365277
Ubfd1,7,122067175,122082194,protein_coding,1,15019,chr7_122067175_122082194
Ubiad1,4,148434495,148444771,protein_coding,-1,10276,chr4_148434495_148444771
Ubl3,5,148504635,148552789,protein_coding,-1,48154,chr5_148504635_148552789
Ubl5,9,20642878,20647140,protein_coding,1,4262,chr9_20642878_20647140
Ubl7,9,57910979,57929968,protein_coding,1,18989,chr9_57910979_57929968
Ublcp1,11,44454571,44470498,protein_coding,-1,15927,chr11_44454571_44470498
Ubn1,16,5050057,5086289,protein_coding,1,36232,chr16_5050057_5086289
Ubn2,6,38433950,38524825,protein_coding,1,90875,chr6_38433950_38524825
Ubox5,2,130590002,130630038,protein_coding,-1,40036,chr2_130590002_130630038
Ubp1,9,113930934,113977202,protein_coding,1,46268,chr9_113930934_113977202
Ubqln1,13,58176156,58215653,protein_coding,-1,39497,chr13_58176156_58215653
Ubqln2,X,153498227,153501570,protein_coding,1,3343,chrX_153498227_153501570
Ubqln4,3,88553758,88569725,protein_coding,1,15967,chr3_88553758_88569725
Ubr1,2,120860269,120970715,protein_coding,-1,110446,chr2_120860269_120970715
Ubr2,17,46928295,47010556,protein_coding,-1,82261,chr17_46928295_47010556
Ubr3,2,69897246,70024013,protein_coding,1,126767,chr2_69897246_70024013
Ubr4,4,139352609,139489588,protein_coding,1,136979,chr4_139352609_139489588
Ubr5,15,37967328,38078854,protein_coding,-1,111526,chr15_37967328_38078854
Ubr7,12,102757967,102777707,protein_coding,1,19740,chr12_102757967_102777707
Ubtd1,19,41981763,42034643,protein_coding,1,52880,chr19_41981763_42034643
Ubtd2,11,32455370,32516687,protein_coding,1,61317,chr11_32455370_32516687
Ubtf,11,102304560,102319742,protein_coding,-1,15182,chr11_102304560_102319742
Ubxn1,19,8871496,8875863,protein_coding,1,4367,chr19_8871496_8875863
Ubxn10,4,138709837,138737167,protein_coding,-1,27330,chr4_138709837_138737167
Ubxn11,4,134102570,134127593,protein_coding,1,25023,chr4_134102570_134127593
Ubxn2a,12,4879032,4907705,protein_coding,-1,28673,chr12_4879032_4907705
Ubxn2b,4,6191098,6221688,protein_coding,1,30590,chr4_6191098_6221688
Ubxn4,1,128243964,128279378,protein_coding,1,35414,chr1_128243964_128279378
Ubxn6,17,56067045,56075028,protein_coding,-1,7983,chr17_56067045_56075028
Ubxn7,16,32332257,32393747,protein_coding,1,61490,chr16_32332257_32393747
Ubxn8,8,33619586,33641967,protein_coding,-1,22381,chr8_33619586_33641967
Uchl1,5,66676091,66687234,protein_coding,1,11143,chr5_66676091_66687234
Uchl1os,5,66626495,66676498,antisense,-1,50003,chr5_66626495_66676498
Uchl3,14,101653967,101696125,protein_coding,1,42158,chr14_101653967_101696125
Uchl4,9,64235201,64236362,protein_coding,1,1161,chr9_64235201_64236362
Uchl5,1,143777272,143807466,protein_coding,1,30194,chr1_143777272_143807466
Uck1,2,32255002,32260159,protein_coding,-1,5157,chr2_32255002_32260159
Uck2,1,167222883,167285320,protein_coding,-1,62437,chr1_167222883_167285320
Uckl1,2,181569149,181584892,protein_coding,-1,15743,chr2_181569149_181584892
Uckl1os,2,181578480,181585170,antisense,1,6690,chr2_181578480_181585170
Ucma,2,4976122,4985748,protein_coding,1,9626,chr2_4976122_4985748
Ucn,5,31138063,31138829,protein_coding,-1,766,chr5_31138063_31138829
Ucn2,9,108986010,108987164,protein_coding,1,1154,chr9_108986010_108987164
Ucp1,8,83290352,83298452,protein_coding,1,8100,chr8_83290352_83298452
Ucp2,7,100493337,100502020,protein_coding,1,8683,chr7_100493337_100502020
Ucp3,7,100472990,100486432,protein_coding,1,13442,chr7_100472990_100486432
Uevld,7,46923216,46958527,protein_coding,-1,35311,chr7_46923216_46958527
Ufc1,1,171288563,171295024,protein_coding,-1,6461,chr1_171288563_171295024
Ufl1,4,25248600,25281821,protein_coding,-1,33221,chr4_25248600_25281821
Ufm1,3,53853376,53863830,protein_coding,-1,10454,chr3_53853376_53863830
Ufsp1,5,137294629,137295665,protein_coding,1,1036,chr5_137294629_137295665
Ufsp2,8,45975528,45996958,protein_coding,1,21430,chr8_45975528_45996958
Ugcg,4,59189257,59222833,protein_coding,1,33576,chr4_59189257_59222833
Ugdh,5,65413221,65435949,protein_coding,-1,22728,chr5_65413221_65435949
Uggt1,1,36140027,36244720,protein_coding,-1,104693,chr1_36140027_36244720
Uggt2,14,118985039,119099430,protein_coding,-1,114391,chr14_118985039_119099430
Ugp2,11,21321138,21371201,protein_coding,-1,50063,chr11_21321138_21371201
Ugt1a1,1,88211959,88218997,protein_coding,1,7038,chr1_88211959_88218997
Ugt1a6a,1,88134809,88218997,protein_coding,1,84188,chr1_88134809_88218997
Ugt1a7c,1,88095062,88220002,protein_coding,1,124940,chr1_88095062_88220002
Ugt2b5,5,87124960,87140318,protein_coding,-1,15358,chr5_87124960_87140318
Ugt8a,3,125865271,125938619,protein_coding,-1,73348,chr3_125865271_125938619
Uhmk1,1,170193420,170215397,protein_coding,-1,21977,chr1_170193420_170215397
Uhrf1,17,56303321,56323486,protein_coding,1,20165,chr17_56303321_56323486
Uhrf1bp1,17,27856441,27900041,protein_coding,1,43600,chr17_27856441_27900041
Uhrf1bp1l,10,89744991,89819871,protein_coding,1,74880,chr10_89744991_89819871
Uhrf2,19,30030513,30093722,protein_coding,1,63209,chr19_30030513_30093722
Uimc1,13,55027880,55100300,protein_coding,-1,72420,chr13_55027880_55100300
Ulbp1,10,7440362,7473638,protein_coding,-1,33276,chr10_7440362_7473638
Ulk1,5,110784488,110810097,protein_coding,-1,25609,chr5_110784488_110810097
Ulk2,11,61775649,61855073,protein_coding,-1,79424,chr11_61775649_61855073
Ulk3,9,57589452,57596233,protein_coding,1,6781,chr9_57589452_57596233
Ulk4,9,120955351,121277197,protein_coding,-1,321846,chr9_120955351_121277197
Umad1,6,8259288,8459470,protein_coding,1,200182,chr6_8259288_8459470
Umpk-ps,8,75383802,75384628,processed_pseudogene,1,826,chr8_75383802_75384628
Umps,16,33954782,33967038,protein_coding,-1,12256,chr16_33954782_33967038
Unc119,11,78343482,78349164,protein_coding,1,5682,chr11_78343482_78349164
Unc119b,5,115122550,115134975,protein_coding,-1,12425,chr5_115122550_115134975
Unc13a,8,71624417,71671757,protein_coding,-1,47340,chr8_71624417_71671757
Unc13b,4,43058953,43264871,protein_coding,1,205918,chr4_43058953_43264871
Unc13c,9,73479422,73968966,protein_coding,-1,489544,chr9_73479422_73968966
Unc13d,11,116062095,116077961,protein_coding,-1,15866,chr11_116062095_116077961
Unc45a,7,80325292,80347993,protein_coding,-1,22701,chr7_80325292_80347993
Unc45b,11,82910550,82943403,protein_coding,1,32853,chr11_82910550_82943403
Unc50,1,37430139,37439124,protein_coding,1,8985,chr1_37430139_37439124
Unc5a,13,54949411,55006018,protein_coding,1,56607,chr13_54949411_55006018
Unc5b,10,60762593,60831581,protein_coding,-1,68988,chr10_60762593_60831581
Unc5c,3,141465216,141834924,protein_coding,1,369708,chr3_141465216_141834924
Unc5cl,17,48451004,48539714,protein_coding,1,88710,chr17_48451004_48539714
Unc5d,8,28646717,29219636,protein_coding,-1,572919,chr8_28646717_29219636
Unc79,12,102948859,103184065,protein_coding,1,235206,chr12_102948859_103184065
Unc80,1,66468367,66699148,protein_coding,1,230781,chr1_66468367_66699148
Unc93a,17,13108617,13131810,protein_coding,-1,23193,chr17_13108617_13131810
Unc93b1,19,3935186,3949340,protein_coding,1,14154,chr19_3935186_3949340
Ung,5,114130386,114139323,protein_coding,1,8937,chr5_114130386_114139323
Unk,11,116030322,116061214,protein_coding,1,30892,chr11_116030322_116061214
Unkl,17,25188397,25234443,protein_coding,1,46046,chr17_25188397_25234443
Uox,3,146570426,146632305,protein_coding,1,61879,chr3_146570426_146632305
Upb1,10,75401115,75441679,protein_coding,1,40564,chr10_75401115_75441679
Upf1,8,70331525,70353278,protein_coding,-1,21753,chr8_70331525_70353278
Upf2,2,5951469,6056703,protein_coding,1,105234,chr2_5951469_6056703
Upf3a,8,13785615,13799193,protein_coding,1,13578,chr8_13785615_13799193
Upf3b,X,37091678,37110322,protein_coding,-1,18644,chrX_37091678_37110322
Upk1a,7,30603092,30612847,protein_coding,-1,9755,chr7_30603092_30612847
Upk1b,16,38773184,38800328,protein_coding,-1,27144,chr16_38773184_38800328
Upp1,11,9118103,9136170,protein_coding,1,18067,chr11_9118103_9136170
Upp2,2,58567298,58792971,protein_coding,1,225673,chr2_58567298_58792971
Uprt,X,104482818,104507490,protein_coding,1,24672,chrX_104482818_104507490
Uqcc1,2,155846894,155930310,protein_coding,-1,83416,chr2_155846894_155930310
Uqcc2,17,27122663,27133916,protein_coding,-1,11253,chr17_27122663_27133916
Uqcc3,19,8880014,8880923,protein_coding,-1,909,chr19_8880014_8880923
Uqcr10,11,4701973,4704342,protein_coding,-1,2369,chr11_4701973_4704342
Uqcr11,10,80402997,80406830,protein_coding,-1,3833,chr10_80402997_80406830
Uqcrb,13,66900617,66905378,protein_coding,-1,4761,chr13_66900617_66905378
Uqcrc1,9,108888502,108949623,protein_coding,1,61121,chr9_108888502_108949623
Uqcrc2,7,120635176,120659524,protein_coding,1,24348,chr7_120635176_120659524
Uqcrfs1,13,30540308,30545362,protein_coding,-1,5054,chr13_30540308_30545362
Uqcrh,4,116066965,116075071,protein_coding,-1,8106,chr4_116066965_116075071
Uqcrq,11,53427922,53430831,protein_coding,-1,2909,chr11_53427922_53430831
Urah,7,140835018,140837966,protein_coding,1,2948,chr7_140835018_140837966
Urb1,16,90751527,90810413,protein_coding,-1,58886,chr16_90751527_90810413
Urb2,8,124021508,124048505,protein_coding,1,26997,chr8_124021508_124048505
Urgcp,11,5713417,5762376,protein_coding,-1,48959,chr11_5713417_5762376
Uri1,7,37959992,38023551,protein_coding,-1,63559,chr7_37959992_38023551
Urm1,2,29820075,29845002,protein_coding,1,24927,chr2_29820075_29845002
Urod,4,116989965,116994413,protein_coding,-1,4448,chr4_116989965_116994413
Uros,7,133686243,133710072,protein_coding,-1,23829,chr7_133686243_133710072
Usb1,8,95332284,95347507,protein_coding,1,15223,chr8_95332284_95347507
Use1,8,71366848,71369732,protein_coding,1,2884,chr8_71366848_71369732
Usf1,1,171411313,171419142,protein_coding,1,7829,chr1_171411313_171419142
Usf2,7,30945248,30956803,protein_coding,-1,11555,chr7_30945248_30956803
Usf2-ps1,7,30926668,30927147,unprocessed_pseudogene,-1,479,chr7_30926668_30927147
Ush1c,7,46195350,46238503,protein_coding,-1,43153,chr7_46195350_46238503
Ush1g,11,115315192,115322041,protein_coding,-1,6849,chr11_115315192_115322041
Ush2a,1,188262023,188965041,protein_coding,1,703018,chr1_188262023_188965041
Ushbp1,8,71384272,71395802,protein_coding,-1,11530,chr8_71384272_71395802
Uso1,5,92137938,92202798,protein_coding,1,64860,chr5_92137938_92202798
Usp1,4,98923810,98935543,protein_coding,1,11733,chr4_98923810_98935543
Usp10,8,119910360,119957560,protein_coding,1,47200,chr8_119910360_119957560
Usp11,X,20703906,20720539,protein_coding,1,16633,chrX_20703906_20720539
Usp12,5,146734809,146795006,protein_coding,-1,60197,chr5_146734809_146795006
Usp13,3,32817546,32938071,protein_coding,1,120525,chr3_32817546_32938071
Usp14,18,9993066,10045119,protein_coding,-1,52053,chr18_9993066_10045119
Usp15,10,123105006,123196995,protein_coding,-1,91989,chr10_123105006_123196995
Usp16,16,87454703,87483517,protein_coding,1,28814,chr16_87454703_87483517
Usp17la,7,104857009,104862667,protein_coding,1,5658,chr7_104857009_104862667
Usp18,6,121245906,121270917,protein_coding,1,25011,chr6_121245906_121270917
Usp19,9,108490602,108502337,protein_coding,1,11735,chr9_108490602_108502337
Usp2,9,44067021,44095627,protein_coding,1,28606,chr9_44067021_44095627
Usp20,2,30982279,31023586,protein_coding,1,41307,chr2_30982279_31023586
Usp21,1,171281945,171287991,protein_coding,-1,6046,chr1_171281945_171287991
Usp22,11,61151785,61175055,protein_coding,-1,23270,chr11_61151785_61175055
Usp24,4,106316213,106441322,protein_coding,1,125109,chr4_106316213_106441322
Usp25,16,77013706,77116780,protein_coding,1,103074,chr16_77013706_77116780
Usp26,X,51753959,51801233,protein_coding,-1,47274,chrX_51753959_51801233
Usp27x,X,7371274,7375830,protein_coding,-1,4556,chrX_7371274_7375830
Usp28,9,48985375,49042517,protein_coding,1,57142,chr9_48985375_49042517
Usp29,7,6730578,6967219,protein_coding,1,236641,chr7_6730578_6967219
Usp3,9,66514637,66593142,protein_coding,-1,78505,chr9_66514637_66593142
Usp30,5,114065461,114124720,protein_coding,1,59259,chr5_114065461_114124720
Usp31,7,121642021,121707253,protein_coding,-1,65232,chr7_121642021_121707253
Usp32,11,84984442,85140161,protein_coding,-1,155719,chr11_84984442_85140161
Usp33,3,152346478,152393617,protein_coding,1,47139,chr3_152346478_152393617
Usp34,11,23306895,23490560,protein_coding,1,183665,chr11_23306895_23490560
Usp35,7,97309380,97332020,protein_coding,-1,22640,chr7_97309380_97332020
Usp36,11,118259651,118290244,protein_coding,-1,30593,chr11_118259651_118290244
Usp37,1,74435511,74544284,protein_coding,-1,108773,chr1_74435511_74544284
Usp38,8,80980733,81014928,protein_coding,-1,34195,chr8_80980733_81014928
Usp39,6,72318677,72345184,protein_coding,-1,26507,chr6_72318677_72345184
Usp4,9,108347853,108392545,protein_coding,1,44692,chr9_108347853_108392545
Usp40,1,87945119,88008551,protein_coding,-1,63432,chr1_87945119_88008551
Usp42,5,143710325,143732280,protein_coding,-1,21955,chr5_143710325_143732280
Usp43,11,67854523,67922153,protein_coding,-1,67630,chr11_67854523_67922153
Usp44,10,93831555,93858088,protein_coding,1,26533,chr10_93831555_93858088
Usp45,4,21767156,21837872,protein_coding,1,70716,chr4_21767156_21837872
Usp46,5,73998453,74068431,protein_coding,-1,69978,chr5_73998453_74068431
Usp47,7,112023504,112111661,protein_coding,1,88157,chr7_112023504_112111661
Usp48,4,137593755,137658537,protein_coding,1,64782,chr4_137593755_137658537
Usp49,17,47630690,47686738,protein_coding,1,56048,chr17_47630690_47686738
Usp5,6,124815019,124829484,protein_coding,-1,14465,chr6_124815019_124829484
Usp50,2,126709096,126783470,protein_coding,-1,74374,chr2_126709096_126783470
Usp51,X,153006469,153009416,protein_coding,1,2947,chrX_153006469_153009416
Usp53,3,122931493,122984510,protein_coding,-1,53017,chr3_122931493_122984510
Usp54,14,20548912,20641063,protein_coding,-1,92151,chr14_20548912_20641063
Usp6nl,2,6322667,6446390,protein_coding,1,123723,chr2_6322667_6446390
Usp7,16,8689595,8792308,protein_coding,-1,102713,chr16_8689595_8792308
Usp8,2,126707328,126759297,protein_coding,1,51969,chr2_126707328_126759297
Usp9x,X,13071498,13173328,protein_coding,1,101830,chrX_13071498_13173328
Usp9y,Y,1298961,1459782,protein_coding,-1,160821,chrY_1298961_1459782
Uspl1,5,149184350,149215434,protein_coding,1,31084,chr5_149184350_149215434
Ust,10,8204756,8518825,protein_coding,-1,314069,chr10_8204756_8518825
Utf1,7,139943789,139945112,protein_coding,1,1323,chr7_139943789_139945112
Utp14a,X,48256862,48282453,protein_coding,1,25591,chrX_48256862_48282453
Utp14b,1,78658038,78671512,protein_coding,1,13474,chr1_78658038_78671512
Utp14b-ps1,3,113019875,113022139,processed_pseudogene,1,2264,chr3_113019875_113022139
Utp15,13,98246845,98263041,protein_coding,-1,16196,chr13_98246845_98263041
Utp18,11,93859243,93885766,protein_coding,-1,26523,chr11_93859243_93885766
Utp20,10,88746607,88826804,protein_coding,-1,80197,chr10_88746607_88826804
Utp23,15,51877429,51884614,protein_coding,1,7185,chr15_51877429_51884614
Utp3,5,88554462,88556090,protein_coding,1,1628,chr5_88554462_88556090
Utp6,11,79932321,79962390,protein_coding,-1,30069,chr11_79932321_79962390
Utrn,10,12382188,12869365,protein_coding,-1,487177,chr10_12382188_12869365
Uts2,4,150997097,151001810,protein_coding,1,4713,chr4_150997097_151001810
Uts2b,16,27353322,27370239,protein_coding,-1,16917,chr16_27353322_27370239
Uts2r,11,121160271,121161973,protein_coding,1,1702,chr11_121160271_121161973
Uty,Y,1096861,1245759,protein_coding,-1,148898,chrY_1096861_1245759
Uvrag,7,98885021,99141141,protein_coding,-1,256120,chr7_98885021_99141141
Uvssa,5,33378549,33419754,protein_coding,1,41205,chr5_33378549_33419754
Uxs1,1,43746966,43827800,protein_coding,-1,80834,chr1_43746966_43827800
Uxt,X,20941722,20962017,protein_coding,-1,20295,chrX_20941722_20962017
Vac14,8,110618585,110720398,protein_coding,1,101813,chr8_110618585_110720398
Vamp1,6,125215551,125245964,protein_coding,1,30413,chr6_125215551_125245964
Vamp2,11,69088490,69092384,protein_coding,1,3894,chr11_69088490_69092384
Vamp3,4,151047300,151057963,protein_coding,-1,10663,chr4_151047300_151057963
Vamp4,1,162570515,162599084,protein_coding,1,28569,chr1_162570515_162599084
Vamp5,6,72368793,72380468,protein_coding,-1,11675,chr6_72368793_72380468
Vamp7-ps,2,174046619,174047273,processed_pseudogene,-1,654,chr2_174046619_174047273
Vamp8,6,72385222,72390703,protein_coding,-1,5481,chr6_72385222_72390703
Vangl1,3,102153583,102204693,protein_coding,-1,51110,chr3_102153583_102204693
Vangl2,1,172000960,172028444,protein_coding,-1,27484,chr1_172000960_172028444
Vapa,17,65578327,65613555,protein_coding,-1,35228,chr17_65578327_65613555
Vapb,2,173737511,173784339,protein_coding,1,46828,chr2_173737511_173784339
Vars,17,35000987,35016322,protein_coding,1,15335,chr17_35000987_35016322
Vars2,17,35655634,35667592,protein_coding,-1,11958,chr17_35655634_35667592
Vash1,12,86678700,86692091,protein_coding,1,13391,chr12_86678700_86692091
Vash2,1,190947646,190979296,protein_coding,-1,31650,chr1_190947646_190979296
Vasn,16,4639941,4650802,protein_coding,1,10861,chr16_4639941_4650802
Vasp,7,19256929,19271817,protein_coding,-1,14888,chr7_19256929_19271817
Vat1,11,101458745,101466230,protein_coding,-1,7485,chr11_101458745_101466230
Vat1l,8,114205612,114374071,protein_coding,1,168459,chr8_114205612_114374071
Vaultrc5,18,36801866,36802008,misc_RNA,1,142,chr18_36801866_36802008
Vav1,17,57279100,57328031,protein_coding,1,48931,chr17_57279100_57328031
Vav2,2,27262104,27427033,protein_coding,-1,164929,chr2_27262104_27427033
Vav3,3,109340653,109685698,protein_coding,1,345045,chr3_109340653_109685698
Vax1,19,59166187,59170056,protein_coding,-1,3869,chr19_59166187_59170056
Vax2,6,83711264,83738313,protein_coding,1,27049,chr6_83711264_83738313
Vax2os,6,83692806,83712201,antisense,-1,19395,chr6_83692806_83712201
Vbp1,X,75514299,75534942,protein_coding,1,20643,chrX_75514299_75534942
Vcam1,3,116109949,116129688,protein_coding,-1,19739,chr3_116109949_116129688
Vcan,13,89655312,89742509,protein_coding,-1,87197,chr13_89655312_89742509
Vcl,14,20929398,21033676,protein_coding,1,104278,chr14_20929398_21033676
Vcp,4,42979963,43000507,protein_coding,-1,20544,chr4_42979963_43000507
Vcp-rs,X,104345829,104348234,processed_pseudogene,-1,2405,chrX_104345829_104348234
Vcpip1,1,9718622,9748382,protein_coding,-1,29760,chr1_9718622_9748382
Vcpkmt,12,69577628,69583110,protein_coding,-1,5482,chr12_69577628_69583110
Vdac1,11,52360860,52389397,protein_coding,1,28537,chr11_52360860_52389397
Vdac2,14,21825238,21845879,protein_coding,1,20641,chr14_21825238_21845879
Vdac3,8,22577075,22593813,protein_coding,-1,16738,chr8_22577075_22593813
Vdac3-ps1,13,18030741,18031593,unprocessed_pseudogene,-1,852,chr13_18030741_18031593
Vdr,15,97854425,97910630,protein_coding,-1,56205,chr15_97854425_97910630
Vegfa,17,46016993,46032369,protein_coding,-1,15376,chr17_46016993_46032369
Vegfb,19,6982473,6987651,protein_coding,-1,5178,chr19_6982473_6987651
Vegfc,8,54077606,54187096,protein_coding,1,109490,chr8_54077606_54187096
Veph1,3,66053558,66296837,protein_coding,-1,243279,chr3_66053558_66296837
Vezf1,11,88068279,88084729,protein_coding,1,16450,chr11_88068279_88084729
Vezt,10,93939165,94035817,protein_coding,-1,96652,chr10_93939165_94035817
Vgf,5,137026392,137033351,protein_coding,1,6959,chr5_137026392_137033351
Vgll2,10,52022502,52028471,protein_coding,1,5969,chr10_52022502_52028471
Vgll3,16,65815257,65866368,protein_coding,1,51111,chr16_65815257_65866368
Vgll4,6,114860628,114969994,protein_coding,-1,109366,chr6_114860628_114969994
Vhl,6,113623959,113631633,protein_coding,1,7674,chr6_113623959_113631633
Vil1,1,74409376,74435559,protein_coding,1,26183,chr1_74409376_74435559
Vill,9,119052778,119071525,protein_coding,1,18747,chr9_119052778_119071525
Vim,2,13573927,13582826,protein_coding,1,8899,chr2_13573927_13582826
Vip,10,5639218,5647617,protein_coding,1,8399,chr10_5639218_5647617
Vipas39,12,87238868,87266256,protein_coding,-1,27388,chr12_87238868_87266256
Vipr1,9,121642716,121672954,protein_coding,1,30238,chr9_121642716_121672954
Vipr2,12,116077726,116146261,protein_coding,1,68535,chr12_116077726_116146261
Vis1,2,45280724,45280924,misc_RNA,1,200,chr2_45280724_45280924
Vit,17,78508064,78627408,protein_coding,1,119344,chr17_78508064_78627408
Vkorc1,7,127893063,127895617,protein_coding,-1,2554,chr7_127893063_127895617
Vkorc1l1,5,129941970,129986692,protein_coding,1,44722,chr5_129941970_129986692
Vldlr,19,27216484,27254231,protein_coding,1,37747,chr19_27216484_27254231
Vma21,X,71815924,71839757,protein_coding,1,23833,chrX_71815924_71839757
Vma21-ps,4,52496939,52497244,processed_pseudogene,-1,305,chr4_52496939_52497244
Vmac,17,56713936,56718022,protein_coding,-1,4086,chr17_56713936_56718022
Vmn1r-ps106,13,22480631,22483043,unprocessed_pseudogene,1,2412,chr13_22480631_22483043
Vmn1r-ps135,13,23268880,23269474,unprocessed_pseudogene,1,594,chr13_23268880_23269474
Vmn1r-ps136,14,61543727,61544108,unprocessed_pseudogene,1,381,chr14_61543727_61544108
Vmn1r-ps14,6,58046448,58049899,transcribed_unprocessed_pseudogene,-1,3451,chr6_58046448_58049899
Vmn1r-ps144,17,20926165,20938090,transcribed_unprocessed_pseudogene,1,11925,chr17_20926165_20938090
Vmn1r-ps145,17,20969061,20969484,unprocessed_pseudogene,-1,423,chr17_20969061_20969484
Vmn1r-ps15,6,58073596,58079129,transcribed_unprocessed_pseudogene,-1,5533,chr6_58073596_58079129
Vmn1r-ps18,6,58205685,58206925,unprocessed_pseudogene,1,1240,chr6_58205685_58206925
Vmn1r-ps24,6,66752276,66760039,transcribed_unprocessed_pseudogene,-1,7763,chr6_66752276_66760039
Vmn1r-ps29,6,89997612,90004589,unprocessed_pseudogene,1,6977,chr6_89997612_90004589
Vmn1r-ps32,6,90146431,90155644,transcribed_unprocessed_pseudogene,1,9213,chr6_90146431_90155644
Vmn1r-ps60,7,12005066,12006310,unprocessed_pseudogene,1,1244,chr7_12005066_12006310
Vmn1r168,7,23539732,23547448,protein_coding,1,7716,chr7_23539732_23547448
Vmn1r206,13,22617456,22624251,protein_coding,-1,6795,chr13_22617456_22624251
Vmn1r208,13,22771474,22777400,protein_coding,-1,5926,chr13_22771474_22777400
Vmn1r21,6,57842830,57850343,protein_coding,-1,7513,chr6_57842830_57850343
Vmn1r214,13,23030418,23037957,protein_coding,1,7539,chr13_23030418_23037957
Vmn1r229,17,20811555,20823627,protein_coding,1,12072,chr17_20811555_20823627
Vmn1r32,6,66552180,66560096,protein_coding,-1,7916,chr6_66552180_66560096
Vmn1r4,6,56924015,56958100,protein_coding,1,34085,chr6_56924015_56958100
Vmn1r51,6,90122596,90132264,protein_coding,1,9668,chr6_90122596_90132264
Vmn1r58,7,5401681,5413396,protein_coding,-1,11715,chr7_5401681_5413396
Vmn1r65,7,6007750,6011010,protein_coding,-1,3260,chr7_6007750_6011010
Vmn2r-ps100,13,65944036,65948582,unprocessed_pseudogene,1,4546,chr13_65944036_65948582
Vmn2r-ps103,13,66249281,66255539,unprocessed_pseudogene,-1,6258,chr13_66249281_66255539
Vmn2r-ps106,13,66682839,66688352,unprocessed_pseudogene,-1,5513,chr13_66682839_66688352
Vmn2r-ps108,13,66809021,66815219,unprocessed_pseudogene,-1,6198,chr13_66809021_66815219
Vmn2r-ps11,3,64632574,64662261,transcribed_unprocessed_pseudogene,-1,29687,chr3_64632574_64662261
Vmn2r-ps110,14,51377284,51380974,transcribed_unprocessed_pseudogene,1,3690,chr14_51377284_51380974
Vmn2r-ps111,14,51377348,51432043,processed_transcript;transcribed_unprocessed_pseudogene,1,54695,chr14_51377348_51432043
Vmn2r-ps117,17,18810835,18841654,unprocessed_pseudogene,1,30819,chr17_18810835_18841654
Vmn2r-ps123,17,19838565,19874206,unprocessed_pseudogene,1,35641,chr17_19838565_19874206
Vmn2r-ps127,17,20329640,20336408,unprocessed_pseudogene,-1,6768,chr17_20329640_20336408
Vmn2r-ps128,17,22916878,22932941,unprocessed_pseudogene,-1,16063,chr17_22916878_22932941
Vmn2r-ps129,17,22992706,23008970,unprocessed_pseudogene,1,16264,chr17_22992706_23008970
Vmn2r-ps133,17,23241650,23277178,unprocessed_pseudogene,-1,35528,chr17_23241650_23277178
Vmn2r-ps134,17,23441011,23446167,unprocessed_pseudogene,-1,5156,chr17_23441011_23446167
Vmn2r-ps15,4,145775612,145775988,unprocessed_pseudogene,1,376,chr4_145775612_145775988
Vmn2r-ps159,4,156331103,156339499,protein_coding,1,8396,chr4_156331103_156339499
Vmn2r-ps16,4,146605105,146605481,unprocessed_pseudogene,1,376,chr4_146605105_146605481
Vmn2r-ps17,4,146264521,146264895,unprocessed_pseudogene,1,374,chr4_146264521_146264895
Vmn2r-ps19,4,147444380,147444648,unprocessed_pseudogene,1,268,chr4_147444380_147444648
Vmn2r-ps20,4,147521531,147521912,unprocessed_pseudogene,1,381,chr4_147521531_147521912
Vmn2r-ps21,5,108872655,108892380,unprocessed_pseudogene,-1,19725,chr5_108872655_108892380
Vmn2r-ps23,5,109578019,109578589,processed_pseudogene,-1,570,chr5_109578019_109578589
Vmn2r-ps24,5,138532077,138532934,processed_pseudogene,1,857,chr5_138532077_138532934
Vmn2r-ps25,5,151435966,151461865,unprocessed_pseudogene,-1,25899,chr5_151435966_151461865
Vmn2r-ps26,5,151513135,151549267,unprocessed_pseudogene,-1,36132,chr5_151513135_151549267
Vmn2r-ps3,3,64053031,64055610,unprocessed_pseudogene,-1,2579,chr3_64053031_64055610
Vmn2r-ps33,6,124081698,124082601,unprocessed_pseudogene,-1,903,chr6_124081698_124082601
Vmn2r-ps37,7,7642172,7645360,unprocessed_pseudogene,-1,3188,chr7_7642172_7645360
Vmn2r-ps41,7,9176976,9180099,unprocessed_pseudogene,-1,3123,chr7_9176976_9180099
Vmn2r-ps44,7,8801136,8825685,unprocessed_pseudogene,-1,24549,chr7_8801136_8825685
Vmn2r-ps45,7,8304225,8325804,unprocessed_pseudogene,-1,21579,chr7_8304225_8325804
Vmn2r-ps54,7,41667979,41727193,transcribed_unprocessed_pseudogene,1,59214,chr7_41667979_41727193
Vmn2r-ps56,7,41744706,41772910,unprocessed_pseudogene,-1,28204,chr7_41744706_41772910
Vmn2r-ps57,7,41937527,41980928,unprocessed_pseudogene,-1,43401,chr7_41937527_41980928
Vmn2r-ps66,7,85053075,85070937,unprocessed_pseudogene,1,17862,chr7_85053075_85070937
Vmn2r-ps69,7,85303953,85342891,unprocessed_pseudogene,1,38938,chr7_85303953_85342891
Vmn2r-ps80,7,85998692,85999624,unprocessed_pseudogene,-1,932,chr7_85998692_85999624
Vmn2r-ps82,7,86053289,86063461,unprocessed_pseudogene,-1,10172,chr7_86053289_86063461
Vmn2r-ps88,8,3139098,3139968,unprocessed_pseudogene,1,870,chr8_3139098_3139968
Vmn2r-ps89,8,4529618,4538187,unprocessed_pseudogene,-1,8569,chr8_4529618_4538187
Vmn2r-ps94,13,33766920,33811602,unprocessed_pseudogene,1,44682,chr13_33766920_33811602
Vmn2r-ps95,13,65353256,65364427,unprocessed_pseudogene,-1,11171,chr13_65353256_65364427
Vmn2r-ps96,13,65421635,65435539,unprocessed_pseudogene,-1,13904,chr13_65421635_65435539
Vmn2r-ps97,13,65564206,65578024,unprocessed_pseudogene,-1,13818,chr13_65564206_65578024
Vmn2r-ps98,13,65727793,65734016,unprocessed_pseudogene,-1,6223,chr13_65727793_65734016
Vmn2r1,3,64081547,64109484,protein_coding,1,27937,chr3_64081547_64109484
Vmn2r111,17,22544504,22573482,protein_coding,-1,28978,chr17_22544504_22573482
Vmn2r112,17,22600951,22620842,protein_coding,1,19891,chr17_22600951_22620842
Vmn2r114,17,23285392,23312537,protein_coding,-1,27145,chr17_23285392_23312537
Vmn2r116,17,23384604,23404422,protein_coding,1,19818,chr17_23384604_23404422
Vmn2r118,17,55590342,55625192,protein_coding,-1,34850,chr17_55590342_55625192
Vmn2r121,X,124124961,124135952,protein_coding,-1,10991,chrX_124124961_124135952
Vmn2r17,5,109419688,109458459,protein_coding,1,38771,chr5_109419688_109458459
Vmn2r18,5,151561190,151606021,protein_coding,-1,44831,chr5_151561190_151606021
Vmn2r2,3,64115278,64141928,protein_coding,-1,26650,chr3_64115278_64141928
Vmn2r28,7,5477255,5493956,protein_coding,-1,16701,chr7_5477255_5493956
Vmn2r29,7,7231327,7247328,protein_coding,-1,16001,chr7_7231327_7247328
Vmn2r46,7,9747811,9770571,protein_coding,-1,22760,chr7_9747811_9770571
Vmn2r54,7,12613839,12640319,protein_coding,-1,26480,chr7_12613839_12640319
Vmn2r55,7,12651706,12685003,protein_coding,-1,33297,chr7_12651706_12685003
Vmn2r56,7,12688721,12735004,protein_coding,-1,46283,chr7_12688721_12735004
Vmn2r57,7,41395945,41448696,protein_coding,-1,52751,chr7_41395945_41448696
Vmn2r62,7,42764055,42793525,protein_coding,-1,29470,chr7_42764055_42793525
Vmn2r8,5,108791843,108808850,protein_coding,-1,17007,chr5_108791843_108808850
Vmn2r84,10,130377925,130394332,protein_coding,-1,16407,chr10_130377925_130394332
Vmn2r85,10,130414064,130429703,protein_coding,-1,15639,chr10_130414064_130429703
Vmn2r86,10,130441562,130456050,protein_coding,-1,14488,chr10_130441562_130456050
Vmn2r87,10,130471052,130497396,protein_coding,-1,26344,chr10_130471052_130497396
Vmn2r88,14,51410820,51420721,protein_coding,1,9901,chr14_51410820_51420721
Vmo1,11,70513516,70514616,protein_coding,-1,1100,chr11_70513516_70514616
Vmp1,11,86583865,86683836,protein_coding,-1,99971,chr11_86583865_86683836
Vopp1,6,57727807,57825159,protein_coding,-1,97352,chr6_57727807_57825159
Vpreb1,16,16868403,16870843,protein_coding,-1,2440,chr16_16868403_16870843
Vpreb3,10,75943057,75949657,protein_coding,1,6600,chr10_75943057_75949657
Vps11,9,44347749,44361670,protein_coding,-1,13921,chr9_44347749_44361670
Vps13a,19,16615366,16780933,protein_coding,-1,165567,chr19_16615366_16780933
Vps13b,15,35371160,35931229,protein_coding,1,560069,chr15_35371160_35931229
Vps13c,9,67840396,67995638,protein_coding,1,155242,chr9_67840396_67995638
Vps13d,4,144972622,145195005,protein_coding,-1,222383,chr4_144972622_145195005
Vps16,2,130424339,130444269,protein_coding,1,19930,chr2_130424339_130444269
Vps18,2,119288740,119298453,protein_coding,1,9713,chr2_119288740_119298453
Vps25,11,101253707,101259549,protein_coding,1,5842,chr11_101253707_101259549
Vps26a,10,62455235,62486805,protein_coding,-1,31570,chr10_62455235_62486805
Vps26b,9,27007771,27030065,protein_coding,-1,22294,chr9_27007771_27030065
Vps28,15,76622087,76626086,protein_coding,-1,3999,chr15_76622087_76626086
Vps29,5,122354369,122364984,protein_coding,1,10615,chr5_122354369_122364984
Vps33a,5,123528659,123573038,protein_coding,-1,44379,chr5_123528659_123573038
Vps33b,7,80269649,80291754,protein_coding,1,22105,chr7_80269649_80291754
Vps35,8,85260392,85299802,protein_coding,-1,39410,chr8_85260392_85299802
Vps36,8,22192809,22220843,protein_coding,1,28034,chr8_22192809_22220843
Vps37a,8,40511783,40550757,protein_coding,1,38974,chr8_40511783_40550757
Vps37b,5,124004641,124032270,protein_coding,-1,27629,chr5_124004641_124032270
Vps37c,19,10688735,10714627,protein_coding,1,25892,chr19_10688735_10714627
Vps37d,5,135072900,135078266,protein_coding,-1,5366,chr5_135072900_135078266
Vps39,2,120316461,120353137,protein_coding,-1,36676,chr2_120316461_120353137
Vps41,13,18717286,18866811,protein_coding,1,149525,chr13_18717286_18866811
Vps45,3,95999832,96058466,protein_coding,-1,58634,chr3_95999832_96058466
Vps4a,8,107031222,107045755,protein_coding,1,14533,chr8_107031222_107045755
Vps4b,1,106764071,106796728,protein_coding,-1,32657,chr1_106764071_106796728
Vps51,19,6067842,6077231,protein_coding,-1,9389,chr19_6067842_6077231
Vps52,17,33955812,33967035,protein_coding,1,11223,chr17_33955812_33967035
Vps53,11,76046226,76179647,protein_coding,-1,133421,chr11_76046226_76179647
Vps54,11,21239281,21321136,protein_coding,1,81855,chr11_21239281_21321136
Vps72,3,95111022,95123051,protein_coding,1,12029,chr3_95111022_95123051
Vps8,16,21423118,21644680,protein_coding,1,221562,chr16_21423118_21644680
Vps9d1,8,123242356,123254348,protein_coding,-1,11992,chr8_123242356_123254348
Vrk1,12,106010228,106077426,protein_coding,1,67198,chr12_106010228_106077426
Vrk2,11,26471322,26593999,protein_coding,-1,122677,chr11_26471322_26593999
Vrk3,7,44748413,44777515,protein_coding,1,29102,chr7_44748413_44777515
Vsig10,5,117319083,117355005,protein_coding,1,35922,chr5_117319083_117355005
Vsig10l,7,43463151,43472019,protein_coding,1,8868,chr7_43463151_43472019
Vsig2,9,37539255,37544205,protein_coding,1,4950,chr9_37539255_37544205
Vsig8,1,172555938,172563717,protein_coding,1,7779,chr1_172555938_172563717
Vsnl1,12,11325242,11436613,protein_coding,-1,111371,chr12_11325242_11436613
Vstm2a,11,16257724,16427310,protein_coding,1,169586,chr11_16257724_16427310
Vstm2b,7,40898328,40930594,protein_coding,1,32266,chr7_40898328_40930594
Vstm2l,2,157914653,157944719,protein_coding,1,30066,chr2_157914653_157944719
Vstm4,14,32856756,32939491,protein_coding,1,82735,chr14_32856756_32939491
Vstm5,9,15239045,15259416,protein_coding,1,20371,chr9_15239045_15259416
Vsx1,2,150680702,150689360,protein_coding,-1,8658,chr2_150680702_150689360
Vsx2,12,84569762,84595457,protein_coding,1,25695,chr12_84569762_84595457
Vta1,10,14654755,14705560,protein_coding,-1,50805,chr10_14654755_14705560
Vtcn1,3,100825459,100896922,protein_coding,1,71463,chr3_100825459_100896922
Vti1a,19,55316295,55627309,protein_coding,1,311014,chr19_55316295_55627309
Vti1b,12,79156017,79172667,protein_coding,-1,16650,chr12_79156017_79172667
Vtn,11,78499091,78502324,protein_coding,1,3233,chr11_78499091_78502324
Vwa1,4,155768149,155774698,protein_coding,-1,6549,chr4_155768149_155774698
Vwa2,19,56874249,56912078,protein_coding,1,37829,chr19_56874249_56912078
Vwa3a,7,120739318,120805742,protein_coding,1,66424,chr7_120739318_120805742
Vwa3b,1,37026596,37187613,protein_coding,1,161017,chr1_37026596_37187613
Vwa5a,9,38718268,38743337,protein_coding,1,25069,chr9_38718268_38743337
Vwa5b1,4,138565360,138635884,protein_coding,-1,70524,chr4_138565360_138635884
Vwa5b2,16,20589471,20605377,protein_coding,1,15906,chr16_20589471_20605377
Vwa7,17,35016579,35026741,protein_coding,1,10162,chr17_35016579_35026741
Vwa8,14,78849052,79202310,protein_coding,1,353258,chr14_78849052_79202310
Vwc2,11,11114223,11268931,protein_coding,1,154708,chr11_11114223_11268931
Vwc2l,1,70725715,70885397,protein_coding,1,159682,chr1_70725715_70885397
Vwce,19,10634213,10666213,protein_coding,1,32000,chr19_10634213_10666213
Vwf,6,125546774,125686679,protein_coding,1,139905,chr6_125546774_125686679
Wac,18,7868832,7929028,protein_coding,1,60196,chr18_7868832_7929028
Wap,11,6635482,6638637,protein_coding,-1,3155,chr11_6635482_6638637
Wars,12,108860030,108894174,protein_coding,-1,34144,chr12_108860030_108894174
Wars2,3,99141068,99239186,protein_coding,1,98118,chr3_99141068_99239186
Was,X,8081453,8090498,protein_coding,-1,9045,chrX_8081453_8090498
Wasf1,10,40883475,40938570,protein_coding,1,55095,chr10_40883475_40938570
Wasf2,4,133130505,133199756,protein_coding,1,69251,chr4_133130505_133199756
Wasf3,5,146384985,146473615,protein_coding,1,88630,chr5_146384985_146473615
Wasl,6,24613805,24665009,protein_coding,-1,51204,chr6_24613805_24665009
Wbp1,6,83119044,83121559,protein_coding,-1,2515,chr6_83119044_83121559
Wbp11,6,136813654,136828233,protein_coding,-1,14579,chr6_136813654_136828233
Wbp1l,19,46599084,46657389,protein_coding,1,58305,chr19_46599084_46657389
Wbp2,11,116078573,116086995,protein_coding,-1,8422,chr11_116078573_116086995
Wbp4,14,79459937,79481520,protein_coding,-1,21583,chr14_79459937_79481520
Wbscr25,5,134987433,135001350,antisense,-1,13917,chr5_134987433_135001350
Wdfy1,1,79702262,79776143,protein_coding,-1,73881,chr1_79702262_79776143
Wdfy2,14,62837678,62961509,protein_coding,1,123831,chr14_62837678_62961509
Wdfy3,5,101832956,102069921,protein_coding,-1,236965,chr5_101832956_102069921
Wdfy4,14,32959547,33185508,protein_coding,-1,225961,chr14_32959547_33185508
Wdhd1,14,47240944,47276857,protein_coding,-1,35913,chr14_47240944_47276857
Wdpcp,11,21572235,21898989,protein_coding,1,326754,chr11_21572235_21898989
Wdr1,5,38526813,38563221,protein_coding,-1,36408,chr5_38526813_38563221
Wdr11,7,129591863,129635738,protein_coding,1,43875,chr7_129591863_129635738
Wdr12,1,60069785,60098645,protein_coding,-1,28860,chr1_60069785_60098645
Wdr13,X,8123301,8132892,protein_coding,-1,9591,chrX_8123301_8132892
Wdr17,8,54629055,54887184,protein_coding,-1,258129,chr8_54629055_54887184
Wdr18,10,79960152,79970203,protein_coding,1,10051,chr10_79960152_79970203
Wdr19,5,65199696,65260415,protein_coding,1,60719,chr5_65199696_65260415
Wdr20,12,110737944,110804238,protein_coding,1,66294,chr12_110737944_110804238
Wdr20rt,12,65225517,65233359,protein_coding,1,7842,chr12_65225517_65233359
Wdr24,17,25823627,25828730,protein_coding,1,5103,chr17_25823627_25828730
Wdr25,12,108893631,109028452,protein_coding,1,134821,chr12_108893631_109028452
Wdr26,1,181173228,181212001,protein_coding,-1,38773,chr1_181173228_181212001
Wdr27,17,14818519,14943158,protein_coding,-1,124639,chr17_14818519_14943158
Wdr3,3,100138180,100162407,protein_coding,-1,24227,chr3_100138180_100162407
Wdr31,4,62448653,62470896,protein_coding,-1,22243,chr4_62448653_62470896
Wdr33,18,31804090,31907397,protein_coding,1,103307,chr18_31804090_31907397
Wdr34,2,30031546,30048881,protein_coding,-1,17335,chr2_30031546_30048881
Wdr35,12,8973892,9028847,protein_coding,1,54955,chr12_8973892_9028847
Wdr36,18,32837225,32867594,protein_coding,1,30369,chr18_32837225_32867594
Wdr37,13,8802968,8871909,protein_coding,-1,68941,chr13_8802968_8871909
Wdr38,2,38997476,39006168,protein_coding,1,8692,chr2_38997476_39006168
Wdr4,17,31494322,31519980,protein_coding,-1,25658,chr17_31494322_31519980
Wdr41,13,94976344,95023314,protein_coding,1,46970,chr13_94976344_95023314
Wdr43,17,71615895,71659031,protein_coding,1,43136,chr17_71615895_71659031
Wdr44,X,23693051,23806025,protein_coding,1,112974,chrX_23693051_23806025
Wdr45,X,7714333,7728206,protein_coding,1,13873,chrX_7714333_7728206
Wdr45b,11,121327224,121354445,protein_coding,-1,27221,chr11_121327224_121354445
Wdr46,17,33940660,33949697,protein_coding,1,9037,chr17_33940660_33949697
Wdr46-ps,5,3989006,3990717,processed_pseudogene,1,1711,chr5_3989006_3990717
Wdr47,3,108591279,108645719,protein_coding,1,54440,chr3_108591279_108645719
Wdr48,9,119894878,119926587,protein_coding,1,31709,chr9_119894878_119926587
Wdr49,3,75274988,75482156,protein_coding,-1,207168,chr3_75274988_75482156
Wdr5,2,27515157,27536535,protein_coding,1,21378,chr2_27515157_27536535
Wdr53,16,32247227,32257083,protein_coding,1,9856,chr16_32247227_32257083
Wdr54,6,83149361,83156397,protein_coding,-1,7036,chr6_83149361_83156397
Wdr55,18,36760220,36763810,protein_coding,1,3590,chr18_36760220_36763810
Wdr59,8,111448797,111522092,protein_coding,-1,73295,chr8_111448797_111522092
Wdr5b,16,36041190,36043928,protein_coding,1,2738,chr16_36041190_36043928
Wdr6,9,108572311,108578739,protein_coding,-1,6428,chr9_108572311_108578739
Wdr60,12,116206262,116263022,protein_coding,-1,56760,chr12_116206262_116263022
Wdr61,9,54714735,54734519,protein_coding,-1,19784,chr9_54714735_54734519
Wdr62,7,30240138,30280419,protein_coding,-1,40281,chr7_30240138_30280419
Wdr64,1,175698593,175815734,protein_coding,1,117141,chr1_175698593_175815734
Wdr66,5,123252102,123327484,protein_coding,1,75382,chr5_123252102_123327484
Wdr7,18,63708685,63989776,protein_coding,1,281091,chr18_63708685_63989776
Wdr70,15,7873055,8099209,protein_coding,-1,226154,chr15_7873055_8099209
Wdr73,7,80890723,80901269,protein_coding,-1,10546,chr7_80890723_80901269
Wdr74,19,8735827,8740624,protein_coding,1,4797,chr19_8735827_8740624
Wdr75,1,45795166,45823619,protein_coding,1,28453,chr1_45795166_45823619
Wdr76,2,121506723,121544860,protein_coding,1,38137,chr2_121506723_121544860
Wdr77,3,105959369,105970037,protein_coding,1,10668,chr3_105959369_105970037
Wdr78,4,103038065,103114555,protein_coding,-1,76490,chr4_103038065_103114555
Wdr81,11,75440944,75454717,protein_coding,-1,13773,chr11_75440944_75454717
Wdr82,9,106170928,106191139,protein_coding,1,20211,chr9_106170928_106191139
Wdr83,8,85075035,85081306,protein_coding,-1,6271,chr8_85075035_85081306
Wdr83os,8,85080740,85082339,protein_coding,1,1599,chr8_85080740_85082339
Wdr86,5,24711738,24730727,protein_coding,-1,18989,chr5_24711738_24730727
Wdr88,7,35238791,35275533,protein_coding,-1,36742,chr7_35238791_35275533
Wdr89,12,75630596,75669537,protein_coding,-1,38941,chr12_75630596_75669537
Wdr90,17,25844771,25861501,protein_coding,-1,16730,chr17_25844771_25861501
Wdr91,6,34880426,34910876,protein_coding,-1,30450,chr6_34880426_34910876
Wdr92,11,17182107,17233796,protein_coding,1,51689,chr11_17182107_17233796
Wdr93,7,79743163,79785950,protein_coding,1,42787,chr7_79743163_79785950
Wdr95,5,149528679,149611894,protein_coding,1,83215,chr5_149528679_149611894
Wdsub1,2,59852364,59882591,protein_coding,-1,30227,chr2_59852364_59882591
Wdtc1,4,133292459,133353481,protein_coding,-1,61022,chr4_133292459_133353481
Wdyhv1,15,58141377,58158665,protein_coding,1,17288,chr15_58141377_58158665
Wee1,7,110122046,110143286,protein_coding,1,21240,chr7_110122046_110143286
Wee2,6,40439088,40466813,protein_coding,1,27725,chr6_40439088_40466813
Wfdc1,8,119666365,119688222,protein_coding,1,21857,chr8_119666365_119688222
Wfdc12,2,164189231,164190608,protein_coding,-1,1377,chr2_164189231_164190608
Wfdc13,2,164685107,164687706,protein_coding,1,2599,chr2_164685107_164687706
Wfdc15a,2,164198863,164200130,protein_coding,-1,1267,chr2_164198863_164200130
Wfdc15b,2,164214454,164221660,protein_coding,-1,7206,chr2_164214454_164221660
Wfdc18,11,83709015,83711348,protein_coding,1,2333,chr11_83709015_83711348
Wfdc2,2,164562413,164568510,protein_coding,1,6097,chr2_164562413_164568510
Wfdc3,2,164731180,164745931,protein_coding,-1,14751,chr2_164731180_164745931
Wfdc9,2,164649631,164656583,protein_coding,-1,6952,chr2_164649631_164656583
Wfikkn1,17,25877628,25880858,protein_coding,-1,3230,chr17_25877628_25880858
Wfikkn2,11,94235956,94246005,protein_coding,-1,10049,chr11_94235956_94246005
Wfs1,5,36966104,36989205,protein_coding,-1,23101,chr5_36966104_36989205
Whamm,7,81571266,81596836,protein_coding,1,25570,chr7_81571266_81596836
Whrn,4,63414910,63495991,protein_coding,-1,81081,chr4_63414910_63495991
Wif1,10,121033960,121100650,protein_coding,1,66690,chr10_121033960_121100650
Wipf1,2,73429610,73529734,protein_coding,-1,100124,chr2_73429610_73529734
Wipf2,11,98863638,98905040,protein_coding,1,41402,chr11_98863638_98905040
Wipf3,6,54429603,54503768,protein_coding,1,74165,chr6_54429603_54503768
Wipi1,11,109573331,109611967,protein_coding,-1,38636,chr11_109573331_109611967
Wipi2,5,142627698,142670588,protein_coding,1,42890,chr5_142627698_142670588
Wiz,17,32354055,32389439,protein_coding,-1,35384,chr17_32354055_32389439
Wls,3,159839672,159938664,protein_coding,1,98992,chr3_159839672_159938664
Wnk1,6,119923969,120038672,protein_coding,-1,114703,chr6_119923969_120038672
Wnk2,13,49036303,49148014,protein_coding,-1,111711,chr13_49036303_49148014
Wnk3,X,151198078,151320152,protein_coding,1,122074,chrX_151198078_151320152
Wnk4,11,101260567,101277409,protein_coding,1,16842,chr11_101260567_101277409
Wnt1,15,98789857,98793837,protein_coding,1,3980,chr15_98789857_98793837
Wnt10a,1,74791516,74804179,protein_coding,1,12663,chr1_74791516_74804179
Wnt10b,15,98770712,98778150,protein_coding,-1,7438,chr15_98770712_98778150
Wnt16,6,22288227,22298522,protein_coding,1,10295,chr6_22288227_22298522
Wnt2,6,17988940,18030585,protein_coding,-1,41645,chr6_17988940_18030585
Wnt2b,3,104945272,104961921,protein_coding,-1,16649,chr3_104945272_104961921
Wnt3,11,103774150,103817957,protein_coding,1,43807,chr11_103774150_103817957
Wnt3a,11,59248033,59290752,protein_coding,-1,42719,chr11_59248033_59290752
Wnt4,4,137277489,137299726,protein_coding,1,22237,chr4_137277489_137299726
Wnt5a,14,28504750,28527448,protein_coding,1,22698,chr14_28504750_28527448
Wnt5b,6,119432531,119544347,protein_coding,-1,111816,chr6_119432531_119544347
Wnt6,1,74771892,74785322,protein_coding,1,13430,chr1_74771892_74785322
Wnt7a,6,91363981,91411363,protein_coding,-1,47382,chr6_91363981_91411363
Wnt7b,15,85535437,85582473,protein_coding,-1,47036,chr15_85535437_85582473
Wnt8a,18,34542313,34548273,protein_coding,1,5960,chr18_34542313_34548273
Wnt9a,11,59306928,59333552,protein_coding,1,26624,chr11_59306928_59333552
Wnt9b,11,103727364,103749821,protein_coding,-1,22457,chr11_103727364_103749821
Wrap53,11,69561758,69580255,protein_coding,-1,18497,chr11_69561758_69580255
Wrap73,4,154142372,154167420,protein_coding,1,25048,chr4_154142372_154167420
Wrn,8,33234384,33385527,protein_coding,-1,151143,chr8_33234384_33385527
Wrnip1,13,32802038,32822609,protein_coding,1,20571,chr13_32802038_32822609
Wsb1,11,79239372,79254671,protein_coding,-1,15299,chr11_79239372_79254671
Wsb2,5,117357304,117378601,protein_coding,1,21297,chr5_117357304_117378601
Wsb2-ps,11,62750064,62751280,processed_pseudogene,-1,1216,chr11_62750064_62751280
Wscd1,11,71749920,71789647,protein_coding,1,39727,chr11_71749920_71789647
Wscd2,5,113490333,113589725,protein_coding,1,99392,chr5_113490333_113589725
Wt1,2,105126529,105173616,protein_coding,1,47087,chr2_105126529_105173616
Wtap,17,12966796,12994169,protein_coding,-1,27373,chr17_12966796_12994169
Wtip,7,34109543,34133268,protein_coding,-1,23725,chr7_34109543_34133268
Wwc1,11,35838400,35980527,protein_coding,-1,142127,chr11_35838400_35980527
Wwc2,8,47823959,47990924,protein_coding,-1,166965,chr8_47823959_47990924
Wwox,8,114439655,115352708,protein_coding,1,913053,chr8_114439655_115352708
Wwp1,4,19608303,19708993,protein_coding,-1,100690,chr4_19608303_19708993
Wwp2,8,107436365,107558595,protein_coding,1,122230,chr8_107436365_107558595
Wwtr1,3,57455649,57575910,protein_coding,-1,120261,chr3_57455649_57575910
Xab2,8,3608421,3621316,protein_coding,-1,12895,chr8_3608421_3621316
Xaf1,11,72301629,72313733,protein_coding,1,12104,chr11_72301629_72313733
Xbp1,11,5520659,5525893,protein_coding,1,5234,chr11_5520659_5525893
Xcr1,9,123852315,123862029,protein_coding,-1,9714,chr9_123852315_123862029
Xdh,17,73883895,73950196,protein_coding,-1,66301,chr17_73883895_73950196
Xiap,X,42059679,42109656,protein_coding,1,49977,chrX_42059679_42109656
Xirp2,2,67173834,67526615,protein_coding,1,352781,chr2_67173834_67526615
Xist,X,103460366,103483254,lincRNA,-1,22888,chrX_103460366_103483254
Xk,X,9272756,9313250,protein_coding,1,40494,chrX_9272756_9313250
Xkr4,1,3205901,3671498,protein_coding,-1,465597,chr1_3205901_3671498
Xkr5,8,18932729,18950975,protein_coding,-1,18246,chr8_18932729_18950975
Xkr6,14,63606503,63820809,protein_coding,1,214306,chr14_63606503_63820809
Xkr7,2,153031852,153055775,protein_coding,1,23923,chr2_153031852_153055775
Xkr8,4,132724897,132732546,protein_coding,-1,7649,chr4_132724897_132732546
Xkrx,X,134149043,134162076,protein_coding,-1,13033,chrX_134149043_134162076
Xlr,X,53777118,53797706,protein_coding,-1,20588,chrX_53777118_53797706
Xlr3a,X,73086293,73097095,protein_coding,-1,10802,chrX_73086293_73097095
Xlr3b,X,73192207,73202930,protein_coding,1,10723,chrX_73192207_73202930
Xlr3c,X,73254540,73265390,protein_coding,-1,10850,chrX_73254540_73265390
Xlr3d-ps,X,74696047,74704076,unprocessed_pseudogene,1,8029,chrX_74696047_74704076
Xlr3e-ps,X,74912417,74920320,unprocessed_pseudogene,1,7903,chrX_74912417_74920320
Xlr4a,X,73074345,73082478,protein_coding,-1,8133,chrX_73074345_73082478
Xlr4b,X,73214333,73222453,protein_coding,1,8120,chrX_73214333_73222453
Xlr4c,X,73233688,73243130,protein_coding,-1,9442,chrX_73233688_73243130
Xlr4e-ps,X,74944963,74952044,unprocessed_pseudogene,1,7081,chrX_74944963_74952044
Xlr5a,X,73107635,73292976,protein_coding,-1,185341,chrX_73107635_73292976
Xlr5b,X,73148796,73158872,protein_coding,1,10076,chrX_73148796_73158872
Xndc1,7,102065511,102083765,protein_coding,1,18254,chr7_102065511_102083765
Xpa,4,46155347,46196311,protein_coding,-1,40964,chr4_46155347_46196311
Xpc,6,91489305,91515888,protein_coding,-1,26583,chr6_91489305_91515888
Xpnpep1,19,52931926,53040214,protein_coding,-1,108288,chr19_52931926_53040214
Xpnpep2,X,48108725,48136981,protein_coding,1,28256,chrX_48108725_48136981
Xpnpep3,15,81400138,81457482,protein_coding,1,57344,chr15_81400138_81457482
Xpo1,11,23256041,23298249,protein_coding,1,42208,chr11_23256041_23298249
Xpo4,14,57577521,57665430,protein_coding,-1,87909,chr14_57577521_57665430
Xpo5,17,46202782,46243598,protein_coding,1,40816,chr17_46202782_46243598
Xpo6,7,126101715,126200501,protein_coding,-1,98786,chr7_126101715_126200501
Xpo7,14,70654246,70766628,protein_coding,-1,112382,chr14_70654246_70766628
Xpot,10,121587380,121626332,protein_coding,-1,38952,chr10_121587380_121626332
Xpr1,1,155275701,155417415,protein_coding,-1,141714,chr1_155275701_155417415
Xrcc1,7,24546289,24573440,protein_coding,1,27151,chr7_24546289_24573440
Xrcc2,5,25689812,25705825,protein_coding,-1,16013,chr5_25689812_25705825
Xrcc3,12,111803192,111813873,protein_coding,-1,10681,chr12_111803192_111813873
Xrcc4,13,89774027,90089608,protein_coding,-1,315581,chr13_89774027_90089608
Xrcc5,1,72307427,72394952,protein_coding,1,87525,chr1_72307427_72394952
Xrcc6,15,81987835,82040085,protein_coding,1,52250,chr15_81987835_82040085
Xrn1,9,95954760,96057803,protein_coding,1,103043,chr9_95954760_96057803
Xrn2,2,147012996,147078000,protein_coding,1,65004,chr2_147012996_147078000
Xrra1,7,99859116,99917822,protein_coding,1,58706,chr7_99859116_99917822
Xxylt1,16,30955144,31081432,protein_coding,-1,126288,chr16_30955144_31081432
Xylb,9,119357381,119393797,protein_coding,1,36416,chr9_119357381_119393797
Xylt1,7,117380979,117673580,protein_coding,1,292601,chr7_117380979_117673580
Xylt2,11,94663851,94677515,protein_coding,-1,13664,chr11_94663851_94677515
Yae1d1,13,17981330,17993349,protein_coding,-1,12019,chr13_17981330_17993349
Yaf2,15,93284278,93336935,protein_coding,-1,52657,chr15_93284278_93336935
Yap1,9,7931999,8004596,protein_coding,-1,72597,chr9_7931999_8004596
Yars,4,129189760,129219607,protein_coding,1,29847,chr4_129189760_129219607
Yars2,16,16302965,16309640,protein_coding,1,6675,chr16_16302965_16309640
Ybey,10,76459567,76469114,protein_coding,-1,9547,chr10_76459567_76469114
Ybx1,4,119277981,119294604,protein_coding,-1,16623,chr4_119277981_119294604
Ybx1-ps2,6,37686239,37687195,processed_pseudogene,-1,956,chr6_37686239_37687195
Ybx2,11,69935796,69941605,protein_coding,1,5809,chr11_69935796_69941605
Ybx3,6,131364855,131388476,protein_coding,-1,23621,chr6_131364855_131388476
Ydjc,16,17144621,17160701,protein_coding,1,16080,chr16_17144621_17160701
Yeats2,16,20141063,20232573,protein_coding,1,91510,chr16_20141063_20232573
Yeats4,10,117215221,117224507,protein_coding,-1,9286,chr10_117215221_117224507
Yes1,5,32611171,32687057,protein_coding,1,75886,chr5_32611171_32687057
Yif1a,19,5088538,5092881,protein_coding,1,4343,chr19_5088538_5092881
Yif1b,7,29238329,29247597,protein_coding,1,9268,chr7_29238329_29247597
Yipf1,4,107314363,107359823,protein_coding,1,45460,chr4_107314363_107359823
Yipf2,9,21588682,21592828,protein_coding,-1,4146,chr9_21588682_21592828
Yipf3,17,46248080,46252537,protein_coding,1,4457,chr17_46248080_46252537
Yipf4,17,74489493,74500277,protein_coding,1,10784,chr17_74489493_74500277
Yipf5,18,40203896,40219429,protein_coding,-1,15533,chr18_40203896_40219429
Yipf6,X,98936316,98949017,protein_coding,1,12701,chrX_98936316_98949017
Yipf7,5,69516671,69542648,protein_coding,-1,25977,chr5_69516671_69542648
Ykt6,11,5955693,5967780,protein_coding,1,12087,chr11_5955693_5967780
Ylpm1,12,84996321,85070515,protein_coding,1,74194,chr12_84996321_85070515
Yme1l1,2,23156369,23199260,protein_coding,1,42891,chr2_23156369_23199260
Yod1,1,130717327,130724358,protein_coding,1,7031,chr1_130717327_130724358
Ypel1,16,17069696,17087045,protein_coding,1,17349,chr16_17069696_17087045
Ypel2,11,86936425,86993707,protein_coding,-1,57282,chr11_86936425_86993707
Ypel3,7,126776955,126780514,protein_coding,1,3559,chr7_126776955_126780514
Ypel4,2,84734058,84738655,protein_coding,1,4597,chr2_84734058_84738655
Ypel5,17,72836453,72851195,protein_coding,1,14742,chr17_72836453_72851195
Yrdc,4,124850679,124855242,protein_coding,1,4563,chr4_124850679_124855242
Ythdc1,5,86804221,86836659,protein_coding,1,32438,chr5_86804221_86836659
Ythdc2,18,44827746,44889724,protein_coding,1,61978,chr18_44827746_44889724
Ythdf1,2,180904377,180920949,protein_coding,-1,16572,chr2_180904377_180920949
Ythdf2,4,132184912,132212303,protein_coding,-1,27391,chr4_132184912_132212303
Ythdf3,3,16183212,16217037,protein_coding,1,33825,chr3_16183212_16217037
Ywhab,2,163994960,164018588,protein_coding,1,23628,chr2_163994960_164018588
Ywhae,11,75732869,75765845,protein_coding,1,32976,chr11_75732869_75765845
Ywhag,5,135908409,135934616,protein_coding,-1,26207,chr5_135908409_135934616
Ywhah,5,33018816,33027966,protein_coding,1,9150,chr5_33018816_33027966
Ywhaq,12,21390071,21417637,protein_coding,-1,27566,chr12_21390071_21417637
Ywhaq-ps1,7,97591693,97592402,processed_pseudogene,-1,709,chr7_97591693_97592402
Ywhaq-ps2,5,114828573,114829215,processed_pseudogene,-1,642,chr5_114828573_114829215
Ywhaz,15,36770770,36796929,protein_coding,-1,26159,chr15_36770770_36796929
Yy1,12,108792973,108820148,protein_coding,1,27175,chr12_108792973_108820148
Yy2,X,157566119,157568985,protein_coding,-1,2866,chrX_157566119_157568985
Zadh2,18,84088063,84097528,protein_coding,1,9465,chr18_84088063_84097528
Zan,5,137378637,137477064,protein_coding,-1,98427,chr5_137378637_137477064
Zap70,1,36761798,36782818,protein_coding,1,21020,chr1_36761798_36782818
Zar1,5,72576806,72581254,protein_coding,-1,4448,chr5_72576806_72581254
Zar1l,5,150507055,150518164,protein_coding,-1,11109,chr5_150507055_150518164
Zbbx,3,75037907,75165034,protein_coding,-1,127127,chr3_75037907_75165034
Zbed3,13,95323612,95337841,protein_coding,1,14229,chr13_95323612_95337841
Zbed4,15,88751660,88784516,protein_coding,1,32856,chr15_88751660_88784516
Zbed5,5,129895723,129903623,protein_coding,1,7900,chr5_129895723_129903623
Zbtb1,12,76370266,76396950,protein_coding,1,26684,chr12_76370266_76396950
Zbtb10,3,9250602,9285333,protein_coding,1,34731,chr3_9250602_9285333
Zbtb11,16,55973883,56008913,protein_coding,1,35030,chr16_55973883_56008913
Zbtb12,17,34879483,34896867,protein_coding,1,17384,chr17_34879483_34896867
Zbtb14,17,69383050,69391199,protein_coding,1,8149,chr17_69383050_69391199
Zbtb16,9,48654297,48836222,protein_coding,-1,181925,chr9_48654297_48836222
Zbtb17,4,141444654,141467930,protein_coding,1,23276,chr4_141444654_141467930
Zbtb18,1,177442351,177450764,protein_coding,1,8413,chr1_177442351_177450764
Zbtb2,10,4367075,4388108,protein_coding,-1,21033,chr10_4367075_4388108
Zbtb20,16,42875881,43642602,protein_coding,1,766721,chr16_42875881_43642602
Zbtb21,16,97943357,97962622,protein_coding,-1,19265,chr16_97943357_97962622
Zbtb22,17,33915904,33919325,protein_coding,1,3421,chr17_33915904_33919325
Zbtb24,10,41450383,41465574,protein_coding,1,15191,chr10_41450383_41465574
Zbtb25,12,76347782,76369602,protein_coding,-1,21820,chr12_76347782_76369602
Zbtb26,2,37432168,37443135,protein_coding,-1,10967,chr2_37432168_37443135
Zbtb3,19,8802555,8804846,protein_coding,1,2291,chr19_8802555_8804846
Zbtb32,7,30589681,30598909,protein_coding,-1,9228,chr7_30589681_30598909
Zbtb33,X,38189793,38197046,protein_coding,1,7253,chrX_38189793_38197046
Zbtb34,2,33406108,33431324,protein_coding,-1,25216,chr2_33406108_33431324
Zbtb37,1,161002922,161034849,protein_coding,-1,31927,chr1_161002922_161034849
Zbtb38,9,96682770,96752831,protein_coding,-1,70061,chr9_96682770_96752831
Zbtb39,10,127739538,127747349,protein_coding,1,7811,chr10_127739538_127747349
Zbtb4,11,69765912,69784023,protein_coding,1,18111,chr11_69765912_69784023
Zbtb40,4,136979732,137048801,protein_coding,-1,69069,chr4_136979732_137048801
Zbtb41,1,139422288,139453005,protein_coding,1,30717,chr1_139422288_139453005
Zbtb42,12,112678828,112682747,protein_coding,1,3919,chr12_112678828_112682747
Zbtb43,2,33450287,33468559,protein_coding,-1,18272,chr2_33450287_33468559
Zbtb44,9,31030644,31075885,protein_coding,1,45241,chr9_31030644_31075885
Zbtb45,7,13003898,13010034,protein_coding,-1,6136,chr7_13003898_13010034
Zbtb46,2,181387762,181459426,protein_coding,-1,71664,chr2_181387762_181459426
Zbtb48,4,152019774,152027671,protein_coding,-1,7897,chr4_152019774_152027671
Zbtb49,5,38189735,38220457,protein_coding,-1,30722,chr5_38189735_38220457
Zbtb5,4,44991242,45012412,protein_coding,-1,21170,chr4_44991242_45012412
Zbtb6,2,37425500,37443171,protein_coding,-1,17671,chr2_37425500_37443171
Zbtb7a,10,81135220,81152995,protein_coding,1,17775,chr10_81135220_81152995
Zbtb7b,3,89377644,89394776,protein_coding,-1,17132,chr3_89377644_89394776
Zbtb7c,18,75820178,76148564,protein_coding,1,328386,chr18_75820178_76148564
Zbtb8a,4,129353628,129378116,protein_coding,-1,24488,chr4_129353628_129378116
Zbtb8b,4,129425765,129440853,protein_coding,-1,15088,chr4_129425765_129440853
Zbtb8os,4,129335695,129354547,protein_coding,1,18852,chr4_129335695_129354547
Zbtb9,17,26973167,27008376,protein_coding,1,35209,chr17_26973167_27008376
Zc2hc1a,3,7503483,7553836,protein_coding,1,50353,chr3_7503483_7553836
Zc2hc1b,10,13149540,13178023,protein_coding,-1,28483,chr10_13149540_13178023
Zc2hc1c,12,85274286,85299358,protein_coding,1,25072,chr12_85274286_85299358
Zc3h10,10,128541963,128547774,protein_coding,-1,5811,chr10_128541963_128547774
Zc3h11a,1,133619862,133661380,protein_coding,-1,41518,chr1_133619862_133661380
Zc3h12a,4,125118423,125127840,protein_coding,-1,9417,chr4_125118423_125127840
Zc3h12b,X,95711678,95932637,protein_coding,1,220959,chrX_95711678_95932637
Zc3h12c,9,52111344,52168572,protein_coding,-1,57228,chr9_52111344_52168572
Zc3h12d,10,7832470,7870396,protein_coding,1,37926,chr10_7832470_7870396
Zc3h13,14,75284373,75344426,protein_coding,1,60053,chr14_75284373_75344426
Zc3h14,12,98746964,98787753,protein_coding,1,40789,chr12_98746964_98787753
Zc3h15,2,83644435,83664622,protein_coding,1,20187,chr2_83644435_83664622
Zc3h18,8,122376609,122417360,protein_coding,1,40751,chr8_122376609_122417360
Zc3h3,15,75754430,75841915,protein_coding,-1,87485,chr15_75754430_75841915
Zc3h4,7,16400910,16437696,protein_coding,1,36786,chr7_16400910_16437696
Zc3h6,2,128967402,129018563,protein_coding,1,51161,chr2_128967402_129018563
Zc3h7a,16,11136592,11176393,protein_coding,-1,39801,chr16_11136592_11176393
Zc3h7b,15,81745057,81796260,protein_coding,1,51203,chr15_81745057_81796260
Zc3h8,2,128926268,128944077,protein_coding,-1,17809,chr2_128926268_128944077
Zc3hav1,6,38305286,38354603,protein_coding,-1,49317,chr6_38305286_38354603
Zc3hav1l,6,38287396,38299259,protein_coding,-1,11863,chr6_38287396_38299259
Zc3hc1,6,30366380,30391028,protein_coding,-1,24648,chr6_30366380_30391028
Zc4h2,X,95639193,95658509,protein_coding,-1,19316,chrX_95639193_95658509
Zcchc10,11,53324679,53333301,protein_coding,1,8622,chr11_53324679_53333301
Zcchc12,X,36195904,36199158,protein_coding,1,3254,chrX_36195904_36199158
Zcchc13,X,103630586,103631670,protein_coding,1,1084,chrX_103630586_103631670
Zcchc14,8,121598703,121652901,protein_coding,-1,54198,chr8_121598703_121652901
Zcchc17,4,130315383,130359943,protein_coding,-1,44560,chr4_130315383_130359943
Zcchc18,X,136993155,136998472,protein_coding,1,5317,chrX_136993155_136998472
Zcchc2,1,105990406,106034074,protein_coding,1,43668,chr1_105990406_106034074
Zcchc24,14,25711642,25769039,protein_coding,-1,57397,chr14_25711642_25769039
Zcchc3,2,152411955,152415027,protein_coding,-1,3072,chr2_152411955_152415027
Zcchc4,5,52775409,52824665,protein_coding,1,49256,chr5_52775409_52824665
Zcchc7,4,44755877,44932215,protein_coding,1,176338,chr4_44755877_44932215
Zcchc8,5,123698294,123721100,protein_coding,-1,22806,chr5_123698294_123721100
Zcchc9,13,91796533,91807705,protein_coding,-1,11172,chr13_91796533_91807705
Zcchc9-ps,2,141127280,141128065,processed_pseudogene,1,785,chr2_141127280_141128065
Zcrb1,15,93386097,93398334,protein_coding,-1,12237,chr15_93386097_93398334
Zcwpw1,5,137787798,137822621,protein_coding,1,34823,chr5_137787798_137822621
Zdbf2,1,63273265,63314576,protein_coding,1,41311,chr1_63273265_63314576
Zdhhc1,8,105472423,105496902,protein_coding,-1,24479,chr8_105472423_105496902
Zdhhc12,2,30090944,30093648,protein_coding,-1,2704,chr2_30090944_30093648
Zdhhc13,7,48789003,48827440,protein_coding,1,38437,chr7_48789003_48827440
Zdhhc14,17,5492557,5753811,protein_coding,1,261254,chr17_5492557_5753811
Zdhhc15,X,104536969,104671064,protein_coding,-1,134095,chrX_104536969_104671064
Zdhhc16,19,41933480,41944104,protein_coding,1,10624,chr19_41933480_41944104
Zdhhc17,10,110941780,111010140,protein_coding,-1,68360,chr10_110941780_111010140
Zdhhc18,4,133605299,133650154,protein_coding,-1,44855,chr4_133605299_133650154
Zdhhc19,16,32496265,32561966,protein_coding,1,65701,chr16_32496265_32561966
Zdhhc2,8,40423815,40510268,protein_coding,1,86453,chr8_40423815_40510268
Zdhhc20,14,57832703,57890276,protein_coding,-1,57573,chr14_57832703_57890276
Zdhhc21,4,82798738,82859958,protein_coding,-1,61220,chr4_82798738_82859958
Zdhhc22,12,86980763,86990430,protein_coding,-1,9667,chr12_86980763_86990430
Zdhhc23,16,43965033,43979791,protein_coding,-1,14758,chr16_43965033_43979791
Zdhhc24,19,4878668,4885397,protein_coding,1,6729,chr19_4878668_4885397
Zdhhc3,9,123066160,123113205,protein_coding,-1,47045,chr9_123066160_123113205
Zdhhc4,5,143316489,143329256,protein_coding,-1,12767,chr5_143316489_143329256
Zdhhc5,2,84687970,84715180,protein_coding,-1,27210,chr2_84687970_84715180
Zdhhc6,19,55271291,55316032,protein_coding,-1,44741,chr19_55271291_55316032
Zdhhc7,8,120080890,120101482,protein_coding,-1,20592,chr8_120080890_120101482
Zdhhc8,16,18220753,18235136,protein_coding,-1,14383,chr16_18220753_18235136
Zdhhc9,X,48171969,48208878,protein_coding,-1,36909,chrX_48171969_48208878
Zeb1,18,5591860,5775467,protein_coding,1,183607,chr18_5591860_5775467
Zeb2,2,44983632,45117395,protein_coding,-1,133763,chr2_44983632_45117395
Zeb2os,2,45110707,45114087,antisense,1,3380,chr2_45110707_45114087
Zer1,2,30097283,30124585,protein_coding,-1,27302,chr2_30097283_30124585
Zfa-ps,10,52542320,52545739,transcribed_processed_pseudogene,-1,3419,chr10_52542320_52545739
Zfand1,3,10339953,10351317,protein_coding,-1,11364,chr3_10339953_10351317
Zfand2a,5,139471211,139484549,protein_coding,-1,13338,chr5_139471211_139484549
Zfand2b,1,75168646,75171629,protein_coding,1,2983,chr1_75168646_75171629
Zfand3,17,30004733,30210828,protein_coding,1,206095,chr17_30004733_30210828
Zfand4,6,116264222,116330302,protein_coding,1,66080,chr6_116264222_116330302
Zfand5,19,21272278,21286840,protein_coding,1,14562,chr19_21272278_21286840
Zfand6,7,84613766,84689959,protein_coding,-1,76193,chr7_84613766_84689959
Zfat,15,68083764,68258856,protein_coding,-1,175092,chr15_68083764_68258856
Zfc3h1,10,115384959,115432772,protein_coding,1,47813,chr10_115384959_115432772
Zfhx2,14,55060262,55092324,protein_coding,-1,32062,chr14_55060262_55092324
Zfhx3,8,107942644,108961630,protein_coding,1,1018986,chr8_107942644_108961630
Zfhx4,3,5218526,5415857,protein_coding,1,197331,chr3_5218526_5415857
Zfp1,8,111643401,111671011,protein_coding,1,27610,chr8_111643401_111671011
Zfp101,17,33360507,33394641,protein_coding,-1,34134,chr17_33360507_33394641
Zfp105,9,122923072,122931028,protein_coding,1,7956,chr9_122923072_122931028
Zfp106,2,120506820,120563843,protein_coding,-1,57023,chr2_120506820_120563843
Zfp108,7,24254794,24262445,protein_coding,1,7651,chr7_24254794_24262445
Zfp109,7,24227572,24237560,protein_coding,-1,9988,chr7_24227572_24237560
Zfp11,5,129654593,129670099,protein_coding,-1,15506,chr5_129654593_129670099
Zfp110,7,12834761,12850577,protein_coding,1,15816,chr7_12834761_12850577
Zfp111,7,24193947,24211443,protein_coding,-1,17496,chr7_24193947_24211443
Zfp112,7,24112314,24127952,protein_coding,1,15638,chr7_24112314_24127952
Zfp113,5,138139702,138155744,protein_coding,-1,16042,chr5_138139702_138155744
Zfp114,7,24175060,24183188,protein_coding,1,8128,chr7_24175060_24183188
Zfp119a,17,55864892,55878930,protein_coding,-1,14038,chr17_55864892_55878930
Zfp119b,17,55938381,55949500,protein_coding,-1,11119,chr17_55938381_55949500
Zfp12,5,143235163,143248834,protein_coding,1,13671,chr5_143235163_143248834
Zfp120,2,150114406,150136708,protein_coding,-1,22302,chr2_150114406_150136708
Zfp128,7,12881177,12893422,protein_coding,1,12245,chr7_12881177_12893422
Zfp13,17,23575844,23599487,protein_coding,-1,23643,chr17_23575844_23599487
Zfp131,13,119765187,119790889,protein_coding,-1,25702,chr13_119765187_119790889
Zfp133-ps,2,144459280,144500267,transcribed_unitary_pseudogene,1,40987,chr2_144459280_144500267
Zfp14,7,30036359,30051380,protein_coding,-1,15021,chr7_30036359_30051380
Zfp141,7,42473386,42505740,protein_coding,-1,32354,chr7_42473386_42505740
Zfp142,1,74565127,74588246,protein_coding,-1,23119,chr1_74565127_74588246
Zfp143,7,110061217,110095394,protein_coding,1,34177,chr7_110061217_110095394
Zfp146,7,30161269,30169750,protein_coding,-1,8481,chr7_30161269_30169750
Zfp148,16,33380836,33504363,protein_coding,1,123527,chr16_33380836_33504363
Zfp148-ps1,8,39282243,39285147,processed_pseudogene,1,2904,chr8_39282243_39285147
Zfp157,5,138441468,138460694,protein_coding,1,19226,chr5_138441468_138460694
Zfp160,17,21008903,21043070,protein_coding,1,34167,chr17_21008903_21043070
Zfp169,13,48487647,48513451,protein_coding,-1,25804,chr13_48487647_48513451
Zfp174,16,3847268,3858880,protein_coding,1,11612,chr16_3847268_3858880
Zfp180,7,24081924,24107713,protein_coding,1,25789,chr7_24081924_24107713
Zfp182,X,21028939,21062316,protein_coding,-1,33377,chrX_21028939_21062316
Zfp184,13,21945094,21960779,protein_coding,1,15685,chr13_21945094_21960779
Zfp185,X,72987339,73031543,protein_coding,1,44204,chrX_72987339_73031543
Zfp189,4,49521176,49531517,protein_coding,1,10341,chr4_49521176_49531517
Zfp2,11,50898712,50916165,protein_coding,-1,17453,chr11_50898712_50916165
Zfp202,9,40192316,40213604,protein_coding,1,21288,chr9_40192316_40213604
Zfp207,11,80383279,80405733,protein_coding,1,22454,chr11_80383279_80405733
Zfp212,6,47920476,47932639,protein_coding,1,12163,chr6_47920476_47932639
Zfp213,17,23556767,23564238,protein_coding,-1,7471,chr17_23556767_23564238
Zfp217,2,170108643,170148103,protein_coding,-1,39460,chr2_170108643_170148103
Zfp219,14,52006077,52020733,protein_coding,-1,14656,chr14_52006077_52020733
Zfp229,17,21730795,21769342,protein_coding,1,38547,chr17_21730795_21769342
Zfp235,7,24134169,24143241,protein_coding,1,9072,chr7_24134169_24143241
Zfp236,18,82593593,82692883,protein_coding,-1,99290,chr18_82593593_82692883
Zfp239,6,117862100,117873291,protein_coding,1,11191,chr6_117862100_117873291
Zfp248,6,118427319,118455528,protein_coding,-1,28209,chr6_118427319_118455528
Zfp251,15,76851609,76871435,protein_coding,-1,19826,chr15_76851609_76871435
Zfp26,9,20428449,20460162,protein_coding,-1,31713,chr9_20428449_20460162
Zfp260,7,30094777,30107622,protein_coding,1,12845,chr7_30094777_30107622
Zfp263,16,3744093,3750790,protein_coding,1,6697,chr16_3744093_3750790
Zfp264,7,6977246,6991087,transcribed_unprocessed_pseudogene,1,13841,chr7_6977246_6991087
Zfp266,9,20495068,20521417,protein_coding,-1,26349,chr9_20495068_20521417
Zfp27,7,29893333,29906572,protein_coding,-1,13239,chr7_29893333_29906572
Zfp273,13,67813740,67827002,protein_coding,1,13262,chr13_67813740_67827002
Zfp275,X,73342621,73359080,protein_coding,1,16459,chrX_73342621_73359080
Zfp276,8,123254195,123269745,protein_coding,1,15550,chr8_123254195_123269745
Zfp277,12,40315046,40445902,protein_coding,-1,130856,chr12_40315046_40445902
Zfp28,7,6383295,6396915,protein_coding,1,13620,chr7_6383295_6396915
Zfp280b,10,76032650,76043234,protein_coding,1,10584,chr10_76032650_76043234
Zfp280c,X,48541625,48594504,protein_coding,-1,52879,chrX_48541625_48594504
Zfp280d,9,72274860,72363777,protein_coding,1,88917,chr9_72274860_72363777
Zfp281,1,136624901,136630053,protein_coding,1,5152,chr1_136624901_136630053
Zfp282,6,47877204,47908485,protein_coding,1,31281,chr6_47877204_47908485
Zfp286,11,62752577,62789462,protein_coding,-1,36885,chr11_62752577_62789462
Zfp287,11,62700356,62731905,protein_coding,-1,31549,chr11_62700356_62731905
Zfp292,4,34803113,34882960,protein_coding,-1,79847,chr4_34803113_34882960
Zfp296,7,19577287,19580656,protein_coding,1,3369,chr7_19577287_19580656
Zfp3,11,70764209,70772928,protein_coding,1,8719,chr11_70764209_70772928
Zfp30,7,29783998,29794702,protein_coding,1,10704,chr7_29783998_29794702
Zfp300,X,21079174,21089527,protein_coding,-1,10353,chrX_21079174_21089527
Zfp316,5,143249697,143270022,protein_coding,-1,20325,chr5_143249697_143270022
Zfp317,9,19622102,19649731,protein_coding,1,27629,chr9_19622102_19649731
Zfp318,17,46383731,46420920,protein_coding,1,37189,chr17_46383731_46420920
Zfp319,8,95323011,95331950,protein_coding,-1,8939,chr8_95323011_95331950
Zfp322a,13,23353103,23369208,protein_coding,-1,16105,chr13_23353103_23369208
Zfp324,7,12965838,12974236,protein_coding,1,8398,chr7_12965838_12974236
Zfp326,5,105876565,105915818,protein_coding,1,39253,chr5_105876565_105915818
Zfp329,7,12804977,12818858,protein_coding,-1,13881,chr7_12804977_12818858
Zfp330,8,82763607,82774160,protein_coding,-1,10553,chr8_82763607_82774160
Zfp334,2,165374264,165388259,protein_coding,-1,13995,chr2_165374264_165388259
Zfp335,2,164891882,164911757,protein_coding,-1,19875,chr2_164891882_164911757
Zfp335os,2,164911354,164919953,antisense,1,8599,chr2_164911354_164919953
Zfp341,2,154613297,154646821,protein_coding,1,33524,chr2_154613297_154646821
Zfp345,2,150470991,150485091,protein_coding,-1,14100,chr2_150470991_150485091
Zfp346,13,55105311,55134825,protein_coding,1,29514,chr13_55105311_55134825
Zfp35,18,23989632,24005376,protein_coding,1,15744,chr18_23989632_24005376
Zfp352,4,90218820,90225702,protein_coding,1,6882,chr4_90218820_90225702
Zfp354a,11,51059257,51072799,protein_coding,1,13542,chr11_51059257_51072799
Zfp354b,11,50921823,50931633,protein_coding,-1,9810,chr11_50921823_50931633
Zfp354c,11,50811086,50827724,protein_coding,-1,16638,chr11_50811086_50827724
Zfp358,8,3493138,3497208,protein_coding,1,4070,chr8_3493138_3497208
Zfp36,7,28376784,28380253,protein_coding,-1,3469,chr7_28376784_28380253
Zfp362,4,128773088,128806045,protein_coding,-1,32957,chr4_128773088_128806045
Zfp365,10,67886103,67912662,protein_coding,-1,26559,chr10_67886103_67912662
Zfp367,13,64133018,64153202,protein_coding,-1,20184,chr13_64133018_64153202
Zfp369,13,65278814,65304221,protein_coding,1,25407,chr13_65278814_65304221
Zfp36l1,12,80107754,80113013,protein_coding,-1,5259,chr12_80107754_80113013
Zfp36l1-ps,X,38180728,38181626,processed_pseudogene,1,898,chrX_38180728_38181626
Zfp36l2,17,84183931,84187947,protein_coding,-1,4016,chr17_84183931_84187947
Zfp37,4,62189540,62231047,protein_coding,-1,41507,chr4_62189540_62231047
Zfp382,7,30121942,30134950,protein_coding,1,13008,chr7_30121942_30134950
Zfp383,7,29908223,29916813,protein_coding,1,8590,chr7_29908223_29916813
Zfp384,6,125009145,125037870,protein_coding,1,28725,chr6_125009145_125037870
Zfp385a,15,103313895,103340093,protein_coding,-1,26198,chr15_103313895_103340093
Zfp385b,2,77410634,77819639,protein_coding,-1,409005,chr2_77410634_77819639
Zfp385c,11,100627543,100692455,protein_coding,-1,64912,chr11_100627543_100692455
Zfp386,12,116047724,116063360,protein_coding,1,15636,chr12_116047724_116063360
Zfp389,13,21504313,21506533,transcribed_processed_pseudogene,-1,2220,chr13_21504313_21506533
Zfp39,11,58888153,58904225,protein_coding,-1,16072,chr11_58888153_58904225
Zfp395,14,65358389,65398930,protein_coding,1,40541,chr14_65358389_65398930
Zfp397,18,23954692,23964673,protein_coding,1,9981,chr18_23954692_23964673
Zfp398,6,47835661,47873537,protein_coding,1,37876,chr6_47835661_47873537
Zfp40,17,23173869,23193252,protein_coding,-1,19383,chr17_23173869_23193252
Zfp407,18,84128027,84589725,protein_coding,-1,461698,chr18_84128027_84589725
Zfp408,2,91643669,91649791,protein_coding,-1,6122,chr2_91643669_91649791
Zfp41,15,75616679,75629827,protein_coding,1,13148,chr15_75616679_75629827
Zfp410,12,84316852,84343723,protein_coding,1,26871,chr12_84316852_84343723
Zfp414,17,33629090,33631779,protein_coding,1,2689,chr17_33629090_33631779
Zfp418,7,7171330,7183562,protein_coding,1,12232,chr7_7171330_7183562
Zfp420,7,29859979,29877292,protein_coding,1,17313,chr7_29859979_29877292
Zfp422,6,116624016,116628999,protein_coding,-1,4983,chr6_116624016_116628999
Zfp423,8,87661810,87959595,protein_coding,-1,297785,chr8_87661810_87959595
Zfp426,9,20468549,20492746,protein_coding,-1,24197,chr9_20468549_20492746
Zfp428,7,24507006,24515682,protein_coding,1,8676,chr7_24507006_24515682
Zfp429,13,67387905,67399819,protein_coding,-1,11914,chr13_67387905_67399819
Zfp433,10,81704825,81726686,protein_coding,1,21861,chr10_81704825_81726686
Zfp438,18,5210029,5334807,protein_coding,-1,124778,chr18_5210029_5334807
Zfp442,2,150407141,150451486,protein_coding,-1,44345,chr2_150407141_150451486
Zfp444,7,6172226,6193811,protein_coding,1,21585,chr7_6172226_6193811
Zfp445,9,122844529,122866006,protein_coding,-1,21477,chr9_122844529_122866006
Zfp446,7,12977848,12985714,protein_coding,1,7866,chr7_12977848_12985714
Zfp449,X,56346400,56365674,protein_coding,1,19274,chrX_56346400_56365674
Zfp451,1,33761545,33814595,protein_coding,-1,53050,chr1_33761545_33814595
Zfp454,11,50872720,50887651,protein_coding,-1,14931,chr11_50872720_50887651
Zfp455,13,67194506,67209298,protein_coding,1,14792,chr13_67194506_67209298
Zfp456,13,67362113,67375810,protein_coding,-1,13697,chr13_67362113_67375810
Zfp457,13,67288138,67306485,protein_coding,-1,18347,chr13_67288138_67306485
Zfp458,13,67254918,67278466,protein_coding,-1,23548,chr13_67254918_67278466
Zfp459,13,67405709,67421418,protein_coding,-1,15709,chr13_67405709_67421418
Zfp46,4,136284683,136293942,protein_coding,1,9259,chr4_136284683_136293942
Zfp462,4,54945048,55083563,protein_coding,1,138515,chr4_54945048_55083563
Zfp467,6,48427697,48445825,protein_coding,-1,18128,chr6_48427697_48445825
Zfp472,17,32965814,32979233,protein_coding,1,13419,chr17_32965814_32979233
Zfp473,7,44731480,44751050,protein_coding,-1,19570,chr7_44731480_44751050
Zfp488,14,33967070,33978764,protein_coding,-1,11694,chr14_33967070_33978764
Zfp493,13,67779693,67792512,protein_coding,1,12819,chr13_67779693_67792512
Zfp503,14,21983959,21989601,protein_coding,-1,5642,chr14_21983959_21989601
Zfp507,7,35772343,35803003,protein_coding,-1,30660,chr7_35772343_35803003
Zfp51,17,21450374,21465587,protein_coding,1,15213,chr17_21450374_21465587
Zfp511,7,140036391,140040602,protein_coding,1,4211,chr7_140036391_140040602
Zfp512,5,31452431,31481754,protein_coding,1,29323,chr5_31452431_31481754
Zfp513,5,31198981,31202303,protein_coding,-1,3322,chr5_31198981_31202303
Zfp516,18,82910663,83005314,protein_coding,1,94651,chr18_82910663_83005314
Zfp518a,19,40894705,40917947,protein_coding,1,23242,chr19_40894705_40917947
Zfp518b,5,38668484,38684826,protein_coding,-1,16342,chr5_38668484_38684826
Zfp52,17,21535539,21562601,protein_coding,1,27062,chr17_21535539_21562601
Zfp520-ps,16,17815028,17816321,processed_pseudogene,-1,1293,chr16_17815028_17816321
Zfp521,18,13687013,13972787,protein_coding,-1,285774,chr18_13687013_13972787
Zfp523,17,28177129,28205886,protein_coding,1,28757,chr17_28177129_28205886
Zfp524,7,5014415,5018488,protein_coding,1,4073,chr7_5014415_5018488
Zfp526,7,25221425,25227507,protein_coding,1,6082,chr7_25221425_25227507
Zfp53,17,21488998,21510473,protein_coding,1,21475,chr17_21488998_21510473
Zfp532,18,65579912,65689443,protein_coding,1,109531,chr18_65579912_65689443
Zfp534,4,147673502,147702553,protein_coding,-1,29051,chr4_147673502_147702553
Zfp536,7,37318024,37773641,protein_coding,-1,455617,chr7_37318024_37773641
Zfp54,17,21423227,21435640,protein_coding,1,12413,chr17_21423227_21435640
Zfp541,7,16061814,16096334,protein_coding,1,34520,chr7_16061814_16096334
Zfp551,7,12415153,12422751,protein_coding,-1,7598,chr7_12415153_12422751
Zfp553,7,127233061,127238179,protein_coding,1,5118,chr7_127233061_127238179
Zfp558,9,18455575,18478268,protein_coding,-1,22693,chr9_18455575_18478268
Zfp560,9,20345136,20385177,protein_coding,-1,40041,chr9_20345136_20385177
Zfp563,17,33089310,33110705,protein_coding,1,21395,chr17_33089310_33110705
Zfp566,7,30077337,30090527,protein_coding,-1,13190,chr7_30077337_30090527
Zfp568,7,29983955,30028282,protein_coding,1,44327,chr7_29983955_30028282
Zfp57,17,37001163,37010635,protein_coding,1,9472,chr17_37001163_37010635
Zfp572,15,59306948,59312013,transcribed_processed_pseudogene,1,5065,chr15_59306948_59312013
Zfp574,7,25072567,25083492,protein_coding,1,10925,chr7_25072567_25083492
Zfp575,7,24583838,24587641,protein_coding,-1,3803,chr7_24583838_24587641
Zfp579,7,4983483,4996158,protein_coding,-1,12675,chr7_4983483_4996158
Zfp58,13,67490167,67500555,protein_coding,-1,10388,chr13_67490167_67500555
Zfp580,7,5051538,5053723,protein_coding,1,2185,chr7_5051538_5053723
Zfp583,7,6315660,6331285,protein_coding,-1,15625,chr7_6315660_6331285
Zfp59,7,27838607,27856438,protein_coding,1,17831,chr7_27838607_27856438
Zfp592,7,80993681,81045164,protein_coding,1,51483,chr7_80993681_81045164
Zfp593,4,134243289,134245592,protein_coding,-1,2303,chr4_134243289_134245592
Zfp595,13,67312998,67332570,protein_coding,-1,19572,chr13_67312998_67332570
Zfp597,16,3858321,3884561,protein_coding,-1,26240,chr16_3858321_3884561
Zfp598,17,24669687,24682016,protein_coding,1,12329,chr17_24669687_24682016
Zfp599,9,22247430,22259895,protein_coding,-1,12465,chr9_22247430_22259895
Zfp60,7,27731389,27753702,protein_coding,1,22313,chr7_27731389_27753702
Zfp605,5,110110092,110129794,protein_coding,1,19702,chr5_110110092_110129794
Zfp606,7,12478293,12496235,protein_coding,1,17942,chr7_12478293_12496235
Zfp608,18,54888048,54992555,protein_coding,-1,104507,chr18_54888048_54992555
Zfp609,9,65692391,65827564,protein_coding,-1,135173,chr9_65692391_65827564
Zfp61,7,24291039,24301232,protein_coding,-1,10193,chr7_24291039_24301232
Zfp612,8,110079746,110092741,protein_coding,1,12995,chr8_110079746_110092741
Zfp617,8,71908635,71934629,protein_coding,1,25994,chr8_71908635_71934629
Zfp618,4,62965573,63139708,protein_coding,1,174135,chr4_62965573_63139708
Zfp619,7,39517766,39540420,protein_coding,1,22654,chr7_39517766_39540420
Zfp62,11,49203292,49218816,protein_coding,1,15524,chr11_49203292_49218816
Zfp622,15,25984366,25998481,protein_coding,1,14115,chr15_25984366_25998481
Zfp623,15,75940952,75949400,protein_coding,1,8448,chr15_75940952_75949400
Zfp626,7,27807196,27822916,protein_coding,1,15720,chr7_27807196_27822916
Zfp628,7,4915217,4922002,protein_coding,1,6785,chr7_4915217_4922002
Zfp629,7,127607031,127615797,protein_coding,-1,8766,chr7_127607031_127615797
Zfp637,6,117841180,117845956,protein_coding,1,4776,chr6_117841180_117845956
Zfp639,3,32510259,32520833,protein_coding,1,10574,chr3_32510259_32520833
Zfp64,2,168893331,168955587,protein_coding,-1,62256,chr2_168893331_168955587
Zfp641,15,98285585,98296161,protein_coding,-1,10576,chr15_98285585_98296161
Zfp644,5,106616739,106697287,protein_coding,-1,80548,chr5_106616739_106697287
Zfp646,7,127876221,127885996,protein_coding,1,9775,chr7_127876221_127885996
Zfp647,15,76910371,76925448,protein_coding,-1,15077,chr15_76910371_76925448
Zfp648,1,154201187,154205689,protein_coding,1,4502,chr1_154201187_154205689
Zfp65,13,67705309,67729173,protein_coding,-1,23864,chr13_67705309_67729173
Zfp651,9,121759330,121771742,protein_coding,1,12412,chr9_121759330_121771742
Zfp652,11,95712673,95835115,protein_coding,1,122442,chr11_95712673_95835115
Zfp652os,11,95700106,95712754,antisense,-1,12648,chr11_95700106_95712754
Zfp653,9,22055411,22071376,protein_coding,-1,15965,chr9_22055411_22071376
Zfp654,16,64780347,64851652,protein_coding,-1,71305,chr16_64780347_64851652
Zfp655,5,145231715,145247302,protein_coding,1,15587,chr5_145231715_145247302
Zfp658,7,43562256,43575461,protein_coding,1,13205,chr7_43562256_43575461
Zfp661,2,127574662,127587094,protein_coding,-1,12432,chr2_127574662_127587094
Zfp663,2,165351297,165368729,protein_coding,-1,17432,chr2_165351297_165368729
Zfp664,5,124862691,124902693,protein_coding,1,40002,chr5_124862691_124902693
Zfp667,7,6286579,6307883,protein_coding,1,21304,chr7_6286579_6307883
Zfp668,7,127863047,127876828,protein_coding,-1,13781,chr7_127863047_127876828
Zfp672,11,58315114,58330339,protein_coding,-1,15225,chr11_58315114_58330339
Zfp677,17,21383748,21399265,protein_coding,1,15517,chr17_21383748_21399265
Zfp68,5,138603652,138619761,protein_coding,-1,16109,chr5_138603652_138619761
Zfp683,4,134053838,134058996,protein_coding,1,5158,chr4_134053838_134058996
Zfp687,3,95006590,95015448,protein_coding,-1,8858,chr3_95006590_95015448
Zfp688,7,127418967,127422068,protein_coding,-1,3101,chr7_127418967_127422068
Zfp689,7,127442136,127449158,protein_coding,-1,7022,chr7_127442136_127449158
Zfp69,4,120930137,120951699,protein_coding,-1,21562,chr4_120930137_120951699
Zfp691,4,119169513,119174195,protein_coding,-1,4682,chr4_119169513_119174195
Zfp692,11,58307069,58314627,protein_coding,1,7558,chr11_58307069_58314627
Zfp697,3,98382461,98753812,protein_coding,1,371351,chr3_98382461_98753812
Zfp7,15,76879259,76892395,protein_coding,1,13136,chr15_76879259_76892395
Zfp703,8,26977325,26981461,protein_coding,1,4136,chr8_26977325_26981461
Zfp704,3,9427020,9610085,protein_coding,-1,183065,chr3_9427020_9610085
Zfp706,15,36997027,37007773,protein_coding,-1,10746,chr15_36997027_37007773
Zfp707,15,75969123,75975868,protein_coding,1,6745,chr15_75969123_75975868
Zfp708,13,67069399,67097976,protein_coding,-1,28577,chr13_67069399_67097976
Zfp709,8,71882019,71895727,protein_coding,1,13708,chr8_71882019_71895727
Zfp710,7,80024814,80094173,protein_coding,1,69359,chr7_80024814_80094173
Zfp711,X,112600526,112635070,protein_coding,1,34544,chrX_112600526_112635070
Zfp712,13,67038596,67061170,protein_coding,-1,22574,chr13_67038596_67061170
Zfp715,7,43296197,43313294,protein_coding,-1,17097,chr7_43296197_43313294
Zfp719,7,43579610,43593235,protein_coding,1,13625,chr7_43579610_43593235
Zfp72,13,74369326,74390836,protein_coding,-1,21510,chr13_74369326_74390836
Zfp738,13,67658685,67687071,protein_coding,-1,28386,chr13_67658685_67687071
Zfp74,7,29930815,29954089,protein_coding,-1,23274,chr7_29930815_29954089
Zfp740,15,102203249,102215606,protein_coding,1,12357,chr15_102203249_102215606
Zfp746,6,48062395,48086593,protein_coding,-1,24198,chr6_48062395_48086593
Zfp747,7,127372537,127376050,protein_coding,-1,3513,chr7_127372537_127376050
Zfp748,13,67538641,67553830,protein_coding,-1,15189,chr13_67538641_67553830
Zfp750,11,121510978,121519333,protein_coding,-1,8355,chr11_121510978_121519333
Zfp758,17,22361453,22377281,protein_coding,1,15828,chr17_22361453_22377281
Zfp759,13,67121660,67141787,protein_coding,1,20127,chr13_67121660_67141787
Zfp760,17,21707741,21725636,protein_coding,1,17895,chr17_21707741_21725636
Zfp763,17,33016863,33033402,protein_coding,-1,16539,chr17_33016863_33033402
Zfp764,7,127403668,127406822,protein_coding,-1,3154,chr7_127403668_127406822
Zfp768,7,127342795,127345589,protein_coding,-1,2794,chr7_127342795_127345589
Zfp770,2,114193461,114201469,protein_coding,-1,8008,chr2_114193461_114201469
Zfp771,7,127244274,127254803,protein_coding,1,10529,chr7_127244274_127254803
Zfp772,7,7202117,7209998,protein_coding,-1,7881,chr7_7202117_7209998
Zfp773,7,7127073,7136755,protein_coding,-1,9682,chr7_7127073_7136755
Zfp775,6,48602063,48623227,protein_coding,1,21164,chr6_48602063_48623227
Zfp777,6,48024188,48048911,protein_coding,-1,24723,chr6_48024188_48048911
Zfp78,7,6363280,6382605,protein_coding,1,19325,chr7_6363280_6382605
Zfp780b,7,27959135,27979171,protein_coding,-1,20036,chr7_27959135_27979171
Zfp781,10,81901911,81930480,protein_coding,-1,28569,chr10_81901911_81930480
Zfp783,6,47943171,47955913,transcribed_unprocessed_pseudogene,1,12742,chr6_47943171_47955913
Zfp784,7,5034439,5038446,protein_coding,-1,4007,chr7_5034439_5038446
Zfp786,6,47819266,47830867,protein_coding,-1,11601,chr6_47819266_47830867
Zfp787,7,6131491,6155997,protein_coding,-1,24506,chr7_6131491_6155997
Zfp788,7,41633203,41651530,protein_coding,1,18327,chr7_41633203_41651530
Zfp790,7,29816114,29831005,protein_coding,1,14891,chr7_29816114_29831005
Zfp791,8,85108553,85123095,protein_coding,-1,14542,chr8_85108553_85123095
Zfp799,17,32815449,32830261,protein_coding,-1,14812,chr17_32815449_32830261
Zfp800,6,28239927,28398005,protein_coding,-1,158078,chr6_28239927_28398005
Zfp804a,2,82053222,82259879,protein_coding,1,206657,chr2_82053222_82259879
Zfp804b,5,6769010,7344756,protein_coding,-1,575746,chr5_6769010_7344756
Zfp808,13,62129886,62236144,protein_coding,1,106258,chr13_62129886_62236144
Zfp809,9,22225714,22243354,protein_coding,1,17640,chr9_22225714_22243354
Zfp81,17,33329342,33358878,protein_coding,-1,29536,chr17_33329342_33358878
Zfp810,9,22276748,22307648,protein_coding,-1,30900,chr9_22276748_22307648
Zfp811,17,32795676,32809931,protein_coding,-1,14255,chr17_32795676_32809931
Zfp813-ps,1,117603878,117628027,lincRNA;processed_pseudogene,1,24149,chr1_117603878_117628027
Zfp819,7,43607169,43618285,protein_coding,1,11116,chr7_43607169_43618285
Zfp82,7,30054489,30072900,protein_coding,-1,18411,chr7_30054489_30072900
Zfp820,17,21816885,21845772,protein_coding,-1,28887,chr17_21816885_21845772
Zfp821,8,109705546,109724932,protein_coding,1,19386,chr8_109705546_109724932
Zfp825,13,74480054,74493992,protein_coding,-1,13938,chr13_74480054_74493992
Zfp827,8,79028437,79193766,protein_coding,1,165329,chr8_79028437_79193766
Zfp830,11,82764345,82765935,protein_coding,1,1590,chr11_82764345_82765935
Zfp831,2,174643534,174710832,protein_coding,1,67298,chr2_174643534_174710832
Zfp839,12,110850253,110869996,protein_coding,1,19743,chr12_110850253_110869996
Zfp84,7,29768552,29779821,protein_coding,1,11269,chr7_29768552_29779821
Zfp846,9,20581291,20605409,protein_coding,1,24118,chr9_20581291_20605409
Zfp85,13,67747800,67755228,protein_coding,-1,7428,chr13_67747800_67755228
Zfp850,7,27984854,28014115,protein_coding,-1,29261,chr7_27984854_28014115
Zfp853,5,143287038,143293623,protein_coding,-1,6585,chr5_143287038_143293623
Zfp85os,13,67729262,67756838,processed_transcript,1,27576,chr13_67729262_67756838
Zfp862-ps,6,48504337,48534832,transcribed_unitary_pseudogene,1,30495,chr6_48504337_48534832
Zfp865,7,5020376,5036768,protein_coding,1,16392,chr7_5020376_5036768
Zfp866,8,69761326,69791178,protein_coding,-1,29852,chr8_69761326_69791178
Zfp867,11,59461197,59472474,protein_coding,-1,11277,chr11_59461197_59472474
Zfp868,8,69610857,69625548,protein_coding,-1,14691,chr8_69610857_69625548
Zfp869,8,69702656,69716983,protein_coding,-1,14327,chr8_69702656_69716983
Zfp87,13,67515781,67526177,protein_coding,-1,10396,chr13_67515781_67526177
Zfp870,17,32879219,32891642,protein_coding,-1,12423,chr17_32879219_32891642
Zfp871,17,32765496,32788287,protein_coding,-1,22791,chr17_32765496_32788287
Zfp872,9,22188090,22202123,protein_coding,1,14033,chr9_22188090_22202123
Zfp873,10,82048123,82064745,protein_coding,1,16622,chr10_82048123_82064745
Zfp874a,13,67424549,67451624,protein_coding,-1,27075,chr13_67424549_67451624
Zfp874b,13,67471513,67484258,protein_coding,-1,12745,chr13_67471513_67484258
Zfp879,11,50832031,50841552,protein_coding,-1,9521,chr11_50832031_50841552
Zfp882,8,71908608,71916354,protein_coding,1,7746,chr8_71908608_71916354
Zfp9,6,118461950,118479320,protein_coding,-1,17370,chr6_118461950_118479320
Zfp90,8,106415327,106426598,protein_coding,1,11271,chr8_106415327_106426598
Zfp91,19,12763660,12796126,protein_coding,-1,32466,chr19_12763660_12796126
Zfp92,X,73411096,73428385,protein_coding,1,17289,chrX_73411096_73428385
Zfp93,7,24270420,24277794,protein_coding,1,7374,chr7_24270420_24277794
Zfp930,8,69209038,69230536,protein_coding,1,21498,chr8_69209038_69230536
Zfp931,2,178067695,178078476,protein_coding,-1,10781,chr2_178067695_178078476
Zfp932,5,109996521,110010411,protein_coding,1,13890,chr5_109996521_110010411
Zfp933,4,147822986,147848366,protein_coding,-1,25380,chr4_147822986_147848366
Zfp934,13,62479827,62571199,protein_coding,-1,91372,chr13_62479827_62571199
Zfp935,13,62453715,62558511,protein_coding,-1,104796,chr13_62453715_62558511
Zfp936,7,43114229,43192109,protein_coding,1,77880,chr7_43114229_43192109
Zfp937,2,150218073,150240725,protein_coding,1,22652,chr2_150218073_150240725
Zfp938,10,82224850,82241280,protein_coding,-1,16430,chr10_82224850_82241280
Zfp939,7,39449518,39477413,transcribed_unprocessed_pseudogene,1,27895,chr7_39449518_39477413
Zfp94,7,24301704,24316666,protein_coding,-1,14962,chr7_24301704_24316666
Zfp940,7,29833620,29853669,protein_coding,-1,20049,chr7_29833620_29853669
Zfp941,7,140807449,140822178,protein_coding,-1,14729,chr7_140807449_140822178
Zfp942,17,21926960,21962464,protein_coding,-1,35504,chr17_21926960_21962464
Zfp943,17,21962552,22071168,protein_coding,1,108616,chr17_21962552_22071168
Zfp944,17,22337989,22361400,protein_coding,-1,23411,chr17_22337989_22361400
Zfp945,17,22846697,22867134,protein_coding,-1,20437,chr17_22846697_22867134
Zfp946,17,22424222,22456689,protein_coding,1,32467,chr17_22424222_22456689
Zfp947,17,22144359,22166190,protein_coding,-1,21831,chr17_22144359_22166190
Zfp948,17,21567008,21588699,protein_coding,1,21691,chr17_21567008_21588699
Zfp949,9,88548020,88571061,protein_coding,1,23041,chr9_88548020_88571061
Zfp951,5,104813169,104860070,protein_coding,-1,46901,chr5_104813169_104860070
Zfp952,17,32993129,33005457,protein_coding,1,12328,chr17_32993129_33005457
Zfp953,13,67339306,67360605,protein_coding,-1,21299,chr13_67339306_67360605
Zfp954,7,7114690,7121488,protein_coding,-1,6798,chr7_7114690_7121488
Zfp955a,17,33239718,33255145,protein_coding,-1,15427,chr17_33239718_33255145
Zfp955b,17,33289544,33307241,protein_coding,1,17697,chr17_33289544_33307241
Zfp956,6,47953390,47965300,protein_coding,1,11910,chr6_47953390_47965300
Zfp957,14,79212355,79247369,protein_coding,-1,35014,chr14_79212355_79247369
Zfp958,8,4613167,4630231,protein_coding,1,17064,chr8_4613167_4630231
Zfp959,17,55892093,55898928,protein_coding,1,6835,chr17_55892093_55898928
Zfp960,17,17064113,17089628,protein_coding,1,25515,chr17_17064113_17089628
Zfp961,8,71951038,71993792,protein_coding,1,42754,chr8_71951038_71993792
Zfp963,8,69741639,69749970,protein_coding,-1,8331,chr8_69741639_69749970
Zfp964,8,69654479,69666982,protein_coding,1,12503,chr8_69654479_69666982
Zfp97,17,17121415,17146831,protein_coding,1,25416,chr17_17121415_17146831
Zfpl1,19,6080762,6084956,protein_coding,-1,4194,chr19_6080762_6084956
Zfpm1,8,122282141,122337251,protein_coding,1,55110,chr8_122282141_122337251
Zfpm2,15,40655035,41104592,protein_coding,1,449557,chr15_40655035_41104592
Zfr,15,12117831,12185683,protein_coding,1,67852,chr15_12117831_12185683
Zfr2,10,81233155,81252123,protein_coding,1,18968,chr10_81233155_81252123
Zfx,X,94074631,94123702,protein_coding,-1,49071,chrX_94074631_94123702
Zfyve1,12,83546558,83597222,protein_coding,-1,50664,chr12_83546558_83597222
Zfyve16,13,92487108,92530868,protein_coding,-1,43760,chr13_92487108_92530868
Zfyve19,2,119208617,119217049,protein_coding,1,8432,chr2_119208617_119217049
Zfyve21,12,111814170,111832192,protein_coding,1,18022,chr12_111814170_111832192
Zfyve26,12,79232346,79296304,protein_coding,-1,63958,chr12_79232346_79296304
Zfyve27,19,42163951,42194590,protein_coding,1,30639,chr19_42163951_42194590
Zfyve28,5,34194893,34288449,protein_coding,-1,93556,chr5_34194893_34288449
Zfyve9,4,108637466,108780798,protein_coding,-1,143332,chr4_108637466_108780798
Zglp1,9,21062393,21067093,protein_coding,-1,4700,chr9_21062393_21067093
Zgpat,2,181364928,181383628,protein_coding,1,18700,chr2_181364928_181383628
Zgrf1,3,127553489,127618023,protein_coding,1,64534,chr3_127553489_127618023
Zhx1,15,58047003,58076541,protein_coding,-1,29538,chr15_58047003_58076541
Zhx2,15,57694665,57839832,protein_coding,1,145167,chr15_57694665_57839832
Zhx3,2,160748708,160872998,protein_coding,-1,124290,chr2_160748708_160872998
Zic1,9,91358058,91365810,protein_coding,-1,7752,chr9_91358058_91365810
Zic2,14,122475435,122479852,protein_coding,1,4417,chr14_122475435_122479852
Zic3,X,58022700,58041736,protein_coding,1,19036,chrX_58022700_58041736
Zic4,9,91362413,91389348,protein_coding,1,26935,chr9_91362413_91389348
Zic5,14,122456795,122465677,protein_coding,-1,8882,chr14_122456795_122465677
Zik1,7,10487229,10495394,protein_coding,-1,8165,chr7_10487229_10495394
Zim1,7,6671269,6696450,protein_coding,-1,25181,chr7_6671269_6696450
Zim3,7,6955685,6977420,antisense,-1,21735,chr7_6955685_6977420
Zkscan1,5,138085084,138107822,protein_coding,1,22738,chr5_138085084_138107822
Zkscan14,5,145194946,145201868,protein_coding,-1,6922,chr5_145194946_145201868
Zkscan16,4,58943628,58958355,protein_coding,1,14727,chr4_58943628_58958355
Zkscan17,11,59485520,59526751,protein_coding,-1,41231,chr11_59485520_59526751
Zkscan2,7,123475384,123500449,protein_coding,-1,25065,chr7_123475384_123500449
Zkscan3,13,21387003,21402755,protein_coding,-1,15752,chr13_21387003_21402755
Zkscan4,13,21478907,21485507,protein_coding,1,6600,chr13_21478907_21485507
Zkscan5,5,145204562,145221750,protein_coding,1,17188,chr5_145204562_145221750
Zkscan6,11,65807175,65829239,protein_coding,1,22064,chr11_65807175_65829239
Zkscan7,9,122885685,122914154,protein_coding;transcribed_unprocessed_pseudogene,1,28469,chr9_122885685_122914154
Zkscan8,13,21513222,21531120,protein_coding,-1,17898,chr13_21513222_21531120
Zmat1,X,134971372,135009209,protein_coding,-1,37837,chrX_134971372_135009209
Zmat2,18,36793876,36799666,protein_coding,1,5790,chr18_36793876_36799666
Zmat3,3,32334792,32366014,protein_coding,-1,31222,chr3_32334792_32366014
Zmat4,8,23636019,24156585,protein_coding,1,520566,chr8_23636019_24156585
Zmat5,11,4704678,4737669,protein_coding,1,32991,chr11_4704678_4737669
Zmiz1,14,25459185,25666743,protein_coding,1,207558,chr14_25459185_25666743
Zmiz1os1,14,25257523,25461128,antisense,-1,203605,chr14_25257523_25461128
Zmiz2,11,6389074,6406158,protein_coding,1,17084,chr11_6389074_6406158
Zmpste24,4,121059237,121098241,protein_coding,-1,39004,chr4_121059237_121098241
Zmym1,4,127047094,127061152,protein_coding,-1,14058,chr4_127047094_127061152
Zmym2,14,56886653,56962701,protein_coding,1,76048,chr14_56886653_56962701
Zmym3,X,101404384,101420849,protein_coding,-1,16465,chrX_101404384_101420849
Zmym4,4,126861939,126968135,protein_coding,-1,106196,chr4_126861939_126968135
Zmym5,14,56790585,56811716,protein_coding,-1,21131,chr14_56790585_56811716
Zmym6,4,127077383,127124372,protein_coding,1,46989,chr4_127077383_127124372
Zmynd10,9,107547298,107551319,protein_coding,1,4021,chr9_107547298_107551319
Zmynd11,13,9684833,9765330,protein_coding,-1,80497,chr13_9684833_9765330
Zmynd12,4,119422814,119467444,protein_coding,1,44630,chr4_119422814_119467444
Zmynd15,11,70459433,70466202,protein_coding,1,6769,chr11_70459433_70466202
Zmynd19,2,24949792,24962075,protein_coding,1,12283,chr2_24949792_24962075
Zmynd8,2,165784152,165899016,protein_coding,-1,114864,chr2_165784152_165899016
Znf41-ps,4,145825237,145829942,unprocessed_pseudogene,1,4705,chr4_145825237_145829942
Znfx1,2,167035793,167063015,protein_coding,-1,27222,chr2_167035793_167063015
Znhit1,5,136982164,136988021,protein_coding,-1,5857,chr5_136982164_136988021
Znhit2,19,6061192,6062472,protein_coding,1,1280,chr19_6061192_6062472
Znhit3,11,84910950,84916366,protein_coding,-1,5416,chr11_84910950_84916366
Znhit6,3,145576205,145604795,protein_coding,1,28590,chr3_145576205_145604795
Znrd1,17,36954356,36958559,protein_coding,-1,4203,chr17_36954356_36958559
Znrd1as,17,36958592,36965625,protein_coding,1,7033,chr17_36958592_36965625
Znrf1,8,111536097,111626030,protein_coding,1,89933,chr8_111536097_111626030
Znrf2,6,54816916,54893500,protein_coding,1,76584,chr6_54816916_54893500
Znrf3,11,5276324,5444847,protein_coding,-1,168523,chr11_5276324_5444847
Znrf4,17,56511248,56512431,protein_coding,-1,1183,chr17_56511248_56512431
Zp1,19,10914287,10920632,protein_coding,-1,6345,chr19_10914287_10920632
Zp2,7,120126772,120145291,protein_coding,-1,18519,chr7_120126772_120145291
Zp3,5,135980099,135988624,protein_coding,1,8525,chr5_135980099_135988624
Zp3r,1,130576713,130629621,protein_coding,-1,52908,chr1_130576713_130629621
Zpbp,11,11279626,11462408,protein_coding,-1,182782,chr11_11279626_11462408
Zpbp2,11,98551097,98558665,protein_coding,1,7568,chr11_98551097_98558665
Zpld1,16,55225175,55297986,protein_coding,-1,72811,chr16_55225175_55297986
Zpr1,9,46273064,46282643,protein_coding,1,9579,chr9_46273064_46282643
Zranb1,7,132931142,132986391,protein_coding,1,55249,chr7_132931142_132986391
Zranb2,3,157534160,157548410,protein_coding,1,14250,chr3_157534160_157548410
Zranb3,1,127954184,128103047,protein_coding,-1,148863,chr1_127954184_128103047
Zrsr1,11,22972005,22976496,protein_coding,1,4491,chr11_22972005_22976496
Zrsr2,X,163935443,163958661,protein_coding,-1,23218,chrX_163935443_163958661
Zscan10,17,23600856,23611019,protein_coding,1,10163,chr17_23600856_23611019
Zscan12,13,21362820,21372289,protein_coding,1,9469,chr13_21362820_21372289
Zscan18,7,12768090,12803635,protein_coding,-1,35545,chr7_12768090_12803635
Zscan2,7,80860920,80876537,protein_coding,1,15617,chr7_80860920_80876537
Zscan20,4,128583539,128610098,protein_coding,-1,26559,chr4_128583539_128610098
Zscan21,5,138116903,138134265,protein_coding,1,17362,chr5_138116903_138134265
Zscan22,7,12897815,12909083,protein_coding,1,11268,chr7_12897815_12909083
Zscan25,5,145280500,145291278,protein_coding,1,10778,chr5_145280500_145291278
Zscan26,13,21442180,21453730,protein_coding,-1,11550,chr13_21442180_21453730
Zscan29,2,121158273,121171125,protein_coding,-1,12852,chr2_121158273_121171125
Zscan30,18,23964818,23987226,transcribed_unprocessed_pseudogene,-1,22408,chr18_23964818_23987226
Zscan4e,7,11306378,11310682,protein_coding,-1,4304,chr7_11306378_11310682
Zscan5b,7,6222278,6239423,protein_coding,1,17145,chr7_6222278_6239423
Zswim1,2,164822686,164826871,protein_coding,1,4185,chr2_164822686_164826871
Zswim2,2,83915079,83941228,protein_coding,-1,26149,chr2_83915079_83941228
Zswim3,2,164805098,164822130,protein_coding,1,17032,chr2_164805098_164822130
Zswim4,8,84210678,84237055,protein_coding,-1,26377,chr8_84210678_84237055
Zswim5,4,116877376,116989264,protein_coding,1,111888,chr4_116877376_116989264
Zswim6,13,107724617,107890064,protein_coding,-1,165447,chr13_107724617_107890064
Zswim7,11,62267224,62281375,protein_coding,-1,14151,chr11_62267224_62281375
Zswim8,14,20707552,20723619,protein_coding,1,16067,chr14_20707552_20723619
Zw10,9,49055613,49078775,protein_coding,1,23162,chr9_49055613_49078775
Zwilch,9,64137144,64173104,protein_coding,-1,35960,chr9_64137144_64173104
Zwint,10,72654845,72674964,protein_coding,1,20119,chr10_72654845_72674964
Zxda,X,94795563,94798183,unprocessed_pseudogene,-1,2620,chrX_94795563_94798183
Zxdb,X,94724569,94730187,protein_coding,1,5618,chrX_94724569_94730187
Zxdc,6,90369492,90403490,protein_coding,1,33998,chr6_90369492_90403490
Zyg11a,4,108181738,108218048,protein_coding,-1,36310,chr4_108181738_108218048
Zyg11b,4,108229724,108301096,protein_coding,-1,71372,chr4_108229724_108301096
Zyx,6,42349630,42360213,protein_coding,1,10583,chr6_42349630_42360213
Zzef1,11,72796226,72927120,protein_coding,1,130894,chr11_72796226_72927120
Zzz3,3,152395473,152462826,protein_coding,1,67353,chr3_152395473_152462826
a,2,154791402,155051012,protein_coding,1,259610,chr2_154791402_155051012
