gene,chr,start,end,gene_biotype,coding_strand,length,genomic_position
Xkr4,1,3205901,3671498,protein_coding,-1,465597,chr1_3205901_3671498
Gm1992,1,3466587,3513553,antisense,1,46966,chr1_3466587_3513553
Gm37381,1,3905739,3986215,lincRNA,-1,80476,chr1_3905739_3986215
Rp1,1,3999557,4409241,protein_coding,-1,409684,chr1_3999557_4409241
Sox17,1,4490931,4497354,protein_coding,-1,6423,chr1_4490931_4497354
Gm37323,1,4583129,4586252,lincRNA,-1,3123,chr1_4583129_4586252
Mrpl15,1,4773206,4785739,protein_coding,-1,12533,chr1_4773206_4785739
Lypla1,1,4807788,4848410,protein_coding,1,40622,chr1_4807788_4848410
Gm37988,1,4807892,4886770,protein_coding,1,78878,chr1_4807892_4886770
Tcea1,1,4857814,4897909,protein_coding,1,40095,chr1_4857814_4897909
Rgs20,1,4909576,5070285,protein_coding,-1,160709,chr1_4909576_5070285
Gm16041,1,4970857,4976820,antisense,1,5963,chr1_4970857_4976820
Atp6v1h,1,5070018,5162529,protein_coding,1,92511,chr1_5070018_5162529
Oprk1,1,5588466,5606131,protein_coding,1,17665,chr1_5588466_5606131
Npbwr1,1,5913707,5917398,protein_coding,-1,3691,chr1_5913707_5917398
Rb1cc1,1,6206197,6276648,protein_coding,1,70451,chr1_6206197_6276648
4732440D04Rik,1,6209866,6215293,antisense,-1,5427,chr1_6209866_6215293
Alkal1,1,6359218,6394731,protein_coding,1,35513,chr1_6359218_6394731
St18,1,6487231,6860940,protein_coding,1,373709,chr1_6487231_6860940
Pcmtd1,1,7088920,7173628,protein_coding,1,84708,chr1_7088920_7173628
Gm26901,1,7349406,7397869,lincRNA,-1,48463,chr1_7349406_7397869
Gm30414,1,7497968,7518149,lincRNA,1,20181,chr1_7497968_7518149
Sntg1,1,8361475,9299878,protein_coding,-1,938403,chr1_8361475_9299878
Rrs1,1,9545408,9547455,protein_coding,1,2047,chr1_9545408_9547455
Adhfe1,1,9547948,9580673,protein_coding,1,32725,chr1_9547948_9580673
Mybl1,1,9667415,9700209,protein_coding,-1,32794,chr1_9667415_9700209
Vcpip1,1,9718622,9748382,protein_coding,-1,29760,chr1_9718622_9748382
1700034P13Rik,1,9747648,9791924,antisense,1,44276,chr1_9747648_9791924
Sgk3,1,9798107,9900845,protein_coding,1,102738,chr1_9798107_9900845
Mcmdc2,1,9908638,9942085,protein_coding,1,33447,chr1_9908638_9942085
Snhg6,1,9941959,9944118,lincRNA,-1,2159,chr1_9941959_9944118
Tcf24,1,9960163,9967932,protein_coding,-1,7769,chr1_9960163_9967932
Ppp1r42,1,9968624,10009136,protein_coding,-1,40512,chr1_9968624_10009136
Gm15818,1,9982387,9992366,antisense,1,9979,chr1_9982387_9992366
Cops5,1,10024601,10038168,protein_coding,-1,13567,chr1_10024601_10038168
Cspp1,1,10037987,10136768,protein_coding,1,98781,chr1_10037987_10136768
Arfgef1,1,10137571,10232670,protein_coding,-1,95099,chr1_10137571_10232670
Cpa6,1,10324720,10719945,protein_coding,-1,395225,chr1_10324720_10719945
Prex2,1,10993465,11303681,protein_coding,1,310216,chr1_10993465_11303681
A830018L16Rik,1,11414105,11975901,protein_coding,1,561796,chr1_11414105_11975901
Gm17644,1,12667563,12673090,lincRNA,1,5527,chr1_12667563_12673090
Sulf1,1,12692277,12861192,protein_coding,1,168915,chr1_12692277_12861192
Slco5a1,1,12866549,12992650,protein_coding,-1,126101,chr1_12866549_12992650
Gm29283,1,13068838,13078662,lincRNA,1,9824,chr1_13068838_13078662
Prdm14,1,13113457,13127163,protein_coding,-1,13706,chr1_13113457_13127163
Ncoa2,1,13139105,13374083,protein_coding,-1,234978,chr1_13139105_13374083
Gm29570,1,13376070,13388413,antisense,1,12343,chr1_13376070_13388413
Tram1,1,13564698,13589910,protein_coding,-1,25212,chr1_13564698_13589910
Lactb2,1,13623330,13660546,protein_coding,-1,37216,chr1_13623330_13660546
Xkr9,1,13668771,13701723,protein_coding,1,32952,chr1_13668771_13701723
Eya1,1,14168954,14310235,protein_coding,-1,141281,chr1_14168954_14310235
Gm9947,1,14752937,14776931,antisense,1,23994,chr1_14752937_14776931
Msc,1,14753346,14755992,protein_coding,-1,2646,chr1_14753346_14755992
Trpa1,1,14872648,14918862,protein_coding,-1,46214,chr1_14872648_14918862
Kcnb2,1,15287254,15723750,protein_coding,1,436496,chr1_15287254_15723750
Terf1,1,15805646,15844052,protein_coding,1,38406,chr1_15805646_15844052
Sbspon,1,15853862,15892722,protein_coding,-1,38860,chr1_15853862_15892722
4930444P10Rik,1,16065979,16093325,protein_coding,-1,27346,chr1_16065979_16093325
Rpl7,1,16101295,16104662,protein_coding,-1,3367,chr1_16101295_16104662
Rdh10,1,16105774,16133734,protein_coding,1,27960,chr1_16105774_16133734
Gm28095,1,16228506,16244062,antisense,1,15556,chr1_16228506_16244062
Stau2,1,16228674,16520112,protein_coding,-1,291438,chr1_16228674_16520112
Gm7568,1,16253592,16267921,antisense,1,14329,chr1_16253592_16267921
Ube2w,1,16540790,16619489,protein_coding,-1,78699,chr1_16540790_16619489
Eloc,1,16641725,16657042,protein_coding,-1,15317,chr1_16641725_16657042
D030040B21Rik,1,16657552,16662278,lincRNA,1,4726,chr1_16657552_16662278
Tmem70,1,16665207,16678275,protein_coding,1,13068,chr1_16665207_16678275
Ly96,1,16688051,16709611,protein_coding,1,21560,chr1_16688051_16709611
Gm28376,1,16898185,17091631,antisense,1,193446,chr1_16898185_17091631
Jph1,1,16964560,17097889,protein_coding,-1,133329,chr1_16964560_17097889
Gm28783,1,17124747,17128956,lincRNA,1,4209,chr1_17124747_17128956
Gdap1,1,17145362,17164271,protein_coding,1,18909,chr1_17145362_17164271
Gm28784,1,17168403,17173103,lincRNA,1,4700,chr1_17168403_17173103
Pi15,1,17601901,17630939,protein_coding,1,29038,chr1_17601901_17630939
Gm28154,1,17615084,17641081,antisense,-1,25997,chr1_17615084_17641081
Gm16070,1,17676027,17727646,antisense,-1,51619,chr1_17676027_17727646
Crispld1,1,17727045,17766344,protein_coding,1,39299,chr1_17727045_17766344
Gm28153,1,17741915,17805417,antisense,-1,63502,chr1_17741915_17805417
Crisp4,1,18115191,18145902,protein_coding,-1,30711,chr1_18115191_18145902
Defb41,1,18250980,18265138,protein_coding,-1,14158,chr1_18250980_18265138
Gm15825,1,19063300,19104840,antisense,-1,41540,chr1_19063300_19104840
Tfap2d,1,19103022,19166346,protein_coding,1,63324,chr1_19103022_19166346
Tfap2b,1,19208914,19238576,protein_coding,1,29662,chr1_19208914_19238576
Pkhd1,1,20057779,20618064,protein_coding,-1,560285,chr1_20057779_20618064
4930486I03Rik,1,20356452,20392300,antisense,1,35848,chr1_20356452_20392300
Gm28653,1,20669882,20684298,lincRNA,1,14416,chr1_20669882_20684298
Il17f,1,20777146,20790617,protein_coding,-1,13471,chr1_20777146_20790617
Mcm3,1,20802968,20820312,protein_coding,-1,17344,chr1_20802968_20820312
6720483E21Rik,1,20888650,20890473,lincRNA,-1,1823,chr1_20888650_20890473
Paqr8,1,20890606,20939650,protein_coding,1,49044,chr1_20890606_20939650
Efhc1,1,20951626,20990841,protein_coding,1,39215,chr1_20951626_20990841
Tram2,1,20996299,21079229,protein_coding,-1,82930,chr1_20996299_21079229
Gm28287,1,21080114,21081748,antisense,1,1634,chr1_21080114_21081748
Tmem14a,1,21218575,21230167,protein_coding,1,11592,chr1_21218575_21230167
Gsta3,1,21240589,21265661,protein_coding,1,25072,chr1_21240589_21265661
Gm28836,1,21250359,21271593,antisense,-1,21234,chr1_21250359_21271593
Khdc1a,1,21349641,21352200,protein_coding,1,2559,chr1_21349641_21352200
Khdc1c,1,21368331,21370845,protein_coding,1,2514,chr1_21368331_21370845
Khdc1b,1,21383556,21386373,protein_coding,1,2817,chr1_21383556_21386373
Kcnq5,1,21398403,21961942,protein_coding,-1,563539,chr1_21398403_21961942
Rims1,1,22286251,22805994,protein_coding,-1,519743,chr1_22286251_22805994
Gm27028,1,23291537,23291935,lincRNA,1,398,chr1_23291537_23291935
Gm29107,1,23293729,23294075,lincRNA,1,346,chr1_23293729_23294075
Ogfrl1,1,23366424,23397772,protein_coding,-1,31348,chr1_23366424_23397772
Gm28822,1,23574587,23596664,lincRNA,1,22077,chr1_23574587_23596664
B3gat2,1,23761753,23849158,protein_coding,1,87405,chr1_23761753_23849158
Smap1,1,23844846,23922317,protein_coding,-1,77471,chr1_23844846_23922317
Sdhaf4,1,23995939,24005656,protein_coding,-1,9717,chr1_23995939_24005656
Fam135a,1,24011093,24100341,protein_coding,-1,89248,chr1_24011093_24100341
Col9a1,1,24177610,24252684,protein_coding,1,75074,chr1_24177610_24252684
Col19a1,1,24261890,24587472,protein_coding,-1,325582,chr1_24261890_24587472
Lmbrd1,1,24678630,24766301,protein_coding,1,87671,chr1_24678630_24766301
Gm29414,1,25026581,25027232,lincRNA,-1,651,chr1_25026581_25027232
Adgrb3,1,25067476,25829707,protein_coding,-1,762231,chr1_25067476_25829707
4931408C20Rik,1,26681814,26687460,protein_coding,-1,5646,chr1_26681814_26687460
Gm5524,1,27884046,27902396,lincRNA,1,18350,chr1_27884046_27902396
Gm597,1,28776117,28780252,protein_coding,-1,4135,chr1_28776117_28780252
Gm9898,1,30718560,30719962,lincRNA,-1,1402,chr1_30718560_30719962
Phf3,1,30802339,30873921,protein_coding,-1,71582,chr1_30802339_30873921
Ptp4a1,1,30940302,30949770,protein_coding,-1,9468,chr1_30940302_30949770
Gm28644,1,31041919,31043675,lincRNA,1,1756,chr1_31041919_31043675
4931428L18Rik,1,30997842,31222684,protein_coding,-1,224842,chr1_30997842_31222684
Gm29128,1,31136026,31150105,antisense,1,14079,chr1_31136026_31150105
Lgsn,1,31176401,31204725,protein_coding,1,28324,chr1_31176401_31204725
Pih1d3,1,31222838,31224288,protein_coding,1,1450,chr1_31222838_31224288
Khdrbs2,1,32172714,32658568,protein_coding,1,485854,chr1_32172714_32658568
Gm5415,1,32543686,32547294,protein_coding,-1,3608,chr1_32543686_32547294
Prim2,1,33453810,33669795,protein_coding,-1,215985,chr1_33453810_33669795
Rab23,1,33719887,33742564,protein_coding,1,22677,chr1_33719887_33742564
Bag2,1,33745484,33757795,protein_coding,-1,12311,chr1_33745484_33757795
Zfp451,1,33761545,33814595,protein_coding,-1,53050,chr1_33761545_33814595
Bend6,1,33852052,33907816,protein_coding,-1,55764,chr1_33852052_33907816
Dst,1,33908225,34308661,protein_coding,1,400436,chr1_33908225_34308661
Gm37233,1,34427002,34433264,lincRNA,-1,6262,chr1_34427002_34433264
Ccdc115,1,34436670,34439672,protein_coding,-1,3002,chr1_34436670_34439672
Gm28306,1,34439511,34444730,antisense,-1,5219,chr1_34439511_34444730
Imp4,1,34439851,34449356,protein_coding,1,9505,chr1_34439851_34449356
Ptpn18,1,34459762,34475733,protein_coding,1,15971,chr1_34459762_34475733
4930568A12Rik,1,34477167,34485933,lincRNA,-1,8766,chr1_34477167_34485933
Cfc1,1,34535648,34544313,protein_coding,1,8665,chr1_34535648_34544313
Prss40,1,34543968,34560943,protein_coding,-1,16975,chr1_34543968_34560943
1700101I19Rik,1,34579202,34579711,antisense,-1,509,chr1_34579202_34579711
Amer3,1,34579657,34590944,protein_coding,1,11287,chr1_34579657_34590944
Arhgef4,1,34678188,34813309,protein_coding,1,135121,chr1_34678188_34813309
Gm38336,1,34809360,34811908,antisense,-1,2548,chr1_34809360_34811908
Fam168b,1,34813219,34843065,protein_coding,-1,29846,chr1_34813219_34843065
Plekhb2,1,34849976,34879580,protein_coding,1,29604,chr1_34849976_34879580
Gm37068,1,35625606,35651297,lincRNA,-1,25691,chr1_35625606_35651297
Gm28415,1,35806974,35810462,lincRNA,1,3488,chr1_35806974_35810462
1110002O04Rik,1,35879845,35881119,lincRNA,1,1274,chr1_35879845_35881119
Gm33222,1,36002985,36011044,lincRNA,-1,8059,chr1_36002985_36011044
Hs6st1,1,36068400,36106446,protein_coding,1,38046,chr1_36068400_36106446
Gm37335,1,36105384,36106446,antisense,-1,1062,chr1_36105384_36106446
Gm33280,1,36132042,36138746,lincRNA,1,6704,chr1_36132042_36138746
Uggt1,1,36140027,36244720,protein_coding,-1,104693,chr1_36140027_36244720
Neurl3,1,36264597,36274679,protein_coding,-1,10082,chr1_36264597_36274679
Arid5a,1,36307733,36324029,protein_coding,1,16296,chr1_36307733_36324029
4930403P22Rik,1,36332708,36333420,lincRNA,1,712,chr1_36332708_36333420
Kansl3,1,36335730,36369181,protein_coding,-1,33451,chr1_36335730_36369181
Fer1l5,1,36372291,36422110,protein_coding,1,49819,chr1_36372291_36422110
Lman2l,1,36419871,36445271,protein_coding,-1,25400,chr1_36419871_36445271
Cnnm4,1,36471620,36508764,protein_coding,1,37144,chr1_36471620_36508764
Cnnm3,1,36511867,36528237,protein_coding,1,16370,chr1_36511867_36528237
Gm38033,1,36527534,36528237,antisense,-1,703,chr1_36527534_36528237
Ankrd23,1,36530188,36536883,protein_coding,-1,6695,chr1_36530188_36536883
Gm42417,1,36530193,36539429,protein_coding,-1,9236,chr1_36530193_36539429
Ankrd39,1,36537507,36547445,protein_coding,-1,9938,chr1_36537507_36547445
Sema4c,1,36548639,36558349,protein_coding,-1,9710,chr1_36548639_36558349
Fam178b,1,36562692,36683183,protein_coding,-1,120491,chr1_36562692_36683183
Cox5b,1,36691449,36693681,protein_coding,1,2232,chr1_36691449_36693681
Actr1b,1,36698114,36714422,protein_coding,-1,16308,chr1_36698114_36714422
4933424G06Rik,1,36710149,36757953,protein_coding,1,47804,chr1_36710149_36757953
Gm33533,1,36739048,36744792,lincRNA,-1,5744,chr1_36739048_36744792
Zap70,1,36761798,36782818,protein_coding,1,21020,chr1_36761798_36782818
Tmem131,1,36792191,36943666,protein_coding,-1,151475,chr1_36792191_36943666
Vwa3b,1,37026596,37187613,protein_coding,1,161017,chr1_37026596_37187613
Gm37020,1,37132273,37133264,antisense,-1,991,chr1_37132273_37133264
Cnga3,1,37214434,37263384,protein_coding,1,48950,chr1_37214434_37263384
Inpp4a,1,37299865,37410736,protein_coding,1,110871,chr1_37299865_37410736
4930439A04Rik,1,37329667,37334172,antisense,-1,4505,chr1_37329667_37334172
Coa5,1,37417084,37430103,protein_coding,-1,13019,chr1_37417084_37430103
Unc50,1,37430139,37439124,protein_coding,1,8985,chr1_37430139_37439124
Mgat4a,1,37439340,37541016,protein_coding,-1,101676,chr1_37439340_37541016
2010300C02Rik,1,37611677,37720085,protein_coding,-1,108408,chr1_37611677_37720085
4930556I23Rik,1,37614259,37615372,antisense,1,1113,chr1_37614259_37615372
Tsga10,1,37754776,37866429,protein_coding,-1,111653,chr1_37754776_37866429
Gm26805,1,37865299,37871388,antisense,1,6089,chr1_37865299_37871388
Lipt1,1,37871738,37876228,protein_coding,1,4490,chr1_37871738_37876228
Mitd1,1,37874801,37890411,protein_coding,-1,15610,chr1_37874801_37890411
Mrpl30,1,37890477,37898535,protein_coding,1,8058,chr1_37890477_37898535
Lyg2,1,37905923,37916493,protein_coding,-1,10570,chr1_37905923_37916493
Gm15457,1,37933596,37954136,antisense,1,20540,chr1_37933596_37954136
Lyg1,1,37946736,37957759,protein_coding,-1,11023,chr1_37946736_37957759
Txndc9,1,37985189,37997893,protein_coding,-1,12704,chr1_37985189_37997893
Eif5b,1,37998010,38055579,protein_coding,1,57569,chr1_37998010_38055579
Rev1,1,38052786,38129801,protein_coding,-1,77015,chr1_38052786_38129801
Gm5099,1,38132083,38159892,lincRNA,1,27809,chr1_38132083_38159892
Aff3,1,38177326,38664955,protein_coding,-1,487629,chr1_38177326_38664955
Gm16150,1,38235420,38246666,antisense,1,11246,chr1_38235420_38246666
Gm16151,1,38307902,38311930,antisense,1,4028,chr1_38307902_38311930
Gm16152,1,38384949,38393974,antisense,1,9025,chr1_38384949_38393974
Lonrf2,1,38793645,38836711,protein_coding,-1,43066,chr1_38793645_38836711
Chst10,1,38863867,38898161,protein_coding,-1,34294,chr1_38863867_38898161
Gm37707,1,38884754,38888072,antisense,1,3318,chr1_38884754_38888072
Nms,1,38939149,38950276,protein_coding,1,11127,chr1_38939149_38950276
Pdcl3,1,38985608,38997238,protein_coding,1,11630,chr1_38985608_38997238
Gm37821,1,39048648,39057637,lincRNA,-1,8989,chr1_39048648_39057637
Npas2,1,39193731,39363236,protein_coding,1,169505,chr1_39193731_39363236
Rpl31,1,39367842,39371911,protein_coding,1,4069,chr1_39367842_39371911
Tbc1d8,1,39371492,39478755,protein_coding,-1,107263,chr1_39371492_39478755
Cnot11,1,39534992,39546889,protein_coding,1,11897,chr1_39534992_39546889
Rnf149,1,39551296,39577405,protein_coding,-1,26109,chr1_39551296_39577405
Creg2,1,39618406,39651474,protein_coding,-1,33068,chr1_39618406_39651474
D930019O06Rik,1,39650176,39657390,antisense,1,7214,chr1_39650176_39657390
Rfx8,1,39665301,39720997,protein_coding,-1,55696,chr1_39665301_39720997
1700066B17Rik,1,39839175,39847334,lincRNA,-1,8159,chr1_39839175_39847334
Map4k4,1,39900913,40026310,protein_coding,1,125397,chr1_39900913_40026310
Il1r2,1,40074079,40125231,protein_coding,1,51152,chr1_40074079_40125231
Gm16894,1,40076228,40085851,antisense,-1,9623,chr1_40076228_40085851
Il1r1,1,40225080,40317257,protein_coding,1,92177,chr1_40225080_40317257
Il1rl2,1,40324610,40367562,protein_coding,1,42952,chr1_40324610_40367562
Il1rl1,1,40429570,40465415,protein_coding,1,35845,chr1_40429570_40465415
Il18r1,1,40465552,40500854,protein_coding,1,35302,chr1_40465552_40500854
Il18rap,1,40515362,40551705,protein_coding,1,36343,chr1_40515362_40551705
Gm35801,1,40572188,40580662,antisense,-1,8474,chr1_40572188_40580662
Slc9a4,1,40580081,40630725,protein_coding,1,50644,chr1_40580081_40630725
Slc9a2,1,40680574,40769273,protein_coding,1,88699,chr1_40680574_40769273
Gm37623,1,40691442,40697636,antisense,-1,6194,chr1_40691442_40697636
Gm37915,1,40771385,40785343,antisense,1,13958,chr1_40771385_40785343
Mfsd9,1,40772038,40790687,protein_coding,-1,18649,chr1_40772038_40790687
Tmem182,1,40805601,40856887,protein_coding,1,51286,chr1_40805601_40856887
Gm29260,1,41781808,41939560,lincRNA,1,157752,chr1_41781808_41939560
Gm9915,1,42229726,42231108,lincRNA,1,1382,chr1_42229726_42231108
Gm29664,1,42238233,42238695,lincRNA,-1,462,chr1_42238233_42238695
Gm28175,1,42261855,42304412,lincRNA,1,42557,chr1_42261855_42304412
Gm28140,1,42324590,42355937,lincRNA,-1,31347,chr1_42324590_42355937
Pantr1,1,42590782,42694842,lincRNA,-1,104060,chr1_42590782_42694842
Pou3f3,1,42694925,42703176,protein_coding,1,8251,chr1_42694925_42703176
Dalir,1,42750712,42752881,lincRNA,1,2169,chr1_42750712_42752881
Mrps9,1,42851233,42905683,protein_coding,1,54450,chr1_42851233_42905683
Gpr45,1,42952872,43035456,protein_coding,1,82584,chr1_42952872_43035456
Tgfbrap1,1,43047200,43098637,protein_coding,-1,51437,chr1_43047200_43098637
Gm28782,1,43056267,43057134,antisense,1,867,chr1_43056267_43057134
8430432A02Rik,1,43092588,43093835,antisense,1,1247,chr1_43092588_43093835
AI597479,1,43098710,43115947,protein_coding,1,17237,chr1_43098710_43115947
Fhl2,1,43123074,43196984,protein_coding,-1,73910,chr1_43123074_43196984
Gm29040,1,43250156,43302925,lincRNA,-1,52769,chr1_43250156_43302925
Nck2,1,43444579,43570515,protein_coding,1,125936,chr1_43444579_43570515
Gm29155,1,43741961,43743895,antisense,-1,1934,chr1_43741961_43743895
Gm29157,1,43742915,43743526,lincRNA,1,611,chr1_43742915_43743526
Gm29156,1,43745784,43746282,lincRNA,-1,498,chr1_43745784_43746282
Uxs1,1,43746966,43827800,protein_coding,-1,80834,chr1_43746966_43827800
Tpp2,1,43933647,44003000,protein_coding,1,69353,chr1_43933647_44003000
Mettl21c,1,44009408,44020034,protein_coding,-1,10626,chr1_44009408_44020034
Gm8251,1,44055872,44079746,protein_coding,-1,23874,chr1_44055872_44079746
Tex30,1,44086613,44102441,protein_coding,-1,15828,chr1_44086613_44102441
Bivm,1,44118957,44144770,protein_coding,1,25813,chr1_44118957_44144770
Ercc5,1,44147744,44181260,protein_coding,1,33516,chr1_44147744_44181260
Mettl21e,1,44204070,44218961,protein_coding,-1,14891,chr1_44204070_44218961
Gulp1,1,44551511,44796838,protein_coding,1,245327,chr1_44551511_44796838
4930521E06Rik,1,44739676,44744949,antisense,-1,5273,chr1_44739676_44744949
Col3a1,1,45311538,45349706,protein_coding,1,38168,chr1_45311538_45349706
Col5a2,1,45374321,45503282,protein_coding,-1,128961,chr1_45374321_45503282
Wdr75,1,45795166,45823619,protein_coding,1,28453,chr1_45795166_45823619
Gm5269,1,45889525,45890273,protein_coding,-1,748,chr1_45889525_45890273
Slc40a1,1,45908068,45926523,protein_coding,-1,18455,chr1_45908068_45926523
Dnah7b,1,46066315,46373550,protein_coding,1,307235,chr1_46066315_46373550
Dnah7c,1,46425592,46807476,protein_coding,1,381884,chr1_46425592_46807476
Slc39a10,1,46807544,46892852,protein_coding,-1,85308,chr1_46807544_46892852
Gm28826,1,47153461,47189071,lincRNA,1,35610,chr1_47153461_47189071
C230029F24Rik,1,49244616,49340443,lincRNA,1,95827,chr1_49244616_49340443
4933411E06Rik,1,50107470,50108962,lincRNA,1,1492,chr1_50107470_50108962
Tmeff2,1,50900647,51187270,protein_coding,1,286623,chr1_50900647_51187270
Gm28319,1,51138281,51141222,antisense,-1,2941,chr1_51138281_51141222
Gm29325,1,51195221,51197748,lincRNA,1,2527,chr1_51195221_51197748
9330175M20Rik,1,51218386,51333779,antisense,-1,115393,chr1_51218386_51333779
Cavin2,1,51289126,51302960,protein_coding,1,13834,chr1_51289126_51302960
Nabp1,1,51465862,51478425,protein_coding,-1,12563,chr1_51465862_51478425
Gm17767,1,51507086,51596718,lincRNA,-1,89632,chr1_51507086_51596718
Gm28055,1,51696324,51746943,lincRNA,-1,50619,chr1_51696324_51746943
Myo1b,1,51749765,51916071,protein_coding,-1,166306,chr1_51749765_51916071
Stat4,1,51987148,52107189,protein_coding,1,120041,chr1_51987148_52107189
Gm31812,1,52108121,52113751,lincRNA,-1,5630,chr1_52108121_52113751
Stat1,1,52119440,52161865,protein_coding,1,42425,chr1_52119440_52161865
Gls,1,52163448,52233232,protein_coding,-1,69784,chr1_52163448_52233232
Nab1,1,52457294,52500679,protein_coding,-1,43385,chr1_52457294_52500679
Gm553,1,52522902,52582679,lincRNA,1,59777,chr1_52522902_52582679
Gm28178,1,52570014,52580291,lincRNA,-1,10277,chr1_52570014_52580291
Nemp2,1,52630703,52651919,protein_coding,1,21216,chr1_52630703_52651919
Mfsd6,1,52656286,52727462,protein_coding,-1,71176,chr1_52656286_52727462
Inpp1,1,52785427,52817688,protein_coding,-1,32261,chr1_52785427_52817688
Hibch,1,52844929,52920986,protein_coding,1,76057,chr1_52844929_52920986
1700019D03Rik,1,52922324,53020179,protein_coding,-1,97855,chr1_52922324_53020179
Mstn,1,53061640,53068079,protein_coding,1,6439,chr1_53061640_53068079
1700019A02Rik,1,53158577,53187636,protein_coding,-1,29059,chr1_53158577_53187636
Pms1,1,53189187,53297018,protein_coding,-1,107831,chr1_53189187_53297018
Gm28777,1,53196113,53197695,antisense,1,1582,chr1_53196113_53197695
Ormdl1,1,53297095,53310309,protein_coding,1,13214,chr1_53297095_53310309
Gm28778,1,53297111,53318035,protein_coding,1,20924,chr1_53297111_53318035
Osgepl1,1,53313624,53326343,protein_coding,1,12719,chr1_53313624_53326343
Gm28551,1,53325507,53352667,protein_coding,-1,27160,chr1_53325507_53352667
Asnsd1,1,53344617,53352752,protein_coding,-1,8135,chr1_53344617_53352752
Dnah7a,1,53397006,53706784,protein_coding,-1,309778,chr1_53397006_53706784
Stk17b,1,53755506,53785224,protein_coding,-1,29718,chr1_53755506_53785224
Hecw2,1,53806876,54195168,protein_coding,-1,388292,chr1_53806876_54195168
Ccdc150,1,54250683,54368727,protein_coding,1,118044,chr1_54250683_54368727
Gtf3c3,1,54396004,54438971,protein_coding,-1,42967,chr1_54396004_54438971
Gm34066,1,54443404,54456763,protein_coding,-1,13359,chr1_54443404_54456763
Pgap1,1,54472994,54557684,protein_coding,-1,84690,chr1_54472994_54557684
Ankrd44,1,54645340,54926387,protein_coding,-1,281047,chr1_54645340_54926387
4930444A19Rik,1,54681729,54767524,antisense,1,85795,chr1_54681729_54767524
Sf3b1,1,54985169,55027481,protein_coding,-1,42312,chr1_54985169_55027481
Coq10b,1,55052770,55072702,protein_coding,1,19932,chr1_55052770_55072702
Hspd1,1,55077835,55088243,protein_coding,-1,10408,chr1_55077835_55088243
Hspe1,1,55088132,55091307,protein_coding,1,3175,chr1_55088132_55091307
Mob4,1,55131231,55154899,protein_coding,1,23668,chr1_55131231_55154899
Rftn2,1,55170159,55226782,protein_coding,-1,56623,chr1_55170159_55226782
Gm10561,1,55226251,55235622,antisense,1,9371,chr1_55226251_55235622
Mars2,1,55237177,55248470,protein_coding,1,11293,chr1_55237177_55248470
Boll,1,55248658,55363469,protein_coding,-1,114811,chr1_55248658_55363469
Plcl1,1,55405921,55754285,protein_coding,1,348364,chr1_55405921_55754285
9130227L01Rik,1,55931241,55972328,lincRNA,1,41087,chr1_55931241_55972328
Gm28240,1,56531824,56533876,lincRNA,1,2052,chr1_56531824_56533876
Hsfy2,1,56636044,56637435,protein_coding,-1,1391,chr1_56636044_56637435
Satb2,1,56793981,56978650,protein_coding,-1,184669,chr1_56793981_56978650
BC055402,1,57200645,57214993,lincRNA,-1,14348,chr1_57200645_57214993
4930558J18Rik,1,57359222,57377544,lincRNA,-1,18322,chr1_57359222_57377544
1700066M21Rik,1,57377620,57385423,protein_coding,1,7803,chr1_57377620_57385423
Tyw5,1,57388237,57407101,protein_coding,-1,18864,chr1_57388237_57407101
Maip1,1,57406328,57417953,protein_coding,1,11625,chr1_57406328_57417953
Spats2l,1,57774162,57948394,protein_coding,1,174232,chr1_57774162_57948394
Gm17234,1,57909835,57917111,antisense,-1,7276,chr1_57909835_57917111
Kctd18,1,57955101,58018956,protein_coding,-1,63855,chr1_57955101_58018956
Sgo2a,1,57995971,58025899,protein_coding,1,29928,chr1_57995971_58025899
Aox1,1,58029931,58106413,protein_coding,1,76482,chr1_58029931_58106413
Aox3,1,58113130,58200698,protein_coding,1,87568,chr1_58113130_58200698
Aox4,1,58210397,58268597,protein_coding,1,58200,chr1_58210397_58268597
Gm15759,1,58254117,58315656,antisense,-1,61539,chr1_58254117_58315656
Aox2,1,58278326,58380259,protein_coding,1,101933,chr1_58278326_58380259
Bzw1,1,58392898,58407353,protein_coding,1,14455,chr1_58392898_58407353
Clk1,1,58410189,58424066,protein_coding,-1,13877,chr1_58410189_58424066
Ppil3,1,58430994,58445486,protein_coding,-1,14492,chr1_58430994_58445486
Nif3l1,1,58445151,58481816,protein_coding,1,36665,chr1_58445151_58481816
Orc2,1,58462771,58505109,protein_coding,-1,42338,chr1_58462771_58505109
Gm15834,1,58505148,58523230,lincRNA,1,18082,chr1_58505148_58523230
Fam126b,1,58522806,58586323,protein_coding,-1,63517,chr1_58522806_58586323
Ndufb3,1,58586384,58595964,protein_coding,1,9580,chr1_58586384_58595964
Cflar,1,58711508,58758884,protein_coding,1,47376,chr1_58711508_58758884
Casp8,1,58795374,58847503,protein_coding,1,52129,chr1_58795374_58847503
Trak2,1,58900449,58973430,protein_coding,-1,72981,chr1_58900449_58973430
Stradb,1,58973522,58995715,protein_coding,1,22193,chr1_58973522_58995715
Gm29018,1,59014224,59059481,antisense,1,45257,chr1_59014224_59059481
C2cd6,1,58997116,59094900,protein_coding,-1,97784,chr1_58997116_59094900
Tmem237,1,59100590,59120408,protein_coding,-1,19818,chr1_59100590_59120408
G730003C15Rik,1,59119833,59122141,antisense,1,2308,chr1_59119833_59122141
Mpp4,1,59120935,59163389,protein_coding,-1,42454,chr1_59120935_59163389
Gm29017,1,59151047,59169320,antisense,1,18273,chr1_59151047_59169320
Als2,1,59162926,59237231,protein_coding,-1,74305,chr1_59162926_59237231
Cdk15,1,59256906,59352993,protein_coding,1,96087,chr1_59256906_59352993
Gm29016,1,59378930,59392299,lincRNA,1,13369,chr1_59378930_59392299
Fzd7,1,59482424,59486955,protein_coding,1,4531,chr1_59482424_59486955
Gm973,1,59516264,59636417,protein_coding,1,120153,chr1_59516264_59636417
Gm28411,1,59532991,59549521,antisense,-1,16530,chr1_59532991_59549521
Sumo1,1,59586558,59670834,protein_coding,-1,84276,chr1_59586558_59670834
Nop58,1,59684971,59719044,protein_coding,1,34073,chr1_59684971_59719044
Bmpr2,1,59763400,59879014,protein_coding,1,115614,chr1_59763400_59879014
Fam117b,1,59913006,59985346,protein_coding,1,72340,chr1_59913006_59985346
Ica1l,1,59982490,60043184,protein_coding,-1,60694,chr1_59982490_60043184
Wdr12,1,60069785,60098645,protein_coding,-1,28860,chr1_60069785_60098645
Carf,1,60098247,60153953,protein_coding,1,55706,chr1_60098247_60153953
Nbeal1,1,60180599,60338328,protein_coding,1,157729,chr1_60180599_60338328
Cyp20a1,1,60343323,60388060,protein_coding,1,44737,chr1_60343323_60388060
Abi2,1,60409619,60481158,protein_coding,1,71539,chr1_60409619_60481158
Raph1,1,60482292,60567104,protein_coding,-1,84812,chr1_60482292_60567104
Cd28,1,60716800,60773359,protein_coding,1,56559,chr1_60716800_60773359
Gm11579,1,60775480,60787527,lincRNA;lncRNA,-1,12047,chr1_60775480_60787527
2310016D23Rik,1,60778843,60803790,lincRNA,1,24947,chr1_60778843_60803790
Ctla4,1,60887000,60942198,protein_coding,1,55198,chr1_60887000_60942198
Icos,1,60977927,61000320,protein_coding,1,22393,chr1_60977927_61000320
Gm11587,1,61301909,61307746,lincRNA,1,5837,chr1_61301909_61307746
9530026F06Rik,1,61378432,61395904,lincRNA,1,17472,chr1_61378432_61395904
Gm11588,1,61440101,61469475,lincRNA,1,29374,chr1_61440101_61469475
Gm28449,1,61474951,61476028,lincRNA,1,1077,chr1_61474951_61476028
4930587A21Rik,1,61616943,61621149,lincRNA,-1,4206,chr1_61616943_61621149
Pard3b,1,61638824,62642284,protein_coding,1,1003460,chr1_61638824_62642284
Pard3bos1,1,61767415,61851540,antisense,-1,84125,chr1_61767415_61851540
Pard3bos3,1,62456725,62499261,antisense,-1,42536,chr1_62456725_62499261
Gm29084,1,62534491,62535942,antisense,-1,1451,chr1_62534491_62535942
Nrp2,1,62703285,62818695,protein_coding,1,115410,chr1_62703285_62818695
Gm29083,1,62714723,62718073,antisense,-1,3350,chr1_62714723_62718073
Gm4208,1,62821355,62832370,lincRNA,-1,11015,chr1_62821355_62832370
Ino80d,1,62958418,63114667,protein_coding,-1,156249,chr1_62958418_63114667
Ino80dos,1,63113078,63158290,lincRNA,1,45212,chr1_63113078_63158290
Ndufs1,1,63143596,63176833,protein_coding,-1,33237,chr1_63143596_63176833
Eef1b2,1,63176825,63180486,protein_coding,1,3661,chr1_63176825_63180486
Gpr1,1,63182691,63214543,protein_coding,-1,31852,chr1_63182691_63214543
Gm11608,1,63266848,63273120,lincRNA,-1,6272,chr1_63266848_63273120
Zdbf2,1,63273265,63314576,protein_coding,1,41311,chr1_63273265_63314576
Adam23,1,63445891,63596276,protein_coding,1,150385,chr1_63445891_63596276
Gm39653,1,63615968,63620819,protein_coding,1,4851,chr1_63615968_63620819
Dytn,1,63622851,63686927,protein_coding,-1,64076,chr1_63622851_63686927
Mdh1b,1,63698819,63730318,protein_coding,-1,31499,chr1_63698819_63730318
Fastkd2,1,63730614,63754655,protein_coding,1,24041,chr1_63730614_63754655
4933402D24Rik,1,63754907,63769267,protein_coding,-1,14360,chr1_63754907_63769267
Gm13749,1,63964727,63968999,lincRNA,1,4272,chr1_63964727_63968999
Klf7,1,64029447,64122282,protein_coding,-1,92835,chr1_64029447_64122282
Gm13748,1,64078654,64090782,antisense,1,12128,chr1_64078654_64090782
Gm28981,1,64185991,64303043,lincRNA,-1,117052,chr1_64185991_64303043
Creb1,1,64532645,64604548,protein_coding,1,71903,chr1_64532645_64604548
Mettl21a,1,64606473,64617242,protein_coding,-1,10769,chr1_64606473_64617242
Gm28982,1,64617784,64626033,lincRNA,1,8249,chr1_64617784_64626033
Gm29152,1,64649935,64652756,lincRNA,1,2821,chr1_64649935_64652756
Ccnyl1,1,64690455,64725644,protein_coding,1,35189,chr1_64690455_64725644
Fzd5,1,64730558,64737751,protein_coding,-1,7193,chr1_64730558_64737751
Plekhm3,1,64785983,64956824,protein_coding,-1,170841,chr1_64785983_64956824
Akr1cl,1,65012689,65032759,protein_coding,-1,20070,chr1_65012689_65032759
Cryge,1,65048554,65051149,protein_coding,-1,2595,chr1_65048554_65051149
Cryga,1,65100389,65103373,protein_coding,-1,2984,chr1_65100389_65103373
Gm28845,1,65100619,65119558,protein_coding,-1,18939,chr1_65100619_65119558
D630023F18Rik,1,65105285,65123214,protein_coding,-1,17929,chr1_65105285_65123214
Idh1,1,65158616,65186500,protein_coding,-1,27884,chr1_65158616_65186500
Pikfyve,1,65186683,65278695,protein_coding,1,92012,chr1_65186683_65278695
Pth2r,1,65282056,65389244,protein_coding,1,107188,chr1_65282056_65389244
Map2,1,66175273,66442583,protein_coding,1,267310,chr1_66175273_66442583
Gm10558,1,66322276,66328796,antisense,-1,6520,chr1_66322276_66328796
Unc80,1,66468367,66699148,protein_coding,1,230781,chr1_66468367_66699148
Rpe,1,66700831,66719805,protein_coding,1,18974,chr1_66700831_66719805
Kansl1l,1,66719248,66817562,protein_coding,-1,98314,chr1_66719248_66817562
Acadl,1,66830839,66863277,protein_coding,-1,32438,chr1_66830839_66863277
Myl1,1,66924295,66945404,protein_coding,-1,21109,chr1_66924295_66945404
Lancl1,1,67000517,67038872,protein_coding,-1,38355,chr1_67000517_67038872
Cps1,1,67123026,67231259,protein_coding,1,108233,chr1_67123026_67231259
Gm15668,1,67249200,67323609,lincRNA,1,74409,chr1_67249200_67323609
Gm15669,1,67792481,67805324,lincRNA,1,12843,chr1_67792481_67805324
Erbb4,1,68032186,69108059,protein_coding,-1,1075873,chr1_68032186_69108059
Gm28497,1,69441056,69444084,lincRNA,1,3028,chr1_69441056_69444084
Gm29113,1,69490357,69493788,lincRNA,-1,3431,chr1_69490357_69493788
Gm29114,1,69513932,69547707,antisense,1,33775,chr1_69513932_69547707
Ikzf2,1,69531214,69687245,protein_coding,-1,156031,chr1_69531214_69687245
Spag16,1,69826970,70725132,protein_coding,1,898162,chr1_69826970_70725132
Vwc2l,1,70725715,70885397,protein_coding,1,159682,chr1_70725715_70885397
Bard1,1,71027498,71103146,protein_coding,-1,75648,chr1_71027498_71103146
Abca12,1,71242276,71414910,protein_coding,-1,172634,chr1_71242276_71414910
Atic,1,71557150,71579631,protein_coding,1,22481,chr1_71557150_71579631
Fn1,1,71585520,71653200,protein_coding,-1,67680,chr1_71585520_71653200
Apol7d,1,71652837,71662843,antisense,1,10006,chr1_71652837_71662843
Gm28818,1,71894068,71917125,lincRNA,-1,23057,chr1_71894068_71917125
4933417E11Rik,1,71958998,72005195,lincRNA,-1,46197,chr1_71958998_72005195
4930556G22Rik,1,71983681,72038731,lincRNA,-1,55050,chr1_71983681_72038731
Gm4319,1,72107155,72122001,lincRNA,-1,14846,chr1_72107155_72122001
Mreg,1,72159442,72212307,protein_coding,-1,52865,chr1_72159442_72212307
Pecr,1,72259167,72284314,protein_coding,-1,25147,chr1_72259167_72284314
Tmem169,1,72284369,72303104,protein_coding,1,18735,chr1_72284369_72303104
Xrcc5,1,72307427,72394952,protein_coding,1,87525,chr1_72307427_72394952
Smarcal1,1,72583251,72633134,protein_coding,1,49883,chr1_72583251_72633134
Gm39662,1,72641188,72642963,antisense,1,1775,chr1_72641188_72642963
Ankar,1,72642980,72700579,protein_coding,-1,57599,chr1_72642980_72700579
Rpl37a,1,72711290,72713813,protein_coding,1,2523,chr1_72711290_72713813
Igfbp2,1,72824503,72852474,protein_coding,1,27971,chr1_72824503_72852474
Igfbp5,1,72857932,72874884,protein_coding,-1,16952,chr1_72857932_72874884
1700027A15Rik,1,72984844,73025507,antisense,1,40663,chr1_72984844_73025507
Gm29185,1,73269064,73306360,lincRNA,1,37296,chr1_73269064_73306360
D530049I02Rik,1,73398968,73430790,lincRNA,1,31822,chr1_73398968_73430790
Gm29186,1,73528937,73536349,lincRNA,1,7412,chr1_73528937_73536349
6030407O03Rik,1,73618088,73864466,lincRNA,-1,246378,chr1_73618088_73864466
Tns1,1,73910231,74124449,protein_coding,-1,214218,chr1_73910231_74124449
Rufy4,1,74125541,74148223,protein_coding,1,22682,chr1_74125541_74148223
Cxcr2,1,74153989,74161246,protein_coding,1,7257,chr1_74153989_74161246
Arpc2,1,74236084,74268209,protein_coding,1,32125,chr1_74236084_74268209
Aamp,1,74279840,74284738,protein_coding,-1,4898,chr1_74279840_74284738
Gm28364,1,74281161,74281866,antisense,1,705,chr1_74281161_74281866
Pnkd,1,74284930,74353694,protein_coding,1,68764,chr1_74284930_74353694
Tmbim1,1,74288247,74305622,protein_coding,-1,17375,chr1_74288247_74305622
Catip,1,74362108,74369321,protein_coding,1,7213,chr1_74362108_74369321
Slc11a1,1,74375195,74386062,protein_coding,1,10867,chr1_74375195_74386062
Ctdsp1,1,74391509,74397285,protein_coding,1,5776,chr1_74391509_74397285
Vil1,1,74409376,74435559,protein_coding,1,26183,chr1_74409376_74435559
Usp37,1,74435511,74544284,protein_coding,-1,108773,chr1_74435511_74544284
Cnot9,1,74506058,74530842,protein_coding,1,24784,chr1_74506058_74530842
Plcd4,1,74542888,74567794,protein_coding,1,24906,chr1_74542888_74567794
Zfp142,1,74565127,74588246,protein_coding,-1,23119,chr1_74565127_74588246
Bcs1l,1,74588289,74592443,protein_coding,1,4154,chr1_74588289_74592443
Rnf25,1,74593748,74601397,protein_coding,-1,7649,chr1_74593748_74601397
Stk36,1,74601445,74636894,protein_coding,1,35449,chr1_74601445_74636894
Ttll4,1,74661745,74703730,protein_coding,1,41985,chr1_74661745_74703730
Cyp27a1,1,74713574,74737892,protein_coding,1,24318,chr1_74713574_74737892
Prkag3,1,74738922,74749221,protein_coding,-1,10299,chr1_74738922_74749221
Wnt6,1,74771892,74785322,protein_coding,1,13430,chr1_74771892_74785322
Gm29539,1,74774943,74777405,antisense,-1,2462,chr1_74774943_74777405
Wnt10a,1,74791516,74804179,protein_coding,1,12663,chr1_74791516_74804179
Cdk5r2,1,74854934,74857732,protein_coding,1,2798,chr1_74854934_74857732
Fev,1,74881509,74885419,protein_coding,-1,3910,chr1_74881509_74885419
Cryba2,1,74889934,74893143,protein_coding,-1,3209,chr1_74889934_74893143
Cfap65,1,74902071,74935599,protein_coding,-1,33528,chr1_74902071_74935599
Gm15841,1,74902371,74907653,antisense,1,5282,chr1_74902371_74907653
Ihh,1,74945315,74951672,protein_coding,-1,6357,chr1_74945315_74951672
Nhej1,1,74967139,75125200,protein_coding,-1,158061,chr1_74967139_75125200
Slc23a3,1,75125541,75133890,protein_coding,-1,8349,chr1_75125541_75133890
Cnppd1,1,75134554,75142711,protein_coding,-1,8157,chr1_75134554_75142711
Retreg2,1,75142778,75147913,protein_coding,1,5135,chr1_75142778_75147913
Zfand2b,1,75168646,75171629,protein_coding,1,2983,chr1_75168646_75171629
Abcb6,1,75171717,75180392,protein_coding,-1,8675,chr1_75171717_75180392
Atg9a,1,75180860,75192196,protein_coding,-1,11336,chr1_75180860_75192196
Ankzf1,1,75192151,75199387,protein_coding,1,7236,chr1_75192151_75199387
Glb1l,1,75198236,75210813,protein_coding,-1,12577,chr1_75198236_75210813
Stk16,1,75210838,75215606,protein_coding,1,4768,chr1_75210838_75215606
Tuba4a,1,75214228,75219865,protein_coding,-1,5637,chr1_75214228_75219865
A630095N17Rik,1,75220095,75232102,protein_coding,-1,12007,chr1_75220095_75232102
Dnajb2,1,75236406,75245692,protein_coding,1,9286,chr1_75236406_75245692
Ptprn,1,75247027,75264502,protein_coding,-1,17475,chr1_75247027_75264502
Gm28294,1,75252322,75257427,antisense,1,5105,chr1_75252322_75257427
Resp18,1,75272199,75278415,protein_coding,-1,6216,chr1_75272199_75278415
Gm28902,1,75272605,75275652,antisense,1,3047,chr1_75272605_75275652
Dnpep,1,75307896,75317990,protein_coding,-1,10094,chr1_75307896_75317990
Des,1,75360329,75368579,protein_coding,1,8250,chr1_75360329_75368579
Gm15179,1,75368212,75375012,antisense,-1,6800,chr1_75368212_75375012
Speg,1,75375297,75432320,protein_coding,1,57023,chr1_75375297_75432320
Gm15178,1,75392131,75396363,antisense,-1,4232,chr1_75392131_75396363
Gmppa,1,75435930,75443179,protein_coding,1,7249,chr1_75435930_75443179
Asic4,1,75450436,75474343,protein_coding,1,23907,chr1_75450436_75474343
Chpf,1,75474569,75479307,protein_coding,-1,4738,chr1_75474569_75479307
Obsl1,1,75479310,75506452,protein_coding,-1,27142,chr1_75479310_75506452
Tmem198,1,75479532,75485705,protein_coding,1,6173,chr1_75479532_75485705
Inha,1,75507077,75510366,protein_coding,1,3289,chr1_75507077_75510366
Stk11ip,1,75521529,75537335,protein_coding,1,15806,chr1_75521529_75537335
Slc4a3,1,75546266,75562172,protein_coding,1,15906,chr1_75546266_75562172
Gm29069,1,76420692,76528422,lincRNA,1,107730,chr1_76420692_76528422
Gm816,1,76890472,77027792,lincRNA,-1,137320,chr1_76890472_77027792
Epha4,1,77367185,77515088,protein_coding,-1,147903,chr1_77367185_77515088
Gm28386,1,77515280,77517128,lincRNA,1,1848,chr1_77515280_77517128
Gm28387,1,77942966,77972376,lincRNA,-1,29410,chr1_77942966_77972376
Pax3,1,78101267,78197134,protein_coding,-1,95867,chr1_78101267_78197134
Sgpp2,1,78310345,78420289,protein_coding,1,109944,chr1_78310345_78420289
Gm28410,1,78325628,78340106,antisense,-1,14478,chr1_78325628_78340106
Farsb,1,78417975,78488897,protein_coding,-1,70922,chr1_78417975_78488897
BC035947,1,78497026,78512158,protein_coding,-1,15132,chr1_78497026_78512158
Mogat1,1,78510991,78538173,protein_coding,1,27182,chr1_78510991_78538173
5730419F03Rik,1,78595031,78609508,lincRNA,-1,14477,chr1_78595031_78609508
Gm29611,1,78615467,78620165,lincRNA,1,4698,chr1_78615467_78620165
Acsl3,1,78657825,78707743,protein_coding,1,49918,chr1_78657825_78707743
Gm29536,1,78791623,79224511,lincRNA,-1,432888,chr1_78791623_79224511
Kcne4,1,78816758,78820028,protein_coding,1,3270,chr1_78816758_78820028
Scg2,1,79434669,79440120,protein_coding,-1,5451,chr1_79434669_79440120
Ap1s3,1,79606876,79671972,protein_coding,-1,65096,chr1_79606876_79671972
Wdfy1,1,79702262,79776143,protein_coding,-1,73881,chr1_79702262_79776143
Mrpl44,1,79776018,79781445,protein_coding,1,5427,chr1_79776018_79781445
Serpine2,1,79794197,79861180,protein_coding,-1,66983,chr1_79794197_79861180
9830004L10Rik,1,80184719,80192073,lincRNA,1,7354,chr1_80184719_80192073
Fam124b,1,80198706,80218473,protein_coding,-1,19767,chr1_80198706_80218473
Cul3,1,80264923,80340480,protein_coding,-1,75557,chr1_80264923_80340480
Gm29125,1,80382822,80386251,lincRNA,1,3429,chr1_80382822_80386251
1700016L21Rik,1,80445932,80479867,antisense,1,33935,chr1_80445932_80479867
Gm45261,1,80449597,80461448,protein_coding,-1,11851,chr1_80449597_80461448
Dock10,1,80501073,80758527,protein_coding,-1,257454,chr1_80501073_80758527
Nyap2,1,81076950,81341764,protein_coding,1,264814,chr1_81076950_81341764
Irs1,1,82233101,82291416,protein_coding,-1,58315,chr1_82233101_82291416
Gm9747,1,82233112,82235933,protein_coding,1,2821,chr1_82233112_82235933
Rhbdd1,1,82316452,82445366,protein_coding,1,128914,chr1_82316452_82445366
Gm28940,1,82392493,82402746,antisense,-1,10253,chr1_82392493_82402746
Col4a4,1,82448423,82586849,protein_coding,-1,138426,chr1_82448423_82586849
Col4a3,1,82586921,82722059,protein_coding,1,135138,chr1_82586921_82722059
Mff,1,82724890,82752394,protein_coding,1,27504,chr1_82724890_82752394
Tm4sf20,1,82756649,82768461,protein_coding,-1,11812,chr1_82756649_82768461
Agfg1,1,82839483,82901182,protein_coding,1,61699,chr1_82839483_82901182
A030005L19Rik,1,82913325,82914130,protein_coding,1,805,chr1_82913325_82914130
A030014E15Rik,1,82924917,82925712,protein_coding,1,795,chr1_82924917_82925712
Slc19a3,1,83012523,83038448,protein_coding,-1,25925,chr1_83012523_83038448
Krtap28-10,1,83041524,83042480,protein_coding,-1,956,chr1_83041524_83042480
Gm47969,1,83044932,83045946,protein_coding,1,1014,chr1_83044932_83045946
Krtap28-13,1,83060930,83061921,protein_coding,1,991,chr1_83060930_83061921
Daw1,1,83159752,83210574,protein_coding,1,50822,chr1_83159752_83210574
Sphkap,1,83254139,83408200,protein_coding,-1,154061,chr1_83254139_83408200
4933436I20Rik,1,83659550,83911644,lincRNA,-1,252094,chr1_83659550_83911644
Pid1,1,84036296,84364180,protein_coding,-1,327884,chr1_84036296_84364180
Dner,1,84369839,84696221,protein_coding,-1,326382,chr1_84369839_84696221
Trip12,1,84721189,84840516,protein_coding,-1,119327,chr1_84721189_84840516
Fbxo36,1,84839841,84900487,protein_coding,1,60646,chr1_84839841_84900487
Slc16a14,1,84905898,84935134,protein_coding,-1,29236,chr1_84905898_84935134
C130026I21Rik,1,84992690,85270566,protein_coding,-1,277876,chr1_84992690_85270566
A530040E14Rik,1,85105946,85114035,antisense,1,8089,chr1_85105946_85114035
Gm16028,1,85246851,85255465,antisense,1,8614,chr1_85246851_85255465
Gm16025,1,85326729,85342615,lincRNA,1,15886,chr1_85326729_85342615
Gm16092,1,85511133,85527161,lincRNA,-1,16028,chr1_85511133_85527161
G530012D18Rik,1,85575676,85577295,protein_coding,1,1619,chr1_85575676_85577295
Sp110,1,85576899,85598817,protein_coding,-1,21918,chr1_85576899_85598817
Sp140,1,85600378,85645037,protein_coding,1,44659,chr1_85600378_85645037
Gm10552,1,85604085,85611896,antisense,-1,7811,chr1_85604085_85611896
Gm17017,1,85641222,85650585,antisense,-1,9363,chr1_85641222_85650585
Sp100,1,85649988,85709998,protein_coding,1,60010,chr1_85649988_85709998
A630001G21Rik,1,85717083,85778643,protein_coding,-1,61560,chr1_85717083_85778643
9930111H07Rik,1,85775271,85784694,lincRNA,1,9423,chr1_85775271_85784694
Cab39,1,85793441,85851576,protein_coding,1,58135,chr1_85793441_85851576
Itm2c,1,85894281,85908675,protein_coding,1,14394,chr1_85894281_85908675
4933407L21Rik,1,85928483,85940624,protein_coding,1,12141,chr1_85928483_85940624
Gm28884,1,85933247,85937332,antisense,-1,4085,chr1_85933247_85937332
Gpr55,1,85938318,85961007,protein_coding,-1,22689,chr1_85938318_85961007
Gm28100,1,85972365,85986917,lincRNA,-1,14552,chr1_85972365_85986917
Spata3,1,86016816,86029958,protein_coding,1,13142,chr1_86016816_86029958
2810459M11Rik,1,86045863,86055456,protein_coding,1,9593,chr1_86045863_86055456
Psmd1,1,86064387,86139151,protein_coding,1,74764,chr1_86064387_86139151
Htr2b,1,86099026,86111970,protein_coding,-1,12944,chr1_86099026_86111970
Gm21972,1,86133637,86162788,protein_coding,1,29151,chr1_86133637_86162788
Armc9,1,86154780,86278284,protein_coding,1,123504,chr1_86154780_86278284
Gm16341,1,86275509,86301375,antisense,-1,25866,chr1_86275509_86301375
B3gnt7,1,86302832,86307305,protein_coding,1,4473,chr1_86302832_86307305
Gm28626,1,86303195,86304059,antisense,-1,864,chr1_86303195_86304059
Ncl,1,86344719,86359400,protein_coding,-1,14681,chr1_86344719_86359400
Nmur1,1,86386303,86426228,protein_coding,-1,39925,chr1_86386303_86426228
Ptma,1,86526726,86530712,protein_coding,1,3986,chr1_86526726_86530712
Pde6d,1,86542994,86582629,protein_coding,-1,39635,chr1_86542994_86582629
Cops7b,1,86582904,86609375,protein_coding,1,26471,chr1_86582904_86609375
Nppc,1,86666291,86670571,protein_coding,-1,4280,chr1_86666291_86670571
Dis3l2,1,86703808,87050095,protein_coding,1,346287,chr1_86703808_87050095
Gm28375,1,86929387,87057596,antisense,-1,128209,chr1_86929387_87057596
Gm29371,1,87080171,87096418,lincRNA,1,16247,chr1_87080171_87096418
Gm29374,1,87142874,87146983,lincRNA,-1,4109,chr1_87142874_87146983
Ecel1,1,87147655,87156521,protein_coding,-1,8866,chr1_87147655_87156521
Prss56,1,87183313,87188405,protein_coding,1,5092,chr1_87183313_87188405
Chrnd,1,87190607,87200070,protein_coding,1,9463,chr1_87190607_87200070
Chrng,1,87204657,87212694,protein_coding,1,8037,chr1_87204657_87212694
Eif4e2,1,87213914,87240488,protein_coding,1,26574,chr1_87213914_87240488
Efhd1,1,87264363,87310839,protein_coding,1,46476,chr1_87264363_87310839
Gigyf2,1,87326998,87450796,protein_coding,1,123798,chr1_87326998_87450796
Kcnj13,1,87386363,87394729,protein_coding,-1,8366,chr1_87386363_87394729
Ngef,1,87476834,87573870,protein_coding,-1,97036,chr1_87476834_87573870
Neu2,1,87509889,87597845,protein_coding,1,87956,chr1_87509889_87597845
Inpp5d,1,87620312,87720507,protein_coding,1,100195,chr1_87620312_87720507
Atg16l1,1,87755870,87792428,protein_coding,1,36558,chr1_87755870_87792428
Sag,1,87803680,87845158,protein_coding,1,41478,chr1_87803680_87845158
Dgkd,1,87853287,87945180,protein_coding,1,91893,chr1_87853287_87945180
Gm19582,1,87853347,87854299,antisense,-1,952,chr1_87853347_87854299
Usp40,1,87945119,88008551,protein_coding,-1,63432,chr1_87945119_88008551
Ugt1a10,1,88055388,88219004,protein_coding,1,163616,chr1_88055388_88219004
Dnajb3,1,88204732,88205782,protein_coding,-1,1050,chr1_88204732_88205782
Mroh2a,1,88226986,88262289,protein_coding,1,35303,chr1_88226986_88262289
Hjurp,1,88262471,88277633,protein_coding,-1,15162,chr1_88262471_88277633
Trpm8,1,88277661,88389293,protein_coding,1,111632,chr1_88277661_88389293
Gm29538,1,88443969,88462608,lincRNA,-1,18639,chr1_88443969_88462608
Gm28888,1,88459683,88465558,lincRNA,1,5875,chr1_88459683_88465558
Glrp1,1,88499871,88510066,protein_coding,-1,10195,chr1_88499871_88510066
Gm19589,1,88551517,88562167,lincRNA,1,10650,chr1_88551517_88562167
Gm29336,1,88656308,88658100,lincRNA,1,1792,chr1_88656308_88658100
Arl4c,1,88673125,88702221,protein_coding,-1,29096,chr1_88673125_88702221
Gm29337,1,88868475,88875410,lincRNA,-1,6935,chr1_88868475_88875410
Sh3bp4,1,89070415,89155068,protein_coding,1,84653,chr1_89070415_89155068
Gm28342,1,89302719,89358144,lincRNA,-1,55425,chr1_89302719_89358144
C030007H22Rik,1,89360342,89406133,lincRNA,-1,45791,chr1_89360342_89406133
Agap1,1,89454806,89897617,protein_coding,1,442811,chr1_89454806_89897617
Gbx2,1,89927956,89931179,protein_coding,-1,3223,chr1_89927956_89931179
Asb18,1,89950220,90014666,protein_coding,-1,64446,chr1_89950220_90014666
Iqca,1,90042132,90153401,protein_coding,-1,111269,chr1_90042132_90153401
Ackr3,1,90203980,90216751,protein_coding,1,12771,chr1_90203980_90216751
Gm28721,1,90255276,90260120,lincRNA,-1,4844,chr1_90255276_90260120
Gm28723,1,90280458,90283912,lincRNA,1,3454,chr1_90280458_90283912
Gm28722,1,90453394,90454501,lincRNA,-1,1107,chr1_90453394_90454501
Cops8,1,90602981,90613341,protein_coding,1,10360,chr1_90602981_90613341
Col6a3,1,90765923,90843971,protein_coding,-1,78048,chr1_90765923_90843971
Mlph,1,90915085,90951142,protein_coding,1,36057,chr1_90915085_90951142
Rab17,1,90958133,90969661,protein_coding,-1,11528,chr1_90958133_90969661
Gm28199,1,90974459,90975260,lincRNA,-1,801,chr1_90974459_90975260
Lrrfip1,1,90998737,91128944,protein_coding,1,130207,chr1_90998737_91128944
Rbm44,1,91145089,91170795,protein_coding,1,25706,chr1_91145089_91170795
Ramp1,1,91179822,91225196,protein_coding,1,45374,chr1_91179822_91225196
Ube2f,1,91250304,91290337,protein_coding,1,40033,chr1_91250304_91290337
Scly,1,91298338,91321075,protein_coding,1,22737,chr1_91298338_91321075
Gm17090,1,91305092,91321101,antisense,-1,16009,chr1_91305092_91321101
Espnl,1,91322075,91348306,protein_coding,1,26231,chr1_91322075_91348306
Klhl30,1,91351016,91362416,protein_coding,1,11400,chr1_91351016_91362416
Erfe,1,91366430,91374217,protein_coding,1,7787,chr1_91366430_91374217
Ilkap,1,91373861,91398815,protein_coding,-1,24954,chr1_91373861_91398815
Hes6,1,91411483,91414038,protein_coding,-1,2555,chr1_91411483_91414038
Per2,1,91415982,91459324,protein_coding,-1,43342,chr1_91415982_91459324
Traf3ip1,1,91494647,91529307,protein_coding,1,34660,chr1_91494647_91529307
Asb1,1,91540544,91559589,protein_coding,1,19045,chr1_91540544_91559589
Gm28380,1,91611406,91624500,lincRNA,1,13094,chr1_91611406_91624500
Gm29100,1,91798528,91802937,antisense,-1,4409,chr1_91798528_91802937
Twist2,1,91801461,91848028,protein_coding,1,46567,chr1_91801461_91848028
Hdac4,1,91928779,92195699,protein_coding,-1,266920,chr1_91928779_92195699
Gm29099,1,92324510,92329888,lincRNA,1,5378,chr1_92324510_92329888
Ndufa10,1,92439010,92473860,protein_coding,-1,34850,chr1_92439010_92473860
Olfr1416,1,92475925,92485113,protein_coding,-1,9188,chr1_92475925_92485113
Cops9,1,92637145,92641985,protein_coding,-1,4840,chr1_92637145_92641985
Otos,1,92644218,92648841,protein_coding,-1,4623,chr1_92644218_92648841
Gm29483,1,92714234,92717202,lincRNA,-1,2968,chr1_92714234_92717202
Gm29481,1,92820958,92837896,antisense,-1,16938,chr1_92820958_92837896
Gpc1,1,92831645,92860779,protein_coding,1,29134,chr1_92831645_92860779
Gm29480,1,92842177,92848771,antisense,-1,6594,chr1_92842177_92848771
Ankmy1,1,92859803,92902906,protein_coding,-1,43103,chr1_92859803_92902906
Dusp28,1,92906981,92908435,protein_coding,1,1454,chr1_92906981_92908435
5033417F24Rik,1,92908378,92910764,antisense,-1,2386,chr1_92908378_92910764
Rnpepl1,1,92910783,92924384,protein_coding,1,13601,chr1_92910783_92924384
9430060I03Rik,1,92933526,92950590,antisense,-1,17064,chr1_92933526_92950590
Capn10,1,92934376,92947941,protein_coding,1,13565,chr1_92934376_92947941
Gpr35,1,92950865,92986391,protein_coding,1,35526,chr1_92950865_92986391
Aqp12,1,93006334,93012269,protein_coding,1,5935,chr1_93006334_93012269
Kif1a,1,93015464,93101951,protein_coding,-1,86487,chr1_93015464_93101951
Gm28086,1,93122931,93124103,lincRNA,-1,1172,chr1_93122931_93124103
Agxt,1,93135240,93145421,protein_coding,1,10181,chr1_93135240_93145421
Crocc2,1,93168725,93231072,protein_coding,1,62347,chr1_93168725_93231072
Sned1,1,93235841,93301065,protein_coding,1,65224,chr1_93235841_93301065
Mterf4,1,93299211,93305915,protein_coding,-1,6704,chr1_93299211_93305915
Gm28535,1,93305964,93317309,antisense,1,11345,chr1_93305964_93317309
Pask,1,93308770,93343482,protein_coding,-1,34712,chr1_93308770_93343482
Ppp1r7,1,93342854,93373489,protein_coding,1,30635,chr1_93342854_93373489
Ano7,1,93373930,93404303,protein_coding,1,30373,chr1_93373930_93404303
Hdlbp,1,93405940,93478815,protein_coding,-1,72875,chr1_93405940_93478815
Farp2,1,93512079,93621976,protein_coding,1,109897,chr1_93512079_93621976
Stk25,1,93619751,93658659,protein_coding,-1,38908,chr1_93619751_93658659
Gm28536,1,93635193,93636509,antisense,1,1316,chr1_93635193_93636509
Bok,1,93685660,93695764,protein_coding,1,10104,chr1_93685660_93695764
Thap4,1,93701935,93754864,protein_coding,-1,52929,chr1_93701935_93754864
Gm10550,1,93731104,93751072,antisense,1,19968,chr1_93731104_93751072
Atg4b,1,93751500,93790610,protein_coding,1,39110,chr1_93751500_93790610
Dtymk,1,93792576,93801934,protein_coding,-1,9358,chr1_93792576_93801934
Ing5,1,93803965,93822101,protein_coding,1,18136,chr1_93803965_93822101
D2hgdh,1,93824909,93852348,protein_coding,1,27439,chr1_93824909_93852348
Gal3st2,1,93861306,93876494,protein_coding,1,15188,chr1_93861306_93876494
Gal3st2b,1,93918311,93942650,protein_coding,1,24339,chr1_93918311_93942650
Gal3st2c,1,93990509,94017147,protein_coding,1,26638,chr1_93990509_94017147
Neu4,1,94020451,94028334,protein_coding,1,7883,chr1_94020451_94028334
Pdcd1,1,94038305,94052553,protein_coding,-1,14248,chr1_94038305_94052553
4930440C22Rik,1,94797083,94802472,lincRNA,1,5389,chr1_94797083_94802472
Fam174a,1,95313623,95335284,protein_coding,1,21661,chr1_95313623_95335284
St8sia4,1,95587682,95667571,protein_coding,-1,79889,chr1_95587682_95667571
4930598F16Rik,1,95701184,95716518,lincRNA,-1,15334,chr1_95701184_95716518
1700063A18Rik,1,95990659,96021758,lincRNA,-1,31099,chr1_95990659_96021758
Gm29601,1,96543059,96556703,lincRNA,-1,13644,chr1_96543059_96556703
4930533P14Rik,1,96612057,96662573,lincRNA,-1,50516,chr1_96612057_96662573
Slco4c1,1,96816270,96872171,protein_coding,-1,55901,chr1_96816270_96872171
Panct2,1,96871126,96907796,antisense,1,36670,chr1_96871126_96907796
Slco6c1,1,97059038,97128301,protein_coding,-1,69263,chr1_97059038_97128301
D1Ertd622e,1,97606318,97662074,protein_coding,-1,55756,chr1_97606318_97662074
Ppip5k2,1,97706048,97770411,protein_coding,-1,64363,chr1_97706048_97770411
Gin1,1,97770172,97793709,protein_coding,1,23537,chr1_97770172_97793709
Pam,1,97795114,98095646,protein_coding,-1,300532,chr1_97795114_98095646
1810006J02Rik,1,98131456,98144655,lincRNA,1,13199,chr1_98131456_98144655
Gm29461,1,98173648,98190698,lincRNA,1,17050,chr1_98173648_98190698
Slco6d1,1,98421124,98516991,protein_coding,1,95867,chr1_98421124_98516991
Gm7967,1,98589517,98607384,lincRNA,1,17867,chr1_98589517_98607384
Cntnap5b,1,99772765,100485942,protein_coding,1,713177,chr1_99772765_100485942
Gm20268,1,101155809,101175202,lincRNA,1,19393,chr1_101155809_101175202
Gm28187,1,101892958,101895091,lincRNA,-1,2133,chr1_101892958_101895091
Cdh20,1,104768529,104995481,protein_coding,1,226952,chr1_104768529_104995481
Gm15699,1,104911431,104912333,antisense,-1,902,chr1_104911431_104912333
Gm29012,1,105116454,105127366,lincRNA,1,10912,chr1_105116454_105127366
Rnf152,1,105276914,105356710,protein_coding,-1,79796,chr1_105276914_105356710
Gm17634,1,105356007,105361737,antisense,1,5730,chr1_105356007_105361737
Pign,1,105518422,105663677,protein_coding,-1,145255,chr1_105518422_105663677
Tnfrsf11a,1,105780718,105847981,protein_coding,1,67263,chr1_105780718_105847981
Gm7160,1,105979350,105990282,lincRNA,-1,10932,chr1_105979350_105990282
Zcchc2,1,105990406,106034074,protein_coding,1,43668,chr1_105990406_106034074
Gm20753,1,106152625,106171524,lincRNA,-1,18899,chr1_106152625_106171524
Phlpp1,1,106171752,106394250,protein_coding,1,222498,chr1_106171752_106394250
A530053M12Rik,1,106400178,106401987,lincRNA,-1,1809,chr1_106400178_106401987
Bcl2,1,106538178,106714274,protein_coding,-1,176096,chr1_106538178_106714274
D630008O14Rik,1,106541943,106575045,antisense,1,33102,chr1_106541943_106575045
Kdsr,1,106720459,106759727,protein_coding,-1,39268,chr1_106720459_106759727
Vps4b,1,106764071,106796728,protein_coding,-1,32657,chr1_106764071_106796728
Serpinb5,1,106861173,106883348,protein_coding,1,22175,chr1_106861173_106883348
Serpinb12,1,106934449,106957080,protein_coding,1,22631,chr1_106934449_106957080
Serpinb13,1,106980984,107001195,protein_coding,1,20211,chr1_106980984_107001195
Serpinb3a,1,107045587,107052303,protein_coding,-1,6716,chr1_107045587_107052303
Serpinb3b,1,107153940,107278361,protein_coding,-1,124421,chr1_107153940_107278361
Serpinb11,1,107361198,107380475,protein_coding,1,19277,chr1_107361198_107380475
Serpinb7,1,107399655,107452689,protein_coding,1,53034,chr1_107399655_107452689
Serpinb2,1,107511423,107535478,protein_coding,1,24055,chr1_107511423_107535478
Serpinb8,1,107590006,107610484,protein_coding,1,20478,chr1_107590006_107610484
Gm15389,1,107687008,107693514,lincRNA,1,6506,chr1_107687008_107693514
D830032E09Rik,1,107917259,108028337,lincRNA,1,111078,chr1_107917259_108028337
Cdh7,1,109982431,110140157,protein_coding,1,157726,chr1_109982431_110140157
Cdh19,1,110888326,110977584,protein_coding,-1,89258,chr1_110888326_110977584
Gm29088,1,111385690,111446645,lincRNA,-1,60955,chr1_111385690_111446645
Dsel,1,111858702,111864918,protein_coding,-1,6216,chr1_111858702_111864918
Gm28189,1,113289340,113290365,lincRNA,1,1025,chr1_113289340_113290365
9330185C12Rik,1,113891385,113964134,lincRNA,-1,72749,chr1_113891385_113964134
Cntnap5a,1,115684756,116587323,protein_coding,1,902567,chr1_115684756_116587323
Gm19965,1,116802983,116823410,protein_coding,1,20427,chr1_116802983_116823410
Zfp813-ps,1,117603878,117628027,lincRNA;processed_pseudogene,1,24149,chr1_117603878_117628027
Gm28363,1,117697131,117727441,protein_coding,1,30310,chr1_117697131_117727441
B020011L13Rik,1,117781133,117803359,protein_coding,1,22226,chr1_117781133_117803359
Gm28360,1,117830081,117854496,protein_coding,1,24415,chr1_117830081_117854496
Gm28168,1,117928015,117949988,protein_coding,1,21973,chr1_117928015_117949988
Gm7145,1,117965939,117986884,protein_coding,1,20945,chr1_117965939_117986884
Gm29106,1,118176542,118202307,protein_coding,1,25765,chr1_118176542_118202307
Tsn,1,118294778,118311739,protein_coding,-1,16961,chr1_118294778_118311739
Nifk,1,118321839,118333822,protein_coding,1,11983,chr1_118321839_118333822
Gm28867,1,118357312,118363449,lincRNA,1,6137,chr1_118357312_118363449
Clasp1,1,118389058,118612678,protein_coding,1,223620,chr1_118389058_118612678
2900060B14Rik,1,118458652,118459267,antisense,-1,615,chr1_118458652_118459267
Tfcp2l1,1,118627945,118685168,protein_coding,1,57223,chr1_118627945_118685168
Gli2,1,118834132,119053619,protein_coding,-1,219487,chr1_118834132_119053619
Gm29456,1,119305346,119326833,lincRNA,-1,21487,chr1_119305346_119326833
Gm29455,1,119329200,119385581,lincRNA,1,56381,chr1_119329200_119385581
Inhbb,1,119415465,119422248,protein_coding,-1,6783,chr1_119415465_119422248
Ralb,1,119470305,119504794,protein_coding,-1,34489,chr1_119470305_119504794
Gm27184,1,119520090,119526359,antisense,-1,6269,chr1_119520090_119526359
Tmem185b,1,119526160,119528983,protein_coding,1,2823,chr1_119526160_119528983
3830432H09Rik,1,119529480,119536165,lincRNA,-1,6685,chr1_119529480_119536165
Epb41l5,1,119545037,119649000,protein_coding,-1,103963,chr1_119545037_119649000
Ptpn4,1,119652467,119837613,protein_coding,-1,185146,chr1_119652467_119837613
Gm28209,1,119903130,119906897,lincRNA,1,3767,chr1_119903130_119906897
Tmem177,1,119907890,119913208,protein_coding,-1,5318,chr1_119907890_119913208
Cfap221,1,119923341,119997234,protein_coding,-1,73893,chr1_119923341_119997234
Sctr,1,120006894,120063536,protein_coding,1,56642,chr1_120006894_120063536
Tmem37,1,120067377,120074074,protein_coding,-1,6697,chr1_120067377_120074074
Dbi,1,120113280,120121078,protein_coding,-1,7798,chr1_120113280_120121078
3110009E18Rik,1,120121187,120188189,protein_coding,1,67002,chr1_120121187_120188189
Steap3,1,120190757,120272705,protein_coding,-1,81948,chr1_120190757_120272705
C1ql2,1,120340582,120343174,protein_coding,1,2592,chr1_120340582_120343174
Marco,1,120474538,120505024,protein_coding,-1,30486,chr1_120474538_120505024
En1,1,120602418,120607992,protein_coding,1,5574,chr1_120602418_120607992
2610027F03Rik,1,120621740,120690403,lincRNA,1,68663,chr1_120621740_120690403
Gm29345,1,120816500,120836997,lincRNA,1,20497,chr1_120816500_120836997
Gm29348,1,120847989,120857486,lincRNA,-1,9497,chr1_120847989_120857486
Celrr,1,121087405,121178441,lincRNA,1,91036,chr1_121087405_121178441
Gm29359,1,121224276,121227526,lincRNA,1,3250,chr1_121224276_121227526
Insig2,1,121304353,121332589,protein_coding,-1,28236,chr1_121304353_121332589
2210011K15Rik,1,121355116,121359900,lincRNA,-1,4784,chr1_121355116_121359900
Ccdc93,1,121431049,121506460,protein_coding,1,75411,chr1_121431049_121506460
Gm15392,1,121489296,121493203,antisense,-1,3907,chr1_121489296_121493203
Htr5b,1,121509842,121528465,protein_coding,-1,18623,chr1_121509842_121528465
Ddx18,1,121553835,121567989,protein_coding,-1,14154,chr1_121553835_121567989
Gm28590,1,122205145,122252180,lincRNA,1,47035,chr1_122205145_122252180
Dpp10,1,123321471,124846039,protein_coding,-1,1524568,chr1_123321471_124846039
1700121L03Rik,1,125190282,125197455,lincRNA,-1,7173,chr1_125190282_125197455
Actr3,1,125392905,125435727,protein_coding,-1,42822,chr1_125392905_125435727
Slc35f5,1,125560595,125595820,protein_coding,1,35225,chr1_125560595_125595820
Gpr39,1,125676995,125873862,protein_coding,1,196867,chr1_125676995_125873862
Lypd1,1,125867622,125913101,protein_coding,-1,45479,chr1_125867622_125913101
Nckap5,1,125913620,126830799,protein_coding,-1,917179,chr1_125913620_126830799
4930599A14Rik,1,126872203,126876615,lincRNA,-1,4412,chr1_126872203_126876615
Mgat5,1,127205015,127488336,protein_coding,1,283321,chr1_127205015_127488336
Tmem163,1,127486546,127679548,protein_coding,-1,193002,chr1_127486546_127679548
Acmsd,1,127729413,127767978,protein_coding,1,38565,chr1_127729413_127767978
2900009J06Rik,1,127753616,127774092,antisense,-1,20476,chr1_127753616_127774092
Ccnt2,1,127774164,127808061,protein_coding,1,33897,chr1_127774164_127808061
Map3k19,1,127814791,127855031,protein_coding,-1,40240,chr1_127814791_127855031
Rab3gap1,1,127868773,127943868,protein_coding,1,75095,chr1_127868773_127943868
Zranb3,1,127954184,128103047,protein_coding,-1,148863,chr1_127954184_128103047
Gm28800,1,127959516,127967452,antisense,1,7936,chr1_127959516_127967452
R3hdm1,1,128103301,128237736,protein_coding,1,134435,chr1_128103301_128237736
Ubxn4,1,128243964,128279378,protein_coding,1,35414,chr1_128243964_128279378
Lct,1,128284756,128328318,protein_coding,-1,43562,chr1_128284756_128328318
Mcm6,1,128331590,128359664,protein_coding,-1,28074,chr1_128331590_128359664
Dars,1,128363707,128417368,protein_coding,-1,53661,chr1_128363707_128417368
Cxcr4,1,128588199,128592293,protein_coding,-1,4094,chr1_128588199_128592293
Gm26686,1,128770599,128774421,lincRNA,-1,3822,chr1_128770599_128774421
Thsd7b,1,129273302,130219278,protein_coding,1,945976,chr1_129273302_130219278
Gm16081,1,130269950,130281258,lincRNA,-1,11308,chr1_130269950_130281258
Cd55b,1,130388537,130423009,protein_coding,-1,34472,chr1_130388537_130423009
Gm15675,1,130429781,130437191,lincRNA,-1,7410,chr1_130429781_130437191
Cd55,1,130439027,130462744,protein_coding,-1,23717,chr1_130439027_130462744
Gm16083,1,130462576,130557075,antisense,1,94499,chr1_130462576_130557075
Zp3r,1,130576713,130629621,protein_coding,-1,52908,chr1_130576713_130629621
C4bp,1,130634773,130661632,protein_coding,-1,26859,chr1_130634773_130661632
Gm29427,1,130670209,130715799,protein_coding,-1,45590,chr1_130670209_130715799
Pfkfb2,1,130689182,130729253,protein_coding,-1,40071,chr1_130689182_130729253
Yod1,1,130717327,130724358,protein_coding,1,7031,chr1_130717327_130724358
AA986860,1,130731976,130744622,protein_coding,1,12646,chr1_130731976_130744622
Gm28857,1,130740162,130741327,antisense,-1,1165,chr1_130740162_130741327
Gm28856,1,130766384,130784433,lincRNA,1,18049,chr1_130766384_130784433
Fcamr,1,130800902,130814740,protein_coding,1,13838,chr1_130800902_130814740
Gm15848,1,130809977,130824084,antisense,-1,14107,chr1_130809977_130824084
Pigr,1,130826684,130852249,protein_coding,1,25565,chr1_130826684_130852249
Fcmr,1,130865669,130880791,protein_coding,1,15122,chr1_130865669_130880791
Il19,1,130932656,130940115,protein_coding,-1,7459,chr1_130932656_130940115
Il10,1,131019845,131024974,protein_coding,1,5129,chr1_131019845_131024974
Mapkapk2,1,131053700,131097826,protein_coding,-1,44126,chr1_131053700_131097826
Dyrk3,1,131127455,131138340,protein_coding,-1,10885,chr1_131127455_131138340
Eif2d,1,131153181,131187658,protein_coding,1,34477,chr1_131153181_131187658
Rassf5,1,131176410,131245258,protein_coding,-1,68848,chr1_131176410_131245258
Ikbke,1,131254343,131279606,protein_coding,-1,25263,chr1_131254343_131279606
Gm28914,1,131259507,131260553,antisense,1,1046,chr1_131259507_131260553
Gm28913,1,131263330,131266749,antisense,1,3419,chr1_131263330_131266749
Srgap2,1,131285251,131527352,protein_coding,-1,242101,chr1_131285251_131527352
Fam72a,1,131527903,131539872,protein_coding,1,11969,chr1_131527903_131539872
Avpr1b,1,131599239,131612000,protein_coding,1,12761,chr1_131599239_131612000
Ctse,1,131638306,131675505,protein_coding,1,37199,chr1_131638306_131675505
Rab7b,1,131688695,131715439,protein_coding,1,26744,chr1_131688695_131715439
Slc26a9,1,131744022,131771504,protein_coding,1,27482,chr1_131744022_131771504
Pm20d1,1,131797381,131821473,protein_coding,1,24092,chr1_131797381_131821473
Slc41a1,1,131827493,131848865,protein_coding,1,21372,chr1_131827493_131848865
Rab29,1,131867224,131872887,protein_coding,1,5663,chr1_131867224_131872887
Nucks1,1,131910534,131936321,protein_coding,1,25787,chr1_131910534_131936321
Slc45a3,1,131962967,131982969,protein_coding,1,20002,chr1_131962967_131982969
Elk4,1,132007607,132032612,protein_coding,1,25005,chr1_132007607_132032612
Mfsd4a,1,132022806,132068062,protein_coding,-1,45256,chr1_132022806_132068062
Cdk18,1,132112237,132139684,protein_coding,-1,27447,chr1_132112237_132139684
Gm29629,1,132139504,132142800,antisense,1,3296,chr1_132139504_132142800
Lemd1,1,132191431,132259227,protein_coding,1,67796,chr1_132191431_132259227
Gm10188,1,132229048,132229767,protein_coding,-1,719,chr1_132229048_132229767
Gm29630,1,132274716,132280411,lincRNA,-1,5695,chr1_132274716_132280411
Klhdc8a,1,132298626,132307357,protein_coding,1,8731,chr1_132298626_132307357
Nuak2,1,132316126,132333488,protein_coding,1,17362,chr1_132316126_132333488
F730311O21Rik,1,132342023,132349626,lincRNA,1,7603,chr1_132342023_132349626
Tmcc2,1,132356315,132391281,protein_coding,-1,34966,chr1_132356315_132391281
Gm15849,1,132381129,132382509,antisense,1,1380,chr1_132381129_132382509
Dstyk,1,132417555,132466958,protein_coding,1,49403,chr1_132417555_132466958
Rbbp5,1,132477365,132505659,protein_coding,1,28294,chr1_132477365_132505659
Tmem81,1,132506230,132508639,protein_coding,1,2409,chr1_132506230_132508639
Cntn2,1,132509427,132543256,protein_coding,-1,33829,chr1_132509427_132543256
Nfasc,1,132564690,132741797,protein_coding,-1,177107,chr1_132564690_132741797
Gm10538,1,132729355,132732826,antisense,1,3471,chr1_132729355_132732826
Lrrn2,1,132880273,132940005,protein_coding,1,59732,chr1_132880273_132940005
Mdm4,1,132959484,133030561,protein_coding,-1,71077,chr1_132959484_133030561
Pik3c2b,1,133045667,133108687,protein_coding,1,63020,chr1_133045667_133108687
Gm28609,1,133050128,133068405,antisense,-1,18277,chr1_133050128_133068405
Ppp1r15b,1,133131143,133139783,protein_coding,1,8640,chr1_133131143_133139783
Plekha6,1,133164210,133303435,protein_coding,1,139225,chr1_133164210_133303435
Gm19461,1,133250398,133269808,antisense,-1,19410,chr1_133250398_133269808
Ren1,1,133350510,133360325,protein_coding,1,9815,chr1_133350510_133360325
Etnk2,1,133363572,133380336,protein_coding,1,16764,chr1_133363572_133380336
Sox13,1,133382303,133424377,protein_coding,-1,42074,chr1_133382303_133424377
Snrpe,1,133603871,133610291,protein_coding,-1,6420,chr1_133603871_133610291
Zc3h11a,1,133619862,133661380,protein_coding,-1,41518,chr1_133619862_133661380
Lax1,1,133679091,133690108,protein_coding,-1,11017,chr1_133679091_133690108
Atp2b4,1,133699457,133801041,protein_coding,-1,101584,chr1_133699457_133801041
Optc,1,133897199,133907999,protein_coding,-1,10800,chr1_133897199_133907999
Gm15851,1,133906531,133914822,antisense,1,8291,chr1_133906531_133914822
Prelp,1,133910304,133921414,protein_coding,-1,11110,chr1_133910304_133921414
Gm1627,1,133962162,133971938,lincRNA,1,9776,chr1_133962162_133971938
Fmod,1,134037254,134048277,protein_coding,1,11023,chr1_134037254_134048277
Btg2,1,134075170,134079120,protein_coding,-1,3950,chr1_134075170_134079120
Chit1,1,134111242,134151540,protein_coding,1,40298,chr1_134111242_134151540
Chil1,1,134182176,134190181,protein_coding,1,8005,chr1_134182176_134190181
Mybph,1,134193448,134201232,protein_coding,1,7784,chr1_134193448_134201232
Adora1,1,134199223,134235431,protein_coding,-1,36208,chr1_134199223_134235431
Ppfia4,1,134296783,134332928,protein_coding,-1,36145,chr1_134296783_134332928
Tmem183a,1,134346097,134361979,protein_coding,-1,15882,chr1_134346097_134361979
Cyb5r1,1,134405559,134411740,protein_coding,1,6181,chr1_134405559_134411740
Adipor1,1,134415378,134433351,protein_coding,1,17973,chr1_134415378_134433351
Platr1,1,134435628,134439597,lincRNA,1,3969,chr1_134435628_134439597
Klhl12,1,134455531,134491018,protein_coding,1,35487,chr1_134455531_134491018
Rabif,1,134494648,134508774,protein_coding,1,14126,chr1_134494648_134508774
Mgat4e,1,134540941,134549682,protein_coding,-1,8741,chr1_134540941_134549682
Kdm5b,1,134560171,134635285,protein_coding,1,75114,chr1_134560171_134635285
Gm26783,1,134642254,134646520,lincRNA,-1,4266,chr1_134642254_134646520
Syt2,1,134646677,134762593,protein_coding,1,115916,chr1_134646677_134762593
Ppp1r12b,1,134754658,134955942,protein_coding,-1,201284,chr1_134754658_134955942
Gm28892,1,134834142,134846415,antisense,1,12273,chr1_134834142_134846415
Ube2t,1,134962565,134974162,protein_coding,1,11597,chr1_134962565_134974162
Lgr6,1,134983301,135105276,protein_coding,-1,121975,chr1_134983301_135105276
Gm10535,1,135108961,135113378,antisense,1,4417,chr1_135108961_135113378
Ptpn7,1,135132700,135145317,protein_coding,1,12617,chr1_135132700_135145317
Arl8a,1,135146824,135156269,protein_coding,1,9445,chr1_135146824_135156269
Gpr37l1,1,135160234,135167681,protein_coding,-1,7447,chr1_135160234_135167681
Gm26642,1,135248561,135266443,antisense,1,17882,chr1_135248561_135266443
Elf3,1,135253575,135258568,protein_coding,-1,4993,chr1_135253575_135258568
Rnpep,1,135262712,135284084,protein_coding,-1,21372,chr1_135262712_135284084
Timm17a,1,135295213,135313778,protein_coding,-1,18565,chr1_135295213_135313778
Lmod1,1,135324807,135368065,protein_coding,1,43258,chr1_135324807_135368065
Shisa4,1,135371057,135375237,protein_coding,-1,4180,chr1_135371057_135375237
Ipo9,1,135382312,135430499,protein_coding,-1,48187,chr1_135382312_135430499
Nav1,1,135434580,135688105,protein_coding,-1,253525,chr1_135434580_135688105
Gm4793,1,135584773,135599948,antisense,1,15175,chr1_135584773_135599948
Csrp1,1,135720061,135752232,protein_coding,1,32171,chr1_135720061_135752232
Phlda3,1,135766119,135769136,protein_coding,1,3017,chr1_135766119_135769136
Tnni1,1,135779434,135810989,protein_coding,1,31555,chr1_135779434_135810989
Lad1,1,135818598,135833342,protein_coding,1,14744,chr1_135818598_135833342
Tnnt2,1,135836354,135852260,protein_coding,1,15906,chr1_135836354_135852260
Pkp1,1,135871395,135919207,protein_coding,-1,47812,chr1_135871395_135919207
Igfn1,1,135953578,136006342,protein_coding,-1,52764,chr1_135953578_136006342
Tmem9,1,136008150,136035342,protein_coding,1,27192,chr1_136008150_136035342
Ascl5,1,136050804,136051370,protein_coding,1,566,chr1_136050804_136051370
Cacna1s,1,136052750,136119822,protein_coding,1,67072,chr1_136052750_136119822
Gm37759,1,136116577,136119822,antisense,-1,3245,chr1_136116577_136119822
Kif21b,1,136131389,136177998,protein_coding,1,46609,chr1_136131389_136177998
Mroh3,1,136181652,136212828,protein_coding,-1,31176,chr1_136181652_136212828
Gm26568,1,136216074,136225071,antisense,1,8997,chr1_136216074_136225071
A430034D21Rik,1,136247662,136250476,lincRNA,1,2814,chr1_136247662_136250476
Gm26781,1,136259407,136274406,antisense,1,14999,chr1_136259407_136274406
Gpr25,1,136259797,136260873,protein_coding,-1,1076,chr1_136259797_136260873
Camsap2,1,136268123,136346104,protein_coding,-1,77981,chr1_136268123_136346104
Ddx59,1,136415271,136440158,protein_coding,1,24887,chr1_136415271_136440158
Kif14,1,136466343,136531511,protein_coding,1,65168,chr1_136466343_136531511
Gm37799,1,136541605,136555873,lincRNA,1,14268,chr1_136541605_136555873
4933409D19Rik,1,136603033,136605468,lincRNA,-1,2435,chr1_136603033_136605468
Platr23,1,136622098,136624650,lincRNA,-1,2552,chr1_136622098_136624650
Zfp281,1,136624901,136630053,protein_coding,1,5152,chr1_136624901_136630053
Gm19705,1,136670769,136690804,lincRNA,1,20035,chr1_136670769_136690804
Platr22,1,136696211,136726142,lincRNA,1,29931,chr1_136696211_136726142
Nr5a2,1,136842571,136960448,protein_coding,-1,117877,chr1_136842571_136960448
Gm26979,1,137917690,137921312,lincRNA,-1,3622,chr1_137917690_137921312
Gm26936,1,137928389,137969240,lincRNA,-1,40851,chr1_137928389_137969240
Ptprc,1,138062861,138175708,protein_coding,-1,112847,chr1_138062861_138175708
Atp6v1g3,1,138273738,138289462,protein_coding,1,15724,chr1_138273738_138289462
Nek7,1,138482875,138620141,protein_coding,-1,137266,chr1_138482875_138620141
Gm28501,1,138515615,138550009,antisense,1,34394,chr1_138515615_138550009
Gm5833,1,138640095,138682077,lincRNA,-1,41982,chr1_138640095_138682077
Lhx9,1,138825186,138848577,protein_coding,-1,23391,chr1_138825186_138848577
2310009B15Rik,1,138851983,138856852,protein_coding,-1,4869,chr1_138851983_138856852
1700019P21Rik,1,138876272,138876951,lincRNA,-1,679,chr1_138876272_138876951
Dennd1b,1,138963435,139178960,protein_coding,1,215525,chr1_138963435_139178960
Crb1,1,139197056,139377100,protein_coding,-1,180044,chr1_139197056_139377100
4933436E23Rik,1,139379452,139402852,lincRNA,1,23400,chr1_139379452_139402852
Gm34816,1,139408278,139413864,lincRNA,1,5586,chr1_139408278_139413864
Zbtb41,1,139422288,139453005,protein_coding,1,30717,chr1_139422288_139453005
Aspm,1,139454772,139494091,protein_coding,1,39319,chr1_139454772_139494091
F13b,1,139501702,139523752,protein_coding,1,22050,chr1_139501702_139523752
Cfhr1,1,139547053,139560272,protein_coding,-1,13219,chr1_139547053_139560272
Gm4788,1,139697623,139781243,protein_coding,-1,83620,chr1_139697623_139781243
Cfhr2,1,139804167,139858718,protein_coding,-1,54551,chr1_139804167_139858718
Cfh,1,140084708,140183764,protein_coding,-1,99056,chr1_140084708_140183764
Kcnt2,1,140246158,140612067,protein_coding,1,365909,chr1_140246158_140612067
4930590L20Rik,1,140570176,140656404,antisense,-1,86228,chr1_140570176_140656404
Cdc73,1,143598800,143702893,protein_coding,-1,104093,chr1_143598800_143702893
B3galt2,1,143640664,143654614,protein_coding,1,13950,chr1_143640664_143654614
Glrx2,1,143716338,143749676,protein_coding,1,33338,chr1_143716338_143749676
Uchl5,1,143777272,143807466,protein_coding,1,30194,chr1_143777272_143807466
Rgs2,1,143999338,144004161,protein_coding,-1,4823,chr1_143999338_144004161
Rgs13,1,144138654,144177372,protein_coding,-1,38718,chr1_144138654_144177372
Rgs1,1,144242296,144249242,protein_coding,-1,6946,chr1_144242296_144249242
Rgs21,1,144516648,144567667,protein_coding,-1,51019,chr1_144516648_144567667
Rgs18,1,144752683,144775435,protein_coding,-1,22752,chr1_144752683_144775435
Gm29514,1,146419436,146495060,antisense,-1,75624,chr1_146419436_146495060
Brinp3,1,146494760,146902472,protein_coding,1,407712,chr1_146494760_146902472
Gm15584,1,146809831,146841696,antisense,-1,31865,chr1_146809831_146841696
Gm29020,1,149106115,149127320,lincRNA,1,21205,chr1_149106115_149127320
Gm29398,1,149413260,149449951,lincRNA,-1,36691,chr1_149413260_149449951
Pla2g4a,1,149829618,149961290,protein_coding,-1,131672,chr1_149829618_149961290
Ptgs2,1,150100031,150108227,protein_coding,1,8196,chr1_150100031_150108227
Ptgs2os2,1,150159043,150164948,lincRNA,-1,5905,chr1_150159043_150164948
Pdc,1,150319417,150333906,protein_coding,1,14489,chr1_150319417_150333906
2310030A07Rik,1,150320681,150346771,antisense,-1,26090,chr1_150320681_150346771
Tpr,1,150392838,150449935,protein_coding,1,57097,chr1_150392838_150449935
Prg4,1,150449412,150466165,protein_coding,-1,16753,chr1_150449412_150466165
Hmcn1,1,150562524,150993435,protein_coding,-1,430911,chr1_150562524_150993435
Gm20631,1,150625266,150783499,antisense,1,158233,chr1_150625266_150783499
Gm29188,1,151001040,151004577,lincRNA,1,3537,chr1_151001040_151004577
C730036E19Rik,1,151138034,151142345,lincRNA,1,4311,chr1_151138034_151142345
Gm47985,1,151182537,151184243,protein_coding,1,1706,chr1_151182537_151184243
Gm10138,1,151339604,151345231,antisense,-1,5627,chr1_151339604_151345231
Ivns1abp,1,151344477,151364422,protein_coding,1,19945,chr1_151344477_151364422
Swt1,1,151367699,151428455,protein_coding,-1,60756,chr1_151367699_151428455
Trmt1l,1,151428542,151458161,protein_coding,1,29619,chr1_151428542_151458161
Rnf2,1,151458004,151500955,protein_coding,-1,42951,chr1_151458004_151500955
Fam129a,1,151571186,151721939,protein_coding,1,150753,chr1_151571186_151721939
2810414N06Rik,1,151748949,151755018,lincRNA,-1,6069,chr1_151748949_151755018
Edem3,1,151755371,151822051,protein_coding,1,66680,chr1_151755371_151822051
1700025G04Rik,1,151852403,152090125,protein_coding,-1,237722,chr1_151852403_152090125
Gm28610,1,151875419,151887063,antisense,1,11644,chr1_151875419_151887063
Tsen15,1,152370735,152386688,protein_coding,-1,15953,chr1_152370735_152386688
Colgalt2,1,152399830,152510695,protein_coding,1,110865,chr1_152399830_152510695
Rgl1,1,152516760,152766351,protein_coding,-1,249591,chr1_152516760_152766351
Apobec4,1,152750551,152757544,protein_coding,1,6993,chr1_152750551_152757544
Arpc5,1,152766542,152775597,protein_coding,1,9055,chr1_152766542_152775597
Ncf2,1,152800194,152836991,protein_coding,1,36797,chr1_152800194_152836991
Smg7,1,152836995,152902646,protein_coding,-1,65651,chr1_152836995_152902646
Nmnat2,1,152954993,153119261,protein_coding,1,164268,chr1_152954993_153119261
Gm28960,1,153066481,153089507,antisense,-1,23026,chr1_153066481_153089507
Lamc2,1,153122756,153186447,protein_coding,-1,63691,chr1_153122756_153186447
Lamc1,1,153218922,153332786,protein_coding,-1,113864,chr1_153218922_153332786
Shcbp1l,1,153425162,153452574,protein_coding,1,27412,chr1_153425162_153452574
Dhx9,1,153455758,153487660,protein_coding,-1,31902,chr1_153455758_153487660
Npl,1,153503015,153550045,protein_coding,-1,47030,chr1_153503015_153550045
Rgs8,1,153653025,153700323,protein_coding,1,47298,chr1_153653025_153700323
Gm29529,1,153690391,153692656,antisense,-1,2265,chr1_153690391_153692656
C230024C17Rik,1,153721240,153737829,lincRNA,-1,16589,chr1_153721240_153737829
Rgs16,1,153740349,153745468,protein_coding,1,5119,chr1_153740349_153745468
Gm28513,1,153743552,153749324,antisense,-1,5772,chr1_153743552_153749324
Rnasel,1,153749426,153764221,protein_coding,1,14795,chr1_153749426_153764221
Rgsl1,1,153779381,153844142,protein_coding,-1,64761,chr1_153779381_153844142
Teddm2,1,153849542,153900228,protein_coding,-1,50686,chr1_153849542_153900228
Teddm1b,1,153874345,153876871,protein_coding,1,2526,chr1_153874345_153876871
Teddm1a,1,153891742,153893058,protein_coding,1,1316,chr1_153891742_153893058
Glul,1,153899944,153909723,protein_coding,1,9779,chr1_153899944_153909723
Gm29290,1,153939226,153941290,lincRNA,1,2064,chr1_153939226_153941290
Gm28286,1,154027363,154034301,lincRNA,-1,6938,chr1_154027363_154034301
A830008E24Rik,1,154037597,154117951,lincRNA,-1,80354,chr1_154037597_154117951
Zfp648,1,154201187,154205689,protein_coding,1,4502,chr1_154201187_154205689
4930452N14Rik,1,154241521,154256906,lincRNA,-1,15385,chr1_154241521_154256906
4930532M18Rik,1,154255689,154270416,lincRNA,1,14727,chr1_154255689_154270416
Cacna1e,1,154390731,154884501,protein_coding,-1,493770,chr1_154390731_154884501
Gm29282,1,155011332,155057179,lincRNA,-1,45847,chr1_155011332_155057179
Gm9530,1,155063447,155083266,lincRNA,-1,19819,chr1_155063447_155083266
Ier5,1,155096361,155099636,protein_coding,-1,3275,chr1_155096361_155099636
Mr1,1,155127277,155146814,protein_coding,-1,19537,chr1_155127277_155146814
Stx6,1,155158715,155208256,protein_coding,1,49541,chr1_155158715_155208256
BC034090,1,155212471,155244444,protein_coding,-1,31973,chr1_155212471_155244444
Gm37622,1,155231304,155233159,antisense,1,1855,chr1_155231304_155233159
Xpr1,1,155275701,155417415,protein_coding,-1,141714,chr1_155275701_155417415
Gm5532,1,155520173,155527143,lincRNA,-1,6970,chr1_155520173_155527143
Acbd6,1,155558120,155691330,protein_coding,1,133210,chr1_155558120_155691330
Lhx4,1,155698031,155751684,protein_coding,-1,53653,chr1_155698031_155751684
Qsox1,1,155776029,155812889,protein_coding,-1,36860,chr1_155776029_155812889
Gm37571,1,155818494,155859591,antisense,1,41097,chr1_155818494_155859591
Cep350,1,155844964,155973255,protein_coding,-1,128291,chr1_155844964_155973255
Tor1aip1,1,156004599,156036480,protein_coding,-1,31881,chr1_156004599_156036480
Tor1aip2,1,156035403,156068861,protein_coding,1,33458,chr1_156035403_156068861
Fam163a,1,156075966,156205026,protein_coding,-1,129060,chr1_156075966_156205026
Tdrd5,1,156255296,156303664,protein_coding,-1,48368,chr1_156255296_156303664
4930518J20Rik,1,156303489,156304966,antisense,1,1477,chr1_156303489_156304966
Nphs2,1,156310727,156328035,protein_coding,1,17308,chr1_156310727_156328035
Axdnd1,1,156323509,156421159,protein_coding,-1,97650,chr1_156323509_156421159
Gm2000,1,156366040,156366484,protein_coding,1,444,chr1_156366040_156366484
Soat1,1,156424525,156474331,protein_coding,-1,49806,chr1_156424525_156474331
Abl2,1,156558786,156649568,protein_coding,1,90782,chr1_156558786_156649568
Tor3a,1,156653617,156674356,protein_coding,-1,20739,chr1_156653617_156674356
Fam20b,1,156678532,156719086,protein_coding,-1,40554,chr1_156678532_156719086
Ralgps2,1,156804166,156939626,protein_coding,-1,135460,chr1_156804166_156939626
Angptl1,1,156838562,156861078,protein_coding,1,22516,chr1_156838562_156861078
4930439D14Rik,1,156939838,156940196,antisense,1,358,chr1_156939838_156940196
Gm28694,1,156972760,157054034,lincRNA,-1,81274,chr1_156972760_157054034
Tex35,1,157099139,157108680,protein_coding,-1,9541,chr1_157099139_157108680
Rasal2,1,157135182,157412595,protein_coding,-1,277413,chr1_157135182_157412595
Cryzl2,1,157458577,157492638,protein_coding,1,34061,chr1_157458577_157492638
Gm15486,1,157497931,157511721,antisense,-1,13790,chr1_157497931_157511721
Sec16b,1,157506728,157568425,protein_coding,1,61697,chr1_157506728_157568425
Brinp2,1,158245269,158356326,protein_coding,-1,111057,chr1_158245269_158356326
Astn1,1,158362273,158691781,protein_coding,1,329508,chr1_158362273_158691781
Gm37679,1,158485032,158554299,antisense,-1,69267,chr1_158485032_158554299
Pappa2,1,158711727,158980490,protein_coding,-1,268763,chr1_158711727_158980490
4930562F17Rik,1,159134272,159166387,lincRNA,1,32115,chr1_159134272_159166387
Cop1,1,159232320,159347640,protein_coding,1,115320,chr1_159232320_159347640
Tnr,1,159523769,159931729,protein_coding,1,407960,chr1_159523769_159931729
Gm38039,1,159928390,159931726,antisense,-1,3336,chr1_159928390_159931726
4930523C07Rik,1,160044382,160080208,protein_coding,1,35826,chr1_160044382_160080208
4930562F07Rik,1,160074735,160077985,lincRNA,-1,3250,chr1_160074735_160077985
Tnn,1,160085029,160153580,protein_coding,-1,68551,chr1_160085029_160153580
Mrps14,1,160195215,160202170,protein_coding,1,6955,chr1_160195215_160202170
Cacybp,1,160202367,160212875,protein_coding,-1,10508,chr1_160202367_160212875
Rabgap1l,1,160219174,160793211,protein_coding,-1,574037,chr1_160219174_160793211
Gm36975,1,160264324,160443072,antisense,1,178748,chr1_160264324_160443072
Gm37083,1,160798682,160800819,lincRNA,1,2137,chr1_160798682_160800819
Rc3h1,1,160906418,160974978,protein_coding,1,68560,chr1_160906418_160974978
Serpinc1,1,160978585,161005863,protein_coding,1,27278,chr1_160978585_161005863
Zbtb37,1,161002922,161034849,protein_coding,-1,31927,chr1_161002922_161034849
Gm37362,1,161030582,161031456,antisense,1,874,chr1_161030582_161031456
Dars2,1,161040601,161070658,protein_coding,-1,30057,chr1_161040601_161070658
Gm37634,1,161040620,161041414,antisense,1,794,chr1_161040620_161041414
Cenpl,1,161070713,161086724,protein_coding,1,16011,chr1_161070713_161086724
Klhl20,1,161088375,161131511,protein_coding,-1,43136,chr1_161088375_161131511
Ankrd45,1,161142691,161170498,protein_coding,1,27807,chr1_161142691_161170498
Tex50,1,161154558,161159314,protein_coding,-1,4756,chr1_161154558_161159314
Prdx6,1,161240112,161251219,protein_coding,-1,11107,chr1_161240112_161251219
Tnfsf4,1,161395409,161418410,protein_coding,1,23001,chr1_161395409_161418410
Tnfsf18,1,161494655,161505290,protein_coding,1,10635,chr1_161494655_161505290
Fasl,1,161780689,161788495,protein_coding,-1,7806,chr1_161780689_161788495
Suco,1,161816114,161876682,protein_coding,-1,60568,chr1_161816114_161876682
Gm31925,1,161890458,161903173,lincRNA,1,12715,chr1_161890458_161903173
4930558K02Rik,1,161942086,161979636,protein_coding,-1,37550,chr1_161942086_161979636
Pigc,1,161969186,161973435,protein_coding,1,4249,chr1_161969186_161973435
Gm38304,1,161969200,162027106,antisense,1,57906,chr1_161969200_162027106
Dnm3,1,161982453,162478034,protein_coding,-1,495581,chr1_161982453_162478034
Dnm3os,1,162217623,162225550,antisense,1,7927,chr1_162217623_162225550
Vamp4,1,162570515,162599084,protein_coding,1,28569,chr1_162570515_162599084
Myoc,1,162639155,162649693,protein_coding,1,10538,chr1_162639155_162649693
Myocos,1,162647193,162658219,protein_coding,-1,11026,chr1_162647193_162658219
Prrc2c,1,162670725,162740556,protein_coding,-1,69831,chr1_162670725_162740556
Fmo4,1,162793188,162813972,protein_coding,-1,20784,chr1_162793188_162813972
Fmo1,1,162829561,162866610,protein_coding,-1,37049,chr1_162829561_162866610
Fmo2,1,162874317,162898726,protein_coding,-1,24409,chr1_162874317_162898726
Fmo6,1,162916551,162937515,protein_coding,-1,20964,chr1_162916551_162937515
Fmo3,1,162953800,162984528,protein_coding,-1,30728,chr1_162953800_162984528
Gm37273,1,162983014,163066682,antisense,1,83668,chr1_162983014_163066682
Mroh9,1,163024302,163085670,protein_coding,-1,61368,chr1_163024302_163085670
Prrx1,1,163245119,163313710,protein_coding,-1,68591,chr1_163245119_163313710
Gm20471,1,163280356,163287045,antisense,1,6689,chr1_163280356_163287045
Gorab,1,163384908,163403669,protein_coding,-1,18761,chr1_163384908_163403669
Gm29500,1,163607377,163610269,lincRNA,1,2892,chr1_163607377_163610269
Mettl11b,1,163702256,163725232,protein_coding,-1,22976,chr1_163702256_163725232
Kifap3,1,163779583,163917109,protein_coding,1,137526,chr1_163779583_163917109
Scyl3,1,163929100,163955126,protein_coding,1,26026,chr1_163929100_163955126
BC055324,1,163945993,163994796,protein_coding,-1,48803,chr1_163945993_163994796
Mettl18,1,163994889,163997243,protein_coding,1,2354,chr1_163994889_163997243
Sele,1,164048234,164057677,protein_coding,1,9443,chr1_164048234_164057677
Selp,1,164115264,164150026,protein_coding,1,34762,chr1_164115264_164150026
Gm16548,1,164148591,164152217,lincRNA,-1,3626,chr1_164148591_164152217
F5,1,164151838,164220277,protein_coding,1,68439,chr1_164151838_164220277
Slc19a2,1,164249046,164265385,protein_coding,1,16339,chr1_164249046_164265385
Ccdc181,1,164275585,164287847,protein_coding,1,12262,chr1_164275585_164287847
Blzf1,1,164289800,164307489,protein_coding,-1,17689,chr1_164289800_164307489
Nme7,1,164304121,164437725,protein_coding,1,133604,chr1_164304121_164437725
Atp1b1,1,164437109,164458355,protein_coding,-1,21246,chr1_164437109_164458355
Gm32391,1,164462442,164463989,lincRNA,1,1547,chr1_164462442_164463989
Gm26685,1,164503309,164514882,lincRNA,1,11573,chr1_164503309_164514882
Gm37754,1,164631757,164659238,lincRNA,1,27481,chr1_164631757_164659238
Gm37853,1,164640953,164698233,lincRNA,-1,57280,chr1_164640953_164698233
Gm37184,1,164681982,164712771,lincRNA,1,30789,chr1_164681982_164712771
Gm36945,1,164705419,164712541,lincRNA,-1,7122,chr1_164705419_164712541
Dpt,1,164796644,164824266,protein_coding,1,27622,chr1_164796644_164824266
Gm32569,1,164803969,164899591,antisense,-1,95622,chr1_164803969_164899591
Xcl1,1,164931644,164935527,protein_coding,-1,3883,chr1_164931644_164935527
4930568G15Rik,1,165064024,165091928,lincRNA,-1,27904,chr1_165064024_165091928
Tbx19,1,165137855,165160773,protein_coding,-1,22918,chr1_165137855_165160773
Sft2d2,1,165174337,165194438,protein_coding,-1,20101,chr1_165174337_165194438
Tiprl,1,165212286,165236996,protein_coding,-1,24710,chr1_165212286_165236996
Gpr161,1,165295789,165326745,protein_coding,1,30956,chr1_165295789_165326745
Dcaf6,1,165328698,165460475,protein_coding,-1,131777,chr1_165328698_165460475
Mpc2,1,165460637,165481214,protein_coding,1,20577,chr1_165460637_165481214
Adcy10,1,165485183,165576774,protein_coding,1,91591,chr1_165485183_165576774
Gm38325,1,165493791,165495167,antisense,-1,1376,chr1_165493791_165495167
Mpzl1,1,165592240,165634538,protein_coding,-1,42298,chr1_165592240_165634538
Rcsd1,1,165646516,165709757,protein_coding,-1,63241,chr1_165646516_165709757
Creg1,1,165763746,165775308,protein_coding,1,11562,chr1_165763746_165775308
Gm36972,1,165775868,165777155,lincRNA,-1,1287,chr1_165775868_165777155
Cd247,1,165788681,165877277,protein_coding,1,88596,chr1_165788681_165877277
Gm37469,1,165848155,165849044,antisense,-1,889,chr1_165848155_165849044
Pou2f1,1,165865154,166002678,protein_coding,-1,137524,chr1_165865154_166002678
Gm26665,1,166002960,166038256,lincRNA,1,35296,chr1_166002960_166038256
Dusp27,1,166098148,166127922,protein_coding,-1,29774,chr1_166098148_166127922
Gpa33,1,166130238,166166510,protein_coding,1,36272,chr1_166130238_166166510
Mael,1,166201201,166238747,protein_coding,-1,37546,chr1_166201201_166238747
Ildr2,1,166254139,166316823,protein_coding,1,62684,chr1_166254139_166316823
5330438I03Rik,1,166306741,166309585,antisense,-1,2844,chr1_166306741_166309585
Gm15853,1,166377878,166380493,antisense,-1,2615,chr1_166377878_166380493
Tada1,1,166379097,166393621,protein_coding,1,14524,chr1_166379097_166393621
Pogk,1,166384622,166409863,protein_coding,-1,25241,chr1_166384622_166409863
Gm4846,1,166483613,166497588,protein_coding,-1,13975,chr1_166483613_166497588
Gm4847,1,166628971,166647693,protein_coding,-1,18722,chr1_166628971_166647693
Fmo9,1,166662055,166681845,protein_coding,-1,19790,chr1_166662055_166681845
Gm16701,1,166974023,167000841,lincRNA,-1,26818,chr1_166974023_167000841
Fam78b,1,167001417,167091302,protein_coding,1,89885,chr1_167001417_167091302
Uck2,1,167222883,167285320,protein_coding,-1,62437,chr1_167222883_167285320
Gm37982,1,167242457,167251492,antisense,1,9035,chr1_167242457_167251492
Gm2453,1,167285068,167289856,lincRNA,1,4788,chr1_167285068_167289856
Tmco1,1,167308378,167333978,protein_coding,1,25600,chr1_167308378_167333978
Aldh9a1,1,167349991,167368532,protein_coding,1,18541,chr1_167349991_167368532
Mgst3,1,167371966,167393841,protein_coding,-1,21875,chr1_167371966_167393841
Lrrc52,1,167445669,167466780,protein_coding,-1,21111,chr1_167445669_167466780
Rxrg,1,167598384,167639623,protein_coding,1,41239,chr1_167598384_167639623
Lmx1a,1,167689237,167848741,protein_coding,1,159504,chr1_167689237_167848741
Gm20711,1,168004139,168122465,antisense,1,118326,chr1_168004139_168122465
Pbx1,1,168119364,168432270,protein_coding,-1,312906,chr1_168119364_168432270
Gm37839,1,169328529,169347632,lincRNA,-1,19103,chr1_169328529_169347632
Nuf2,1,169497934,169531464,protein_coding,-1,33530,chr1_169497934_169531464
Rgs5,1,169655501,169695813,protein_coding,1,40312,chr1_169655501_169695813
Rgs4,1,169741477,169747642,protein_coding,-1,6165,chr1_169741477_169747642
Ccdc190,1,169928648,169934653,protein_coding,1,6005,chr1_169928648_169934653
Hsd17b7,1,169949535,169969241,protein_coding,-1,19706,chr1_169949535_169969241
3110045C21Rik,1,169969409,169972396,antisense,1,2987,chr1_169969409_169972396
Ddr2,1,169972307,170110762,protein_coding,-1,138455,chr1_169972307_170110762
Uap1,1,170141938,170174957,protein_coding,-1,33019,chr1_170141938_170174957
Gm37748,1,170175180,170176319,lincRNA,1,1139,chr1_170175180_170176319
Gm37502,1,170175382,170177772,lincRNA,-1,2390,chr1_170175382_170177772
Uhmk1,1,170193420,170215397,protein_coding,-1,21977,chr1_170193420_170215397
4930500M09Rik,1,170214860,170216422,antisense,1,1562,chr1_170214860_170216422
Sh2d1b2,1,170232749,170253608,protein_coding,1,20859,chr1_170232749_170253608
Sh2d1b1,1,170277320,170286769,protein_coding,1,9449,chr1_170277320_170286769
Gm7694,1,170298199,170306332,protein_coding,-1,8133,chr1_170298199_170306332
Nos1ap,1,170302668,170589861,protein_coding,-1,287193,chr1_170302668_170589861
Spata46,1,170308803,170312125,protein_coding,1,3322,chr1_170308803_170312125
Olfml2b,1,170644532,170682789,protein_coding,1,38257,chr1_170644532_170682789
Atf6,1,170704674,170867771,protein_coding,-1,163097,chr1_170704674_170867771
Dusp12,1,170873498,170885540,protein_coding,-1,12042,chr1_170873498_170885540
Gm26620,1,170885065,170885881,protein_coding,1,816,chr1_170885065_170885881
Fcrlb,1,170907273,170912941,protein_coding,-1,5668,chr1_170907273_170912941
Fcrla,1,170917576,170927583,protein_coding,-1,10007,chr1_170917576_170927583
Fcgr2b,1,170958617,170976547,protein_coding,-1,17930,chr1_170958617_170976547
Gm10522,1,170981944,170986466,lincRNA,1,4522,chr1_170981944_170986466
Fcgr4,1,171018920,171029761,protein_coding,1,10841,chr1_171018920_171029761
Fcgr3,1,171051174,171064935,protein_coding,-1,13761,chr1_171051174_171064935
Cfap126,1,171113918,171126967,protein_coding,1,13049,chr1_171113918_171126967
Sdhc,1,171127165,171150603,protein_coding,-1,23438,chr1_171127165_171150603
Mpz,1,171150711,171161130,protein_coding,1,10419,chr1_171150711_171161130
Pcp4l1,1,171173262,171196268,protein_coding,-1,23006,chr1_171173262_171196268
Nr1i3,1,171213970,171220701,protein_coding,1,6731,chr1_171213970_171220701
Tomm40l,1,171216011,171222514,protein_coding,-1,6503,chr1_171216011_171222514
Apoa2,1,171225054,171226379,protein_coding,1,1325,chr1_171225054_171226379
Fcer1g,1,171229572,171234365,protein_coding,-1,4793,chr1_171229572_171234365
Ndufs2,1,171234853,171251388,protein_coding,-1,16535,chr1_171234853_171251388
Adamts4,1,171250421,171260637,protein_coding,1,10216,chr1_171250421_171260637
B4galt3,1,171270328,171276896,protein_coding,1,6568,chr1_171270328_171276896
Ppox,1,171275990,171281186,protein_coding,-1,5196,chr1_171275990_171281186
Usp21,1,171281945,171287991,protein_coding,-1,6046,chr1_171281945_171287991
Ufc1,1,171288563,171295024,protein_coding,-1,6461,chr1_171288563_171295024
Gm20045,1,171320601,171326177,lincRNA,-1,5576,chr1_171320601_171326177
Dedd,1,171329145,171342331,protein_coding,1,13186,chr1_171329145_171342331
Nit1,1,171338008,171345646,protein_coding,-1,7638,chr1_171338008_171345646
Pfdn2,1,171345670,171359254,protein_coding,1,13584,chr1_171345670_171359254
Klhdc9,1,171358446,171360798,protein_coding,-1,2352,chr1_171358446_171360798
Nectin4,1,171370099,171388598,protein_coding,1,18499,chr1_171370099_171388598
Arhgap30,1,171388954,171410298,protein_coding,1,21344,chr1_171388954_171410298
Usf1,1,171411313,171419142,protein_coding,1,7829,chr1_171411313_171419142
Tstd1,1,171418872,171420352,protein_coding,1,1480,chr1_171418872_171420352
F11r,1,171437535,171464603,protein_coding,1,27068,chr1_171437535_171464603
B930036N10Rik,1,171500568,171504111,antisense,-1,3543,chr1_171500568_171504111
Alyref2,1,171503478,171504750,protein_coding,1,1272,chr1_171503478_171504750
Itln1,1,171518122,171535294,protein_coding,-1,17172,chr1_171518122_171535294
Ly9,1,171588624,171607410,protein_coding,-1,18786,chr1_171588624_171607410
Slamf7,1,171632403,171653035,protein_coding,-1,20632,chr1_171632403_171653035
Cd48,1,171682009,171705258,protein_coding,1,23249,chr1_171682009_171705258
Slamf1,1,171767127,171801184,protein_coding,1,34057,chr1_171767127_171801184
Cd84,1,171839697,171890718,protein_coding,1,51021,chr1_171839697_171890718
Gm10521,1,171895664,171898237,protein_coding,1,2573,chr1_171895664_171898237
Gm37065,1,171909957,171919356,antisense,-1,9399,chr1_171909957_171919356
Slamf6,1,171917515,171953170,protein_coding,1,35655,chr1_171917515_171953170
Vangl2,1,172000960,172028444,protein_coding,-1,27484,chr1_172000960_172028444
Nhlh1,1,172052292,172057573,protein_coding,-1,5281,chr1_172052292_172057573
Ncstn,1,172066013,172082795,protein_coding,-1,16782,chr1_172066013_172082795
Copa,1,172082529,172122330,protein_coding,1,39801,chr1_172082529_172122330
Gm37756,1,172089910,172092679,antisense,-1,2769,chr1_172089910_172092679
Pex19,1,172126755,172136493,protein_coding,1,9738,chr1_172126755_172136493
Dcaf8,1,172148084,172197005,protein_coding,1,48921,chr1_172148084_172197005
Pea15a,1,172196728,172206804,protein_coding,-1,10076,chr1_172196728_172206804
Casq1,1,172209894,172219868,protein_coding,-1,9974,chr1_172209894_172219868
Gm17224,1,172213021,172213680,antisense,1,659,chr1_172213021_172213680
Atp1a4,1,172223513,172258414,protein_coding,-1,34901,chr1_172223513_172258414
Gm37950,1,172237291,172238290,antisense,1,999,chr1_172237291_172238290
Igsf8,1,172261641,172319841,protein_coding,1,58200,chr1_172261641_172319841
Atp1a2,1,172271709,172298064,protein_coding,-1,26355,chr1_172271709_172298064
Kcnj9,1,172320501,172329318,protein_coding,-1,8817,chr1_172320501_172329318
Gm36937,1,172322994,172323661,antisense,1,667,chr1_172322994_172323661
Kcnj10,1,172341210,172374085,protein_coding,1,32875,chr1_172341210_172374085
Pigm,1,172376546,172384099,protein_coding,1,7553,chr1_172376546_172384099
Slamf9,1,172475358,172478575,protein_coding,1,3217,chr1_172475358_172478575
Igsf9,1,172481788,172498878,protein_coding,1,17090,chr1_172481788_172498878
Tagln2,1,172500047,172507380,protein_coding,1,7333,chr1_172500047_172507380
Cfap45,1,172520801,172545870,protein_coding,1,25069,chr1_172520801_172545870
Vsig8,1,172555938,172563717,protein_coding,1,7779,chr1_172555938_172563717
Slamf8,1,172581758,172590568,protein_coding,-1,8810,chr1_172581758_172590568
Fcrl6,1,172596642,172602551,protein_coding,-1,5909,chr1_172596642_172602551
Dusp23,1,172630764,172632962,protein_coding,-1,2198,chr1_172630764_172632962
Crp,1,172698055,172833031,protein_coding,1,134976,chr1_172698055_172833031
Olfr16,1,172950409,172958357,protein_coding,1,7948,chr1_172950409_172958357
Olfr1408,1,173128049,173137374,protein_coding,-1,9325,chr1_173128049_173137374
Olfr1406,1,173181853,173190640,protein_coding,-1,8787,chr1_173181853_173190640
Olfr418,1,173266001,173273994,protein_coding,1,7993,chr1_173266001_173273994
Ackr1,1,173331886,173333750,protein_coding,-1,1864,chr1_173331886_173333750
Cadm3,1,173333258,173367695,protein_coding,-1,34437,chr1_173333258_173367695
Aim2,1,173350879,173466040,protein_coding,1,115161,chr1_173350879_173466040
Ifi206,1,173468485,173491041,protein_coding,-1,22556,chr1_173468485_173491041
Ifi213,1,173566283,173599274,protein_coding,-1,32991,chr1_173566283_173599274
Ifi209,1,173630917,173647928,protein_coding,1,17011,chr1_173630917_173647928
Ifi208,1,173673675,173698395,protein_coding,1,24720,chr1_173673675_173698395
Ifi207,1,173723427,173741747,protein_coding,-1,18320,chr1_173723427_173741747
Ifi204,1,173747293,173766943,protein_coding,-1,19650,chr1_173747293_173766943
Mndal,1,173849126,173880881,protein_coding,-1,31755,chr1_173849126_173880881
Ifi202b,1,173962568,173982744,protein_coding,-1,20176,chr1_173962568_173982744
Ifi205,1,174011998,174031810,protein_coding,-1,19812,chr1_174011998_174031810
Olfr433,1,174040705,174044411,protein_coding,1,3706,chr1_174040705_174044411
Olfr432,1,174049205,174054752,protein_coding,1,5547,chr1_174049205_174054752
Olfr420,1,174155633,174162195,protein_coding,1,6562,chr1_174155633_174162195
Spta1,1,174172776,174248450,protein_coding,1,75674,chr1_174172776_174248450
Olfr417,1,174365122,174374472,protein_coding,1,9350,chr1_174365122_174374472
Olfr248,1,174391046,174392055,protein_coding,1,1009,chr1_174391046_174392055
Olfr414,1,174424064,174434747,protein_coding,1,10683,chr1_174424064_174434747
Olfr220,1,174442082,174451277,protein_coding,1,9195,chr1_174442082_174451277
Fmn2,1,174501825,174822729,protein_coding,1,320904,chr1_174501825_174822729
Grem2,1,174833785,174921819,protein_coding,-1,88034,chr1_174833785_174921819
Rgs7,1,175059087,175492500,protein_coding,-1,433413,chr1_175059087_175492500
Gm36307,1,175574309,175578425,lincRNA,1,4116,chr1_175574309_175578425
Fh1,1,175600374,175625635,protein_coding,-1,25261,chr1_175600374_175625635
Kmo,1,175620381,175662116,protein_coding,1,41735,chr1_175620381_175662116
Opn3,1,175662421,175692776,protein_coding,-1,30355,chr1_175662421_175692776
Wdr64,1,175698593,175815734,protein_coding,1,117141,chr1_175698593_175815734
Exo1,1,175880581,175913489,protein_coding,1,32908,chr1_175880581_175913489
Pld5,1,175962306,176275312,protein_coding,-1,313006,chr1_175962306_176275312
Gm38101,1,176276213,176279769,lincRNA,1,3556,chr1_176276213_176279769
Gm36536,1,176430111,176527273,lincRNA,-1,97162,chr1_176430111_176527273
Cep170,1,176733653,176814067,protein_coding,-1,80414,chr1_176733653_176814067
Gm36992,1,176754517,176758876,antisense,1,4359,chr1_176754517_176758876
Sdccag8,1,176814660,177020437,protein_coding,1,205777,chr1_176814660_177020437
Gm15423,1,176927999,176932711,antisense,-1,4712,chr1_176927999_176932711
Akt3,1,177020073,177258203,protein_coding,-1,238130,chr1_177020073_177258203
Gm26801,1,177428338,177443270,antisense,-1,14932,chr1_177428338_177443270
Zbtb18,1,177442351,177450764,protein_coding,1,8413,chr1_177442351_177450764
Gm37306,1,177467378,177476267,lincRNA,1,8889,chr1_177467378_177476267
Gm37280,1,177589021,177594522,lincRNA,-1,5501,chr1_177589021_177594522
2310043L19Rik,1,177641542,177642943,lincRNA,-1,1401,chr1_177641542_177642943
1700016C15Rik,1,177729814,177753324,protein_coding,1,23510,chr1_177729814_177753324
Adss,1,177762962,177796511,protein_coding,-1,33549,chr1_177762962_177796511
Catspere2,1,177983423,178172705,protein_coding,1,189282,chr1_177983423_178172705
Desi2,1,178187417,178257301,protein_coding,1,69884,chr1_178187417_178257301
B230369F24Rik,CHR_MG4281_PATCH,178313327,178318549,antisense;lncRNA,-1,5222,chrCHR_MG4281_PATCH_178313327_178318549
Cox20,1,178319129,178322693,protein_coding,1,3564,chr1_178319129_178322693
Hnrnpu,1,178321107,178337797,protein_coding,-1,16690,chr1_178321107_178337797
Efcab2,1,178406085,178484513,protein_coding,1,78428,chr1_178406085_178484513
Kif26b,1,178529125,178939200,protein_coding,1,410075,chr1_178529125_178939200
Gm16564,1,178898582,178917614,antisense,-1,19032,chr1_178898582_178917614
Smyd3,1,178951960,179518041,protein_coding,-1,566081,chr1_178951960_179518041
Tfb2m,1,179528055,179546267,protein_coding,-1,18212,chr1_179528055_179546267
Cnst,1,179546370,179627478,protein_coding,1,81108,chr1_179546370_179627478
Sccpdh,1,179668210,179687189,protein_coding,1,18979,chr1_179668210_179687189
Kif28,1,179695297,179745271,protein_coding,-1,49974,chr1_179695297_179745271
Ahctf1,1,179744894,179803680,protein_coding,-1,58786,chr1_179744894_179803680
Gm10518,1,179803376,179804676,antisense,1,1300,chr1_179803376_179804676
Cdc42bpa,1,179960472,180165603,protein_coding,1,205131,chr1_179960472_180165603
Coq8a,1,180165238,180199602,protein_coding,-1,34364,chr1_180165238_180199602
Gm37336,1,180202303,180212401,lincRNA,-1,10098,chr1_180202303_180212401
Psen2,1,180227004,180263438,protein_coding,-1,36434,chr1_180227004_180263438
Gm31728,1,180256429,180274963,antisense,1,18534,chr1_180256429_180274963
Itpkb,1,180330485,180424802,protein_coding,1,94317,chr1_180330485_180424802
Stum,1,180432387,180483504,protein_coding,-1,51117,chr1_180432387_180483504
Gm37267,1,180508778,180519727,lincRNA,-1,10949,chr1_180508778_180519727
Parp1,1,180568924,180601254,protein_coding,1,32330,chr1_180568924_180601254
Lin9,1,180641150,180690694,protein_coding,1,49544,chr1_180641150_180690694
Mixl1,1,180693043,180697034,protein_coding,-1,3991,chr1_180693043_180697034
Acbd3,1,180726043,180754204,protein_coding,1,28161,chr1_180726043_180754204
Gm37768,1,180743210,180755836,antisense,-1,12626,chr1_180743210_180755836
Gm38293,1,180763497,180768656,lincRNA,-1,5159,chr1_180763497_180768656
H3f3a,1,180800832,180813943,protein_coding,-1,13111,chr1_180800832_180813943
H3f3aos,1,180813776,180816859,antisense,1,3083,chr1_180813776_180816859
Sde2,1,180851127,180868113,protein_coding,1,16986,chr1_180851127_180868113
Lefty2,1,180893108,180899103,protein_coding,1,5995,chr1_180893108_180899103
Pycr2,1,180904293,180908088,protein_coding,1,3795,chr1_180904293_180908088
Lefty1,1,180935022,180938400,protein_coding,1,3378,chr1_180935022_180938400
Tmem63a,1,180942344,180975112,protein_coding,1,32768,chr1_180942344_180975112
2210411M09Rik,1,180952064,180958149,antisense,-1,6085,chr1_180952064_180958149
Ephx1,1,180976210,181020904,protein_coding,-1,44694,chr1_180976210_181020904
9130409I23Rik,1,181051237,181060667,protein_coding,1,9430,chr1_181051237_181060667
Gm37406,1,181062070,181064475,lincRNA,1,2405,chr1_181062070_181064475
Nvl,1,181087138,181144204,protein_coding,-1,57066,chr1_181087138_181144204
Cnih4,1,181144693,181168994,protein_coding,1,24301,chr1_181144693_181168994
Wdr26,1,181173228,181212001,protein_coding,-1,38773,chr1_181173228_181212001
A430110L20Rik,1,181225986,181228498,lincRNA,1,2512,chr1_181225986_181228498
Cnih3,1,181352628,181460641,protein_coding,1,108013,chr1_181352628_181460641
Ccdc121,1,181509633,181511451,protein_coding,-1,1818,chr1_181509633_181511451
Dnah14,1,181576559,181815774,protein_coding,1,239215,chr1_181576559_181815774
Lbr,1,181815335,181843046,protein_coding,-1,27711,chr1_181815335_181843046
Gm5533,1,181851574,181853189,lincRNA,-1,1615,chr1_181851574_181853189
Enah,1,181896384,182019990,protein_coding,-1,123606,chr1_181896384_182019990
Srp9,1,182124737,182132407,protein_coding,1,7670,chr1_182124737_182132407
Vmn1r1,1,182154704,182164486,protein_coding,-1,9782,chr1_182154704_182164486
Degs1,1,182275772,182282804,protein_coding,-1,7032,chr1_182275772_182282804
1700047M11Rik,1,182287990,182303325,lincRNA,1,15335,chr1_182287990_182303325
Fbxo28,1,182313102,182341629,protein_coding,-1,28527,chr1_182313102_182341629
Trp53bp2,1,182409172,182462432,protein_coding,1,53260,chr1_182409172_182462432
Capn2,1,182467260,182517608,protein_coding,-1,50348,chr1_182467260_182517608
Gm37885,1,182484179,182492473,antisense,1,8294,chr1_182484179_182492473
Capn8,1,182565007,182632352,protein_coding,1,67345,chr1_182565007_182632352
Ccdc185,1,182747126,182749180,protein_coding,-1,2054,chr1_182747126_182749180
Susd4,1,182763860,182896591,protein_coding,1,132731,chr1_182763860_182896591
Tlr5,1,182954788,182976044,protein_coding,1,21256,chr1_182954788_182976044
Disp1,1,183086266,183221522,protein_coding,-1,135256,chr1_183086266_183221522
Brox,1,183276352,183297269,protein_coding,-1,20917,chr1_183276352_183297269
Aida,1,183296590,183325476,protein_coding,1,28886,chr1_183296590_183325476
Mia3,1,183326725,183369553,protein_coding,-1,42828,chr1_183326725_183369553
Taf1a,1,183388981,183410198,protein_coding,1,21217,chr1_183388981_183410198
Gm37986,1,183414466,183414848,lincRNA,1,382,chr1_183414466_183414848
Hhipl2,1,183418215,183436808,protein_coding,1,18593,chr1_183418215_183436808
Gm33973,1,183563512,183564045,lincRNA,1,533,chr1_183563512_183564045
Gm34068,1,183748977,183809746,lincRNA,1,60769,chr1_183748977_183809746
Dusp10,1,184013302,184075636,protein_coding,1,62334,chr1_184013302_184075636
1700056E22Rik,1,184033030,184034301,protein_coding,-1,1271,chr1_184033030_184034301
Gm37223,1,184358329,184394271,lincRNA,1,35942,chr1_184358329_184394271
1700112H15Rik,1,184527841,184557691,lincRNA,-1,29850,chr1_184527841_184557691
Gm37800,1,184610280,184629473,lincRNA,-1,19193,chr1_184610280_184629473
Hlx,1,184727140,184732619,protein_coding,-1,5479,chr1_184727140_184732619
C130074G19Rik,1,184871926,184883218,protein_coding,-1,11292,chr1_184871926_184883218
Mark1,1,184896789,184999570,protein_coding,-1,102781,chr1_184896789_184999570
Gm38251,1,184923136,184942500,antisense,1,19364,chr1_184923136_184942500
Gm34732,1,185082738,185085964,lincRNA,-1,3226,chr1_185082738_185085964
Gm37662,1,185091991,185099547,lincRNA,1,7556,chr1_185091991_185099547
Rab3gap2,1,185204117,185286759,protein_coding,1,82642,chr1_185204117_185286759
Gm34882,1,185243713,185247889,antisense,-1,4176,chr1_185243713_185247889
Iars2,1,185284726,185329396,protein_coding,-1,44670,chr1_185284726_185329396
2010103J01Rik,1,185312187,185313803,antisense,1,1616,chr1_185312187_185313803
Bpnt1,1,185332149,185357777,protein_coding,1,25628,chr1_185332149_185357777
4930532G15Rik,1,185359461,185362865,lincRNA,-1,3404,chr1_185359461_185362865
Eprs,1,185363044,185428360,protein_coding,1,65316,chr1_185363044_185428360
9630028B13Rik,1,185429355,185441819,lincRNA,-1,12464,chr1_185429355_185441819
Gm2061,1,185447116,185455568,antisense,-1,8452,chr1_185447116_185455568
Slc30a10,1,185454848,185468762,protein_coding,1,13914,chr1_185454848_185468762
Lyplal1,1,186087731,186117310,protein_coding,-1,29579,chr1_186087731_186117310
Gm37134,1,186177338,186223789,lincRNA,1,46451,chr1_186177338_186223789
A730004F24Rik,1,186511838,186558681,lincRNA,-1,46843,chr1_186511838_186558681
Tgfb2,1,186622792,186705989,protein_coding,-1,83197,chr1_186622792_186705989
Gm29491,1,186705695,186707033,antisense,1,1338,chr1_186705695_186707033
Rrp15,1,186720978,186749358,protein_coding,-1,28380,chr1_186720978_186749358
A430105J06Rik,1,186749396,186752921,lincRNA,1,3525,chr1_186749396_186752921
Spata17,1,187044648,187215465,protein_coding,-1,170817,chr1_187044648_187215465
1700007P06Rik,1,187125138,187127852,antisense,1,2714,chr1_187125138_187127852
Gpatch2,1,187215508,187351704,protein_coding,1,136196,chr1_187215508_187351704
Gm38155,1,187344970,187377469,antisense,-1,32499,chr1_187344970_187377469
Gm37896,1,187447877,187462664,lincRNA,1,14787,chr1_187447877_187462664
Esrrg,1,187608791,188214885,protein_coding,1,606094,chr1_187608791_188214885
Gm36388,1,187616852,187651824,antisense,-1,34972,chr1_187616852_187651824
9330162B11Rik,1,188006576,188008990,antisense,-1,2414,chr1_188006576_188008990
Gm38064,1,188246140,188257885,lincRNA,1,11745,chr1_188246140_188257885
Ush2a,1,188262023,188965041,protein_coding,1,703018,chr1_188262023_188965041
Kctd3,1,188971095,189007841,protein_coding,-1,36746,chr1_188971095_189007841
Kcnk2,1,189207930,189402273,protein_coding,-1,194343,chr1_189207930_189402273
A430027H14Rik,1,189343431,189344897,antisense,1,1466,chr1_189343431_189344897
Cenpf,1,189640606,189688086,protein_coding,-1,47480,chr1_189640606_189688086
Ptpn14,1,189728268,189876695,protein_coding,1,148427,chr1_189728268_189876695
Gm26574,1,189833141,189836620,antisense,-1,3479,chr1_189833141_189836620
Gm37422,1,189879935,189884652,antisense,1,4717,chr1_189879935_189884652
Smyd2,1,189880492,189922363,protein_coding,-1,41871,chr1_189880492_189922363
Prox1,1,190118035,190170714,protein_coding,-1,52679,chr1_190118035_190170714
Gm28172,1,190168670,190169633,antisense,1,963,chr1_190168670_190169633
Prox1os,1,190170296,190217276,antisense,1,46980,chr1_190170296_190217276
Gm29678,1,190403645,190417145,lincRNA,1,13500,chr1_190403645_190417145
Gm30725,1,190419333,190444855,lincRNA,-1,25522,chr1_190419333_190444855
Rps6kc1,1,190700202,190911770,protein_coding,-1,211568,chr1_190700202_190911770
Angel2,1,190925112,190946962,protein_coding,1,21850,chr1_190925112_190946962
Vash2,1,190947646,190979296,protein_coding,-1,31650,chr1_190947646_190979296
Gm31373,1,190992692,190994677,lincRNA,1,1985,chr1_190992692_190994677
Flvcr1,1,191005847,191026158,protein_coding,-1,20311,chr1_191005847_191026158
A230020J21Rik,1,191025350,191029781,antisense,1,4431,chr1_191025350_191029781
Spata45,1,191036639,191042942,protein_coding,1,6303,chr1_191036639_191042942
Tatdn3,1,191045826,191062932,protein_coding,-1,17106,chr1_191045826_191062932
Nsl1,1,191063012,191086474,protein_coding,1,23462,chr1_191063012_191086474
Batf3,1,191097847,191108945,protein_coding,1,11098,chr1_191097847_191108945
Atf3,1,191170296,191218039,protein_coding,-1,47743,chr1_191170296_191218039
D730003I15Rik,1,191224454,191226140,lincRNA,1,1686,chr1_191224454_191226140
Gm37168,1,191267178,191288714,lincRNA,1,21536,chr1_191267178_191288714
Nenf,1,191306789,191318194,protein_coding,-1,11405,chr1_191306789_191318194
Ppp2r5a,1,191351975,191403272,protein_coding,-1,51297,chr1_191351975_191403272
Gm32200,1,191436340,191465048,lincRNA,-1,28708,chr1_191436340_191465048
Gm37432,1,191490910,191493905,lincRNA,-1,2995,chr1_191490910_191493905
Dtl,1,191537356,191575544,protein_coding,-1,38188,chr1_191537356_191575544
Ints7,1,191575636,191623688,protein_coding,1,48052,chr1_191575636_191623688
Lpgat1,1,191717834,191784255,protein_coding,1,66421,chr1_191717834_191784255
Gm38037,CHR_MG3999_PATCH,191820370,191821993,antisense;lncRNA,-1,1623,chrCHR_MG3999_PATCH_191820370_191821993
Nek2,1,191821444,191833050,protein_coding,1,11606,chr1_191821444_191833050
1700034H15Rik,CHR_MG3999_PATCH,191886130,191907527,antisense;lncRNA,-1,21397,chrCHR_MG3999_PATCH_191886130_191907527
Slc30a1,1,191906767,191913247,protein_coding,1,6480,chr1_191906767_191913247
Rd3,1,191977219,191988283,protein_coding,1,11064,chr1_191977219_191988283
Gm26670,CHR_MG3999_PATCH,191986681,191990138,antisense;lncRNA,-1,3457,chrCHR_MG3999_PATCH_191986681_191990138
Traf5,1,191997054,192092559,protein_coding,-1,95505,chr1_191997054_192092559
Gm26879,CHR_MG3999_PATCH,192044658,192099628,antisense;lncRNA,1,54970,chrCHR_MG3999_PATCH_192044658_192099628
Rcor3,1,192050849,192138062,protein_coding,-1,87213,chr1_192050849_192138062
Gm10516,1,192136896,192151026,antisense,1,14130,chr1_192136896_192151026
Kcnh1,1,192190774,192510159,protein_coding,1,319385,chr1_192190774_192510159
Hhat,1,192496711,192771223,protein_coding,-1,274512,chr1_192496711_192771223
1700065J18Rik,1,192841661,192842740,lincRNA,1,1079,chr1_192841661_192842740
Sertad4,1,192844488,192855756,protein_coding,-1,11268,chr1_192844488_192855756
Gm15867,1,192854923,192856246,antisense,1,1323,chr1_192854923_192856246
Syt14,1,192891233,193035775,protein_coding,-1,144542,chr1_192891233_193035775
Gm31406,1,193040973,193042405,lincRNA,-1,1432,chr1_193040973_193042405
Irf6,1,193153111,193172023,protein_coding,1,18912,chr1_193153111_193172023
A130010J15Rik,1,193168046,193177832,protein_coding,1,9786,chr1_193168046_193177832
Traf3ip3,1,193175453,193201703,protein_coding,-1,26250,chr1_193175453_193201703
Gm15872,1,193187274,193192379,antisense,1,5105,chr1_193187274_193192379
4930570N18Rik,1,193203038,193226208,antisense,1,23170,chr1_193203038_193226208
Lamb3,1,193207699,193343878,protein_coding,1,136179,chr1_193207699_193343878
Hsd11b1,1,193221634,193264075,protein_coding,-1,42441,chr1_193221634_193264075
G0s2,1,193272161,193273217,protein_coding,-1,1056,chr1_193272161_193273217
Camk1g,1,193346346,193370298,protein_coding,-1,23952,chr1_193346346_193370298
4930503O07Rik,1,194212187,194222759,lincRNA,-1,10572,chr1_194212187_194222759
Plxna2,1,194618218,194816869,protein_coding,1,198651,chr1_194618218_194816869
Cd34,1,194938819,194961279,protein_coding,1,22460,chr1_194938819_194961279
Gm16897,1,194955759,194976960,antisense,-1,21201,chr1_194955759_194976960
Gm32250,1,194989062,194995345,lincRNA,-1,6283,chr1_194989062_194995345
Gm37027,1,195017892,195018242,lincRNA,-1,350,chr1_195017892_195018242
Cd46,1,195036826,195092249,protein_coding,-1,55423,chr1_195036826_195092249
Cr1l,1,195097382,195131586,protein_coding,-1,34204,chr1_195097382_195131586
Cr2,1,195136811,195176716,protein_coding,-1,39905,chr1_195136811_195176716
Fam171a1,2,3114224,3227806,protein_coding,1,113582,chr2_3114224_3227806
Nmt2,2,3284212,3328877,protein_coding,1,44665,chr2_3284212_3328877
Rpp38,2,3328949,3332643,protein_coding,-1,3694,chr2_3328949_3332643
Acbd7,2,3336168,3340993,protein_coding,1,4825,chr2_3336168_3340993
Olah,2,3341982,3397210,protein_coding,-1,55228,chr2_3341982_3397210
Meig1,2,3409043,3422648,protein_coding,-1,13605,chr2_3409043_3422648
Dclre1c,2,3424131,3464130,protein_coding,1,39999,chr2_3424131_3464130
Suv39h2,2,3455815,3475031,protein_coding,-1,19216,chr2_3455815_3475031
Gm13184,2,3468613,3474546,antisense,1,5933,chr2_3468613_3474546
Hspa14,2,3488850,3512814,protein_coding,-1,23964,chr2_3488850_3512814
Cdnf,2,3513030,3526376,protein_coding,1,13346,chr2_3513030_3526376
Fam107b,2,3570488,3782142,protein_coding,1,211654,chr2_3570488_3782142
Gm13180,2,3855030,3877575,lincRNA,1,22545,chr2_3855030_3877575
Frmd4a,2,4017717,4614043,protein_coding,1,596326,chr2_4017717_4614043
1700080N15Rik,2,4132063,4141141,antisense,-1,9078,chr2_4132063_4141141
Gm13175,2,4458434,4466670,antisense,-1,8236,chr2_4458434_4466670
Gm13179,2,4586024,4587287,antisense,-1,1263,chr2_4586024_4587287
Prpf18,2,4622058,4652113,protein_coding,-1,30055,chr2_4622058_4652113
Bend7,2,4717831,4802142,protein_coding,1,84311,chr2_4717831_4802142
Sephs1,2,4881564,4910557,protein_coding,1,28993,chr2_4881564_4910557
Phyh,2,4919019,4938730,protein_coding,1,19711,chr2_4919019_4938730
Ucma,2,4976122,4985748,protein_coding,1,9626,chr2_4976122_4985748
Mcm10,2,4989714,5012791,protein_coding,-1,23077,chr2_4989714_5012791
Optn,2,5020642,5064051,protein_coding,-1,43409,chr2_5020642_5064051
4930551O13Rik,2,5037280,5041133,antisense,1,3853,chr2_5037280_5041133
Ccdc3,2,5137776,5230878,protein_coding,1,93102,chr2_5137776_5230878
Camk1d,2,5293457,5714515,protein_coding,-1,421058,chr2_5293457_5714515
Cdc123,2,5794294,5845164,protein_coding,-1,50870,chr2_5794294_5845164
Nudt5,2,5845019,5871895,protein_coding,1,26876,chr2_5845019_5871895
Gm13199,2,5862080,5862934,protein_coding,-1,854,chr2_5862080_5862934
Sec61a2,2,5870987,5895432,protein_coding,-1,24445,chr2_5870987_5895432
Gm13267,2,5895510,5900131,antisense,1,4621,chr2_5895510_5900131
Dhtkd1,2,5896115,5942792,protein_coding,-1,46677,chr2_5896115_5942792
Upf2,2,5951469,6056703,protein_coding,1,105234,chr2_5951469_6056703
Proser2,2,6097607,6130211,protein_coding,-1,32604,chr2_6097607_6130211
Gm10857,2,6132869,6140568,lincRNA,1,7699,chr2_6132869_6140568
Echdc3,2,6188465,6213033,protein_coding,-1,24568,chr2_6188465_6213033
A230108P19Rik,2,6193251,6321611,antisense,1,128360,chr2_6193251_6321611
Gm13383,2,6255946,6257266,lincRNA,-1,1320,chr2_6255946_6257266
Usp6nl,2,6322667,6446390,protein_coding,1,123723,chr2_6322667_6446390
Gm13388,2,6431786,6436033,antisense,-1,4247,chr2_6431786_6436033
Gm13391,2,6472000,6478619,lincRNA,1,6619,chr2_6472000_6478619
Celf2,2,6539694,7509563,protein_coding,-1,969869,chr2_6539694_7509563
Gm13389,2,6884270,6886924,antisense,1,2654,chr2_6884270_6886924
Gm28641,2,7529939,7531307,lincRNA,1,1368,chr2_7529939_7531307
Gm13211,2,7716151,7781408,lincRNA,-1,65257,chr2_7716151_7781408
1700061F12Rik,2,9189515,9197477,lincRNA,1,7962,chr2_9189515_9197477
Gm13219,2,9352431,9447676,lincRNA,1,95245,chr2_9352431_9447676
Gata3,2,9857078,9890034,protein_coding,-1,32956,chr2_9857078_9890034
Gm13262,2,9906178,9914678,antisense,1,8500,chr2_9906178_9914678
Taf3,2,9914552,10048596,protein_coding,-1,134044,chr2_9914552_10048596
Atp5c1,2,10056016,10080510,protein_coding,-1,24494,chr2_10056016_10080510
Kin,2,10080593,10092806,protein_coding,1,12213,chr2_10080593_10092806
Itih2,2,10094593,10131396,protein_coding,-1,36803,chr2_10094593_10131396
Itih5,2,10153571,10256529,protein_coding,1,102958,chr2_10153571_10256529
Sfmbt2,2,10370510,10595253,protein_coding,1,224743,chr2_10370510_10595253
Gm13264,2,11036873,11060129,lincRNA,1,23256,chr2_11036873_11060129
Prkcq,2,11172108,11301222,protein_coding,1,129114,chr2_11172108_11301222
Gm38171,2,11315372,11319874,lincRNA,-1,4502,chr2_11315372_11319874
8030442B05Rik,2,11338366,11398501,lincRNA,-1,60135,chr2_11338366_11398501
Gm13293,2,11339488,11344111,lincRNA,1,4623,chr2_11339488_11344111
Pfkfb3,2,11471433,11554077,protein_coding,-1,82644,chr2_11471433_11554077
Gm10851,2,11521706,11530836,antisense,1,9130,chr2_11521706_11530836
Rbm17,2,11585437,11604153,protein_coding,-1,18716,chr2_11585437_11604153
Il2ra,2,11642807,11693193,protein_coding,1,50386,chr2_11642807_11693193
Il15ra,2,11705290,11734317,protein_coding,1,29027,chr2_11705290_11734317
Ankrd16,2,11777876,11790329,protein_coding,1,12453,chr2_11777876_11790329
Itga8,2,12106632,12301922,protein_coding,-1,195290,chr2_12106632_12301922
E030013I19Rik,2,12300946,12312315,antisense,1,11369,chr2_12300946_12312315
Mindy3,2,12347263,12419470,protein_coding,-1,72207,chr2_12347263_12419470
Pter,2,12924041,13003455,protein_coding,1,79414,chr2_12924041_13003455
C1ql3,2,13003457,13011806,protein_coding,-1,8349,chr2_13003457_13011806
Rsu1,2,13076821,13271415,protein_coding,-1,194594,chr2_13076821_13271415
Cubn,2,13276338,13491813,protein_coding,-1,215475,chr2_13276338_13491813
Trdmt1,2,13509014,13544668,protein_coding,-1,35654,chr2_13509014_13544668
Vim,2,13573927,13582826,protein_coding,1,8899,chr2_13573927_13582826
St8sia6,2,13651021,13794064,protein_coding,-1,143043,chr2_13651021_13794064
Gm37126,2,13672516,13674434,antisense,1,1918,chr2_13672516_13674434
Hacd1,2,13850282,14056135,protein_coding,-1,205853,chr2_13850282_14056135
Stam,2,14074098,14149634,protein_coding,1,75536,chr2_14074098_14149634
Tmem236,2,14174523,14221993,protein_coding,1,47470,chr2_14174523_14221993
Mrc1,2,14229392,14332057,protein_coding,1,102665,chr2_14229392_14332057
Slc39a12,2,14388316,14494977,protein_coding,1,106661,chr2_14388316_14494977
Cacnb2,2,14603088,14987908,protein_coding,1,384820,chr2_14603088_14987908
Gm10848,2,14706834,14739722,antisense,-1,32888,chr2_14706834_14739722
Gm13269,2,14740372,14767024,antisense,-1,26652,chr2_14740372_14767024
Nsun6,2,14995131,15055069,protein_coding,-1,59938,chr2_14995131_15055069
Arl5b,2,15049395,15082456,protein_coding,1,33061,chr2_15049395_15082456
Malrd1,2,15526479,16255555,protein_coding,1,729076,chr2_15526479_16255555
Plxdc2,2,16356304,16755839,protein_coding,1,399535,chr2_16356304_16755839
Gm13322,2,17181743,17185487,lincRNA,-1,3744,chr2_17181743_17185487
Nebl,2,17343909,17731464,protein_coding,-1,387555,chr2_17343909_17731464
Gm13324,2,17559060,17559998,antisense,1,938,chr2_17559060_17559998
H2al2a,2,17996417,17996958,protein_coding,-1,541,chr2_17996417_17996958
A930004D18Rik,2,18025193,18037737,protein_coding,-1,12544,chr2_18025193_18037737
Gm13330,2,18032533,18039633,antisense,1,7100,chr2_18032533_18039633
Skida1,2,18040676,18049051,protein_coding,-1,8375,chr2_18040676_18049051
Mllt10,2,18055237,18212388,protein_coding,1,157151,chr2_18055237_18212388
Dnajc1,2,18195654,18392830,protein_coding,-1,197176,chr2_18195654_18392830
Commd3,2,18672384,18676231,protein_coding,1,3847,chr2_18672384_18676231
Bmi1,2,18677018,18686629,protein_coding,1,9611,chr2_18677018_18686629
Spag6,2,18694032,18750413,protein_coding,1,56381,chr2_18694032_18750413
Carlr,2,18799245,18801818,protein_coding,-1,2573,chr2_18799245_18801818
Pip4k2a,2,18842255,18998126,protein_coding,-1,155871,chr2_18842255_18998126
4930426L09Rik,2,18998343,18999804,bidirectional_promoter_lncRNA,1,1461,chr2_18998343_18999804
Armc3,2,19199302,19310241,protein_coding,1,110939,chr2_19199302_19310241
4930447M23Rik,2,19344317,19351050,lincRNA,1,6733,chr2_19344317_19351050
Msrb2,2,19371440,19394976,protein_coding,1,23536,chr2_19371440_19394976
Gm33940,2,19428046,19430443,lincRNA,1,2397,chr2_19428046_19430443
Gm13344,2,19429104,19431983,antisense,-1,2879,chr2_19429104_19431983
4921504E06Rik,2,19462837,19553914,protein_coding,-1,91077,chr2_19462837_19553914
Gm13348,2,19634034,19636986,antisense,-1,2952,chr2_19634034_19636986
Otud1,2,19657752,19660583,protein_coding,1,2831,chr2_19657752_19660583
Gm13346,2,19676711,19686157,lincRNA,-1,9446,chr2_19676711_19686157
Etl4,2,19909780,20810713,protein_coding,1,900933,chr2_19909780_20810713
Gm17171,2,20300817,20324670,antisense,-1,23853,chr2_20300817_20324670
Gm13335,2,20420570,20432934,antisense,-1,12364,chr2_20420570_20432934
Gm13362,2,20709375,20713234,antisense,-1,3859,chr2_20709375_20713234
Arhgap21,2,20847919,20968881,protein_coding,-1,120962,chr2_20847919_20968881
Gm13375,2,20969054,20969997,antisense,1,943,chr2_20969054_20969997
Gm13376,2,21097099,21120659,lincRNA,1,23560,chr2_21097099_21120659
Enkur,2,21180731,21205365,protein_coding,-1,24634,chr2_21180731_21205365
Thnsl1,2,21205724,21215009,protein_coding,1,9285,chr2_21205724_21215009
Gm13327,2,21341925,21369111,antisense,-1,27186,chr2_21341925_21369111
Gpr158,2,21367542,21830547,protein_coding,1,463005,chr2_21367542_21830547
Myo3a,2,22227503,22618252,protein_coding,1,390749,chr2_22227503_22618252
Gad2,2,22622205,22693874,protein_coding,1,71669,chr2_22622205_22693874
1700092C17Rik,2,22755984,22762273,lincRNA,1,6289,chr2_22755984_22762273
Apbb1ip,2,22774094,22875653,protein_coding,1,101559,chr2_22774094_22875653
Pdss1,2,22895522,22940266,protein_coding,1,44744,chr2_22895522_22940266
Abi1,2,22940073,23040241,protein_coding,-1,100168,chr2_22940073_23040241
Acbd5,2,23068167,23115558,protein_coding,1,47391,chr2_23068167_23115558
Mastl,2,23115606,23156024,protein_coding,-1,40418,chr2_23115606_23156024
Yme1l1,2,23156369,23199260,protein_coding,1,42891,chr2_23156369_23199260
Nxph2,2,23321246,23401973,protein_coding,1,80727,chr2_23321246_23401973
Spopl,2,23506220,23572106,protein_coding,-1,65886,chr2_23506220_23572106
Hnmt,2,24002910,24049394,protein_coding,-1,46484,chr2_24002910_24049394
Tbpl2,2,24071721,24096595,protein_coding,-1,24874,chr2_24071721_24096595
Il1f9,2,24186476,24193568,protein_coding,1,7092,chr2_24186476_24193568
Il1f6,2,24215418,24225702,protein_coding,1,10284,chr2_24215418_24225702
Il1f5,2,24276954,24283426,protein_coding,1,6472,chr2_24276954_24283426
Il1rn,2,24336853,24351494,protein_coding,1,14641,chr2_24336853_24351494
Psd4,2,24367580,24414954,protein_coding,1,47374,chr2_24367580_24414954
Pax8,2,24420560,24475599,protein_coding,-1,55039,chr2_24420560_24475599
Gm13417,2,24545492,24566697,lincRNA,-1,21205,chr2_24545492_24566697
Cacna1b,2,24603887,24763152,protein_coding,-1,159265,chr2_24603887_24763152
Ehmt1,2,24789928,24919614,protein_coding,-1,129686,chr2_24789928_24919614
Arrdc1,2,24925352,24935252,protein_coding,-1,9900,chr2_24925352_24935252
Zmynd19,2,24949792,24962075,protein_coding,1,12283,chr2_24949792_24962075
Dph7,2,24962400,24972163,protein_coding,1,9763,chr2_24962400_24972163
Mrpl41,2,24974117,24975098,protein_coding,-1,981,chr2_24974117_24975098
Pnpla7,2,24976033,25054057,protein_coding,1,78024,chr2_24976033_25054057
Nsmf,2,25054355,25062881,protein_coding,1,8526,chr2_25054355_25062881
Entpd8,2,25080304,25085716,protein_coding,1,5412,chr2_25080304_25085716
Noxa1,2,25085667,25095149,protein_coding,-1,9482,chr2_25085667_25095149
Gm13387,2,25122603,25145396,lincRNA,-1,22793,chr2_25122603_25145396
Nrarp,2,25180758,25183339,protein_coding,1,2581,chr2_25180758_25183339
Gm38287,2,25180781,25183339,antisense,-1,2558,chr2_25180781_25183339
Tor4a,2,25192966,25196886,protein_coding,-1,3920,chr2_25192966_25196886
Nelfb,2,25199712,25211489,protein_coding,-1,11777,chr2_25199712_25211489
Stpg3,2,25212207,25214637,protein_coding,-1,2430,chr2_25212207_25214637
Fam166a,2,25218745,25222280,protein_coding,1,3535,chr2_25218745_25222280
Tubb4b,2,25222160,25224702,protein_coding,-1,2542,chr2_25222160_25224702
Slc34a3,2,25228898,25234364,protein_coding,-1,5466,chr2_25228898_25234364
Cysrt1,2,25238818,25242452,protein_coding,-1,3634,chr2_25238818_25242452
Rnf208,2,25242929,25244262,protein_coding,1,1333,chr2_25242929_25244262
AL732309.1,2,25116281,25176199,unitary_pseudogene,1,59918,chr2_25116281_25176199
Ndor1,2,25244819,25256022,protein_coding,-1,11203,chr2_25244819_25256022
Tmem203,2,25255439,25256292,protein_coding,1,853,chr2_25255439_25256292
Tprn,2,25262618,25269885,protein_coding,1,7267,chr2_25262618_25269885
Ssna1,2,25271039,25272438,protein_coding,-1,1399,chr2_25271039_25272438
Anapc2,2,25272478,25285915,protein_coding,1,13437,chr2_25272478_25285915
Tmem210,2,25288145,25289189,protein_coding,1,1044,chr2_25288145_25289189
Lrrc26,2,25289915,25291180,protein_coding,1,1265,chr2_25289915_25291180
Grin1,2,25291181,25319187,protein_coding,-1,28006,chr2_25291181_25319187
Grin1os,2,25291220,25298925,antisense,1,7705,chr2_25291220_25298925
Man1b1,2,25332338,25352212,protein_coding,1,19874,chr2_25332338_25352212
Dpp7,2,25352276,25356359,protein_coding,-1,4083,chr2_25352276_25356359
Uap1l1,2,25359889,25365682,protein_coding,-1,5793,chr2_25359889_25365682
Sapcd2,2,25372321,25378213,protein_coding,1,5892,chr2_25372321_25378213
Npdc1,2,25399351,25409494,protein_coding,1,10143,chr2_25399351_25409494
Fut7,2,25423267,25426374,protein_coding,1,3107,chr2_25423267_25426374
Abca2,2,25428703,25448540,protein_coding,1,19837,chr2_25428703_25448540
Paxx,2,25455141,25461094,protein_coding,-1,5953,chr2_25455141_25461094
Clic3,2,25456838,25458776,protein_coding,1,1938,chr2_25456838_25458776
Ptgds,2,25466709,25470046,protein_coding,-1,3337,chr2_25466709_25470046
C8g,2,25498651,25501719,protein_coding,-1,3068,chr2_25498651_25501719
Fbxw5,2,25500750,25505471,protein_coding,1,4721,chr2_25500750_25505471
Traf2,2,25517982,25546940,protein_coding,-1,28958,chr2_25517982_25546940
Edf1,2,25557847,25562082,protein_coding,1,4235,chr2_25557847_25562082
Mamdc4,2,25563115,25574845,protein_coding,-1,11730,chr2_25563115_25574845
Phpt1,2,25573430,25575224,protein_coding,-1,1794,chr2_25573430_25575224
Rabl6,2,25583018,25608521,protein_coding,-1,25503,chr2_25583018_25608521
Fcnaos,2,25607892,25631761,antisense,1,23869,chr2_25607892_25631761
Ccdc183,2,25608635,25617678,protein_coding,-1,9043,chr2_25608635_25617678
Tmem141,2,25620067,25622005,protein_coding,-1,1938,chr2_25620067_25622005
Fcna,2,25624666,25628030,protein_coding,-1,3364,chr2_25624666_25628030
Lcn6,2,25676786,25681608,protein_coding,1,4822,chr2_25676786_25681608
Lcn10,2,25682726,25686081,protein_coding,1,3355,chr2_25682726_25686081
A230005M16Rik,2,25705850,25709716,antisense,-1,3866,chr2_25705850_25709716
Bmyc,2,25706739,25707721,protein_coding,1,982,chr2_25706739_25707721
Obp2b,2,25737009,25740097,protein_coding,1,3088,chr2_25737009_25740097
Glt6d1,2,25793859,25815848,protein_coding,-1,21989,chr2_25793859_25815848
Sohlh1,2,25842995,25847248,protein_coding,-1,4253,chr2_25842995_25847248
Kcnt1,2,25863734,25918273,protein_coding,1,54539,chr2_25863734_25918273
Camsap1,2,25926838,25983282,protein_coding,-1,56444,chr2_25926838_25983282
Ubac1,2,25998543,26021747,protein_coding,-1,23204,chr2_25998543_26021747
Nacc2,2,26055535,26123220,protein_coding,-1,67685,chr2_26055535_26123220
Gm13554,2,26059010,26060275,antisense,1,1265,chr2_26059010_26060275
Tmem250-ps,2,26136814,26140521,protein_coding,-1,3707,chr2_26136814_26140521
1810012K08Rik,2,26138546,26139543,lincRNA,1,997,chr2_26138546_26139543
Lhx3,2,26200212,26208289,protein_coding,-1,8077,chr2_26200212_26208289
Gm27196,2,26206702,26209283,antisense,1,2581,chr2_26206702_26209283
Qsox2,2,26208637,26237525,protein_coding,-1,28888,chr2_26208637_26237525
Ccdc187,2,26243469,26294557,protein_coding,-1,51088,chr2_26243469_26294557
Gpsm1,2,26315515,26348237,protein_coding,1,32722,chr2_26315515_26348237
Dnlz,2,26348121,26352110,protein_coding,-1,3989,chr2_26348121_26352110
Card9,2,26352176,26360918,protein_coding,-1,8742,chr2_26352176_26360918
Snapc4,2,26362765,26380653,protein_coding,-1,17888,chr2_26362765_26380653
Gm13563,2,26381526,26389018,antisense,1,7492,chr2_26381526_26389018
Pmpca,2,26389339,26397122,protein_coding,1,7783,chr2_26389339_26397122
Inpp5e,2,26396249,26409203,protein_coding,-1,12954,chr2_26396249_26409203
Sec16a,2,26409431,26445216,protein_coding,-1,35785,chr2_26409431_26445216
Notch1,2,26457903,26516663,protein_coding,-1,58760,chr2_26457903_26516663
Egfl7,2,26580014,26593120,protein_coding,1,13106,chr2_26580014_26593120
Gm20532,2,26586639,26635634,protein_coding,1,48995,chr2_26586639_26635634
Agpat2,2,26593057,26604417,protein_coding,-1,11360,chr2_26593057_26604417
Snhg7os,2,26640372,26645944,antisense,1,5572,chr2_26640372_26645944
Abo,2,26842503,26864979,protein_coding,-1,22476,chr2_26842503_26864979
Surf6,2,26888628,26902879,protein_coding,-1,14251,chr2_26888628_26902879
Med22,2,26905262,26910677,protein_coding,-1,5415,chr2_26905262_26910677
Rpl7a,2,26910764,26913318,protein_coding,1,2554,chr2_26910764_26913318
Surf1,2,26913381,26916530,protein_coding,-1,3149,chr2_26913381_26916530
Surf2,2,26916367,26920183,protein_coding,1,3816,chr2_26916367_26920183
Surf4,2,26920040,26933928,protein_coding,-1,13888,chr2_26920040_26933928
Stkld1,2,26934047,26953496,protein_coding,1,19449,chr2_26934047_26953496
Rexo4,2,26953563,26964386,protein_coding,-1,10823,chr2_26953563_26964386
Adamts13,2,26973416,27009628,protein_coding,1,36212,chr2_26973416_27009628
Cacfd1,2,27009926,27021089,protein_coding,1,11163,chr2_27009926_27021089
Slc2a6,2,27021363,27027998,protein_coding,-1,6635,chr2_27021363_27027998
Gm13398,2,27037285,27040853,protein_coding,1,3568,chr2_27037285_27040853
Mymk,2,27061636,27072179,protein_coding,-1,10543,chr2_27061636_27072179
Adamtsl2,2,27079379,27108981,protein_coding,1,29602,chr2_27079379_27108981
Fam163b,2,27110380,27142491,protein_coding,-1,32111,chr2_27110380_27142491
Dbhos,2,27144898,27162703,antisense,-1,17805,chr2_27144898_27162703
Dbh,2,27165233,27183200,protein_coding,1,17967,chr2_27165233_27183200
Sardh,2,27188393,27248337,protein_coding,-1,59944,chr2_27188393_27248337
Sardhos,2,27189382,27234710,antisense,1,45328,chr2_27189382_27234710
Vav2,2,27262104,27427033,protein_coding,-1,164929,chr2_27262104_27427033
AA645442,2,27326704,27331297,antisense,1,4593,chr2_27326704_27331297
Brd3os,2,27442324,27444221,protein_coding,1,1897,chr2_27442324_27444221
Brd3,2,27445579,27507662,protein_coding,-1,62083,chr2_27445579_27507662
Wdr5,2,27515157,27536535,protein_coding,1,21378,chr2_27515157_27536535
Rxra,2,27676440,27762957,protein_coding,1,86517,chr2_27676440_27762957
Col5a1,2,27886425,28039514,protein_coding,1,153089,chr2_27886425_28039514
Fcnb,2,28076378,28084885,protein_coding,-1,8507,chr2_28076378_28084885
Gm13371,2,28092032,28093514,lincRNA,-1,1482,chr2_28092032_28093514
F730016J06Rik,2,28095477,28127731,lincRNA,1,32254,chr2_28095477_28127731
Olfm1,2,28192992,28230736,protein_coding,1,37744,chr2_28192992_28230736
Gm13373,2,28315016,28324050,lincRNA,-1,9034,chr2_28315016_28324050
Ppp1r26,2,28446800,28455508,protein_coding,1,8708,chr2_28446800_28455508
1700007K13Rik,2,28462001,28466332,protein_coding,-1,4331,chr2_28462001_28466332
Mrps2,2,28468066,28471178,protein_coding,1,3112,chr2_28468066_28471178
Gbgt1,2,28496891,28505415,protein_coding,1,8524,chr2_28496891_28505415
Gm10134,2,28506095,28507773,lincRNA,1,1678,chr2_28506095_28507773
Ralgds,2,28513125,28553081,protein_coding,1,39956,chr2_28513125_28553081
Cel,2,28555795,28563403,protein_coding,-1,7608,chr2_28555795_28563403
Gm13381,2,28562197,28576698,antisense,1,14501,chr2_28562197_28576698
Gtf3c5,2,28566311,28583751,protein_coding,-1,17440,chr2_28566311_28583751
Gfi1b,2,28609450,28621982,protein_coding,-1,12532,chr2_28609450_28621982
Tsc1,2,28641228,28691167,protein_coding,1,49939,chr2_28641228_28691167
Spaca9,2,28692080,28699727,protein_coding,-1,7647,chr2_28692080_28699727
Ak8,2,28700164,28813165,protein_coding,1,113001,chr2_28700164_28813165
Gtf3c4,2,28822299,28840360,protein_coding,-1,18061,chr2_28822299_28840360
Ddx31,2,28840406,28905571,protein_coding,1,65165,chr2_28840406_28905571
Barhl1,2,28907679,28916668,protein_coding,-1,8989,chr2_28907679_28916668
Cfap77,2,28926949,29055066,protein_coding,-1,128117,chr2_28926949_29055066
Ttf1,2,29060262,29087656,protein_coding,1,27394,chr2_29060262_29087656
Gm13393,2,29088666,29094501,lincRNA,1,5835,chr2_29088666_29094501
Setx,2,29124181,29182471,protein_coding,1,58290,chr2_29124181_29182471
Ntng2,2,29194541,29253005,protein_coding,-1,58464,chr2_29194541_29253005
Med27,2,29346819,29524793,protein_coding,1,177974,chr2_29346819_29524793
Gm13402,2,29349842,29396459,antisense,-1,46617,chr2_29349842_29396459
Rapgef1,2,29619720,29740978,protein_coding,1,121258,chr2_29619720_29740978
Gm13420,2,29744919,29751685,protein_coding,-1,6766,chr2_29744919_29751685
Gm13547,2,29759312,29764089,protein_coding,1,4777,chr2_29759312_29764089
Trub2,2,29761224,29788502,protein_coding,-1,27278,chr2_29761224_29788502
Coq4,2,29787493,29797935,protein_coding,1,10442,chr2_29787493_29797935
Slc27a4,2,29802634,29817522,protein_coding,1,14888,chr2_29802634_29817522
Urm1,2,29820075,29845002,protein_coding,1,24927,chr2_29820075_29845002
2600006K01Rik,2,29868723,29870317,antisense,-1,1594,chr2_29868723_29870317
Cercam,2,29869164,29882840,protein_coding,1,13676,chr2_29869164_29882840
Odf2,2,29889221,29931746,protein_coding,1,42525,chr2_29889221_29931746
Gle1,2,29935426,29960371,protein_coding,1,24945,chr2_29935426_29960371
Sptan1,2,29965560,30031451,protein_coding,1,65891,chr2_29965560_30031451
Wdr34,2,30031546,30048881,protein_coding,-1,17335,chr2_30031546_30048881
Set,2,30057378,30072577,protein_coding,1,15199,chr2_30057378_30072577
Pkn3,2,30077684,30091022,protein_coding,1,13338,chr2_30077684_30091022
Zdhhc12,2,30090944,30093648,protein_coding,-1,2704,chr2_30090944_30093648
Zer1,2,30097283,30124585,protein_coding,-1,27302,chr2_30097283_30124585
Tbc1d13,2,30133746,30152013,protein_coding,1,18267,chr2_30133746_30152013
Endog,2,30171493,30174069,protein_coding,1,2576,chr2_30171493_30174069
Spout1,2,30173453,30178459,protein_coding,-1,5006,chr2_30173453_30178459
Kyat1,2,30185124,30205847,protein_coding,-1,20723,chr2_30185124_30205847
1700084E18Rik,2,30236795,30238223,antisense,-1,1428,chr2_30236795_30238223
Lrrc8a,2,30237715,30263790,protein_coding,1,26075,chr2_30237715_30263790
Gm28035,2,30240567,30282148,protein_coding,1,41581,chr2_30240567_30282148
Gm28038,2,30281043,30301078,protein_coding,1,20035,chr2_30281043_30301078
Dolk,2,30284231,30286334,protein_coding,-1,2103,chr2_30284231_30286334
Nup188,2,30286397,30344266,protein_coding,1,57869,chr2_30286397_30344266
Sh3glb2,2,30344809,30359337,protein_coding,-1,14528,chr2_30344809_30359337
Miga2,2,30364233,30385521,protein_coding,1,21288,chr2_30364233_30385521
Dolpp1,2,30392254,30400529,protein_coding,1,8275,chr2_30392254_30400529
Crat,2,30400471,30415813,protein_coding,-1,15342,chr2_30400471_30415813
Gm16323,2,30413716,30415338,antisense,1,1622,chr2_30413716_30415338
Ptpa,2,30416039,30447806,protein_coding,1,31767,chr2_30416039_30447806
Ier5l,2,30471537,30474219,protein_coding,-1,2682,chr2_30471537_30474219
Gm14487,2,30534729,30539022,lincRNA,1,4293,chr2_30534729_30539022
Cstad,2,30595040,30608943,protein_coding,1,13903,chr2_30595040_30608943
9330198N18Rik,2,30629655,30689210,lincRNA,1,59555,chr2_30629655_30689210
Gm14486,2,30658468,30678011,lincRNA,-1,19543,chr2_30658468_30678011
1700001O22Rik,2,30794769,30803661,protein_coding,-1,8892,chr2_30794769_30803661
4930527E20Rik,2,30803793,30807429,antisense,1,3636,chr2_30803793_30807429
Ntmt1,2,30807826,30823033,protein_coding,1,15207,chr2_30807826_30823033
Asb6,2,30823097,30830333,protein_coding,-1,7236,chr2_30823097_30830333
Prrx2,2,30834972,30881251,protein_coding,1,46279,chr2_30834972_30881251
Ptges,2,30889471,30929863,protein_coding,-1,40392,chr2_30889471_30929863
Tor1b,2,30952959,30959015,protein_coding,1,6056,chr2_30952959_30959015
Tor1a,2,30960627,30967933,protein_coding,-1,7306,chr2_30960627_30967933
BC005624,2,30972177,30982201,protein_coding,-1,10024,chr2_30972177_30982201
Usp20,2,30982279,31023586,protein_coding,1,41307,chr2_30982279_31023586
Fnbp1,2,31026206,31142008,protein_coding,-1,115802,chr2_31026206_31142008
Gpr107,2,31152316,31218775,protein_coding,1,66459,chr2_31152316_31218775
Gm13405,2,31209470,31211347,antisense,-1,1877,chr2_31209470_31211347
Ncs1,2,31245823,31295989,protein_coding,1,50166,chr2_31245823_31295989
Hmcn2,2,31314415,31460738,protein_coding,1,146323,chr2_31314415_31460738
Ass1,2,31470207,31520672,protein_coding,1,50465,chr2_31470207_31520672
Fubp3,2,31572651,31617526,protein_coding,1,44875,chr2_31572651_31617526
Prdm12,2,31640037,31655795,protein_coding,1,15758,chr2_31640037_31655795
Exosc2,2,31670715,31681349,protein_coding,1,10634,chr2_31670715_31681349
Gm13427,2,31676364,31688469,antisense,-1,12105,chr2_31676364_31688469
Abl1,2,31688376,31804227,protein_coding,1,115851,chr2_31688376_31804227
Qrfp,2,31806166,31810580,protein_coding,-1,4414,chr2_31806166_31810580
Fibcd1,2,31813290,31846005,protein_coding,-1,32715,chr2_31813290_31846005
Lamc3,2,31887291,31946539,protein_coding,1,59248,chr2_31887291_31946539
Aif1l,2,31950139,31973442,protein_coding,1,23303,chr2_31950139_31973442
Nup214,2,31974436,32053975,protein_coding,1,79539,chr2_31974436_32053975
Gm13609,2,32016644,32017344,antisense,-1,700,chr2_32016644_32017344
Fam78a,2,32050055,32084857,protein_coding,-1,34802,chr2_32050055_32084857
Plpp7,2,32095528,32110820,protein_coding,1,15292,chr2_32095528_32110820
Prrc2b,2,32151082,32234537,protein_coding,1,83455,chr2_32151082_32234537
Gm13610,2,32232782,32236382,antisense,-1,3600,chr2_32232782_32236382
Pomt1,2,32236590,32255005,protein_coding,1,18415,chr2_32236590_32255005
Uck1,2,32255002,32260159,protein_coding,-1,5157,chr2_32255002_32260159
Swi5,2,32278816,32288075,protein_coding,-1,9259,chr2_32278816_32288075
Golga2,2,32287384,32307921,protein_coding,1,20537,chr2_32287384_32307921
Dnm1,2,32308471,32353338,protein_coding,-1,44867,chr2_32308471_32353338
Ciz1,2,32352327,32380970,protein_coding,1,28643,chr2_32352327_32380970
1110008P14Rik,2,32377097,32381938,protein_coding,-1,4841,chr2_32377097_32381938
Lcn2,2,32384633,32388252,protein_coding,-1,3619,chr2_32384633_32388252
Ptges2,2,32395896,32405772,protein_coding,1,9876,chr2_32395896_32405772
Slc25a25,2,32414487,32451445,protein_coding,-1,36958,chr2_32414487_32451445
Naif1,2,32450457,32456953,protein_coding,1,6496,chr2_32450457_32456953
Gm13412,2,32525031,32527990,lincRNA,1,2959,chr2_32525031_32527990
Fam102a,2,32535332,32569756,protein_coding,1,34424,chr2_32535332_32569756
Dpm2,2,32570858,32573579,protein_coding,1,2721,chr2_32570858_32573579
9430097D07Rik,2,32574184,32575684,antisense,-1,1500,chr2_32574184_32575684
Pip5kl1,2,32574797,32583782,protein_coding,1,8985,chr2_32574797_32583782
St6galnac4,2,32587095,32599698,protein_coding,1,12603,chr2_32587095_32599698
St6galnac6,2,32599709,32620806,protein_coding,1,21097,chr2_32599709_32620806
Ak1,2,32621758,32635058,protein_coding,1,13300,chr2_32621758_32635058
Eng,2,32646595,32682669,protein_coding,1,36074,chr2_32646595_32682669
Fpgs,2,32682609,32704145,protein_coding,-1,21536,chr2_32682609_32704145
Cdk9,2,32705784,32713076,protein_coding,-1,7292,chr2_32705784_32713076
Sh2d3c,2,32721055,32755512,protein_coding,1,34457,chr2_32721055_32755512
6330409D20Rik,2,32732620,32741016,protein_coding,-1,8396,chr2_32732620_32741016
Ttc16,2,32757026,32775633,protein_coding,-1,18607,chr2_32757026_32775633
Tor2a,2,32757234,32762244,protein_coding,1,5010,chr2_32757234_32762244
Ptrh1,2,32775786,32777597,protein_coding,1,1811,chr2_32775786_32777597
Cfap157,2,32777381,32784428,protein_coding,-1,7047,chr2_32777381_32784428
Stxbp1,2,32787602,32847245,protein_coding,-1,59643,chr2_32787602_32847245
Gm13524,2,32846186,32848168,antisense,1,1982,chr2_32846186_32848168
Gm13523,2,32873755,32876001,antisense,-1,2246,chr2_32873755_32876001
Fam129b,2,32876114,32925254,protein_coding,1,49140,chr2_32876114_32925254
Lrsam1,2,32925216,32961614,protein_coding,-1,36398,chr2_32925216_32961614
Rpl12,2,32961559,32965345,protein_coding,1,3786,chr2_32961559_32965345
Slc2a8,2,32972990,32982083,protein_coding,-1,9093,chr2_32972990_32982083
Garnl3,2,32986224,33131654,protein_coding,-1,145430,chr2_32986224_33131654
Ralgps1,2,33133417,33371486,protein_coding,-1,238069,chr2_33133417_33371486
Gm13528,2,33177902,33181881,antisense,1,3979,chr2_33177902_33181881
Angptl2,2,33216069,33247717,protein_coding,1,31648,chr2_33216069_33247717
Zbtb34,2,33406108,33431324,protein_coding,-1,25216,chr2_33406108_33431324
Gm13536,2,33446802,33449207,antisense,1,2405,chr2_33446802_33449207
Zbtb43,2,33450287,33468559,protein_coding,-1,18272,chr2_33450287_33468559
Gm13530,2,33489782,33503632,lincRNA,1,13850,chr2_33489782_33503632
Lmx1b,2,33560965,33640608,protein_coding,-1,79643,chr2_33560965_33640608
9430024E24Rik,2,33716361,33718899,lincRNA,-1,2538,chr2_33716361_33718899
Mvb12b,2,33729953,33887946,protein_coding,-1,157993,chr2_33729953_33887946
Nron,2,33805816,33813591,antisense;misc_RNA,1,7775,chr2_33805816_33813591
Gm13403,2,33935788,33942145,lincRNA,-1,6357,chr2_33935788_33942145
Gm13404,2,33978246,33980324,lincRNA,1,2078,chr2_33978246_33980324
C230014O12Rik,2,34018289,34107735,lincRNA,-1,89446,chr2_34018289_34107735
Gm38389,2,34097397,34111444,lincRNA,-1,14047,chr2_34097397_34111444
Pbx3,2,34171457,34373142,protein_coding,-1,201685,chr2_34171457_34373142
C79798,2,34287771,34304440,antisense,1,16669,chr2_34287771_34304440
Mapkap1,2,34406771,34624950,protein_coding,1,218179,chr2_34406771_34624950
Gapvd1,2,34674594,34755232,protein_coding,-1,80638,chr2_34674594_34755232
Hspa5,2,34771970,34777547,protein_coding,1,5577,chr2_34771970_34777547
Rabepk,2,34777556,34799912,protein_coding,-1,22356,chr2_34777556_34799912
Fbxw2,2,34804514,34826311,protein_coding,-1,21797,chr2_34804514_34826311
Gm34653,2,34833007,34839728,protein_coding,1,6721,chr2_34833007_34839728
Psmd5,2,34849734,34874968,protein_coding,-1,25234,chr2_34849734_34874968
Cutal,2,34874396,34892132,protein_coding,1,17736,chr2_34874396_34892132
Phf19,2,34893757,34914026,protein_coding,-1,20269,chr2_34893757_34914026
Traf1,2,34941750,34961772,protein_coding,-1,20022,chr2_34941750_34961772
Hc,2,34983331,35061438,protein_coding,-1,78107,chr2_34983331_35061438
Gm13449,2,34993973,35013446,antisense,1,19473,chr2_34993973_35013446
AI182371,2,35081861,35101543,protein_coding,-1,19682,chr2_35081861_35101543
Cntrl,2,35109492,35178822,protein_coding,1,69330,chr2_35109492_35178822
Rab14,2,35180205,35201120,protein_coding,-1,20915,chr2_35180205_35201120
Gsn,2,35256380,35307892,protein_coding,1,51512,chr2_35256380_35307892
Stom,2,35313986,35336976,protein_coding,-1,22990,chr2_35313986_35336976
4930568D16Rik,2,35354218,35367729,protein_coding,-1,13511,chr2_35354218_35367729
4930402F06Rik,2,35375562,35397175,protein_coding,-1,21613,chr2_35375562_35397175
Ggta1,2,35400179,35463231,protein_coding,-1,63052,chr2_35400179_35463231
Gm35202,2,35503531,35506090,lincRNA,1,2559,chr2_35503531_35506090
Dab2ip,2,35558266,35730994,protein_coding,1,172728,chr2_35558266_35730994
Ttll11,2,35751241,35979913,protein_coding,-1,228672,chr2_35751241_35979913
9030204H09Rik,2,35819190,35823385,antisense,1,4195,chr2_35819190_35823385
Ndufa8,2,36036326,36049406,protein_coding,-1,13080,chr2_36036326_36049406
Morn5,2,36049458,36079718,protein_coding,1,30260,chr2_36049458_36079718
Lhx6,2,36081953,36105408,protein_coding,-1,23455,chr2_36081953_36105408
Rbm18,2,36116079,36136773,protein_coding,-1,20694,chr2_36116079_36136773
Mrrf,2,36136389,36190647,protein_coding,1,54258,chr2_36136389_36190647
Gm13431,2,36216777,36222934,lincRNA,1,6157,chr2_36216777_36222934
Ptgs1,2,36230426,36252272,protein_coding,1,21846,chr2_36230426_36252272
Olfr338,2,36373519,36382433,protein_coding,1,8914,chr2_36373519_36382433
Olfr339,2,36418947,36426123,protein_coding,1,7176,chr2_36418947_36426123
Olfr344,2,36566662,36576178,protein_coding,1,9516,chr2_36566662_36576178
Olfr346,2,36685788,36691293,protein_coding,1,5505,chr2_36685788_36691293
Olfr50,2,36790538,36797392,protein_coding,1,6854,chr2_36790538_36797392
Olfr351,2,36857539,36862660,protein_coding,-1,5121,chr2_36857539_36862660
Olfr352,2,36868460,36872785,protein_coding,1,4325,chr2_36868460_36872785
Olfr354,2,36905680,36916038,protein_coding,1,10358,chr2_36905680_36916038
Olfr362,2,37101706,37117910,protein_coding,-1,16204,chr2_37101706_37117910
Olfr365,2,37188198,37206019,protein_coding,1,17821,chr2_37188198_37206019
Olfr366,2,37211574,37224506,protein_coding,1,12932,chr2_37211574_37224506
Pdcl,2,37350074,37359332,protein_coding,-1,9258,chr2_37350074_37359332
Rc3h2,2,37370069,37422903,protein_coding,-1,52834,chr2_37370069_37422903
Zbtb6,2,37425500,37443171,protein_coding,-1,17671,chr2_37425500_37443171
Rabgap1,2,37443279,37566454,protein_coding,1,123175,chr2_37443279_37566454
Strbp,2,37483228,37703859,protein_coding,-1,220631,chr2_37483228_37703859
Crb2,2,37776249,37799103,protein_coding,1,22854,chr2_37776249_37799103
Dennd1a,2,37798991,38287390,protein_coding,-1,488399,chr2_37798991_38287390
Gm13556,2,38285307,38287291,antisense,1,1984,chr2_38285307_38287291
Lhx2,2,38339281,38369733,protein_coding,1,30452,chr2_38339281_38369733
Gm27197,2,38347357,38348316,antisense,-1,959,chr2_38347357_38348316
Gm13584,2,38359580,38363980,antisense,-1,4400,chr2_38359580_38363980
Gm13589,2,38424002,38455851,lincRNA,1,31849,chr2_38424002_38455851
Nek6,2,38511643,38594606,protein_coding,1,82963,chr2_38511643_38594606
Psmb7,2,38588036,38644087,protein_coding,-1,56051,chr2_38588036_38644087
Nr5a1,2,38692656,38714542,protein_coding,-1,21886,chr2_38692656_38714542
Nr5a1os,2,38712676,38720638,antisense,1,7962,chr2_38712676_38720638
Nr6a1,2,38723370,38927688,protein_coding,-1,204318,chr2_38723370_38927688
Nr6a1os,2,38823257,38852370,antisense,1,29113,chr2_38823257_38852370
Olfml2a,2,38931978,38963753,protein_coding,1,31775,chr2_38931978_38963753
Gm13496,2,38996713,38998258,antisense,-1,1545,chr2_38996713_38998258
Wdr38,2,38997476,39006168,protein_coding,1,8692,chr2_38997476_39006168
Rpl35,2,39001580,39005624,protein_coding,-1,4044,chr2_39001580_39005624
Arpc5l,2,39005348,39015877,protein_coding,1,10529,chr2_39005348_39015877
Golga1,2,39016155,39065541,protein_coding,-1,49386,chr2_39016155_39065541
Scai,2,39066214,39190734,protein_coding,-1,124520,chr2_39066214_39190734
Ppp6c,2,39194354,39226451,protein_coding,-1,32097,chr2_39194354_39226451
Lrp1b,2,40595246,42653624,protein_coding,-1,2058378,chr2_40595246_42653624
Kynu,2,43555329,43682715,protein_coding,1,127386,chr2_43555329_43682715
Arhgap15,2,43748824,44395953,protein_coding,1,647129,chr2_43748824_44395953
Arhgap15os,2,44059238,44065324,antisense,-1,6086,chr2_44059238_44065324
Gtdc1,2,44564412,44927657,protein_coding,-1,363245,chr2_44564412_44927657
Zeb2,2,44983632,45117395,protein_coding,-1,133763,chr2_44983632_45117395
Zeb2os,2,45110707,45114087,antisense,1,3380,chr2_45110707_45114087
Gm28643,2,45156925,45168467,lincRNA,1,11542,chr2_45156925_45168467
Gm13479,2,45357265,45404035,lincRNA,1,46770,chr2_45357265_45404035
Gm13465,2,45733457,45753311,lincRNA,1,19854,chr2_45733457_45753311
Gm13467,2,45747803,45751684,lincRNA,-1,3881,chr2_45747803_45751684
Gm13470,2,46419535,46442710,lincRNA,-1,23175,chr2_46419535_46442710
Gm13481,2,48062548,48457245,lincRNA,-1,394697,chr2_48062548_48457245
Acvr2a,2,48814109,48903269,protein_coding,1,89160,chr2_48814109_48903269
Orc4,2,48902824,48950277,protein_coding,-1,47453,chr2_48902824_48950277
Mbd5,2,48949508,49325405,protein_coding,1,375897,chr2_48949508_49325405
Epc2,2,49451486,49551948,protein_coding,1,100462,chr2_49451486_49551948
Kif5c,2,49619298,49774778,protein_coding,1,155480,chr2_49619298_49774778
Lypd6b,2,49787688,49948849,protein_coding,1,161161,chr2_49787688_49948849
Gm13480,2,49805976,49812948,lincRNA,-1,6972,chr2_49805976_49812948
Lypd6,2,50066429,50193569,protein_coding,1,127140,chr2_50066429_50193569
Mmadhc,2,50279881,50296801,protein_coding,-1,16920,chr2_50279881_50296801
Gm13483,2,50296810,50433967,lincRNA,1,137157,chr2_50296810_50433967
Gm13485,2,50547914,50552258,lincRNA,1,4344,chr2_50547914_50552258
Rnd3,2,51130438,51149111,protein_coding,-1,18673,chr2_51130438_51149111
Gm13497,2,51241831,51295945,lincRNA,1,54114,chr2_51241831_51295945
Gm13499,2,51363572,51365499,lincRNA,-1,1927,chr2_51363572_51365499
1700057H21Rik,2,51420984,51438785,lincRNA,-1,17801,chr2_51420984_51438785
Gm13490,2,51656966,51732009,lincRNA,-1,75043,chr2_51656966_51732009
Rbm43,2,51924448,51935163,protein_coding,-1,10715,chr2_51924448_51935163
Nmi,2,51948487,51973494,protein_coding,-1,25007,chr2_51948487_51973494
Tnfaip6,2,52038009,52056686,protein_coding,1,18677,chr2_52038009_52056686
Rif1,2,52072832,52122383,protein_coding,1,49551,chr2_52072832_52122383
Neb,2,52136647,52378474,protein_coding,-1,241827,chr2_52136647_52378474
Gm13522,2,52367063,52390307,antisense,1,23244,chr2_52367063_52390307
Arl5a,2,52397951,52424901,protein_coding,-1,26950,chr2_52397951_52424901
Cacnb4,2,52428320,52676831,protein_coding,-1,248511,chr2_52428320_52676831
Stam2,2,52691664,52742281,protein_coding,-1,50617,chr2_52691664_52742281
Fmnl2,2,52857860,53133804,protein_coding,1,275944,chr2_52857860_53133804
Prpf40a,2,53134704,53191702,protein_coding,-1,56998,chr2_53134704_53191702
Arl6ip6,2,53191726,53219220,protein_coding,1,27494,chr2_53191726_53219220
Rprm,2,54084093,54085552,protein_coding,-1,1459,chr2_54084093_54085552
Galnt13,2,54436317,55118309,protein_coding,1,681992,chr2_54436317_55118309
Gm14033,2,55411790,55433435,lincRNA,1,21645,chr2_55411790_55433435
Kcnj3,2,55435970,55598145,protein_coding,1,162175,chr2_55435970_55598145
Nr4a2,2,57106830,57124003,protein_coding,-1,17173,chr2_57106830_57124003
Gpd2,2,57237635,57370719,protein_coding,1,133084,chr2_57237635_57370719
Gm33594,2,57982192,57986017,lincRNA,-1,3825,chr2_57982192_57986017
Galnt5,2,57997884,58045860,protein_coding,1,47976,chr2_57997884_58045860
Ermn,2,58045113,58052864,protein_coding,-1,7751,chr2_58045113_58052864
Cytip,2,58129137,58195532,protein_coding,-1,66395,chr2_58129137_58195532
Gm13546,2,58164001,58177063,antisense,1,13062,chr2_58164001_58177063
Acvr1c,2,58267453,58357895,protein_coding,-1,90442,chr2_58267453_58357895
Gm13544,2,58276779,58286902,antisense,1,10123,chr2_58276779_58286902
Acvr1,2,58388644,58567157,protein_coding,-1,178513,chr2_58388644_58567157
Upp2,2,58567298,58792971,protein_coding,1,225673,chr2_58567298_58792971
Ccdc148,2,58821070,59160683,protein_coding,-1,339613,chr2_58821070_59160683
Gm11099,2,58859434,58907618,protein_coding,1,48184,chr2_58859434_58907618
Pkp4,2,59160850,59355208,protein_coding,1,194358,chr2_59160850_59355208
Dapl1,2,59484653,59505020,protein_coding,1,20367,chr2_59484653_59505020
Tanc1,2,59612042,59846149,protein_coding,1,234107,chr2_59612042_59846149
Wdsub1,2,59852364,59882591,protein_coding,-1,30227,chr2_59852364_59882591
Baz2b,2,59899363,60209839,protein_coding,-1,310476,chr2_59899363_60209839
Gm13572,2,60037141,60038837,lincRNA,1,1696,chr2_60037141_60038837
Gm13620,2,60125096,60125819,lincRNA,1,723,chr2_60125096_60125819
Cd302,2,60251993,60284488,protein_coding,-1,32495,chr2_60251993_60284488
Ly75,2,60292103,60383303,protein_coding,-1,91200,chr2_60292103_60383303
Gm13571,2,60338188,60371234,antisense,1,33046,chr2_60338188_60371234
Pla2r1,2,60417543,60553308,protein_coding,-1,135765,chr2_60417543_60553308
Itgb6,2,60598292,60722643,protein_coding,-1,124351,chr2_60598292_60722643
Rbms1,2,60750193,60963192,protein_coding,-1,212999,chr2_60750193_60963192
Gm13582,2,60964376,60975151,lincRNA,-1,10775,chr2_60964376_60975151
Tank,2,61578585,61654171,protein_coding,1,75586,chr2_61578585_61654171
Psmd14,2,61711694,61800376,protein_coding,1,88682,chr2_61711694_61800376
Tbr1,2,61802930,61814114,protein_coding,1,11184,chr2_61802930_61814114
Slc4a10,2,62046462,62326730,protein_coding,1,280268,chr2_62046462_62326730
Dpp4,2,62330073,62412231,protein_coding,-1,82158,chr2_62330073_62412231
Gm13561,2,62357071,62470913,antisense,1,113842,chr2_62357071_62470913
Gm13565,2,62436880,62441142,lincRNA,-1,4262,chr2_62436880_62441142
Gm13564,2,62452936,62456648,lincRNA,-1,3712,chr2_62452936_62456648
Gcg,2,62474530,62483650,protein_coding,-1,9120,chr2_62474530_62483650
Fap,2,62500943,62574075,protein_coding,-1,73132,chr2_62500943_62574075
Ifih1,2,62595798,62646255,protein_coding,-1,50457,chr2_62595798_62646255
Gca,2,62664285,62694109,protein_coding,1,29824,chr2_62664285_62694109
Kcnh7,2,62693414,63184287,protein_coding,-1,490873,chr2_62693414_63184287
Gm13569,2,62809187,62810698,antisense,1,1511,chr2_62809187_62810698
Fign,2,63971507,64098038,protein_coding,-1,126531,chr2_63971507_64098038
Gm13575,2,64382602,64393860,lincRNA,-1,11258,chr2_64382602_64393860
Grb14,2,64912476,65024987,protein_coding,-1,112511,chr2_64912476_65024987
Cobll1,2,65088339,65239403,protein_coding,-1,151064,chr2_65088339_65239403
Gm13594,2,65238756,65239675,antisense,1,919,chr2_65238756_65239675
Slc38a11,2,65316430,65364034,protein_coding,-1,47604,chr2_65316430_65364034
Scn3a,2,65457118,65567627,protein_coding,-1,110509,chr2_65457118_65567627
Gm13595,2,65509265,65512605,antisense,1,3340,chr2_65509265_65512605
Scn2a,2,65620771,65767447,protein_coding,1,146676,chr2_65620771_65767447
Csrnp3,2,65845767,66031546,protein_coding,1,185779,chr2_65845767_66031546
Gm13619,2,65852408,65860619,antisense,-1,8211,chr2_65852408_65860619
Gm13617,2,65944299,65954070,antisense,-1,9771,chr2_65944299_65954070
Galnt3,2,66082766,66124994,protein_coding,-1,42228,chr2_66082766_66124994
Gm28638,2,66125317,66175250,lincRNA,1,49933,chr2_66125317_66175250
Ttc21b,2,66184327,66256617,protein_coding,-1,72290,chr2_66184327_66256617
Gm13618,2,66187836,66192813,antisense,1,4977,chr2_66187836_66192813
Scn1a,2,66270778,66440840,protein_coding,-1,170062,chr2_66270778_66440840
Gm13629,2,66440880,66546026,antisense,1,105146,chr2_66440880_66546026
Scn9a,2,66480080,66634962,protein_coding,-1,154882,chr2_66480080_66634962
Scn7a,2,66673425,66784914,protein_coding,-1,111489,chr2_66673425_66784914
Gm13598,2,67157646,67194735,lincRNA,-1,37089,chr2_67157646_67194735
Gm13599,2,67309659,67396491,antisense,-1,86832,chr2_67309659_67396491
Gm21830,2,67413725,67433086,protein_coding,1,19361,chr2_67413725_67433086
Xirp2,2,67173834,67526615,protein_coding,1,352781,chr2_67173834_67526615
Gm13601,2,67491044,67516525,antisense,-1,25481,chr2_67491044_67516525
B3galt1,2,67565871,68122689,protein_coding,1,556818,chr2_67565871_68122689
Gm26743,2,67677031,67687282,lincRNA,-1,10251,chr2_67677031_67687282
Stk39,2,68210445,68472268,protein_coding,-1,261823,chr2_68210445_68472268
Gm13596,2,68476082,68477752,antisense,1,1670,chr2_68476082_68477752
4933409G03Rik,2,68582413,68616463,protein_coding,1,34050,chr2_68582413_68616463
4932414N04Rik,2,68656486,68748467,protein_coding,1,91981,chr2_68656486_68748467
Gm36231,2,68820311,68845252,lincRNA,-1,24941,chr2_68820311_68845252
Cers6,2,68861441,69114282,protein_coding,1,252841,chr2_68861441_69114282
Nostrin,2,69135800,69189330,protein_coding,1,53530,chr2_69135800_69189330
Spc25,2,69193895,69206194,protein_coding,-1,12299,chr2_69193895_69206194
G6pc2,2,69211073,69227841,protein_coding,1,16768,chr2_69211073_69227841
Abcb11,2,69238282,69342616,protein_coding,-1,104334,chr2_69238282_69342616
Gm13613,2,69248307,69272491,antisense,1,24184,chr2_69248307_69272491
Dhrs9,2,69380445,69404533,protein_coding,1,24088,chr2_69380445_69404533
Lrp2,2,69424340,69586065,protein_coding,-1,161725,chr2_69424340_69586065
Bbs5,2,69647171,69667571,protein_coding,1,20400,chr2_69647171_69667571
Klhl41,2,69670120,69684230,protein_coding,1,14110,chr2_69670120_69684230
Fastkd1,2,69686815,69713516,protein_coding,-1,26701,chr2_69686815_69713516
Ppig,2,69722545,69754012,protein_coding,1,31467,chr2_69722545_69754012
Ccdc173,2,69758033,69789575,protein_coding,-1,31542,chr2_69758033_69789575
Phospho2,2,69789623,69800005,protein_coding,1,10382,chr2_69789623_69800005
Klhl23,2,69821944,69836651,protein_coding,1,14707,chr2_69821944_69836651
Ssb,2,69861562,69871846,protein_coding,1,10284,chr2_69861562_69871846
Mettl5,2,69871198,69885615,protein_coding,-1,14417,chr2_69871198_69885615
Mettl5os,2,69885728,69888155,antisense,1,2427,chr2_69885728_69888155
Ubr3,2,69897246,70024013,protein_coding,1,126767,chr2_69897246_70024013
Myo3b,2,70039126,70429198,protein_coding,1,390072,chr2_70039126_70429198
Sp5,2,70474923,70477729,protein_coding,1,2806,chr2_70474923_70477729
Gad1os,2,70489940,70563357,antisense,-1,73417,chr2_70489940_70563357
Erich2,2,70508819,70540884,protein_coding,1,32065,chr2_70508819_70540884
Gad1,2,70553072,70602014,protein_coding,1,48942,chr2_70553072_70602014
Gm26558,2,70661149,70662109,antisense,-1,960,chr2_70661149_70662109
Gorasp2,2,70661576,70712636,protein_coding,1,51060,chr2_70661576_70712636
Tlk1,2,70712407,70825728,protein_coding,-1,113321,chr2_70712407_70825728
Gm13632,2,70877829,70884408,lincRNA,1,6579,chr2_70877829_70884408
Mettl8,2,70964561,71055583,protein_coding,-1,91022,chr2_70964561_71055583
Dcaf17,2,71055328,71099142,protein_coding,1,43814,chr2_71055328_71099142
Cybrd1,2,71117923,71142926,protein_coding,1,25003,chr2_71117923_71142926
Dync1i2,2,71211706,71263303,protein_coding,1,51597,chr2_71211706_71263303
Slc25a12,2,71271063,71367749,protein_coding,-1,96686,chr2_71271063_71367749
Hat1,2,71388958,71441622,protein_coding,1,52664,chr2_71388958_71441622
Metap1d,2,71453276,71525194,protein_coding,1,71918,chr2_71453276_71525194
Dlx1as,2,71516454,71537891,antisense,-1,21437,chr2_71516454_71537891
Dlx1,2,71528113,71533981,protein_coding,1,5868,chr2_71528113_71533981
Dlx2,2,71543408,71546754,protein_coding,-1,3346,chr2_71543408_71546754
Platr26,2,71719417,71730966,lincRNA,1,11549,chr2_71719417_71730966
Gm13647,2,71737815,71745397,lincRNA,1,7582,chr2_71737815_71745397
Itga6,2,71745616,71858416,protein_coding,1,112800,chr2_71745616_71858416
Pdk1,2,71873224,71903858,protein_coding,1,30634,chr2_71873224_71903858
Rapgef4,2,71981240,72257474,protein_coding,1,276234,chr2_71981240_72257474
Rapgef4os1,2,72097603,72148796,antisense,-1,51193,chr2_72097603_72148796
Rapgef4os2,2,72224688,72232302,antisense,-1,7614,chr2_72224688_72232302
Rapgef4os3,2,72244965,72248975,antisense,-1,4010,chr2_72244965_72248975
Map3k20,2,72285637,72442610,protein_coding,1,156973,chr2_72285637_72442610
Cdca7,2,72476159,72486893,protein_coding,1,10734,chr2_72476159_72486893
8430437L04Rik,2,72703510,72729468,lincRNA,1,25958,chr2_72703510_72729468
6430710C18Rik,2,72745846,72813717,lincRNA,-1,67871,chr2_72745846_72813717
Sp3,2,72936427,72980446,protein_coding,-1,44019,chr2_72936427_72980446
Gm11084,2,72971548,72986716,protein_coding,-1,15168,chr2_72971548_72986716
Sp3os,2,72979424,72988677,antisense,1,9253,chr2_72979424_72988677
Ola1,2,73092801,73218924,protein_coding,-1,126123,chr2_73092801_73218924
Sp9,2,73271925,73284706,protein_coding,1,12781,chr2_73271925_73284706
Cir1,2,73283105,73312701,protein_coding,-1,29596,chr2_73283105_73312701
Scrn3,2,73312601,73337818,protein_coding,1,25217,chr2_73312601_73337818
Gpr155,2,73341506,73386572,protein_coding,-1,45066,chr2_73341506_73386572
Gm13703,2,73357268,73364333,antisense,1,7065,chr2_73357268_73364333
Gm13709,2,73370909,73379297,antisense,1,8388,chr2_73370909_73379297
Gm13707,2,73421909,73429142,antisense,1,7233,chr2_73421909_73429142
Wipf1,2,73429610,73529734,protein_coding,-1,100124,chr2_73429610_73529734
Gm13708,2,73459705,73477602,lincRNA,1,17897,chr2_73459705_73477602
Chrna1,2,73563215,73580338,protein_coding,-1,17123,chr2_73563215_73580338
Chrna1os,2,73584850,73589208,antisense,1,4358,chr2_73584850_73589208
Chn1os3,2,73596526,73616012,antisense,1,19486,chr2_73596526_73616012
Chn1,2,73610660,73775346,protein_coding,-1,164686,chr2_73610660_73775346
Chn1os1,2,73658270,73660263,antisense,1,1993,chr2_73658270_73660263
Atf2,2,73816509,73892639,protein_coding,-1,76130,chr2_73816509_73892639
Atp5g3,2,73908447,73911326,protein_coding,-1,2879,chr2_73908447_73911326
A630050E04Rik,2,74100924,74102342,lincRNA,-1,1418,chr2_74100924_74102342
Gm13667,2,74135757,74150834,lincRNA,1,15077,chr2_74135757_74150834
4930441J16Rik,2,74298940,74307717,lincRNA,-1,8777,chr2_74298940_74307717
Lnpk,2,74520291,74579435,protein_coding,-1,59144,chr2_74520291_74579435
4930445N08Rik,2,74579076,74584544,antisense,1,5468,chr2_74579076_74584544
Hoxd1,2,74762980,74765142,protein_coding,1,2162,chr2_74762980_74765142
Mtx2,2,74825803,74878431,protein_coding,1,52628,chr2_74825803_74878431
Gm13652,2,75124871,75137798,lincRNA,-1,12927,chr2_75124871_75137798
2600014E21Rik,2,75138843,75317820,lincRNA,1,178977,chr2_75138843_75317820
A330043C09Rik,2,75147118,75177658,lincRNA,-1,30540,chr2_75147118_75177658
Gm13658,2,75436057,75444179,lincRNA,1,8122,chr2_75436057_75444179
Gm13660,2,75458966,75464788,lincRNA,-1,5822,chr2_75458966_75464788
Hnrnpa3,2,75659261,75669407,protein_coding,1,10146,chr2_75659261_75669407
Nfe2l2,2,75675513,75704641,protein_coding,-1,29128,chr2_75675513_75704641
Agps,2,75832177,75931350,protein_coding,1,99173,chr2_75832177_75931350
Ttc30b,2,75935849,75938585,protein_coding,-1,2736,chr2_75935849_75938585
Ttc30a2,2,75975740,75978170,protein_coding,-1,2430,chr2_75975740_75978170
Ttc30a1,2,75978247,75981967,protein_coding,-1,3720,chr2_75978247_75981967
Pde11a,2,75989141,76338774,protein_coding,-1,349633,chr2_75989141_76338774
Cyct,2,76353942,76360450,protein_coding,-1,6508,chr2_76353942_76360450
Rbm45,2,76369984,76383768,protein_coding,1,13784,chr2_76369984_76383768
Osbpl6,2,76406508,76600647,protein_coding,1,194139,chr2_76406508_76600647
Prkra,2,76629898,76648015,protein_coding,-1,18117,chr2_76629898_76648015
Pjvk,2,76648476,76658556,protein_coding,1,10080,chr2_76648476_76658556
Fkbp7,2,76663044,76673116,protein_coding,-1,10072,chr2_76663044_76673116
Plekha3,2,76675281,76696828,protein_coding,1,21547,chr2_76675281_76696828
Ttn,2,76703980,76982547,protein_coding,-1,278567,chr2_76703980_76982547
Gm13938,2,76722776,76786708,antisense,1,63932,chr2_76722776_76786708
Ccdc141,2,77009902,77170636,protein_coding,-1,160734,chr2_77009902_77170636
Sestd1,2,77180340,77280592,protein_coding,-1,100252,chr2_77180340_77280592
Gm13943,2,77314751,77317035,lincRNA,1,2284,chr2_77314751_77317035
Zfp385b,2,77410634,77819639,protein_coding,-1,409005,chr2_77410634_77819639
Gm13944,2,77462669,77480938,antisense,1,18269,chr2_77462669_77480938
Gm13661,2,77840616,77842936,lincRNA,1,2320,chr2_77840616_77842936
Cwc22,2,77881159,77946375,protein_coding,-1,65216,chr2_77881159_77946375
4930440I19Rik,2,78051177,78194430,lincRNA,1,143253,chr2_78051177_78194430
Gm14461,2,78237547,78302230,lincRNA,1,64683,chr2_78237547_78302230
Ube2e3,2,78868124,78921293,protein_coding,1,53169,chr2_78868124_78921293
Itga4,2,79255426,79333123,protein_coding,1,77697,chr2_79255426_79333123
Cerkl,2,79330543,79456785,protein_coding,-1,126242,chr2_79330543_79456785
Ppp1r1c,2,79707780,79818496,protein_coding,1,110716,chr2_79707780_79818496
Pde1a,2,79834453,80129458,protein_coding,-1,295005,chr2_79834453_80129458
Prdx6b,2,80292472,80295356,protein_coding,1,2884,chr2_80292472_80295356
Dnajc10,2,80315466,80354043,protein_coding,1,38577,chr2_80315466_80354043
Frzb,2,80411970,80447625,protein_coding,-1,35655,chr2_80411970_80447625
Nckap1,2,80500512,80581380,protein_coding,-1,80868,chr2_80500512_80581380
Dusp19,2,80617045,80632361,protein_coding,1,15316,chr2_80617045_80632361
Nup35,2,80617236,80658906,protein_coding,1,41670,chr2_80617236_80658906
Zfp804a,2,82053222,82259879,protein_coding,1,206657,chr2_82053222_82259879
A130030D18Rik,2,82375372,82392202,lincRNA,-1,16830,chr2_82375372_82392202
Fsip2,2,82943634,83008937,protein_coding,1,65303,chr2_82943634_83008937
Gm28675,2,83100258,83126216,lincRNA,-1,25958,chr2_83100258_83126216
Zc3h15,2,83644435,83664622,protein_coding,1,20187,chr2_83644435_83664622
Gm13686,2,83700657,83701116,antisense,-1,459,chr2_83700657_83701116
Itgav,2,83724397,83806916,protein_coding,1,82519,chr2_83724397_83806916
Fam171b,2,83812636,83883486,protein_coding,1,70850,chr2_83812636_83883486
Zswim2,2,83915079,83941228,protein_coding,-1,26149,chr2_83915079_83941228
Calcrl,2,84330626,84425411,protein_coding,-1,94785,chr2_84330626_84425411
Tfpi,2,84432855,84476775,protein_coding,-1,43920,chr2_84432855_84476775
Gm13710,2,84500760,84531322,lincRNA,-1,30562,chr2_84500760_84531322
Ctnnd1,2,84600071,84650765,protein_coding,-1,50694,chr2_84600071_84650765
Gm28635,2,84601439,84678041,protein_coding,-1,76602,chr2_84601439_84678041
Btbd18,2,84659079,84668780,protein_coding,1,9701,chr2_84659079_84668780
Tmx2,2,84671316,84679140,protein_coding,-1,7824,chr2_84671316_84679140
Med19,2,84678402,84688215,protein_coding,1,9813,chr2_84678402_84688215
Zdhhc5,2,84687970,84715180,protein_coding,-1,27210,chr2_84687970_84715180
Clp1,2,84722104,84727350,protein_coding,-1,5246,chr2_84722104_84727350
Ypel4,2,84734058,84738655,protein_coding,1,4597,chr2_84734058_84738655
Gm19426,2,84742169,84743655,protein_coding,-1,1486,chr2_84742169_84743655
Serping1,2,84765387,84775444,protein_coding,-1,10057,chr2_84765387_84775444
Ube2l6,2,84798828,84810335,protein_coding,1,11507,chr2_84798828_84810335
Smtnl1,2,84811176,84822652,protein_coding,-1,11476,chr2_84811176_84822652
Timm10,2,84826997,84830213,protein_coding,1,3216,chr2_84826997_84830213
Slc43a1,2,84838850,84863594,protein_coding,1,24744,chr2_84838850_84863594
Rtn4rl2,2,84871924,84886710,protein_coding,-1,14786,chr2_84871924_84886710
Slc43a3,2,84936579,84958509,protein_coding,1,21930,chr2_84936579_84958509
Prg3,2,84988215,84993886,protein_coding,1,5671,chr2_84988215_84993886
P2rx3,2,84998583,85037462,protein_coding,-1,38879,chr2_84998583_85037462
Ssrp1,2,85037234,85047109,protein_coding,1,9875,chr2_85037234_85047109
Tnks1bp1,2,85048022,85073048,protein_coding,1,25026,chr2_85048022_85073048
Aplnr,2,85136225,85139923,protein_coding,1,3698,chr2_85136225_85139923
Gm13713,2,85160778,85193325,antisense,1,32547,chr2_85160778_85193325
Lrrc55,2,85162334,85197197,protein_coding,-1,34863,chr2_85162334_85197197
Gm13716,2,85196932,85198675,antisense,1,1743,chr2_85196932_85198675
Gm13715,2,85233675,85243678,lincRNA,1,10003,chr2_85233675_85243678
Olfr987,2,85330779,85339315,protein_coding,-1,8536,chr2_85330779_85339315
Olfr988,2,85352428,85363227,protein_coding,-1,10799,chr2_85352428_85363227
Olfr992,2,85398824,85409469,protein_coding,-1,10645,chr2_85398824_85409469
Olfr994,2,85429380,85436451,protein_coding,-1,7071,chr2_85429380_85436451
Olfr995,2,85437528,85443639,protein_coding,-1,6111,chr2_85437528_85443639
Olfr1023,2,85885640,85891213,protein_coding,1,5573,chr2_85885640_85891213
Olfr1029,2,85973895,85978913,protein_coding,1,5018,chr2_85973895_85978913
Olfr1030,2,85979276,85988294,protein_coding,1,9018,chr2_85979276_85988294
Olfr1033,2,86020633,86045171,protein_coding,1,24538,chr2_86020633_86045171
Olfr1034,2,86045861,86050742,protein_coding,1,4881,chr2_86045861_86050742
Olfr1043,2,86161890,86167522,protein_coding,-1,5632,chr2_86161890_86167522
Olfr1044,2,86168589,86177820,protein_coding,-1,9231,chr2_86168589_86177820
Olfr52,2,86179412,86185683,protein_coding,-1,6271,chr2_86179412_86185683
Olfr1057,2,86372561,86378393,protein_coding,-1,5832,chr2_86372561_86378393
Olfr1062,2,86420399,86426749,protein_coding,-1,6350,chr2_86420399_86426749
Olfr228,2,86481921,86487386,protein_coding,-1,5465,chr2_86481921_86487386
Olfr1087,2,86687235,86698395,protein_coding,-1,11160,chr2_86687235_86698395
Olfr1090,2,86752724,86758993,protein_coding,-1,6269,chr2_86752724_86758993
Olfr141,2,86804134,86810018,protein_coding,-1,5884,chr2_86804134_86810018
Gm13723,2,86869011,86874802,protein_coding,-1,5791,chr2_86869011_86874802
Olfr1104,2,87020703,87027080,protein_coding,-1,6377,chr2_87020703_87027080
Olfr1106,2,87046811,87052273,protein_coding,-1,5462,chr2_87046811_87052273
Olfr259,2,87104578,87114567,protein_coding,-1,9989,chr2_87104578_87114567
Olfr1112,2,87187798,87192767,protein_coding,1,4969,chr2_87187798_87192767
Olfr1115,2,87248013,87253868,protein_coding,1,5855,chr2_87248013_87253868
Olfr1116,2,87267534,87278262,protein_coding,1,10728,chr2_87267534_87278262
Olfr1122,2,87385849,87391930,protein_coding,1,6081,chr2_87385849_87391930
Olfr1123,2,87416635,87423211,protein_coding,1,6576,chr2_87416635_87423211
Olfr1124,2,87430275,87436623,protein_coding,1,6348,chr2_87430275_87436623
Pramel7,2,87489087,87497093,protein_coding,-1,8006,chr2_87489087_87497093
Olfr153,2,87531796,87533053,protein_coding,1,1257,chr2_87531796_87533053
Olfr1129,2,87573902,87577259,protein_coding,1,3357,chr2_87573902_87577259
Olfr1130,2,87606212,87609852,protein_coding,1,3640,chr2_87606212_87609852
Olfr1132,2,87632583,87637535,protein_coding,-1,4952,chr2_87632583_87637535
Olfr1137,2,87708873,87713179,protein_coding,-1,4306,chr2_87708873_87713179
Olfr1138,2,87736747,87739978,protein_coding,-1,3231,chr2_87736747_87739978
Olfr1140,2,87743752,87747581,protein_coding,1,3829,chr2_87743752_87747581
Olfr152,2,87779483,87784572,protein_coding,1,5089,chr2_87779483_87784572
Olfr1152,2,87866492,87874156,protein_coding,1,7664,chr2_87866492_87874156
Olfr1156,2,87947053,87953100,protein_coding,-1,6047,chr2_87947053_87953100
Olfr1157,2,87958485,87968299,protein_coding,-1,9814,chr2_87958485_87968299
Olfr73,2,88032288,88037699,protein_coding,-1,5411,chr2_88032288_88037699
Olfr1167,2,88146150,88155193,protein_coding,-1,9043,chr2_88146150_88155193
Olfr1173,2,88273040,88279875,protein_coding,-1,6835,chr2_88273040_88279875
Olfr1178,2,88387062,88400799,protein_coding,1,13737,chr2_88387062_88400799
Olfr1179,2,88401859,88406453,protein_coding,-1,4594,chr2_88401859_88406453
Olfr1180,2,88410649,88419151,protein_coding,-1,8502,chr2_88410649_88419151
Olfr1183,2,88454867,88469199,protein_coding,1,14332,chr2_88454867_88469199
Olfr1186,2,88518551,88526790,protein_coding,1,8239,chr2_88518551_88526790
Olfr1189,2,88586454,88592762,protein_coding,1,6308,chr2_88586454_88592762
Olfr1191-ps1,2,88640542,88648438,protein_coding,1,7896,chr2_88640542_88648438
Olfr1192-ps1,2,88648509,88659772,protein_coding,1,11263,chr2_88648509_88659772
Olfr1195,2,88681455,88689187,protein_coding,-1,7732,chr2_88681455_88689187
Olfr1196,2,88697303,88704597,protein_coding,-1,7294,chr2_88697303_88704597
Olfr1198,2,88743970,88751370,protein_coding,-1,7400,chr2_88743970_88751370
Olfr1200,2,88763511,88770488,protein_coding,-1,6977,chr2_88763511_88770488
Olfr1202,2,88814496,88820711,protein_coding,1,6215,chr2_88814496_88820711
Olfr1204,2,88849292,88857920,protein_coding,1,8628,chr2_88849292_88857920
Olfr1208,2,88895575,88902311,protein_coding,-1,6736,chr2_88895575_88902311
Olfr1209,2,88904942,88915157,protein_coding,-1,10215,chr2_88904942_88915157
Olfr1211,2,88926876,88938111,protein_coding,-1,11235,chr2_88926876_88938111
Olfr1214,2,88986479,88992653,protein_coding,-1,6174,chr2_88986479_88992653
Olfr1215,2,89000021,89006973,protein_coding,-1,6952,chr2_89000021_89006973
Olfr1216,2,89007563,89018340,protein_coding,-1,10777,chr2_89007563_89018340
Olfr1217,2,89021336,89032065,protein_coding,-1,10729,chr2_89021336_89032065
Olfr1219,2,89072241,89083513,protein_coding,-1,11272,chr2_89072241_89083513
Olfr1220,2,89094188,89106835,protein_coding,-1,12647,chr2_89094188_89106835
Olfr1222,2,89122885,89133054,protein_coding,-1,10169,chr2_89122885_89133054
Olfr1223,2,89143508,89151560,protein_coding,-1,8052,chr2_89143508_89151560
Olfr1226,2,89188839,89200048,protein_coding,-1,11209,chr2_89188839_89200048
Olfr1229,2,89280476,89288014,protein_coding,-1,7538,chr2_89280476_89288014
Olfr1233,2,89333208,89342398,protein_coding,-1,9190,chr2_89333208_89342398
Olfr1238,2,89401991,89409676,protein_coding,-1,7685,chr2_89401991_89409676
Olfr1246,2,89586141,89593157,protein_coding,-1,7016,chr2_89586141_89593157
Olfr1247,2,89604959,89614130,protein_coding,-1,9171,chr2_89604959_89614130
Olfr1250,2,89653773,89661467,protein_coding,-1,7694,chr2_89653773_89661467
Olfr1254,2,89787325,89793619,protein_coding,-1,6294,chr2_89787325_89793619
Olfr1256,2,89825311,89841555,protein_coding,-1,16244,chr2_89825311_89841555
Olfr48,2,89841793,89848205,protein_coding,-1,6412,chr2_89841793_89848205
Olfr1260,2,89974340,89981586,protein_coding,1,7246,chr2_89974340_89981586
Olfr1264,2,90018526,90025577,protein_coding,-1,7051,chr2_90018526_90025577
Olfr1270,2,90145255,90153091,protein_coding,-1,7836,chr2_90145255_90153091
Olfr1271,2,90260546,90271032,protein_coding,-1,10486,chr2_90260546_90271032
Olfr1272,2,90280263,90292841,protein_coding,-1,12578,chr2_90280263_90292841
Ptprj,2,90429754,90580647,protein_coding,-1,150893,chr2_90429754_90580647
4933423P22Rik,2,90479236,90488425,antisense,1,9189,chr2_90479236_90488425
Nup160,2,90677215,90736328,protein_coding,1,59113,chr2_90677215_90736328
Fnbp4,2,90745370,90781021,protein_coding,1,35651,chr2_90745370_90781021
Agbl2,2,90782727,90834437,protein_coding,1,51710,chr2_90782727_90834437
Mtch2,2,90847155,90866810,protein_coding,1,19655,chr2_90847155_90866810
C1qtnf4,2,90885860,90890525,protein_coding,1,4665,chr2_90885860_90890525
Ndufs3,2,90894634,90904827,protein_coding,-1,10193,chr2_90894634_90904827
Kbtbd4,2,90904740,90911626,protein_coding,1,6886,chr2_90904740_90911626
Celf1,2,90940382,91019498,protein_coding,1,79116,chr2_90940382_91019498
Rapsn,2,91035620,91045730,protein_coding,1,10110,chr2_91035620_91045730
Psmc3,2,91054009,91066369,protein_coding,1,12360,chr2_91054009_91066369
Slc39a13,2,91061791,91070417,protein_coding,-1,8626,chr2_91061791_91070417
Spi1,2,91082390,91115756,protein_coding,1,33366,chr2_91082390_91115756
Mybpc3,2,91118144,91136516,protein_coding,1,18372,chr2_91118144_91136516
Madd,2,91137360,91183837,protein_coding,-1,46477,chr2_91137360_91183837
Nr1h3,2,91184061,91202834,protein_coding,-1,18773,chr2_91184061_91202834
Acp2,2,91202885,91214098,protein_coding,1,11213,chr2_91202885_91214098
Ddb2,2,91211572,91236982,protein_coding,-1,25410,chr2_91211572_91236982
Pacsin3,2,91255954,91264679,protein_coding,1,8725,chr2_91255954_91264679
Arfgap2,2,91264974,91276931,protein_coding,1,11957,chr2_91264974_91276931
1110051M20Rik,2,91275068,91444704,protein_coding,-1,169636,chr2_91275068_91444704
Lrp4,2,91457511,91513779,protein_coding,1,56268,chr2_91457511_91513779
Ckap5,2,91526762,91620664,protein_coding,1,93902,chr2_91526762_91620664
F2,2,91625320,91636414,protein_coding,-1,11094,chr2_91625320_91636414
Zfp408,2,91643669,91649791,protein_coding,-1,6122,chr2_91643669_91649791
Arhgap1,2,91649860,91672326,protein_coding,1,22466,chr2_91649860_91672326
Atg13,2,91674618,91710576,protein_coding,-1,35958,chr2_91674618_91710576
Harbi1,2,91710852,91721545,protein_coding,1,10693,chr2_91710852_91721545
Ambra1,2,91730134,91918849,protein_coding,1,188715,chr2_91730134_91918849
Chrm4,2,91927249,91928688,protein_coding,1,1439,chr2_91927249_91928688
Mdk,2,91929805,91932297,protein_coding,-1,2492,chr2_91929805_91932297
Dgkz,2,91932824,91975864,protein_coding,-1,43040,chr2_91932824_91975864
Gm9821,2,91945703,91948688,antisense,1,2985,chr2_91945703_91948688
Creb3l1,2,91982328,92024502,protein_coding,-1,42174,chr2_91982328_92024502
Gm13780,2,92043373,92096042,lincRNA,-1,52669,chr2_92043373_92096042
Phf21a,2,92093117,92364666,protein_coding,1,271549,chr2_92093117_92364666
Large2,2,92365046,92374869,protein_coding,-1,9823,chr2_92365046_92374869
Pex16,2,92374676,92381217,protein_coding,1,6541,chr2_92374676_92381217
1700029I15Rik,2,92382538,92385708,protein_coding,1,3170,chr2_92382538_92385708
Mapk8ip1,2,92383676,92401263,protein_coding,-1,17587,chr2_92383676_92401263
Cry2,2,92403646,92434043,protein_coding,-1,30397,chr2_92403646_92434043
Slc35c1,2,92452764,92460538,protein_coding,-1,7774,chr2_92452764_92460538
Gm13814,2,92483926,92529809,lincRNA,1,45883,chr2_92483926_92529809
Gm13817,2,92529694,92540980,lincRNA,-1,11286,chr2_92529694_92540980
Chst1,2,92599707,92615250,protein_coding,1,15543,chr2_92599707_92615250
Gm13816,2,92742230,92759208,lincRNA,1,16978,chr2_92742230_92759208
Syt13,2,92915098,92956058,protein_coding,1,40960,chr2_92915098_92956058
Prdm11,2,92972018,93046167,protein_coding,-1,74149,chr2_92972018_93046167
4631405J19Rik,2,93027956,93044732,antisense,1,16776,chr2_93027956_93044732
Gm13802,2,93085942,93098244,lincRNA,-1,12302,chr2_93085942_93098244
Trp53i11,2,93187548,93201759,protein_coding,1,14211,chr2_93187548_93201759
Tspan18,2,93201760,93334505,protein_coding,-1,132745,chr2_93201760_93334505
Gm13807,2,93403547,93417830,antisense,1,14283,chr2_93403547_93417830
Cd82,2,93419111,93463140,protein_coding,-1,44029,chr2_93419111_93463140
Alx4,2,93642384,93681339,protein_coding,1,38955,chr2_93642384_93681339
Ext2,2,93661028,93822568,protein_coding,-1,161540,chr2_93661028_93822568
Accs,2,93833467,93849943,protein_coding,-1,16476,chr2_93833467_93849943
Accsl,2,93855361,93869157,protein_coding,-1,13796,chr2_93855361_93869157
Gm13889,2,93955810,93957201,protein_coding,-1,1391,chr2_93955810_93957201
Gm27027,2,93956817,93996354,protein_coding,-1,39537,chr2_93956817_93996354
Alkbh3os1,2,93980034,93983575,antisense,1,3541,chr2_93980034_93983575
Alkbh3,2,93980550,94010807,protein_coding,-1,30257,chr2_93980550_94010807
Hsd17b12,2,94032689,94157964,protein_coding,-1,125275,chr2_94032689_94157964
Mir670hg,2,94160636,94264918,lincRNA,-1,104282,chr2_94160636_94264918
Ttc17,2,94300767,94406689,protein_coding,-1,105922,chr2_94300767_94406689
Api5,2,94411682,94438136,protein_coding,-1,26454,chr2_94411682_94438136
Gm13794,2,95394242,95397651,lincRNA,1,3409,chr2_95394242_95397651
Lrrc4c,2,96318169,97631666,protein_coding,1,1313497,chr2_96318169_97631666
4930445B16Rik,2,96987018,97083561,lincRNA,-1,96543,chr2_96987018_97083561
Gm10801,2,98662237,98664083,protein_coding,1,1846,chr2_98662237_98664083
Gm10800,2,98666547,98667301,protein_coding,-1,754,chr2_98666547_98667301
B230118H07Rik,2,101560781,101649532,protein_coding,-1,88751,chr2_101560781_101649532
Rag2,2,101624718,101632529,protein_coding,1,7811,chr2_101624718_101632529
Traf6,2,101678429,101701669,protein_coding,1,23240,chr2_101678429_101701669
Prr5l,2,101714285,101883027,protein_coding,-1,168742,chr2_101714285_101883027
Gm13905,2,101872175,101883256,lincRNA,1,11081,chr2_101872175_101883256
Commd9,2,101886247,101901646,protein_coding,1,15399,chr2_101886247_101901646
Ldlrad3,2,101950203,102186385,protein_coding,-1,236182,chr2_101950203_102186385
Gm13919,2,102039629,102066725,antisense,1,27096,chr2_102039629_102066725
Trim44,2,102300119,102407828,protein_coding,-1,107709,chr2_102300119_102407828
Fjx1,2,102449366,102452499,protein_coding,-1,3133,chr2_102449366_102452499
Pamr1,2,102550012,102643041,protein_coding,1,93029,chr2_102550012_102643041
Slc1a2,2,102658659,102790784,protein_coding,1,132125,chr2_102658659_102790784
Gm13872,2,102737907,102746760,antisense,-1,8853,chr2_102737907_102746760
Cd44,2,102811141,102901665,protein_coding,-1,90524,chr2_102811141_102901665
Pdhx,2,103021075,103073513,protein_coding,-1,52438,chr2_103021075_103073513
Apip,2,103073675,103092644,protein_coding,1,18969,chr2_103073675_103092644
Gm13874,2,103177787,103186681,lincRNA,1,8894,chr2_103177787_103186681
Ehf,2,103263433,103303278,protein_coding,-1,39845,chr2_103263433_103303278
A930006I01Rik,2,103338601,103372764,lincRNA,-1,34163,chr2_103338601_103372764
BC016548,2,103377643,103389044,lincRNA,-1,11401,chr2_103377643_103389044
Elf5,2,103411688,103450989,protein_coding,1,39301,chr2_103411688_103450989
Cat,2,103453849,103485160,protein_coding,-1,31311,chr2_103453849_103485160
Abtb2,2,103566310,103718423,protein_coding,1,152113,chr2_103566310_103718423
Nat10,2,103721256,103761270,protein_coding,-1,40014,chr2_103721256_103761270
Caprin1,2,103762941,103797649,protein_coding,-1,34708,chr2_103762941_103797649
Lmo2,2,103957986,103981878,protein_coding,1,23892,chr2_103957986_103981878
4931422A03Rik,2,103966943,104028361,protein_coding,-1,61418,chr2_103966943_104028361
Fbxo3,2,104027721,104063240,protein_coding,1,35519,chr2_104027721_104063240
Gm10799,2,104068047,104068550,protein_coding,-1,503,chr2_104068047_104068550
Cd59b,2,104069849,104091187,protein_coding,1,21338,chr2_104069849_104091187
Cd59a,2,104095801,104115354,protein_coding,1,19553,chr2_104095801_104115354
A930018P22Rik,2,104122769,104124749,protein_coding,1,1980,chr2_104122769_104124749
D430041D05Rik,2,104143073,104411013,protein_coding,-1,267940,chr2_104143073_104411013
Gm13883,2,104256672,104275757,antisense,1,19085,chr2_104256672_104275757
Hipk3,2,104426481,104494446,protein_coding,-1,67965,chr2_104426481_104494446
Cstf3,2,104590523,104665429,protein_coding,1,74906,chr2_104590523_104665429
Tcp11l1,2,104657288,104712169,protein_coding,-1,54881,chr2_104657288_104712169
Pin1rt1,2,104713926,104716379,protein_coding,-1,2453,chr2_104713926_104716379
Depdc7,2,104721784,104742878,protein_coding,-1,21094,chr2_104721784_104742878
Qser1,2,104754795,104816760,protein_coding,-1,61965,chr2_104754795_104816760
Prrg4,2,104830741,104849876,protein_coding,-1,19135,chr2_104830741_104849876
Ccdc73,2,104867805,105017904,protein_coding,1,150099,chr2_104867805_105017904
Eif3m,2,104999656,105017080,protein_coding,-1,17424,chr2_104999656_105017080
Wt1os,2,105076538,105126510,antisense,-1,49972,chr2_105076538_105126510
Gm11060,2,105092018,105093760,protein_coding,1,1742,chr2_105092018_105093760
Wt1,2,105126529,105173616,protein_coding,1,47087,chr2_105126529_105173616
Them7,2,105224320,105379796,protein_coding,1,155476,chr2_105224320_105379796
Rcn1,2,105386291,105399319,protein_coding,-1,13028,chr2_105386291_105399319
4930527A07Rik,2,105476501,105477357,lincRNA,1,856,chr2_105476501_105477357
Pax6os1,2,105536080,105670330,antisense,-1,134250,chr2_105536080_105670330
Pax6,2,105668900,105697364,protein_coding,1,28464,chr2_105668900_105697364
Elp4,2,105701027,105904564,protein_coding,-1,203537,chr2_105701027_105904564
Gm13954,2,105708999,105710098,antisense,1,1099,chr2_105708999_105710098
Immp1l,2,105904638,105965558,protein_coding,1,60920,chr2_105904638_105965558
Dnajc24,2,105966709,106003549,protein_coding,-1,36840,chr2_105966709_106003549
Gm29053,2,106038463,106040496,lincRNA,-1,2033,chr2_106038463_106040496
Gm14015,2,106463823,106523103,lincRNA,-1,59280,chr2_106463823_106523103
Mpped2,2,106693269,106868356,protein_coding,1,175087,chr2_106693269_106868356
Arl14ep,2,106962527,106974424,protein_coding,-1,11897,chr2_106962527_106974424
Kcna4,2,107290639,107298502,protein_coding,1,7863,chr2_107290639_107298502
Gm13912,2,108183716,108291319,lincRNA,-1,107603,chr2_108183716_108291319
Gm13923,2,109022687,109025444,lincRNA,1,2757,chr2_109022687_109025444
Mettl15,2,109092297,109280748,protein_coding,-1,188451,chr2_109092297_109280748
Kif18a,2,109280738,109341747,protein_coding,1,61009,chr2_109280738_109341747
Gm45346,2,109670908,109676591,antisense,-1,5683,chr2_109670908_109676591
Bdnf,2,109674700,109727007,protein_coding,1,52307,chr2_109674700_109727007
Lin7c,2,109890853,109901003,protein_coding,1,10150,chr2_109890853_109901003
Lgr4,2,109917647,110014257,protein_coding,1,96610,chr2_109917647_110014257
Ccdc34,2,110017817,110173360,protein_coding,1,155543,chr2_110017817_110173360
Ccdc34os,2,110031250,110050479,antisense,-1,19229,chr2_110031250_110050479
Gm13936,2,110196889,110256131,antisense,1,59242,chr2_110196889_110256131
Bbox1,2,110262697,110314560,protein_coding,-1,51863,chr2_110262697_110314560
Fibin,2,110360917,110363183,protein_coding,-1,2266,chr2_110360917_110363183
Slc5a12,2,110597298,110647779,protein_coding,1,50481,chr2_110597298_110647779
Ano3,2,110655201,110950923,protein_coding,-1,295722,chr2_110655201_110950923
Muc15,2,110721340,110739527,protein_coding,1,18187,chr2_110721340_110739527
Gm13942,2,111051320,111057574,lincRNA,-1,6254,chr2_111051320_111057574
Gm13941,2,111088372,111105982,protein_coding,-1,17610,chr2_111088372_111105982
Gm15130,2,111134114,111152936,protein_coding,-1,18822,chr2_111134114_111152936
Gm13962,2,111246131,111256163,antisense,-1,10032,chr2_111246131_111256163
Olfr1276,2,111254516,111262026,protein_coding,1,7510,chr2_111254516_111262026
Olfr1277,2,111264946,111274106,protein_coding,-1,9160,chr2_111264946_111274106
Olfr1280,2,111314017,111326003,protein_coding,1,11986,chr2_111314017_111326003
Olfr1281,2,111326520,111332852,protein_coding,1,6332,chr2_111326520_111332852
Olfr1284,2,111375522,111380613,protein_coding,1,5091,chr2_111375522_111380613
Olfr1286,2,111417842,111423115,protein_coding,-1,5273,chr2_111417842_111423115
Olfr1291-ps1,2,111497180,111504553,protein_coding,1,7373,chr2_111497180_111504553
Olfr1295,2,111561423,111569681,protein_coding,-1,8258,chr2_111561423_111569681
Olfr1302,2,111777429,111782700,protein_coding,1,5271,chr2_111777429_111782700
Olfr1305,2,111867657,111877149,protein_coding,-1,9492,chr2_111867657_111877149
Olfr1307,2,111930116,111949440,protein_coding,-1,19324,chr2_111930116_111949440
Olfr1310,2,112004574,112012708,protein_coding,-1,8134,chr2_112004574_112012708
Olfr1312,2,112038068,112050238,protein_coding,-1,12170,chr2_112038068_112050238
Olfr1313,2,112070088,112077843,protein_coding,-1,7755,chr2_112070088_112077843
Olfr1315-ps1,2,112110057,112115440,protein_coding,-1,5383,chr2_112110057_112115440
Olfr1316,2,112126996,112134977,protein_coding,-1,7981,chr2_112126996_112134977
Olfr1317,2,112140329,112144054,protein_coding,1,3725,chr2_112140329_112144054
Olfr1318,2,112154198,112159157,protein_coding,1,4959,chr2_112154198_112159157
Lpcat4,2,112239468,112247111,protein_coding,1,7643,chr2_112239468_112247111
Nutm1,2,112247948,112259291,protein_coding,-1,11343,chr2_112247948_112259291
Nop10,2,112261926,112263269,protein_coding,1,1343,chr2_112261926_112263269
Slc12a6,2,112265825,112363163,protein_coding,1,97338,chr2_112265825_112363163
Gm21985,2,112266314,112406319,protein_coding,1,140005,chr2_112266314_112406319
Emc4,2,112363011,112368027,protein_coding,-1,5016,chr2_112363011_112368027
Katnbl1,2,112379211,112414240,protein_coding,1,35029,chr2_112379211_112414240
Emc7,2,112454997,112472162,protein_coding,1,17165,chr2_112454997_112472162
Chrm5,2,112479171,112480769,protein_coding,-1,1598,chr2_112479171_112480769
Aven,2,112492964,112634573,protein_coding,1,141609,chr2_112492964_112634573
Ryr3,2,112631355,113217096,protein_coding,-1,585741,chr2_112631355_113217096
Tmco5b,2,113285732,113297190,protein_coding,1,11458,chr2_113285732_113297190
Fmn1,2,113327736,113716767,protein_coding,1,389031,chr2_113327736_113716767
Gm13963,2,113387107,113441094,antisense,-1,53987,chr2_113387107_113441094
Gm13966,2,113440681,113442304,antisense,-1,1623,chr2_113440681_113442304
Gm13964,2,113500679,113504034,antisense,-1,3355,chr2_113500679_113504034
4930533B01Rik,2,113691053,113708550,antisense,-1,17497,chr2_113691053_113708550
Grem1,2,113746164,113758646,protein_coding,-1,12482,chr2_113746164_113758646
Scg5,2,113776362,113829121,protein_coding,-1,52759,chr2_113776362_113829121
Arhgap11a,2,113831492,113848661,protein_coding,-1,17169,chr2_113831492_113848661
Gjd2,2,114009601,114013619,protein_coding,-1,4018,chr2_114009601_114013619
Actc1,2,114047282,114053548,protein_coding,-1,6266,chr2_114047282_114053548
C130080G10Rik,2,114054335,114064868,antisense,1,10533,chr2_114054335_114064868
Aqr,2,114101170,114187024,protein_coding,-1,85854,chr2_114101170_114187024
Zfp770,2,114193461,114201469,protein_coding,-1,8008,chr2_114193461_114201469
Gm29234,2,114272174,114273435,lincRNA,-1,1261,chr2_114272174_114273435
Dph6,2,114516416,114654964,protein_coding,-1,138548,chr2_114516416_114654964
Gm13974,2,114854093,115043972,lincRNA,1,189879,chr2_114854093_115043972
Gm28494,2,114897916,115220708,lincRNA,-1,322792,chr2_114897916_115220708
Gm28493,2,115135550,115137786,lincRNA,1,2236,chr2_115135550_115137786
3110099E03Rik,2,115493513,115527744,lincRNA,-1,34231,chr2_115493513_115527744
Gm13977,2,115556786,115581555,antisense,-1,24769,chr2_115556786_115581555
BC052040,2,115581716,115778768,protein_coding,1,197052,chr2_115581716_115778768
Meis2,2,115863064,116065839,protein_coding,-1,202775,chr2_115863064_116065839
2700033N17Rik,2,116066218,116067444,lincRNA,-1,1226,chr2_116066218_116067444
G630016G05Rik,2,116067225,116085911,lincRNA,1,18686,chr2_116067225_116085911
Gm13990,2,116848099,116877168,antisense,-1,29069,chr2_116848099_116877168
Tmco5,2,116878691,116892494,protein_coding,1,13803,chr2_116878691_116892494
D330050G23Rik,2,116900152,116912791,lincRNA,1,12639,chr2_116900152_116912791
Gm29340,2,116972575,116976428,lincRNA,-1,3853,chr2_116972575_116976428
Spred1,2,117121374,117182279,protein_coding,1,60905,chr2_117121374_117182279
Fam98b,2,117249739,117271540,protein_coding,1,21801,chr2_117249739_117271540
Rasgrp1,2,117279993,117343001,protein_coding,-1,63008,chr2_117279993_117343001
Gm13982,2,117414392,117417697,lincRNA,-1,3305,chr2_117414392_117417697
Gm13985,2,117806678,117812813,lincRNA,-1,6135,chr2_117806678_117812813
4930412B13Rik,2,117821928,117909136,lincRNA,1,87208,chr2_117821928_117909136
Thbs1,2,118111876,118127133,protein_coding,1,15257,chr2_118111876_118127133
Fsip1,2,118130424,118256966,protein_coding,-1,126542,chr2_118130424_118256966
A930104D05Rik,2,118270233,118276169,lincRNA,-1,5936,chr2_118270233_118276169
Gpr176,2,118277110,118373419,protein_coding,-1,96309,chr2_118277110_118373419
1700054M17Rik,2,118304914,118308166,antisense,1,3252,chr2_118304914_118308166
Eif2ak4,2,118388618,118475234,protein_coding,1,86616,chr2_118388618_118475234
Srp14,2,118475850,118479711,protein_coding,-1,3861,chr2_118475850_118479711
Bmf,2,118528757,118549687,protein_coding,-1,20930,chr2_118528757_118549687
Bub1b,2,118598211,118641591,protein_coding,1,43380,chr2_118598211_118641591
Pak6,2,118663303,118698020,protein_coding,1,34717,chr2_118663303_118698020
Ankrd63,2,118699103,118703963,protein_coding,-1,4860,chr2_118699103_118703963
Plcb2,2,118707517,118728438,protein_coding,-1,20921,chr2_118707517_118728438
Inafm2,2,118745758,118748810,protein_coding,1,3052,chr2_118745758_118748810
Phgr1,2,118772769,118778165,protein_coding,1,5396,chr2_118772769_118778165
Disp2,2,118779719,118811293,protein_coding,1,31574,chr2_118779719_118811293
Knstrn,2,118814003,118853957,protein_coding,1,39954,chr2_118814003_118853957
Gm14091,2,118829874,118834122,antisense,-1,4248,chr2_118829874_118834122
Ivd,2,118861954,118882909,protein_coding,1,20955,chr2_118861954_118882909
Bahd1,2,118900377,118924528,protein_coding,1,24151,chr2_118900377_118924528
Chst14,2,118926496,118928585,protein_coding,1,2089,chr2_118926496_118928585
Gm14089,2,118997068,119000684,antisense,1,3616,chr2_118997068_119000684
Ccdc32,2,119017779,119029393,protein_coding,-1,11614,chr2_119017779_119029393
Rpusd2,2,119034790,119039769,protein_coding,1,4979,chr2_119034790_119039769
Knl1,2,119047119,119105501,protein_coding,1,58382,chr2_119047119_119105501
Rad51,2,119112793,119147445,protein_coding,1,34652,chr2_119112793_119147445
Rmdn3,2,119137001,119157034,protein_coding,-1,20033,chr2_119137001_119157034
Gchfr,2,119167773,119172390,protein_coding,1,4617,chr2_119167773_119172390
Dnajc17,2,119172500,119208795,protein_coding,-1,36295,chr2_119172500_119208795
Gm14137,2,119174509,119177575,protein_coding,1,3066,chr2_119174509_119177575
Zfyve19,2,119208617,119217049,protein_coding,1,8432,chr2_119208617_119217049
Ppp1r14d,2,119218119,119229906,protein_coding,-1,11787,chr2_119218119_119229906
Spint1,2,119237362,119249527,protein_coding,1,12165,chr2_119237362_119249527
Rhov,2,119269201,119271272,protein_coding,-1,2071,chr2_119269201_119271272
Vps18,2,119288740,119298453,protein_coding,1,9713,chr2_119288740_119298453
Dll4,2,119325784,119335962,protein_coding,1,10178,chr2_119325784_119335962
Chac1,2,119351229,119354381,protein_coding,1,3152,chr2_119351229_119354381
Ino80,2,119373042,119477687,protein_coding,-1,104645,chr2_119373042_119477687
Exd1,2,119516505,119547627,protein_coding,-1,31122,chr2_119516505_119547627
Chp1,2,119547697,119587027,protein_coding,1,39330,chr2_119547697_119587027
Oip5,2,119609512,119618469,protein_coding,-1,8957,chr2_119609512_119618469
Nusap1,2,119618298,119651244,protein_coding,1,32946,chr2_119618298_119651244
Ndufaf1,2,119655446,119662827,protein_coding,-1,7381,chr2_119655446_119662827
Rtf1,2,119675068,119735407,protein_coding,1,60339,chr2_119675068_119735407
Itpka,2,119742337,119751263,protein_coding,1,8926,chr2_119742337_119751263
Ltk,2,119751320,119760431,protein_coding,-1,9111,chr2_119751320_119760431
Rpap1,2,119763304,119787537,protein_coding,-1,24233,chr2_119763304_119787537
Tyro3,2,119797733,119818104,protein_coding,1,20371,chr2_119797733_119818104
Mga,2,119897228,119969581,protein_coding,1,72353,chr2_119897228_119969581
Mapkbp1,2,119972699,120027408,protein_coding,1,54709,chr2_119972699_120027408
Gm13999,2,120024807,120027453,antisense,-1,2646,chr2_120024807_120027453
Gm28042,2,120027493,120043033,protein_coding,1,15540,chr2_120027493_120043033
Ehd4,2,120089175,120154606,protein_coding,-1,65431,chr2_120089175_120154606
Pla2g4e,2,120166412,120245335,protein_coding,-1,78923,chr2_120166412_120245335
Pla2g4d,2,120265595,120289197,protein_coding,-1,23602,chr2_120265595_120289197
Pla2g4f,2,120299957,120314165,protein_coding,-1,14208,chr2_120299957_120314165
Vps39,2,120316461,120353137,protein_coding,-1,36676,chr2_120316461_120353137
Tmem87a,2,120355312,120404113,protein_coding,-1,48801,chr2_120355312_120404113
Ganc,2,120403896,120461700,protein_coding,1,57804,chr2_120403896_120461700
Capn3,2,120463572,120504918,protein_coding,1,41346,chr2_120463572_120504918
Zfp106,2,120506820,120563843,protein_coding,-1,57023,chr2_120506820_120563843
Snap23,2,120567671,120601255,protein_coding,1,33584,chr2_120567671_120601255
Lrrc57,2,120604238,120609520,protein_coding,-1,5282,chr2_120604238_120609520
Haus2,2,120609383,120621560,protein_coding,1,12177,chr2_120609383_120621560
Stard9,2,120629121,120731895,protein_coding,1,102774,chr2_120629121_120731895
Cdan1,2,120716154,120850128,protein_coding,-1,133974,chr2_120716154_120850128
Ttbk2,2,120732816,120850604,protein_coding,-1,117788,chr2_120732816_120850604
Ubr1,2,120860269,120970715,protein_coding,-1,110446,chr2_120860269_120970715
Tmem62,2,120977017,121007852,protein_coding,1,30835,chr2_120977017_121007852
Ccndbp1,2,121008403,121016904,protein_coding,1,8501,chr2_121008403_121016904
Epb42,2,121017891,121037072,protein_coding,-1,19181,chr2_121017891_121037072
Tgm5,2,121046111,121085841,protein_coding,-1,39730,chr2_121046111_121085841
Tgm7,2,121093565,121116396,protein_coding,-1,22831,chr2_121093565_121116396
Lcmt2,2,121128307,121140653,protein_coding,-1,12346,chr2_121128307_121140653
Adal,2,121140428,121156680,protein_coding,1,16252,chr2_121140428_121156680
Zscan29,2,121158273,121171125,protein_coding,-1,12852,chr2_121158273_121171125
Tubgcp4,2,121170654,121198770,protein_coding,1,28116,chr2_121170654_121198770
Trp53bp1,2,121193281,121271407,protein_coding,-1,78126,chr2_121193281_121271407
Map1a,2,121289600,121310832,protein_coding,1,21232,chr2_121289600_121310832
Gm14978,2,121293703,121296008,antisense,-1,2305,chr2_121293703_121296008
Ppip5k1,2,121310561,121355396,protein_coding,-1,44835,chr2_121310561_121355396
Ckmt1,2,121357714,121363737,protein_coding,1,6023,chr2_121357714_121363737
Strc,2,121363728,121387168,protein_coding,-1,23440,chr2_121363728_121387168
Catsper2,2,121392631,121413792,protein_coding,-1,21161,chr2_121392631_121413792
Pdia3,2,121413775,121438687,protein_coding,1,24912,chr2_121413775_121438687
Ell3,2,121439010,121444278,protein_coding,-1,5268,chr2_121439010_121444278
Serinc4,2,121439059,121456781,protein_coding,-1,17722,chr2_121439059_121456781
Serf2,2,121449195,121458313,protein_coding,1,9118,chr2_121449195_121458313
Hypk,2,121453290,121458672,protein_coding,1,5382,chr2_121453290_121458672
Mfap1b,2,121460235,121474067,protein_coding,-1,13832,chr2_121460235_121474067
Mfap1a,2,121491911,121506665,protein_coding,-1,14754,chr2_121491911_121506665
Wdr76,2,121506723,121544860,protein_coding,1,38137,chr2_121506723_121544860
Frmd5,2,121545529,121807087,protein_coding,-1,261558,chr2_121545529_121807087
Gm14019,2,121865781,121866717,antisense,-1,936,chr2_121865781_121866717
Casc4,2,121866970,121936220,protein_coding,1,69250,chr2_121866970_121936220
Mageb3,2,121953752,121956092,protein_coding,-1,2340,chr2_121953752_121956092
Ctdspl2,2,121956001,122013642,protein_coding,1,57641,chr2_121956001_122013642
Eif3j1,2,122028546,122056598,protein_coding,1,28052,chr2_122028546_122056598
Spg11,2,122053520,122118386,protein_coding,-1,64866,chr2_122053520_122118386
Patl2,2,122120108,122186189,protein_coding,-1,66081,chr2_122120108_122186189
B2m,2,122147686,122153083,protein_coding,1,5397,chr2_122147686_122153083
Trim69,2,122160700,122179027,protein_coding,1,18327,chr2_122160700_122179027
Terb2,2,122186272,122206397,protein_coding,1,20125,chr2_122186272_122206397
Sord,2,122234749,122265340,protein_coding,1,30591,chr2_122234749_122265340
Duox2,2,122279247,122298449,protein_coding,-1,19202,chr2_122279247_122298449
Duoxa2,2,122298900,122302885,protein_coding,1,3985,chr2_122298900_122302885
Duoxa1,2,122302191,122313730,protein_coding,-1,11539,chr2_122302191_122313730
Duox1,2,122315672,122347972,protein_coding,1,32300,chr2_122315672_122347972
Shf,2,122348892,122369162,protein_coding,-1,20270,chr2_122348892_122369162
Slc28a2,2,122426477,122461137,protein_coding,1,34660,chr2_122426477_122461137
Gatm,2,122594467,122611303,protein_coding,-1,16836,chr2_122594467_122611303
AA467197,2,122636986,122652630,protein_coding,1,15644,chr2_122636986_122652630
Slc30a4,2,122681233,122714102,protein_coding,-1,32869,chr2_122681233_122714102
Bloc1s6os,2,122733290,122738362,antisense,-1,5072,chr2_122733290_122738362
Bloc1s6,2,122738503,122749475,protein_coding,1,10972,chr2_122738503_122749475
Sqor,2,122765237,122809569,protein_coding,1,44332,chr2_122765237_122809569
Sema6d,2,124089969,124667770,protein_coding,1,577801,chr2_124089969_124667770
4930517E11Rik,2,124123636,124129956,lincRNA,-1,6320,chr2_124123636_124129956
4930583P06Rik,2,124217679,124222331,lincRNA,-1,4652,chr2_124217679_124222331
Slc24a5,2,125068124,125088677,protein_coding,1,20553,chr2_125068124_125088677
Myef2,2,125084628,125123661,protein_coding,-1,39033,chr2_125084628_125123661
Ctxn2,2,125136633,125147841,protein_coding,1,11208,chr2_125136633_125147841
Slc12a1,2,125152505,125230002,protein_coding,1,77497,chr2_125152505_125230002
Gm14002,2,125207529,125217512,antisense,-1,9983,chr2_125207529_125217512
Dut,2,125247190,125258608,protein_coding,1,11418,chr2_125247190_125258608
Fbn1,2,125300594,125507993,protein_coding,-1,207399,chr2_125300594_125507993
Gm9913,2,125505089,125507881,antisense,1,2792,chr2_125505089_125507881
Cep152,2,125563088,125625113,protein_coding,-1,62025,chr2_125563088_125625113
Shc4,2,125627447,125724148,protein_coding,-1,96701,chr2_125627447_125724148
Eid1,2,125673095,125674785,protein_coding,1,1690,chr2_125673095_125674785
Secisbp2l,2,125736986,125782870,protein_coding,-1,45884,chr2_125736986_125782870
Cops2,2,125830304,125859139,protein_coding,-1,28835,chr2_125830304_125859139
Galk2,2,125859109,125984299,protein_coding,1,125190,chr2_125859109_125984299
Fam227b,2,125983483,126152004,protein_coding,-1,168521,chr2_125983483_126152004
Fgf7,2,126034658,126091185,protein_coding,1,56527,chr2_126034658_126091185
Dtwd1,2,126152141,126165279,protein_coding,1,13138,chr2_126152141_126165279
Gm17555,2,126215100,126216212,protein_coding,1,1112,chr2_126215100_126216212
Atp8b4,2,126320973,126500674,protein_coding,-1,179701,chr2_126320973_126500674
Slc27a2,2,126552407,126588243,protein_coding,1,35836,chr2_126552407_126588243
Hdc,2,126593667,126619299,protein_coding,-1,25632,chr2_126593667_126619299
Gabpb1,2,126627442,126676337,protein_coding,-1,48895,chr2_126627442_126676337
Gm27003,2,126675916,126683805,antisense,1,7889,chr2_126675916_126683805
Usp8,2,126707328,126759297,protein_coding,1,51969,chr2_126707328_126759297
Usp50,2,126709096,126783470,protein_coding,-1,74374,chr2_126709096_126783470
Trpm7,2,126791565,126876230,protein_coding,-1,84665,chr2_126791565_126876230
Sppl2a,2,126890391,126933235,protein_coding,-1,42844,chr2_126890391_126933235
Ap4e1,2,127008717,127067909,protein_coding,1,59192,chr2_127008717_127067909
Blvra,2,127070665,127097084,protein_coding,1,26419,chr2_127070665_127097084
Ncaph,2,127103809,127133954,protein_coding,-1,30145,chr2_127103809_127133954
Itpripl1,2,127138772,127143442,protein_coding,-1,4670,chr2_127138772_127143442
1810024B03Rik,2,127186355,127208280,protein_coding,-1,21925,chr2_127186355_127208280
Snrnp200,2,127208386,127240451,protein_coding,1,32065,chr2_127208386_127240451
Ciao1,2,127240938,127247816,protein_coding,-1,6878,chr2_127240938_127247816
Tmem127,2,127247908,127261107,protein_coding,1,13199,chr2_127247908_127261107
Stard7,2,127270218,127298932,protein_coding,1,28714,chr2_127270218_127298932
Dusp2,2,127336159,127338376,protein_coding,1,2217,chr2_127336159_127338376
Astl,2,127338639,127357651,protein_coding,1,19012,chr2_127338639_127357651
Gpat2,2,127425199,127436092,protein_coding,1,10893,chr2_127425199_127436092
Fahd2a,2,127436215,127444565,protein_coding,-1,8350,chr2_127436215_127444565
Kcnip3,2,127456498,127522094,protein_coding,-1,65596,chr2_127456498_127522094
Prom2,2,127526473,127541467,protein_coding,-1,14994,chr2_127526473_127541467
Zfp661,2,127574662,127587094,protein_coding,-1,12432,chr2_127574662_127587094
Mrps5,2,127587222,127606829,protein_coding,1,19607,chr2_127587222_127606829
Mal,2,127633226,127656695,protein_coding,-1,23469,chr2_127633226_127656695
Gm14244,2,127691899,127700488,antisense,1,8589,chr2_127691899_127700488
Mall,2,127704386,127729932,protein_coding,-1,25546,chr2_127704386_127729932
Nphp1,2,127740732,127788897,protein_coding,-1,48165,chr2_127740732_127788897
Bub1,2,127801122,127831865,protein_coding,-1,30743,chr2_127801122_127831865
Acoxl,2,127838876,128123873,protein_coding,1,284997,chr2_127838876_128123873
Bcl2l11,2,128126038,128162547,protein_coding,1,36509,chr2_128126038_128162547
Gm14009,2,128189987,128204634,lincRNA,1,14647,chr2_128189987_128204634
Gm14010,2,128423654,128424565,lincRNA,1,911,chr2_128423654_128424565
Gm29010,2,128433723,128460051,lincRNA,1,26328,chr2_128433723_128460051
Spdye4c,2,128591209,128598464,protein_coding,1,7255,chr2_128591209_128598464
Gm39929,2,128601765,128609630,lincRNA,-1,7865,chr2_128601765_128609630
Anapc1,2,128610104,128687391,protein_coding,-1,77287,chr2_128610104_128687391
Mertk,2,128698956,128802894,protein_coding,1,103938,chr2_128698956_128802894
Gm14011,2,128751271,128753705,antisense,-1,2434,chr2_128751271_128753705
Tmem87b,2,128818118,128854261,protein_coding,1,36143,chr2_128818118_128854261
Fbln7,2,128862981,128897034,protein_coding,1,34053,chr2_128862981_128897034
Zc3h8,2,128926268,128944077,protein_coding,-1,17809,chr2_128926268_128944077
4933427J07Rik,2,128955671,128957861,antisense,-1,2190,chr2_128955671_128957861
Gm10762,2,128965505,128968044,antisense,-1,2539,chr2_128965505_128968044
Zc3h6,2,128967402,129018563,protein_coding,1,51161,chr2_128967402_129018563
Ttl,2,129065942,129096283,protein_coding,1,30341,chr2_129065942_129096283
Polr1b,2,129100995,129126594,protein_coding,1,25599,chr2_129100995_129126594
Chchd5,2,129129700,129134134,protein_coding,1,4434,chr2_129129700_129134134
AI847159,2,129158666,129180667,antisense,-1,22001,chr2_129158666_129180667
Gm14029,2,129182482,129183947,antisense,-1,1465,chr2_129182482_129183947
Slc20a1,2,129198764,129211616,protein_coding,1,12852,chr2_129198764_129211616
A730036I17Rik,2,129218969,129235604,lincRNA,1,16635,chr2_129218969_129235604
Gm14024,2,129246376,129268526,antisense,1,22150,chr2_129246376_129268526
Ckap2l,2,129268210,129297212,protein_coding,-1,29002,chr2_129268210_129297212
Il1a,2,129299610,129309972,protein_coding,-1,10362,chr2_129299610_129309972
Il1b,2,129364570,129371139,protein_coding,-1,6569,chr2_129364570_129371139
Il1bos,2,129369897,129375748,antisense,1,5851,chr2_129369897_129375748
F830045P16Rik,2,129458359,129536602,protein_coding,-1,78243,chr2_129458359_129536602
Gm14041,2,129565047,129566068,antisense,-1,1021,chr2_129565047_129566068
Sirpa,2,129592835,129632228,protein_coding,1,39393,chr2_129592835_129632228
Pdyn,2,129686565,129699844,protein_coding,-1,13279,chr2_129686565_129699844
Stk35,2,129800517,129832287,protein_coding,1,31770,chr2_129800517_129832287
Gm28196,2,129948568,129949207,lincRNA,1,639,chr2_129948568_129949207
Tgm3,2,130012349,130050399,protein_coding,1,38050,chr2_130012349_130050399
Tgm6,2,130112416,130154232,protein_coding,1,41816,chr2_130112416_130154232
Snrpb,2,130171414,130179403,protein_coding,-1,7989,chr2_130171414_130179403
Tmc2,2,130195194,130264445,protein_coding,1,69251,chr2_130195194_130264445
Nop56,2,130274430,130279313,protein_coding,1,4883,chr2_130274430_130279313
Idh3b,2,130279309,130284547,protein_coding,-1,5238,chr2_130279309_130284547
Ebf4,2,130295169,130370481,protein_coding,1,75312,chr2_130295169_130370481
Cpxm1,2,130390775,130397574,protein_coding,-1,6799,chr2_130390775_130397574
Gm28372,2,130405239,130408256,protein_coding,1,3017,chr2_130405239_130408256
Pced1a,2,130417247,130424701,protein_coding,-1,7454,chr2_130417247_130424701
Vps16,2,130424339,130444269,protein_coding,1,19930,chr2_130424339_130444269
Ptpra,2,130450278,130556124,protein_coding,1,105846,chr2_130450278_130556124
4930473A02Rik,2,130543791,130563749,antisense,-1,19958,chr2_130543791_130563749
Mrps26,2,130563742,130568695,protein_coding,1,4953,chr2_130563742_130568695
Oxt,2,130576173,130577054,protein_coding,1,881,chr2_130576173_130577054
Avp,2,130580620,130582554,protein_coding,-1,1934,chr2_130580620_130582554
Ubox5,2,130590002,130630038,protein_coding,-1,40036,chr2_130590002_130630038
Lzts3,2,130632839,130642803,protein_coding,-1,9964,chr2_130632839_130642803
Ddrgk1,2,130653960,130664659,protein_coding,-1,10699,chr2_130653960_130664659
Itpa,2,130667610,130681614,protein_coding,1,14004,chr2_130667610_130681614
Slc4a11,2,130684113,130697519,protein_coding,-1,13406,chr2_130684113_130697519
4930402H24Rik,2,130706200,130906406,protein_coding,-1,200206,chr2_130706200_130906406
Atrn,2,130906495,131030333,protein_coding,1,123838,chr2_130906495_131030333
Gfra4,2,131039632,131043088,protein_coding,-1,3456,chr2_131039632_131043088
Adam33,2,131050591,131063814,protein_coding,-1,13223,chr2_131050591_131063814
Siglec1,2,131069220,131086765,protein_coding,-1,17545,chr2_131069220_131086765
Hspa12b,2,131127280,131146321,protein_coding,1,19041,chr2_131127280_131146321
1700037H04Rik,2,131146324,131160081,protein_coding,-1,13757,chr2_131146324_131160081
Gm14232,2,131159537,131171342,antisense,1,11805,chr2_131159537_131171342
Spef1,2,131170261,131187282,protein_coding,-1,17021,chr2_131170261_131187282
Cdc25b,2,131186949,131198497,protein_coding,1,11548,chr2_131186949_131198497
Ap5s1,2,131207078,131213514,protein_coding,1,6436,chr2_131207078_131213514
Mavs,2,131234063,131248025,protein_coding,1,13962,chr2_131234063_131248025
Pank2,2,131262495,131299188,protein_coding,1,36693,chr2_131262495_131299188
Rnf24,2,131298064,131352892,protein_coding,-1,54828,chr2_131298064_131352892
Smox,2,131491496,131525922,protein_coding,1,34426,chr2_131491496_131525922
Adra1d,2,131545850,131562283,protein_coding,-1,16433,chr2_131545850_131562283
Gm14285,2,131561614,131563179,antisense,1,1565,chr2_131561614_131563179
Gm14280,2,131652897,131721838,antisense,-1,68941,chr2_131652897_131721838
5330413P13Rik,2,131820006,131847683,lincRNA,-1,27677,chr2_131820006_131847683
Prnp,2,131909928,131938429,protein_coding,1,28501,chr2_131909928_131938429
Prn,2,131909957,131956130,protein_coding,1,46173,chr2_131909957_131956130
Rassf2,2,131989415,132030258,protein_coding,-1,40843,chr2_131989415_132030258
Slc23a2,2,132052496,132145108,protein_coding,-1,92612,chr2_132052496_132145108
Gm14051,2,132144533,132220250,antisense,1,75717,chr2_132144533_132220250
Tmem230,2,132239492,132247807,protein_coding,-1,8315,chr2_132239492_132247807
Pcna,2,132249162,132253314,protein_coding,-1,4152,chr2_132249162_132253314
AV099323,2,132253357,132261333,antisense,1,7976,chr2_132253357_132261333
Cds2,2,132263148,132312050,protein_coding,1,48902,chr2_132263148_132312050
Prokr2,2,132337733,132385447,protein_coding,-1,47714,chr2_132337733_132385447
4921508D12Rik,2,132424741,132452499,lincRNA,1,27758,chr2_132424741_132452499
Gm14095,2,132483212,132501148,lincRNA,-1,17936,chr2_132483212_132501148
1700026D11Rik,2,132490634,132524057,antisense,1,33423,chr2_132490634_132524057
Gpcpd1,2,132529082,132587729,protein_coding,-1,58647,chr2_132529082_132587729
AU019990,2,132598195,132653068,lincRNA,1,54873,chr2_132598195_132653068
Gm14097,2,132694432,132698523,antisense,-1,4091,chr2_132694432_132698523
Chgb,2,132781278,132795079,protein_coding,1,13801,chr2_132781278_132795079
Trmt6,2,132804207,132816055,protein_coding,-1,11848,chr2_132804207_132816055
Mcm8,2,132816141,132844197,protein_coding,1,28056,chr2_132816141_132844197
Gm14104,2,132845999,132847256,antisense,-1,1257,chr2_132845999_132847256
Crls1,2,132846666,132866785,protein_coding,1,20119,chr2_132846666_132866785
Lrrn4,2,132868305,132880891,protein_coding,-1,12586,chr2_132868305_132880891
Fermt1,2,132904389,132945906,protein_coding,-1,41517,chr2_132904389_132945906
A430048G15Rik,2,133432095,133453362,lincRNA,1,21267,chr2_133432095_133453362
Bmp2,2,133552159,133562885,protein_coding,1,10726,chr2_133552159_133562885
Hao1,2,134497361,134554368,protein_coding,-1,57007,chr2_134497361_134554368
Tmx4,2,134594185,134644145,protein_coding,-1,49960,chr2_134594185_134644145
Plcb1,2,134786067,135475258,protein_coding,1,689191,chr2_134786067_135475258
4930545L23Rik,2,135169573,135215616,antisense,-1,46043,chr2_135169573_135215616
9630028H03Rik,2,135325447,135583584,antisense,-1,258137,chr2_135325447_135583584
Platr3,2,135648907,135652063,lincRNA,1,3156,chr2_135648907_135652063
Plcb4,2,135659011,136014593,protein_coding,1,355582,chr2_135659011_136014593
Gm14211,2,135686174,135693154,lincRNA,-1,6980,chr2_135686174_135693154
Gm14210,2,135811945,135812927,lincRNA,-1,982,chr2_135811945_135812927
Lamp5,2,136052239,136069917,protein_coding,1,17678,chr2_136052239_136069917
Pak7,2,136081104,136387967,protein_coding,-1,306863,chr2_136081104_136387967
Gm14218,2,136137006,136140161,antisense,1,3155,chr2_136137006_136140161
Ankef1,2,136501910,136562091,protein_coding,1,60181,chr2_136501910_136562091
Snap25,2,136713453,136782428,protein_coding,1,68975,chr2_136713453_136782428
Mkks,2,136873780,136891389,protein_coding,-1,17609,chr2_136873780_136891389
Slx4ip,2,136891218,137071950,protein_coding,1,180732,chr2_136891218_137071950
Jag1,2,137081456,137116644,protein_coding,-1,35188,chr2_137081456_137116644
Gm14055,2,137288503,137329126,lincRNA,1,40623,chr2_137288503_137329126
Gm14064,2,137663435,137829244,lincRNA,1,165809,chr2_137663435_137829244
Btbd3,2,138256565,138589292,protein_coding,1,332727,chr2_138256565_138589292
Gm14061,2,138589392,138649122,lincRNA,1,59730,chr2_138589392_138649122
Sptlc3,2,139493913,139637674,protein_coding,1,143761,chr2_139493913_139637674
Ism1,2,139678178,139758581,protein_coding,1,80403,chr2_139678178_139758581
Tasp1,2,139833480,140066805,protein_coding,-1,233325,chr2_139833480_140066805
Esf1,2,140119883,140170564,protein_coding,-1,50681,chr2_140119883_140170564
Gm17374,2,140152043,140153532,protein_coding,1,1489,chr2_140152043_140153532
Ndufaf5,2,140170649,140203689,protein_coding,1,33040,chr2_140170649_140203689
Sel1l2,2,140229855,140389706,protein_coding,-1,159851,chr2_140229855_140389706
Macrod2,2,140395309,142392966,protein_coding,1,1997657,chr2_140395309_142392966
Flrt3,2,140650914,140671469,protein_coding,-1,20555,chr2_140650914_140671469
Macrod2os2,2,141229670,141235426,antisense,-1,5756,chr2_141229670_141235426
Macrod2os1,2,141230431,141286991,antisense,-1,56560,chr2_141230431_141286991
Kif16b,2,142617474,142901531,protein_coding,-1,284057,chr2_142617474_142901531
Kif16bos,2,142902965,142903572,antisense,1,607,chr2_142902965_142903572
Snrpb2,2,143063039,143072853,protein_coding,1,9814,chr2_143063039_143072853
Otor,2,143078473,143081713,protein_coding,1,3240,chr2_143078473_143081713
Pcsk2os1,2,143535476,143547837,antisense,-1,12361,chr2_143535476_143547837
Pcsk2,2,143546156,143816285,protein_coding,1,270129,chr2_143546156_143816285
Pcsk2os2,2,143747583,143795965,antisense,-1,48382,chr2_143747583_143795965
Bfsp1,2,143826528,143863173,protein_coding,-1,36645,chr2_143826528_143863173
Dstn,2,143915320,143943324,protein_coding,1,28004,chr2_143915320_143943324
Rrbp1,2,143947395,144011263,protein_coding,-1,63868,chr2_143947395_144011263
Banf2,2,144033059,144073979,protein_coding,1,40920,chr2_144033059_144073979
Banf2os,2,144059138,144068806,antisense,-1,9668,chr2_144059138_144068806
Gm5535,2,144098815,144207990,lincRNA,-1,109175,chr2_144098815_144207990
4930444E06Rik,2,144243241,144244849,antisense,1,1608,chr2_144243241_144244849
Snx5,2,144250123,144270906,protein_coding,-1,20783,chr2_144250123_144270906
Mgme1,2,144270663,144281227,protein_coding,1,10564,chr2_144270663_144281227
Ovol2,2,144305175,144332146,protein_coding,-1,26971,chr2_144305175_144332146
1700108N11Rik,2,144331459,144332639,antisense,1,1180,chr2_144331459_144332639
Kat14,2,144368983,144407676,protein_coding,1,38693,chr2_144368983_144407676
Dzank1,2,144470557,144527414,protein_coding,-1,56857,chr2_144470557_144527414
Polr3f,2,144527718,144541995,protein_coding,1,14277,chr2_144527718_144541995
Rbbp9,2,144542265,144550869,protein_coding,-1,8604,chr2_144542265_144550869
Sec23b,2,144556229,144590749,protein_coding,1,34520,chr2_144556229_144590749
Smim26,2,144594054,144595366,protein_coding,1,1312,chr2_144594054_144595366
Dtd1,2,144599897,144768758,protein_coding,1,168861,chr2_144599897_144768758
Scp2d1,2,144823656,144824415,protein_coding,1,759,chr2_144823656_144824415
Slc24a3,2,145167754,145642166,protein_coding,1,474412,chr2_145167754_145642166
Gm14092,2,145550652,145554982,antisense,-1,4330,chr2_145550652_145554982
Rin2,2,145675215,145887616,protein_coding,1,212401,chr2_145675215_145887616
Naa20,2,145902099,145916425,protein_coding,1,14326,chr2_145902099_145916425
Crnkl1,2,145917479,145935014,protein_coding,-1,17535,chr2_145917479_145935014
Cfap61,2,145934784,146215039,protein_coding,1,280255,chr2_145934784_146215039
Insm1,2,146221921,146225020,protein_coding,1,3099,chr2_146221921_146225020
Ralgapa2,2,146239879,146512344,protein_coding,-1,272465,chr2_146239879_146512344
A930019D19Rik,2,146259286,146267160,antisense,1,7874,chr2_146259286_146267160
Gm14114,2,146828327,146839732,lincRNA,-1,11405,chr2_146828327_146839732
Kiz,2,146855864,146970097,protein_coding,1,114233,chr2_146855864_146970097
Xrn2,2,147012996,147078000,protein_coding,1,65004,chr2_147012996_147078000
Nkx2-2,2,147177546,147194243,protein_coding,-1,16697,chr2_147177546_147194243
Nkx2-2os,2,147184083,147331681,antisense;misc_RNA,1,147598,chr2_147184083_147331681
Gm14110,2,147323562,147325087,lincRNA,-1,1525,chr2_147323562_147325087
Pax1,2,147361925,147393295,protein_coding,1,31370,chr2_147361925_147393295
A530006G24Rik,2,147710693,147717632,lincRNA,1,6939,chr2_147710693_147717632
9030622O22Rik,2,147944740,148040203,lincRNA,-1,95463,chr2_147944740_148040203
Sstr4,2,148395344,148396767,protein_coding,1,1423,chr2_148395344_148396767
Thbd,2,148404466,148408188,protein_coding,-1,3722,chr2_148404466_148408188
Cd93,2,148436640,148443563,protein_coding,-1,6923,chr2_148436640_148443563
Gm14120,2,148468890,148478780,lincRNA,1,9890,chr2_148468890_148478780
Nxt1,2,148672601,148676027,protein_coding,1,3426,chr2_148672601_148676027
Gzf1,2,148681023,148692949,protein_coding,1,11926,chr2_148681023_148692949
Napb,2,148693985,148732467,protein_coding,-1,38482,chr2_148693985_148732467
Cstl1,2,148750358,148755433,protein_coding,1,5075,chr2_148750358_148755433
Cst11,2,148768609,148771497,protein_coding,-1,2888,chr2_148768609_148771497
Cst12,2,148789361,148793546,protein_coding,1,4185,chr2_148789361_148793546
Cst13,2,148820081,148830410,protein_coding,1,10329,chr2_148820081_148830410
Cst3,2,148871722,148875692,protein_coding,-1,3970,chr2_148871722_148875692
Gm1330,2,148990343,149003251,protein_coding,-1,12908,chr2_148990343_149003251
Gm14135,2,149257277,149262145,lincRNA,1,4868,chr2_149257277_149262145
Cst10,2,149405057,149410293,protein_coding,1,5236,chr2_149405057_149410293
Gm14133,2,149743927,149798743,lincRNA,-1,54816,chr2_149743927_149798743
Syndig1,2,149829211,150004392,protein_coding,1,175181,chr2_149829211_150004392
C530025M09Rik,2,149828339,149831642,antisense,-1,3303,chr2_149828339_149831642
Zfp120,2,150114406,150136708,protein_coding,-1,22302,chr2_150114406_150136708
Gm14139,2,150181755,150193279,protein_coding,1,11524,chr2_150181755_150193279
Zfp937,2,150218073,150240725,protein_coding,1,22652,chr2_150218073_150240725
Gm21994,2,150254518,150255591,protein_coding,-1,1073,chr2_150254518_150255591
Gm14124,2,150257517,150270300,protein_coding,1,12783,chr2_150257517_150270300
3300002I08Rik,2,150310935,150362765,protein_coding,-1,51830,chr2_150310935_150362765
Gm10130,2,150311431,150363071,protein_coding,1,51640,chr2_150311431_150363071
Zfp442,2,150407141,150451486,protein_coding,-1,44345,chr2_150407141_150451486
Zfp345,2,150470991,150485091,protein_coding,-1,14100,chr2_150470991_150485091
Cst7,2,150570415,150578944,protein_coding,1,8529,chr2_150570415_150578944
Apmap,2,150583080,150608567,protein_coding,-1,25487,chr2_150583080_150608567
Acss1,2,150618105,150668500,protein_coding,-1,50395,chr2_150618105_150668500
Vsx1,2,150680702,150689360,protein_coding,-1,8658,chr2_150680702_150689360
Platr15,2,150704536,150706876,lincRNA,-1,2340,chr2_150704536_150706876
Entpd6,2,150749042,150771675,protein_coding,1,22633,chr2_150749042_150771675
Pygb,2,150786735,150831758,protein_coding,1,45023,chr2_150786735_150831758
Abhd12,2,150832493,150904741,protein_coding,-1,72248,chr2_150832493_150904741
Gins1,2,150905400,150931280,protein_coding,1,25880,chr2_150905400_150931280
Ninl,2,150934519,151039382,protein_coding,-1,104863,chr2_150934519_151039382
Nanp,2,151029685,151039398,protein_coding,-1,9713,chr2_151029685_151039398
Gm14147,2,151098245,151103818,protein_coding,1,5573,chr2_151098245_151103818
Gm14145,2,151104892,151106326,lincRNA,1,1434,chr2_151104892_151106326
Gm14149,2,151205195,151231614,lincRNA,1,26419,chr2_151205195_151231614
Gm14152,2,151380650,151432402,lincRNA,-1,51752,chr2_151380650_151432402
Gm14146,2,151462045,151469613,antisense,-1,7568,chr2_151462045_151469613
Nsfl1c,2,151494182,151511414,protein_coding,1,17232,chr2_151494182_151511414
Gm14167,2,151540731,151542348,antisense,-1,1617,chr2_151540731_151542348
Fkbp1a,2,151542483,151561692,protein_coding,1,19209,chr2_151542483_151561692
Sdcbp2,2,151572622,151590005,protein_coding,1,17383,chr2_151572622_151590005
Snph,2,151590549,151632593,protein_coding,-1,42044,chr2_151590549_151632593
Rad21l,2,151645404,151668533,protein_coding,-1,23129,chr2_151645404_151668533
Tmem74bos,2,151679361,151686339,protein_coding,-1,6978,chr2_151679361_151686339
Tmem74b,2,151702008,151712157,protein_coding,1,10149,chr2_151702008_151712157
Psmf1,2,151715812,151744186,protein_coding,-1,28374,chr2_151715812_151744186
4930556L07Rik,2,151747578,151749978,lincRNA,-1,2400,chr2_151747578_151749978
Gm14155,2,151829067,151832108,lincRNA,1,3041,chr2_151829067_151832108
Rspo4,2,151842927,151874668,protein_coding,1,31741,chr2_151842927_151874668
Angpt4,2,151911210,151945337,protein_coding,1,34127,chr2_151911210_151945337
Gm14154,2,151947273,151950641,antisense,-1,3368,chr2_151947273_151950641
Fam110a,2,151969398,151980219,protein_coding,-1,10821,chr2_151969398_151980219
Slc52a3,2,151996511,152009258,protein_coding,1,12747,chr2_151996511_152009258
AA387200,2,152074855,152076808,antisense,-1,1953,chr2_152074855_152076808
Scrt2,2,152081529,152095802,protein_coding,1,14273,chr2_152081529_152095802
Srxn1,2,152105516,152111376,protein_coding,1,5860,chr2_152105516_152111376
Tcf15,2,152143561,152149097,protein_coding,1,5536,chr2_152143561_152149097
Csnk2a1,2,152226839,152281852,protein_coding,1,55013,chr2_152226839_152281852
Tbc1d20,2,152293828,152313996,protein_coding,1,20168,chr2_152293828_152313996
Rbck1,2,152316334,152332653,protein_coding,-1,16319,chr2_152316334_152332653
Trib3,2,152337422,152344032,protein_coding,-1,6610,chr2_152337422_152344032
Nrsn2,2,152368755,152376638,protein_coding,-1,7883,chr2_152368755_152376638
Sox12,2,152393611,152398063,protein_coding,-1,4452,chr2_152393611_152398063
Zcchc3,2,152411955,152415027,protein_coding,-1,3072,chr2_152411955_152415027
6820408C15Rik,2,152415587,152444330,protein_coding,1,28743,chr2_152415587_152444330
Defb23,2,152459055,152464620,protein_coding,-1,5565,chr2_152459055_152464620
Defb20,2,152477063,152479934,protein_coding,1,2871,chr2_152477063_152479934
Gm14161,2,152549714,152553932,lincRNA,-1,4218,chr2_152549714_152553932
Defb36,2,152604327,152612729,protein_coding,1,8402,chr2_152604327_152612729
Rem1,2,152626951,152635198,protein_coding,1,8247,chr2_152626951_152635198
1700030C14Rik,2,152652883,152654330,antisense,-1,1447,chr2_152652883_152654330
H13,2,152669461,152708670,protein_coding,1,39209,chr2_152669461_152708670
Id1,2,152736251,152737410,protein_coding,1,1159,chr2_152736251_152737410
Cox4i2,2,152754173,152765037,protein_coding,1,10864,chr2_152754173_152765037
Bcl2l1,2,152780668,152831728,protein_coding,-1,51060,chr2_152780668_152831728
Tpx2,2,152847964,152895321,protein_coding,1,47357,chr2_152847964_152895321
Mylk2,2,152911352,152923068,protein_coding,1,11716,chr2_152911352_152923068
Foxs1,2,152931898,152933208,protein_coding,-1,1310,chr2_152931898_152933208
Dusp15,2,152940997,152951698,protein_coding,-1,10701,chr2_152940997_152951698
Ttll9,2,152962485,153008482,protein_coding,1,45997,chr2_152962485_153008482
Pdrg1,2,153008890,153015427,protein_coding,-1,6537,chr2_153008890_153015427
Xkr7,2,153031852,153055775,protein_coding,1,23923,chr2_153031852_153055775
Ccm2l,2,153065955,153081735,protein_coding,1,15780,chr2_153065955_153081735
Hck,2,153108468,153151441,protein_coding,1,42973,chr2_153108468_153151441
Tm9sf4,2,153161303,153210466,protein_coding,1,49163,chr2_153161303_153210466
Tspyl3,2,153222370,153225441,protein_coding,-1,3071,chr2_153222370_153225441
Plagl2,2,153227759,153241426,protein_coding,-1,13667,chr2_153227759_153241426
Pofut1,2,153241533,153270247,protein_coding,1,28714,chr2_153241533_153270247
Kif3b,2,153291413,153333390,protein_coding,1,41977,chr2_153291413_153333390
Asxl1,2,153345829,153404007,protein_coding,1,58178,chr2_153345829_153404007
Nol4l,2,153407462,153529971,protein_coding,-1,122509,chr2_153407462_153529971
4930404H24Rik,2,153492790,153493841,protein_coding,1,1051,chr2_153492790_153493841
Commd7,2,153616933,153632781,protein_coding,-1,15848,chr2_153616933_153632781
Dnmt3bos,2,153648690,153650286,antisense,-1,1596,chr2_153648690_153650286
Dnmt3b,2,153649450,153687730,protein_coding,1,38280,chr2_153649450_153687730
Dnmt3c,2,153696652,153729907,protein_coding,1,33255,chr2_153696652_153729907
Mapre1,2,153741274,153773310,protein_coding,1,32036,chr2_153741274_153773310
Efcab8,2,153779931,153844751,protein_coding,1,64820,chr2_153779931_153844751
Sun5,2,153856188,153871084,protein_coding,-1,14896,chr2_153856188_153871084
Bpifb2,2,153875045,153895270,protein_coding,1,20225,chr2_153875045_153895270
Bpifb4,2,153938221,153964101,protein_coding,1,25880,chr2_153938221_153964101
Bpifa6,2,153974945,154000495,protein_coding,1,25550,chr2_153974945_154000495
Bpifa2,2,154008265,154016079,protein_coding,1,7814,chr2_154008265_154016079
Bpifa3,2,154130336,154138356,protein_coding,1,8020,chr2_154130336_154138356
Bpifb1,2,154190818,154220369,protein_coding,1,29551,chr2_154190818_154220369
Bpifb5,2,154223742,154240902,protein_coding,1,17160,chr2_154223742_154240902
Bpifb9a,2,154257854,154271245,protein_coding,1,13391,chr2_154257854_154271245
Bpifb9b,2,154307227,154320646,protein_coding,1,13419,chr2_154307227_154320646
Cdk5rap1,2,154335380,154373010,protein_coding,-1,37630,chr2_154335380_154373010
Snta1,2,154376313,154408099,protein_coding,-1,31786,chr2_154376313_154408099
Cbfa2t2,2,154436481,154539356,protein_coding,1,102875,chr2_154436481_154539356
Necab3,2,154544399,154558890,protein_coding,-1,14491,chr2_154544399_154558890
1700003F12Rik,2,154547085,154550003,protein_coding,1,2918,chr2_154547085_154550003
Actl10,2,154551776,154553276,protein_coding,1,1500,chr2_154551776_154553276
E2f1,2,154559407,154569892,protein_coding,-1,10485,chr2_154559407_154569892
Pxmp4,2,154585758,154603708,protein_coding,-1,17950,chr2_154585758_154603708
4930519P11Rik,2,154611810,154613437,antisense,-1,1627,chr2_154611810_154613437
Zfp341,2,154613297,154646821,protein_coding,1,33524,chr2_154613297_154646821
Gm14198,2,154630002,154632636,antisense,-1,2634,chr2_154630002_154632636
Chmp4b,2,154651705,154694785,protein_coding,1,43080,chr2_154651705_154694785
Gm14216,2,154722352,154738451,lincRNA,-1,16099,chr2_154722352_154738451
Gm14214,2,154769255,154770030,protein_coding,-1,775,chr2_154769255_154770030
Raly,2,154791096,154867261,protein_coding,1,76165,chr2_154791096_154867261
a,2,154791402,155051012,protein_coding,1,259610,chr2_154791402_155051012
Eif2s2,2,154871410,154892935,protein_coding,-1,21525,chr2_154871410_154892935
Ahcy,2,155059310,155074497,protein_coding,-1,15187,chr2_155059310_155074497
Gm45609,2,155074181,155099510,antisense,1,25329,chr2_155074181_155099510
2310005A03Rik,2,155097789,155100081,lincRNA,-1,2292,chr2_155097789_155100081
Itch,2,155133509,155226855,protein_coding,1,93346,chr2_155133509_155226855
Dynlrb1,2,155236533,155250277,protein_coding,1,13744,chr2_155236533_155250277
Map1lc3a,2,155276297,155278073,protein_coding,1,1776,chr2_155276297_155278073
Pigu,2,155278243,155357430,protein_coding,-1,79187,chr2_155278243_155357430
Trp53inp2,2,155381059,155389850,protein_coding,1,8791,chr2_155381059_155389850
Ncoa6,2,155390656,155473894,protein_coding,-1,83238,chr2_155390656_155473894
Ggt7,2,155490379,155518237,protein_coding,-1,27858,chr2_155490379_155518237
Acss2,2,155517948,155585724,protein_coding,1,67776,chr2_155517948_155585724
Acss2os,2,155547040,155556930,antisense,-1,9890,chr2_155547040_155556930
Gss,2,155563181,155592810,protein_coding,-1,29629,chr2_155563181_155592810
Gssos2,2,155591131,155592851,antisense,1,1720,chr2_155591131_155592851
Gssos1,2,155592319,155594955,antisense,1,2636,chr2_155592319_155594955
Gm14257,2,155593565,155594475,antisense,-1,910,chr2_155593565_155594475
Myh7b,2,155611212,155634307,protein_coding,1,23095,chr2_155611212_155634307
Trpc4ap,2,155634271,155692384,protein_coding,-1,58113,chr2_155634271_155692384
Edem2,2,155701677,155729475,protein_coding,-1,27798,chr2_155701677_155729475
Procr,2,155751117,155755471,protein_coding,1,4354,chr2_155751117_155755471
Mmp24,2,155775342,155818366,protein_coding,1,43024,chr2_155775342_155818366
BC029722,2,155817730,155819426,protein_coding,-1,1696,chr2_155817730_155819426
Eif6,2,155819832,155826925,protein_coding,-1,7093,chr2_155819832_155826925
Gm16098,2,155826788,155827953,antisense,1,1165,chr2_155826788_155827953
Fam83c,2,155827548,155834854,protein_coding,-1,7306,chr2_155827548_155834854
Uqcc1,2,155846894,155930310,protein_coding,-1,83416,chr2_155846894_155930310
Gdf5,2,155941023,155945367,protein_coding,-1,4344,chr2_155941023_155945367
Cep250,2,155956458,155998900,protein_coding,1,42442,chr2_155956458_155998900
6430550D23Rik,2,155973279,156007977,protein_coding,-1,34698,chr2_155973279_156007977
Ergic3,2,156008045,156018279,protein_coding,1,10234,chr2_156008045_156018279
Fer1l4,2,156019139,156052947,protein_coding,-1,33808,chr2_156019139_156052947
Spag4,2,156065175,156070617,protein_coding,1,5442,chr2_156065175_156070617
Cpne1,2,156071842,156111965,protein_coding,-1,40123,chr2_156071842_156111965
Gm28036,2,156071845,156127092,protein_coding,-1,55247,chr2_156071845_156127092
Nfs1,2,156123639,156144186,protein_coding,-1,20547,chr2_156123639_156144186
Romo1,2,156144039,156145797,protein_coding,1,1758,chr2_156144039_156145797
Rbm39,2,156147239,156180238,protein_coding,-1,32999,chr2_156147239_156180238
Phf20,2,156196466,156309952,protein_coding,1,113486,chr2_156196466_156309952
Scand1,2,156311846,156312747,protein_coding,-1,901,chr2_156311846_156312747
Cnbd2,2,156312299,156375638,protein_coding,1,63339,chr2_156312299_156375638
Gm14252,2,156332317,156339381,antisense,-1,7064,chr2_156332317_156339381
2900097C17Rik,2,156388065,156392979,lincRNA,-1,4914,chr2_156388065_156392979
Epb41l1,2,156420909,156543214,protein_coding,1,122305,chr2_156420909_156543214
Gm14225,2,156445033,156447608,antisense,-1,2575,chr2_156445033_156447608
Gm14224,2,156451906,156455651,antisense,-1,3745,chr2_156451906_156455651
Aar2,2,156547584,156568972,protein_coding,1,21388,chr2_156547584_156568972
Gm14168,2,156571792,156577457,lincRNA,1,5665,chr2_156571792_156577457
Dlgap4,2,156613705,156764363,protein_coding,1,150658,chr2_156613705_156764363
Gm14174,2,156614447,156615448,lincRNA,-1,1001,chr2_156614447_156615448
Myl9,2,156775420,156781658,protein_coding,1,6238,chr2_156775420_156781658
Gm14230,2,156833049,156839892,lincRNA,-1,6843,chr2_156833049_156839892
Tgif2,2,156840007,156855570,protein_coding,1,15563,chr2_156840007_156855570
Sla2,2,156872457,156887192,protein_coding,-1,14735,chr2_156872457_156887192
Ndrg3,2,156927345,156992056,protein_coding,-1,64711,chr2_156927345_156992056
Dsn1,2,156995265,157007154,protein_coding,-1,11889,chr2_156995265_157007154
Soga1,2,157015799,157079254,protein_coding,-1,63455,chr2_157015799_157079254
Tldc2,2,157087055,157096482,protein_coding,1,9427,chr2_157087055_157096482
Samhd1,2,157097533,157135265,protein_coding,-1,37732,chr2_157097533_157135265
Rbl1,2,157145893,157204534,protein_coding,-1,58641,chr2_157145893_157204534
Mroh8,2,157208550,157279549,protein_coding,-1,70999,chr2_157208550_157279549
Rpn2,2,157279017,157326319,protein_coding,1,47302,chr2_157279017_157326319
Ghrh,2,157329497,157347506,protein_coding,-1,18009,chr2_157329497_157347506
Manbal,2,157367594,157396763,protein_coding,1,29169,chr2_157367594_157396763
Src,2,157418444,157471862,protein_coding,1,53418,chr2_157418444_157471862
Gm14286,2,157544266,157545469,antisense,-1,1203,chr2_157544266_157545469
Blcap,2,157556362,157571274,protein_coding,-1,14912,chr2_157556362_157571274
Nnat,2,157560078,157562522,protein_coding,1,2444,chr2_157560078_157562522
Ctnnbl1,2,157737401,157891614,protein_coding,1,154213,chr2_157737401_157891614
Vstm2l,2,157914653,157944719,protein_coding,1,30066,chr2_157914653_157944719
Tti1,2,157981803,158028433,protein_coding,-1,46630,chr2_157981803_158028433
Rprd1b,2,158028497,158132297,protein_coding,1,103800,chr2_158028497_158132297
2010009K17Rik,2,158070367,158091797,antisense,-1,21430,chr2_158070367_158091797
Tgm2,2,158116402,158146436,protein_coding,-1,30034,chr2_158116402_158146436
D630003M21Rik,2,158182533,158229222,protein_coding,-1,46689,chr2_158182533_158229222
1700060C20Rik,2,158192008,158195749,antisense,1,3741,chr2_158192008_158195749
Bpi,2,158258094,158284531,protein_coding,1,26437,chr2_158258094_158284531
Lbp,2,158306493,158332852,protein_coding,1,26359,chr2_158306493_158332852
Gm23925,2,158359797,158359929,lincRNA;snoRNA,-1,132,chr2_158359797_158359929
Snhg11,2,158375638,158386151,protein_coding,1,10513,chr2_158375638_158386151
Ralgapb,2,158409848,158499253,protein_coding,1,89405,chr2_158409848_158499253
Adig,2,158502612,158508198,protein_coding,1,5586,chr2_158502612_158508198
Arhgap40,2,158512796,158550762,protein_coding,1,37966,chr2_158512796_158550762
Slc32a1,2,158610767,158615748,protein_coding,1,4981,chr2_158610767_158615748
Gm14205,2,158610910,158611820,antisense,-1,910,chr2_158610910_158611820
Actr5,2,158624888,158639211,protein_coding,1,14323,chr2_158624888_158639211
Ppp1r16b,2,158665398,158766334,protein_coding,1,100936,chr2_158665398_158766334
Fam83d,2,158768093,158786637,protein_coding,1,18544,chr2_158768093_158786637
Dhx35,2,158794807,158858214,protein_coding,1,63407,chr2_158794807_158858214
Gm14223,2,159911773,159947376,lincRNA,-1,35603,chr2_159911773_159947376
9130015L21Rik,2,160016653,160040619,lincRNA,1,23966,chr2_160016653_160040619
Gm826,2,160311393,160334162,protein_coding,-1,22769,chr2_160311393_160334162
Mafb,2,160363703,160367065,protein_coding,-1,3362,chr2_160363703_160367065
Gm14221,2,160568379,160619971,lincRNA,-1,51592,chr2_160568379_160619971
Top1,2,160645888,160722764,protein_coding,1,76876,chr2_160645888_160722764
Plcg1,2,160731300,160775760,protein_coding,1,44460,chr2_160731300_160775760
Gm27206,2,160743927,160751909,antisense,-1,7982,chr2_160743927_160751909
Zhx3,2,160748708,160872998,protein_coding,-1,124290,chr2_160748708_160872998
Gm16751,2,160840836,160888028,antisense,-1,47192,chr2_160840836_160888028
Lpin3,2,160880670,160906002,protein_coding,1,25332,chr2_160880670_160906002
Emilin3,2,160906437,160912328,protein_coding,-1,5891,chr2_160906437_160912328
Gm14228,2,160925541,160926648,lincRNA,-1,1107,chr2_160925541_160926648
Chd6,2,160946978,161109075,protein_coding,-1,162097,chr2_160946978_161109075
Gm45447,2,161109411,161114858,antisense,1,5447,chr2_161109411_161114858
Gm14243,2,161179064,161216577,lincRNA,1,37513,chr2_161179064_161216577
Ptprt,2,161521990,162661147,protein_coding,-1,1139157,chr2_161521990_162661147
Ptprtos,2,162390813,162393945,antisense,1,3132,chr2_162390813_162393945
Gm14246,2,162679455,162680529,lincRNA,1,1074,chr2_162679455_162680529
Gm14255,2,162867079,162868194,lincRNA,-1,1115,chr2_162867079_162868194
Srsf6,2,162931528,162937121,protein_coding,1,5593,chr2_162931528_162937121
L3mbtl1,2,162943472,162974522,protein_coding,1,31050,chr2_162943472_162974522
Sgk2,2,162987330,163014127,protein_coding,1,26797,chr2_162987330_163014127
Ift52,2,163017354,163046141,protein_coding,1,28787,chr2_163017354_163046141
Mybl2,2,163054687,163084688,protein_coding,1,30001,chr2_163054687_163084688
Gm11454,2,163122606,163143959,lincRNA,1,21353,chr2_163122606_163143959
Gm14254,2,163152895,163156106,lincRNA,-1,3211,chr2_163152895_163156106
Tox2,2,163203125,163324170,protein_coding,1,121045,chr2_163203125_163324170
Jph2,2,163336242,163397993,protein_coding,-1,61751,chr2_163336242_163397993
Oser1,2,163405822,163424697,protein_coding,-1,18875,chr2_163405822_163424697
2900093K20Rik,2,163419795,163420361,antisense,1,566,chr2_163419795_163420361
Gdap1l1,2,163438476,163455324,protein_coding,1,16848,chr2_163438476_163455324
Fitm2,2,163466379,163472629,protein_coding,-1,6250,chr2_163466379_163472629
2310001K24Rik,2,163471957,163473005,antisense,1,1048,chr2_163471957_163473005
R3hdml,2,163492318,163502612,protein_coding,1,10294,chr2_163492318_163502612
Hnf4aos,2,163493807,163541720,antisense,-1,47913,chr2_163493807_163541720
Hnf4a,2,163506808,163572910,protein_coding,1,66102,chr2_163506808_163572910
Ttpal,2,163602314,163619013,protein_coding,1,16699,chr2_163602314_163619013
Serinc3,2,163623272,163645131,protein_coding,-1,21859,chr2_163623272_163645131
0610039K10Rik,2,163644850,163645801,antisense,1,951,chr2_163644850_163645801
Pkig,2,163658386,163726158,protein_coding,1,67772,chr2_163658386_163726158
Gm16316,2,163685004,163692279,antisense,-1,7275,chr2_163685004_163692279
Ada,2,163726584,163750239,protein_coding,-1,23655,chr2_163726584_163750239
Kcnk15,2,163853651,163859746,protein_coding,1,6095,chr2_163853651_163859746
Rims4,2,163859751,163918683,protein_coding,-1,58932,chr2_163859751_163918683
Ywhab,2,163994960,164018588,protein_coding,1,23628,chr2_163994960_164018588
Pabpc1l,2,164025450,164050538,protein_coding,1,25088,chr2_164025450_164050538
Tomm34,2,164053540,164071169,protein_coding,-1,17629,chr2_164053540_164071169
Stk4,2,164070322,164155524,protein_coding,1,85202,chr2_164070322_164155524
Kcns1,2,164163619,164171113,protein_coding,-1,7494,chr2_164163619_164171113
Wfdc5,2,164176327,164182742,protein_coding,-1,6415,chr2_164176327_164182742
A730032A03Rik,2,164177584,164196564,antisense,1,18980,chr2_164177584_164196564
Wfdc12,2,164189231,164190608,protein_coding,-1,1377,chr2_164189231_164190608
Wfdc15b,2,164214454,164221660,protein_coding,-1,7206,chr2_164214454_164221660
Svs4,2,164275952,164278459,protein_coding,-1,2507,chr2_164275952_164278459
Slpi,2,164354070,164389095,protein_coding,-1,35025,chr2_164354070_164389095
Matn4,2,164389393,164405160,protein_coding,-1,15767,chr2_164389393_164405160
Rbpjl,2,164403141,164415448,protein_coding,1,12307,chr2_164403141_164415448
Sdc4,2,164424247,164443887,protein_coding,-1,19640,chr2_164424247_164443887
Sys1,2,164456964,164479638,protein_coding,1,22674,chr2_164456964_164479638
Gm14302,2,164459896,164460955,antisense,-1,1059,chr2_164459896_164460955
Gm20458,2,164460967,164490760,protein_coding,1,29793,chr2_164460967_164490760
Trp53tg5,2,164470301,164473724,protein_coding,-1,3423,chr2_164470301_164473724
Dbndd2,2,164486106,164493319,protein_coding,1,7213,chr2_164486106_164493319
Pigt,2,164497520,164508301,protein_coding,1,10781,chr2_164497520_164508301
Gm14317,2,164550530,164559730,lincRNA,1,9200,chr2_164550530_164559730
Wfdc2,2,164562413,164568510,protein_coding,1,6097,chr2_164562413_164568510
Spint3,2,164569695,164573459,protein_coding,-1,3764,chr2_164569695_164573459
Eppin,2,164588343,164593594,protein_coding,-1,5251,chr2_164588343_164593594
Wfdc8,2,164596458,164613626,protein_coding,-1,17168,chr2_164596458_164613626
Wfdc9,2,164649631,164656583,protein_coding,-1,6952,chr2_164649631_164656583
Wfdc11,2,164662894,164674087,protein_coding,-1,11193,chr2_164662894_164674087
Spint4,2,164698501,164702453,protein_coding,1,3952,chr2_164698501_164702453
Wfdc3,2,164731180,164745931,protein_coding,-1,14751,chr2_164731180_164745931
Dnttip1,2,164745983,164768607,protein_coding,1,22624,chr2_164745983_164768607
Gm11457,2,164754242,164769666,antisense,-1,15424,chr2_164754242_164769666
Ube2c,2,164769898,164778822,protein_coding,1,8924,chr2_164769898_164778822
Tnnc2,2,164777161,164779967,protein_coding,-1,2806,chr2_164777161_164779967
Snx21,2,164785823,164793816,protein_coding,1,7993,chr2_164785823_164793816
Acot8,2,164792765,164804882,protein_coding,-1,12117,chr2_164792765_164804882
Zswim3,2,164805098,164822130,protein_coding,1,17032,chr2_164805098_164822130
Zswim1,2,164822686,164826871,protein_coding,1,4185,chr2_164822686_164826871
Spata25,2,164826389,164828537,protein_coding,-1,2148,chr2_164826389_164828537
Neurl2,2,164830732,164833456,protein_coding,-1,2724,chr2_164830732_164833456
Ctsa,2,164832873,164841032,protein_coding,1,8159,chr2_164832873_164841032
Pltp,2,164839518,164857711,protein_coding,-1,18193,chr2_164839518_164857711
Pcif1,2,164879304,164894454,protein_coding,1,15150,chr2_164879304_164894454
Zfp335,2,164891882,164911757,protein_coding,-1,19875,chr2_164891882_164911757
Zfp335os,2,164911354,164919953,antisense,1,8599,chr2_164911354_164919953
Mmp9,2,164940780,164955850,protein_coding,1,15070,chr2_164940780_164955850
Slc12a5,2,164960802,164999731,protein_coding,1,38929,chr2_164960802_164999731
Ncoa5,2,165000357,165034867,protein_coding,-1,34510,chr2_165000357_165034867
Cd40,2,165055627,165072948,protein_coding,1,17321,chr2_165055627_165072948
1700025C18Rik,2,165078693,165090750,protein_coding,-1,12057,chr2_165078693_165090750
Cdh22,2,165111507,165234853,protein_coding,-1,123346,chr2_165111507_165234853
Gm14397,2,165159412,165163969,antisense,1,4557,chr2_165159412_165163969
Slc35c2,2,165276554,165287869,protein_coding,-1,11315,chr2_165276554_165287869
Elmo2,2,165288031,165326479,protein_coding,-1,38448,chr2_165288031_165326479
Zfp663,2,165351297,165368729,protein_coding,-1,17432,chr2_165351297_165368729
Zfp334,2,165374264,165388259,protein_coding,-1,13995,chr2_165374264_165388259
Ocstamp,2,165393760,165400405,protein_coding,-1,6645,chr2_165393760_165400405
Slc13a3,2,165405028,165473230,protein_coding,-1,68202,chr2_165405028_165473230
Gm14437,2,165442264,165450485,antisense,1,8221,chr2_165442264_165450485
Trp53rka,2,165490110,165493324,protein_coding,-1,3214,chr2_165490110_165493324
Slc2a10,2,165503787,165519917,protein_coding,1,16130,chr2_165503787_165519917
Eya2,2,165595032,165771727,protein_coding,1,176695,chr2_165595032_165771727
Zmynd8,2,165784152,165899016,protein_coding,-1,114864,chr2_165784152_165899016
Gm11465,2,165880025,165882056,antisense,1,2031,chr2_165880025_165882056
Platr29,2,165976757,165985924,lincRNA,-1,9167,chr2_165976757_165985924
Gm11464,2,165980726,165992517,lincRNA,-1,11791,chr2_165980726_165992517
Ncoa3,2,165992636,166073242,protein_coding,1,80606,chr2_165992636_166073242
Sulf2,2,166073089,166155663,protein_coding,-1,82574,chr2_166073089_166155663
Gm11468,2,166273908,166294831,lincRNA,1,20923,chr2_166273908_166294831
Gm14268,2,166380828,166398187,lincRNA,-1,17359,chr2_166380828_166398187
5031425F14Rik,2,166447451,166459232,lincRNA,1,11781,chr2_166447451_166459232
Prex1,2,166566342,166713832,protein_coding,-1,147490,chr2_166566342_166713832
Trp53rkb,2,166792531,166799505,protein_coding,1,6974,chr2_166792531_166799505
Arfgef2,2,166805588,166898052,protein_coding,1,92464,chr2_166805588_166898052
Cse1l,2,166906040,166946389,protein_coding,1,40349,chr2_166906040_166946389
Stau1,2,166947549,166996299,protein_coding,-1,48750,chr2_166947549_166996299
Ddx27,2,167015193,167034947,protein_coding,1,19754,chr2_167015193_167034947
Znfx1,2,167035793,167063015,protein_coding,-1,27222,chr2_167035793_167063015
Kcnb1,2,167095969,167190155,protein_coding,-1,94186,chr2_167095969_167190155
Ptgis,2,167191805,167240604,protein_coding,-1,48799,chr2_167191805_167240604
Gm14291,2,167201576,167202799,antisense,1,1223,chr2_167201576_167202799
B4galt5,2,167298444,167349183,protein_coding,-1,50739,chr2_167298444_167349183
Slc9a8,2,167421712,167477000,protein_coding,1,55288,chr2_167421712_167477000
Spata2,2,167481133,167492887,protein_coding,-1,11754,chr2_167481133_167492887
Rnf114,2,167492645,167516173,protein_coding,1,23528,chr2_167492645_167516173
Snai1,2,167538195,167542814,protein_coding,1,4619,chr2_167538195_167542814
Ube2v1,2,167607638,167632095,protein_coding,-1,24457,chr2_167607638_167632095
Gm20431,2,167607850,167661496,protein_coding,-1,53646,chr2_167607850_167661496
Tmem189,2,167642608,167689822,protein_coding,-1,47214,chr2_167642608_167689822
Gm14320,2,167662109,167667697,antisense,1,5588,chr2_167662109_167667697
Cebpb,2,167688915,167690418,protein_coding,1,1503,chr2_167688915_167690418
A530013C23Rik,2,167691177,167729172,lincRNA,1,37995,chr2_167691177_167729172
Gm14321,2,167777467,167782569,lincRNA,1,5102,chr2_167777467_167782569
9230111E07Rik,2,167782053,167783486,lincRNA,1,1433,chr2_167782053_167783486
1200007C13Rik,2,167827693,167833646,lincRNA,-1,5953,chr2_167827693_167833646
Gm14319,2,167858585,167862542,lincRNA,1,3957,chr2_167858585_167862542
Ptpn1,2,167932057,167979385,protein_coding,1,47328,chr2_167932057_167979385
Ripor3,2,167980164,168010618,protein_coding,-1,30454,chr2_167980164_168010618
Pard6b,2,168081004,168101203,protein_coding,1,20199,chr2_168081004_168101203
Gm14235,2,168148017,168153533,lincRNA,-1,5516,chr2_168148017_168153533
E130018N17Rik,2,168152603,168154513,lincRNA,-1,1910,chr2_168152603_168154513
Gm20716,2,168180986,168230364,protein_coding,-1,49378,chr2_168180986_168230364
Dpm1,2,168209048,168230591,protein_coding,-1,21543,chr2_168209048_168230591
Mocs3,2,168230622,168232594,protein_coding,1,1972,chr2_168230622_168232594
Kcng1,2,168260117,168281736,protein_coding,-1,21619,chr2_168260117_168281736
Gm14262,2,168289019,168295121,lincRNA,-1,6102,chr2_168289019_168295121
Nfatc2,2,168476410,168601657,protein_coding,-1,125247,chr2_168476410_168601657
Atp9a,2,168634438,168742409,protein_coding,-1,107971,chr2_168634438_168742409
Sall4,2,168748332,168767943,protein_coding,-1,19611,chr2_168748332_168767943
Zfp64,2,168893331,168955587,protein_coding,-1,62256,chr2_168893331_168955587
Gm14260,2,168986566,168987373,lincRNA,-1,807,chr2_168986566_168987373
Gm9873,2,169020025,169021385,lincRNA,1,1360,chr2_169020025_169021385
Gm14258,2,169106453,169110415,lincRNA,1,3962,chr2_169106453_169110415
9430093N23Rik,2,169234991,169237770,lincRNA,1,2779,chr2_169234991_169237770
Gm14250,2,169389081,169395524,lincRNA,1,6443,chr2_169389081_169395524
4930529I22Rik,2,169399145,169405450,lincRNA,-1,6305,chr2_169399145_169405450
Gm14249,2,169480617,169504843,lincRNA,1,24226,chr2_169480617_169504843
Gm11011,2,169582845,169587745,protein_coding,-1,4900,chr2_169582845_169587745
Tshz2,2,169633013,170071816,protein_coding,1,438803,chr2_169633013_170071816
Zfp217,2,170108643,170148103,protein_coding,-1,39460,chr2_170108643_170148103
Bcas1,2,170346991,170427845,protein_coding,-1,80854,chr2_170346991_170427845
Bcas1os2,2,170356361,170380435,antisense,1,24074,chr2_170356361_170380435
Cyp24a1,2,170482708,170497145,protein_coding,-1,14437,chr2_170482708_170497145
Pfdn4,2,170496428,170519123,protein_coding,1,22695,chr2_170496428_170519123
Gm16796,2,170499357,170511927,antisense,-1,12570,chr2_170499357_170511927
Gm14637,2,170576054,170578424,antisense,1,2370,chr2_170576054_170578424
4930470P17Rik,2,170579418,170602017,protein_coding,-1,22599,chr2_170579418_170602017
Gm14264,2,170652434,170662465,lincRNA,-1,10031,chr2_170652434_170662465
Dok5,2,170731807,170879769,protein_coding,1,147962,chr2_170731807_170879769
Gm14266,2,171193269,171271350,lincRNA,1,78081,chr2_171193269_171271350
Gm14641,2,171995941,172003995,lincRNA,-1,8054,chr2_171995941_172003995
Cbln4,2,172036233,172043466,protein_coding,-1,7233,chr2_172036233_172043466
Gm14271,2,172046526,172050134,antisense,1,3608,chr2_172046526_172050134
Mc3r,2,172248492,172251114,protein_coding,1,2622,chr2_172248492_172251114
Gm14273,2,172324334,172338663,antisense,1,14329,chr2_172324334_172338663
Fam210b,2,172345565,172355749,protein_coding,1,10184,chr2_172345565_172355749
Aurka,2,172356190,172370535,protein_coding,-1,14345,chr2_172356190_172370535
Cstf1,2,172370681,172382448,protein_coding,1,11767,chr2_172370681_172382448
Cass4,2,172393794,172433757,protein_coding,1,39963,chr2_172393794_172433757
Gm14455,2,172425804,172440560,antisense,-1,14756,chr2_172425804_172440560
Rtf2,2,172440556,172469908,protein_coding,1,29352,chr2_172440556_172469908
Gcnt7,2,172450313,172458596,protein_coding,-1,8283,chr2_172450313_172458596
Fam209,2,172472520,172474331,protein_coding,1,1811,chr2_172472520_172474331
Tfap2c,2,172549593,172558622,protein_coding,1,9029,chr2_172549593_172558622
Bmp7,2,172868012,172940321,protein_coding,-1,72309,chr2_172868012_172940321
Spo11,2,172977700,172993576,protein_coding,1,15876,chr2_172977700_172993576
Rae1,2,173000117,173015739,protein_coding,1,15622,chr2_173000117_173015739
Rbm38,2,173020498,173034734,protein_coding,1,14236,chr2_173020498_173034734
Gm14453,2,173025685,173034580,antisense,-1,8895,chr2_173025685_173034580
Ctcfl,2,173093609,173119525,protein_coding,-1,25916,chr2_173093609_173119525
Ctcflos,2,173110818,173133204,antisense,1,22386,chr2_173110818_173133204
Pck1,2,173153048,173159273,protein_coding,1,6225,chr2_173153048_173159273
Zbp1,2,173206612,173218923,protein_coding,-1,12311,chr2_173206612_173218923
Pmepa1,2,173224458,173276533,protein_coding,-1,52075,chr2_173224458_173276533
Pmepa1os,2,173276698,173278428,antisense,1,1730,chr2_173276698_173278428
1700021F07Rik,2,173522586,173528501,protein_coding,1,5915,chr2_173522586_173528501
Rab22a,2,173659760,173707343,protein_coding,1,47583,chr2_173659760_173707343
1700010B08Rik,2,173719415,173722089,protein_coding,1,2674,chr2_173719415_173722089
Vapb,2,173737511,173784339,protein_coding,1,46828,chr2_173737511_173784339
Stx16,2,174076308,174099771,protein_coding,1,23463,chr2_174076308_174099771
Npepl1,2,174110349,174123070,protein_coding,1,12721,chr2_174110349_174123070
Gm10714,2,174125038,174183918,antisense,-1,58880,chr2_174125038_174183918
Gnas,2,174284320,174346744,protein_coding,1,62424,chr2_174284320_174346744
Gm20721,2,174330319,174346712,protein_coding,-1,16393,chr2_174330319_174346712
Nelfcd,2,174415804,174427502,protein_coding,1,11698,chr2_174415804_174427502
Ctsz,2,174427493,174439039,protein_coding,-1,11546,chr2_174427493_174439039
Tubb1,2,174450695,174457882,protein_coding,1,7187,chr2_174450695_174457882
Atp5e,2,174461072,174464105,protein_coding,-1,3033,chr2_174461072_174464105
Prelid3b,2,174465067,174473081,protein_coding,-1,8014,chr2_174465067_174473081
Zfp831,2,174643534,174710832,protein_coding,1,67298,chr2_174643534_174710832
Edn3,2,174760619,174784042,protein_coding,1,23423,chr2_174760619_174784042
Gm14618,2,174842305,174853357,lincRNA,-1,11052,chr2_174842305_174853357
Gm14616,2,174856289,174866531,lincRNA,1,10242,chr2_174856289_174866531
Gm14444,2,175010241,175019248,protein_coding,1,9007,chr2_175010241_175019248
Gm14393,2,175061549,175067781,protein_coding,-1,6232,chr2_175061549_175067781
Gm14399,2,175129493,175142012,protein_coding,-1,12519,chr2_175129493_175142012
Gm14443,2,175166255,175175871,protein_coding,-1,9616,chr2_175166255_175175871
Gm14391,2,175191065,175206917,protein_coding,-1,15852,chr2_175191065_175206917
Gm14440,2,175275125,175286805,protein_coding,1,11680,chr2_175275125_175286805
Gm4631,2,175321955,175338197,protein_coding,-1,16242,chr2_175321955_175338197
Gm2007,2,175741537,175751419,protein_coding,1,9882,chr2_175741537_175751419
Gm14288,2,175789357,175801093,protein_coding,-1,11736,chr2_175789357_175801093
Gm6710,2,175869219,175881248,protein_coding,1,12029,chr2_175869219_175881248
Zfp966,2,175918881,175931100,protein_coding,-1,12219,chr2_175918881_175931100
Gm2026,2,175965331,175980303,protein_coding,1,14972,chr2_175965331_175980303
Gm11008,2,176097450,176100706,lincRNA,1,3256,chr2_176097450_176100706
2210418O10Rik,2,176226569,176240328,protein_coding,1,13759,chr2_176226569_176240328
Gm14434,2,176473278,176486783,protein_coding,-1,13505,chr2_176473278_176486783
Gm14308,2,176613364,176636344,protein_coding,-1,22980,chr2_176613364_176636344
Zfp973,2,176670522,176719085,protein_coding,1,48563,chr2_176670522_176719085
Gm14305,2,176708328,176721813,protein_coding,1,13485,chr2_176708328_176721813
Gm14295,2,176798612,176811223,protein_coding,1,12611,chr2_176798612_176811223
Gm14408,2,176831140,176836730,protein_coding,1,5590,chr2_176831140_176836730
Gm14296,2,176892509,176927809,protein_coding,-1,35300,chr2_176892509_176927809
Gm14419,2,177000956,177012787,protein_coding,1,11831,chr2_177000956_177012787
Gm14401,2,177074320,177087347,protein_coding,1,13027,chr2_177074320_177087347
Gm14410,2,177183453,177206421,protein_coding,-1,22968,chr2_177183453_177206421
Gm14409,2,177264654,177267036,protein_coding,-1,2382,chr2_177264654_177267036
Gm14412,2,177314520,177324307,protein_coding,-1,9787,chr2_177314520_177324307
Gm14418,2,177387124,177398320,protein_coding,-1,11196,chr2_177387124_177398320
Zfp970,2,177464733,177478129,protein_coding,1,13396,chr2_177464733_177478129
Gm14403,2,177498215,177509763,protein_coding,1,11548,chr2_177498215_177509763
Gm14406,2,177569204,177578210,protein_coding,-1,9006,chr2_177569204_177578210
Gm14322,2,177759288,177770472,protein_coding,1,11184,chr2_177759288_177770472
Gm14325,2,177831791,177840336,protein_coding,-1,8545,chr2_177831791_177840336
Gm14327,2,177897096,177905784,protein_coding,1,8688,chr2_177897096_177905784
Zfp972,2,177903340,177925613,protein_coding,-1,22273,chr2_177903340_177925613
Gm14326,2,177935993,177957297,protein_coding,-1,21304,chr2_177935993_177957297
Zfp971,2,178023284,178034022,protein_coding,1,10738,chr2_178023284_178034022
Zfp931,2,178067695,178078476,protein_coding,-1,10781,chr2_178067695_178078476
Phactr3,2,178118975,178338492,protein_coding,1,219517,chr2_178118975_178338492
Sycp2,2,178345293,178407685,protein_coding,-1,62392,chr2_178345293_178407685
Ppp1r3d,2,178411206,178414472,protein_coding,-1,3266,chr2_178411206_178414472
Fam217b,2,178414524,178424428,protein_coding,1,9904,chr2_178414524_178424428
Cdh26,2,178430531,178487366,protein_coding,1,56835,chr2_178430531_178487366
Cdh4,2,179442431,179899373,protein_coding,1,456942,chr2_179442431_179899373
Taf4,2,179912152,179976646,protein_coding,-1,64494,chr2_179912152_179976646
Lsm14b,2,180024987,180035465,protein_coding,1,10478,chr2_180024987_180035465
Psma7,2,180036374,180042433,protein_coding,-1,6059,chr2_180036374_180042433
Ss18l1,2,180042509,180070201,protein_coding,1,27692,chr2_180042509_180070201
Mtg2,2,180070588,180085902,protein_coding,1,15314,chr2_180070588_180085902
Hrh3,2,180099465,180104488,protein_coding,-1,5023,chr2_180099465_180104488
Gm17180,2,180099913,180101502,antisense,1,1589,chr2_180099913_180101502
Osbpl2,2,180119306,180162680,protein_coding,1,43374,chr2_180119306_180162680
Adrm1,2,180171485,180176286,protein_coding,1,4801,chr2_180171485_180176286
Lama5,2,180176373,180225859,protein_coding,-1,49486,chr2_180176373_180225859
Rps21,2,180257377,180258445,protein_coding,1,1068,chr2_180257377_180258445
Cables2,2,180258540,180273496,protein_coding,-1,14956,chr2_180258540_180273496
Gata5,2,180325133,180334699,protein_coding,-1,9566,chr2_180325133_180334699
B230312C02Rik,2,180370491,180385885,lincRNA,-1,15394,chr2_180370491_180385885
Slco4a1,2,180456245,180474867,protein_coding,1,18622,chr2_180456245_180474867
Ntsr1,2,180499976,180544980,protein_coding,1,45004,chr2_180499976_180544980
Mrgbp,2,180581304,180586304,protein_coding,1,5000,chr2_180581304_180586304
Ogfr,2,180589245,180595836,protein_coding,1,6591,chr2_180589245_180595836
Col9a3,2,180597790,180622189,protein_coding,1,24399,chr2_180597790_180622189
Tcfl5,2,180621956,180642708,protein_coding,-1,20752,chr2_180621956_180642708
Dido1,2,180657964,180709999,protein_coding,-1,52035,chr2_180657964_180709999
Gid8,2,180710117,180718733,protein_coding,1,8616,chr2_180710117_180718733
Slc17a9,2,180725263,180742280,protein_coding,1,17017,chr2_180725263_180742280
Gm14340,2,180818343,180824630,lincRNA,-1,6287,chr2_180818343_180824630
Gm14342,2,180829490,180889660,lincRNA,-1,60170,chr2_180829490_180889660
Gm14344,2,180836481,180848914,lincRNA,1,12433,chr2_180836481_180848914
Gm27032,2,180894105,180895220,lincRNA,1,1115,chr2_180894105_180895220
Ythdf1,2,180904377,180920949,protein_coding,-1,16572,chr2_180904377_180920949
Birc7,2,180929023,180934010,protein_coding,1,4987,chr2_180929023_180934010
Nkain4,2,180934772,180954699,protein_coding,-1,19927,chr2_180934772_180954699
Gm14341,2,180954464,180966812,antisense,1,12348,chr2_180954464_180966812
Arfgap1,2,180967225,180982526,protein_coding,1,15301,chr2_180967225_180982526
Col20a1,2,180986535,181018363,protein_coding,1,31828,chr2_180986535_181018363
Chrna4,2,181018380,181043546,protein_coding,-1,25166,chr2_181018380_181043546
Kcnq2,2,181075579,181135300,protein_coding,-1,59721,chr2_181075579_181135300
Eef1a2,2,181147653,181157014,protein_coding,-1,9361,chr2_181147653_181157014
Ppdpf,2,181187247,181188771,protein_coding,1,1524,chr2_181187247_181188771
Ptk6,2,181193721,181202789,protein_coding,-1,9068,chr2_181193721_181202789
Srms,2,181205562,181213185,protein_coding,-1,7623,chr2_181205562_181213185
Helz2,2,181227615,181242027,protein_coding,-1,14412,chr2_181227615_181242027
Gmeb2,2,181251449,181288035,protein_coding,-1,36586,chr2_181251449_181288035
Stmn3,2,181306459,181314500,protein_coding,-1,8041,chr2_181306459_181314500
Rtel1,2,181319739,181356616,protein_coding,1,36877,chr2_181319739_181356616
Arfrp1,2,181357690,181365404,protein_coding,-1,7714,chr2_181357690_181365404
Zgpat,2,181364928,181383628,protein_coding,1,18700,chr2_181364928_181383628
Zbtb46,2,181387762,181459426,protein_coding,-1,71664,chr2_181387762_181459426
Tpd52l2,2,181497142,181517966,protein_coding,1,20824,chr2_181497142_181517966
Dnajc5,2,181520485,181555133,protein_coding,1,34648,chr2_181520485_181555133
Uckl1,2,181569149,181584892,protein_coding,-1,15743,chr2_181569149_181584892
Uckl1os,2,181578480,181585170,antisense,1,6690,chr2_181578480_181585170
Zfp512b,2,181582103,181592803,protein_coding,-1,10700,chr2_181582103_181592803
Prpf6,2,181591868,181655660,protein_coding,1,63792,chr2_181591868_181655660
Samd10,2,181595218,181599212,protein_coding,-1,3994,chr2_181595218_181599212
Gm29797,2,181657034,181659467,protein_coding,1,2433,chr2_181657034_181659467
Sox18,2,181669836,181671640,protein_coding,-1,1804,chr2_181669836_181671640
Tcea2,2,181680310,181688071,protein_coding,1,7761,chr2_181680310_181688071
Rgs19,2,181688419,181693977,protein_coding,-1,5558,chr2_181688419_181693977
Lkaaear1,2,181696793,181698442,protein_coding,-1,1649,chr2_181696793_181698442
Oprl1,2,181715016,181720985,protein_coding,1,5969,chr2_181715016_181720985
Myt1,2,181763332,181827797,protein_coding,1,64465,chr2_181763332_181827797
Pcmtd2,2,181837854,181857461,protein_coding,1,19607,chr2_181837854_181857461
Polr3k,2,181864337,181870830,protein_coding,1,6493,chr2_181864337_181870830
Gm14496,2,181991129,182003861,protein_coding,1,12732,chr2_181991129_182003861
Nudt11,X,6047453,6055110,protein_coding,1,7657,chrX_6047453_6055110
AU022751,X,6081219,6083419,protein_coding,-1,2200,chrX_6081219_6083419
Nudt10,X,6168696,6173015,protein_coding,-1,4319,chrX_6168696_6173015
Bmp15,X,6314107,6320721,protein_coding,-1,6614,chrX_6314107_6320721
Shroom4,X,6399854,6637448,protein_coding,1,237594,chrX_6399854_6637448
Dgkk,X,6779049,6948363,protein_coding,1,169314,chrX_6779049_6948363
Ccnb3,X,6933837,7041619,protein_coding,-1,107782,chrX_6933837_7041619
Clcn5,X,7153810,7319358,protein_coding,-1,165548,chrX_7153810_7319358
Usp27x,X,7371274,7375830,protein_coding,-1,4556,chrX_7371274_7375830
Ppp1r3f,X,7557296,7574283,protein_coding,-1,16987,chrX_7557296_7574283
Flicr,X,7573600,7581027,antisense,1,7427,chrX_7573600_7581027
Foxp3,X,7573644,7595245,protein_coding,1,21601,chrX_7573644_7595245
Ccdc22,X,7593809,7605517,protein_coding,-1,11708,chrX_7593809_7605517
Cacna1f,X,7607083,7635196,protein_coding,1,28113,chrX_7607083_7635196
Syp,X,7638471,7653256,protein_coding,1,14785,chrX_7638471_7653256
Gm14703,X,7651106,7657258,antisense,-1,6152,chrX_7651106_7657258
Prickle3,X,7657260,7668186,protein_coding,1,10926,chrX_7657260_7668186
Plp2,X,7667941,7671390,protein_coding,-1,3449,chrX_7667941_7671390
Magix,X,7673164,7681251,protein_coding,-1,8087,chrX_7673164_7681251
Gpkow,X,7697131,7710262,protein_coding,1,13131,chrX_7697131_7710262
Wdr45,X,7714333,7728206,protein_coding,1,13873,chrX_7714333_7728206
Gm45208,X,7722245,7730530,protein_coding,1,8285,chrX_7722245_7730530
Praf2,X,7728439,7731064,protein_coding,1,2625,chrX_7728439_7731064
Ccdc120,X,7731714,7750905,protein_coding,-1,19191,chrX_7731714_7750905
Tfe3,X,7762560,7775202,protein_coding,1,12642,chrX_7762560_7775202
Gripap1,X,7789765,7820567,protein_coding,1,30802,chrX_7789765_7820567
Kcnd1,X,7822289,7838280,protein_coding,1,15991,chrX_7822289_7838280
Otud5,X,7841364,7876626,protein_coding,1,35262,chrX_7841364_7876626
Pim2,X,7878262,7883432,protein_coding,1,5170,chrX_7878262_7883432
Slc35a2,X,7884028,7894492,protein_coding,1,10464,chrX_7884028_7894492
Pqbp1,X,7894519,7899269,protein_coding,-1,4750,chrX_7894519_7899269
Timm17b,X,7899357,7908351,protein_coding,1,8994,chrX_7899357_7908351
Gm10490,X,7909542,7909927,protein_coding,1,385,chrX_7909542_7909927
Pcsk1n,X,7919822,7924410,protein_coding,1,4588,chrX_7919822_7924410
Eras,X,7924276,7928607,protein_coding,-1,4331,chrX_7924276_7928607
Hdac6,X,7930120,7947889,protein_coding,-1,17769,chrX_7930120_7947889
Gata1,X,7959260,7978071,protein_coding,-1,18811,chrX_7959260_7978071
Glod5,X,8004200,8018492,protein_coding,-1,14292,chrX_8004200_8018492
Gm14820,X,8042943,8074619,antisense,1,31676,chrX_8042943_8074619
Suv39h1,X,8061171,8074760,protein_coding,-1,13589,chrX_8061171_8074760
Was,X,8081453,8090498,protein_coding,-1,9045,chrX_8081453_8090498
Wdr13,X,8123301,8132892,protein_coding,-1,9591,chrX_8123301_8132892
Rbm3,X,8138975,8145880,protein_coding,-1,6905,chrX_8138975_8145880
Rbm3os,X,8145429,8147964,antisense,1,2535,chrX_8145429_8147964
Tbc1d25,X,8154472,8176181,protein_coding,-1,21709,chrX_8154472_8176181
Ebp,X,8185329,8193512,protein_coding,-1,8183,chrX_8185329_8193512
Porcn,X,8193848,8206525,protein_coding,-1,12677,chrX_8193848_8206525
Ftsj1,X,8238668,8252406,protein_coding,-1,13738,chrX_8238668_8252406
Slc38a5,X,8271133,8280179,protein_coding,1,9046,chrX_8271133_8280179
Ssxb2,X,8454345,8461726,protein_coding,-1,7381,chrX_8454345_8461726
Gm14459,X,8514052,8524954,protein_coding,-1,10902,chrX_8514052_8524954
Ssxb3,X,8583404,8591816,protein_coding,-1,8412,chrX_8583404_8591816
Ssx9,X,8748432,8754587,protein_coding,1,6155,chrX_8748432_8754587
Ssxb5,X,8803691,8809386,protein_coding,1,5695,chrX_8803691_8809386
Gm6592,X,8843994,8849607,protein_coding,1,5613,chrX_8843994_8849607
Gm5751,X,8874253,8880750,protein_coding,1,6497,chrX_8874253_8880750
B630019K06Rik,X,8892382,8894964,protein_coding,1,2582,chrX_8892382_8894964
Lancl3,X,9199902,9268085,protein_coding,1,68183,chrX_9199902_9268085
Gm14862,X,9250928,9256899,protein_coding,-1,5971,chrX_9250928_9256899
Xk,X,9272756,9313250,protein_coding,1,40494,chrX_9272756_9313250
Cybb,X,9435252,9487771,protein_coding,-1,52519,chrX_9435252_9487771
H2al1o,X,9571901,9572409,protein_coding,-1,508,chrX_9571901_9572409
Dynlt3,X,9654267,9663003,protein_coding,-1,8736,chrX_9654267_9663003
Sytl5,X,9885622,9994543,protein_coding,1,108921,chrX_9885622_9994543
Srpx,X,10037977,10117709,protein_coding,-1,79732,chrX_10037977_10117709
Rpgr,X,10073621,10216920,protein_coding,-1,143299,chrX_10073621_10216920
Otc,X,10252305,10321024,protein_coding,1,68719,chrX_10252305_10321024
Tspan7,X,10485158,10596605,protein_coding,1,111447,chrX_10485158_10596605
Mid1ip1,X,10715013,10719690,protein_coding,1,4677,chrX_10715013_10719690
Gm14493,X,10717473,10718710,antisense,-1,1237,chrX_10717473_10718710
Bcor,X,12036740,12160355,protein_coding,-1,123615,chrX_12036740_12160355
Gm14635,X,12339782,12354996,lincRNA,-1,15214,chrX_12339782_12354996
Atp6ap2,X,12587801,12617049,protein_coding,1,29248,chrX_12587801_12617049
1810030O07Rik,X,12654879,12673668,protein_coding,-1,18789,chrX_12654879_12673668
Med14,X,12675369,12762073,protein_coding,-1,86704,chrX_12675369_12762073
Usp9x,X,13071498,13173328,protein_coding,1,101830,chrX_13071498_13173328
2010308F09Rik,X,13234641,13247736,lincRNA,-1,13095,chrX_13234641_13247736
Ddx3x,X,13280970,13294052,protein_coding,1,13082,chrX_13280970_13294052
Nyx,X,13466110,13489313,protein_coding,1,23203,chrX_13466110_13489313
Cask,X,13517080,13851367,protein_coding,-1,334287,chrX_13517080_13851367
Gpr34,X,13632089,13640858,protein_coding,1,8769,chrX_13632089_13640858
Gpr82,X,13661363,13667433,protein_coding,1,6070,chrX_13661363_13667433
Gm14505,X,14796735,14839980,lincRNA,1,43245,chrX_14796735_14839980
Drr1,X,15922304,15939249,lincRNA,-1,16945,chrX_15922304_15939249
Maoa,X,16619698,16687818,protein_coding,1,68120,chrX_16619698_16687818
Maob,X,16709282,16817366,protein_coding,-1,108084,chrX_16709282_16817366
Ndp,X,16885521,16911774,protein_coding,-1,26253,chrX_16885521_16911774
Efhc2,X,17132049,17319368,protein_coding,-1,187319,chrX_17132049_17319368
Fundc1,X,17556564,17572325,protein_coding,-1,15761,chrX_17556564_17572325
Kdm6a,X,18162575,18279936,protein_coding,1,117361,chrX_18162575_18279936
Gm26652,X,19224789,19237856,lincRNA,-1,13067,chrX_19224789_19237856
Tex13c3,X,19479420,19481319,protein_coding,-1,1899,chrX_19479420_19481319
Chst7,X,20059560,20097521,protein_coding,1,37961,chrX_20059560_20097521
Slc9a7,X,20105754,20291807,protein_coding,-1,186053,chrX_20105754_20291807
Rp2,X,20364481,20405653,protein_coding,1,41172,chrX_20364481_20405653
Jade3,X,20425688,20519939,protein_coding,1,94251,chrX_20425688_20519939
Rgn,X,20549787,20562089,protein_coding,1,12302,chrX_20549787_20562089
Ndufb11,X,20615326,20617619,protein_coding,-1,2293,chrX_20615326_20617619
Rbm10,X,20617503,20650901,protein_coding,1,33398,chrX_20617503_20650901
Uba1,X,20658326,20683179,protein_coding,1,24853,chrX_20658326_20683179
Cdk16,X,20687954,20699880,protein_coding,1,11926,chrX_20687954_20699880
Usp11,X,20703906,20720539,protein_coding,1,16633,chrX_20703906_20720539
Araf,X,20797814,20860519,protein_coding,1,62705,chrX_20797814_20860519
Syn1,X,20860511,20921004,protein_coding,-1,60493,chrX_20860511_20921004
Timp1,X,20870166,20874735,protein_coding,1,4569,chrX_20870166_20874735
Cfp,X,20925454,20931555,protein_coding,-1,6101,chrX_20925454_20931555
Elk1,X,20933395,20950608,protein_coding,-1,17213,chrX_20933395_20950608
Uxt,X,20941722,20962017,protein_coding,-1,20295,chrX_20941722_20962017
Zfp182,X,21028939,21062316,protein_coding,-1,33377,chrX_21028939_21062316
Spaca5,X,21068406,21077963,protein_coding,1,9557,chrX_21068406_21077963
Zfp300,X,21079174,21089527,protein_coding,-1,10353,chrX_21079174_21089527
Ssxa1,X,21115820,21121192,protein_coding,1,5372,chrX_21115820_21121192
4930453H23Rik,X,21206580,21221665,lincRNA,-1,15085,chrX_21206580_21221665
Gm6938,X,21312210,21334727,lincRNA,-1,22517,chrX_21312210_21334727
Agtr2,X,21484544,21489164,protein_coding,1,4620,chrX_21484544_21489164
Slc6a14,X,21714896,21742355,protein_coding,1,27459,chrX_21714896_21742355
Gm28268,X,21751379,21761733,lincRNA,1,10354,chrX_21751379_21761733
Klhl13,X,23219271,23365082,protein_coding,-1,145811,chrX_23219271_23365082
Wdr44,X,23693051,23806025,protein_coding,1,112974,chrX_23693051_23806025
Gm4907,X,23882553,23907607,protein_coding,1,25054,chrX_23882553_23907607
Gm5934,X,24474308,24500760,protein_coding,-1,26452,chrX_24474308_24500760
Gm4297,X,24552250,24574895,protein_coding,-1,22645,chrX_24552250_24574895
Gm5935,X,24753162,24775164,protein_coding,-1,22002,chrX_24753162_24775164
Gm5169,X,25277483,25301455,protein_coding,-1,23972,chrX_25277483_25301455
E330010L02Rik,X,25917944,25954696,lincRNA,-1,36752,chrX_25917944_25954696
Gm2012,X,26200678,26231355,protein_coding,-1,30677,chrX_26200678_26231355
Gm2030,X,26286977,26310044,protein_coding,-1,23067,chrX_26286977_26310044
Slx,X,26522656,26545565,protein_coding,-1,22909,chrX_26522656_26545565
Gm14525,X,26672777,26702638,protein_coding,-1,29861,chrX_26672777_26702638
Gm6121,X,26912743,26935697,protein_coding,-1,22954,chrX_26912743_26935697
Gm2101,X,27658161,27692894,lincRNA,1,34733,chrX_27658161_27692894
Gm2117,X,28005050,28047399,lincRNA,1,42349,chrX_28005050_28047399
Gm4836,X,28270710,28293632,protein_coding,-1,22922,chrX_28270710_28293632
Gm2200,X,29012994,29046381,lincRNA;lncRNA,1,33387,chrX_29012994_29046381
Gm3669,X,29881290,29916031,lincRNA,-1,34741,chrX_29881290_29916031
E330016L19Rik,X,30037837,30087879,lincRNA,1,50042,chrX_30037837_30087879
Gm7437,X,30373539,30422500,lincRNA,1,48961,chrX_30373539_30422500
Gm14974,X,30587056,30621275,lincRNA,-1,34219,chrX_30587056_30621275
Gm10487,X,30820542,30843469,protein_coding,-1,22927,chrX_30820542_30843469
Gm10486,X,35067384,35090316,protein_coding,1,22932,chrX_35067384_35090316
Gm2309,X,35129015,35179028,lincRNA,1,50013,chrX_35129015_35179028
Gm14553,X,35294189,35348739,lincRNA,-1,54550,chrX_35294189_35348739
Gm14819,X,35404183,35427093,protein_coding,1,22910,chrX_35404183_35427093
Dock11,X,35888832,36076562,protein_coding,1,187730,chrX_35888832_36076562
Il13ra1,X,36112110,36171259,protein_coding,1,59149,chrX_36112110_36171259
Zcchc12,X,36195904,36199158,protein_coding,1,3254,chrX_36195904_36199158
Lonrf3,X,36328353,36362341,protein_coding,1,33988,chrX_36328353_36362341
Gm14569,X,36423601,36491830,protein_coding,-1,68229,chrX_36423601_36491830
Pgrmc1,X,36598206,36606079,protein_coding,1,7873,chrX_36598206_36606079
Akap17b,X,36608314,36645395,protein_coding,-1,37081,chrX_36608314_36645395
Slc25a43,X,36743659,36777202,protein_coding,1,33543,chrX_36743659_36777202
Slc25a5,X,36795651,36798807,protein_coding,1,3156,chrX_36795651_36798807
Gm14549,X,36814771,36817200,antisense,1,2429,chrX_36814771_36817200
C330007P06Rik,X,36823737,36874111,protein_coding,-1,50374,chrX_36823737_36874111
Ube2a,X,36873900,36884222,protein_coding,1,10322,chrX_36873900_36884222
Nkrf,X,36887540,36903513,protein_coding,-1,15973,chrX_36887540_36903513
Gm15008,X,36910834,36911985,antisense,1,1151,chrX_36910834_36911985
Rpl39,X,37082520,37085402,protein_coding,-1,2882,chrX_37082520_37085402
Upf3b,X,37091678,37110322,protein_coding,-1,18644,chrX_37091678_37110322
Nkap,X,37126795,37150746,protein_coding,1,23951,chrX_37126795_37150746
Akap14,X,37150698,37168842,protein_coding,-1,18144,chrX_37150698_37168842
Ndufa1,X,37187588,37191163,protein_coding,-1,3575,chrX_37187588_37191163
Rnf113a1,X,37191245,37192467,protein_coding,1,1222,chrX_37191245_37192467
Rhox1,X,37213804,37222258,protein_coding,-1,8454,chrX_37213804_37222258
Rhox4a2,X,37390848,37395621,protein_coding,1,4773,chrX_37390848_37395621
Rhox4b,X,37432494,37437279,protein_coding,1,4785,chrX_37432494_37437279
Rhox4d,X,37514359,37519176,protein_coding,1,4817,chrX_37514359_37519176
Rhox2e,X,37530452,37541813,protein_coding,1,11361,chrX_37530452_37541813
Rhox2f,X,37571405,37576163,protein_coding,1,4758,chrX_37571405_37576163
Rhox2h,X,37668989,37673277,protein_coding,-1,4288,chrX_37668989_37673277
Rhox8,X,37782002,37878944,protein_coding,-1,96942,chrX_37782002_37878944
Rhox12,X,38104077,38110907,protein_coding,-1,6830,chrX_38104077_38110907
Rhox13,X,38121219,38129967,protein_coding,1,8748,chrX_38121219_38129967
Zbtb33,X,38189793,38197046,protein_coding,1,7253,chrX_38189793_38197046
Tmem255a,X,38196573,38252439,protein_coding,-1,55866,chrX_38196573_38252439
Atp1b4,X,38316184,38336769,protein_coding,1,20585,chrX_38316184_38336769
Lamp2,X,38401357,38456454,protein_coding,-1,55097,chrX_38401357_38456454
Gm7598,X,38476461,38482486,lincRNA,1,6025,chrX_38476461_38482486
Cul4b,X,38533274,38576196,protein_coding,-1,42922,chrX_38533274_38576196
Mcts1,X,38600578,38613426,protein_coding,1,12848,chrX_38600578_38613426
C1galt1c1,X,38630785,38635087,protein_coding,-1,4302,chrX_38630785_38635087
Gm14565,X,38705481,38737762,lincRNA,-1,32281,chrX_38705481_38737762
6030498E09Rik,X,38772671,38962686,protein_coding,1,190015,chrX_38772671_38962686
Gria3,X,41400854,41678601,protein_coding,1,277747,chrX_41400854_41678601
Thoc2,X,41794991,41920674,protein_coding,-1,125683,chrX_41794991_41920674
Xiap,X,42059679,42109656,protein_coding,1,49977,chrX_42059679_42109656
Stag2,X,42149317,42277185,protein_coding,1,127868,chrX_42149317_42277185
Tex13c2,X,42489691,42491524,protein_coding,1,1833,chrX_42489691_42491524
Sh2d1a,X,42502453,42529330,protein_coding,1,26877,chrX_42502453_42529330
Tenm1,X,42527866,43429126,protein_coding,-1,901260,chrX_42527866_43429126
Dcaf12l2,X,44365458,44368342,protein_coding,-1,2884,chrX_44365458_44368342
Dcaf12l1,X,44786570,44790197,protein_coding,-1,3627,chrX_44786570_44790197
4930515L19Rik,X,46267559,46328911,antisense,-1,61352,chrX_46267559_46328911
Gm29242,X,46473585,46774099,lincRNA,-1,300514,chrX_46473585_46774099
Smarca1,X,47809368,47892974,protein_coding,-1,83606,chrX_47809368_47892974
Ocrl,X,47912387,47965868,protein_coding,1,53481,chrX_47912387_47965868
Apln,X,48025146,48034853,protein_coding,-1,9707,chrX_48025146_48034853
Xpnpep2,X,48108725,48136981,protein_coding,1,28256,chrX_48108725_48136981
Sash3,X,48146436,48161565,protein_coding,1,15129,chrX_48146436_48161565
Zdhhc9,X,48171969,48208878,protein_coding,-1,36909,chrX_48171969_48208878
Utp14a,X,48256862,48282453,protein_coding,1,25591,chrX_48256862_48282453
Bcorl1,X,48341358,48408049,protein_coding,1,66691,chrX_48341358_48408049
Elf4,X,48411046,48463132,protein_coding,-1,52086,chrX_48411046_48463132
Aifm1,X,48474944,48513563,protein_coding,-1,38619,chrX_48474944_48513563
Rab33a,X,48519285,48530232,protein_coding,1,10947,chrX_48519285_48530232
Zfp280c,X,48541625,48594504,protein_coding,-1,52879,chrX_48541625_48594504
Slc25a14,X,48623413,48662294,protein_coding,1,38881,chrX_48623413_48662294
Gpr119,X,48667979,48674478,protein_coding,-1,6499,chrX_48667979_48674478
Rbmx2,X,48695004,48710723,protein_coding,1,15719,chrX_48695004_48710723
Enox2,X,49009707,49288259,protein_coding,-1,278552,chrX_49009707_49288259
Gm14696,X,49313319,49345237,lincRNA,-1,31918,chrX_49313319_49345237
Gm14697,X,49332409,49447972,antisense,-1,115563,chrX_49332409_49447972
Arhgap36,X,49463945,49500244,protein_coding,1,36299,chrX_49463945_49500244
Olfr1321,X,49723577,49735059,protein_coding,-1,11482,chrX_49723577_49735059
Igsf1,X,49782536,49797749,protein_coding,-1,15213,chrX_49782536_49797749
Olfr1322,X,49882991,49891483,protein_coding,-1,8492,chrX_49882991_49891483
Olfr1323,X,50005448,50019359,protein_coding,-1,13911,chrX_50005448_50019359
Stk26,X,50841047,50893097,protein_coding,1,52050,chrX_50841047_50893097
Frmd7,X,50895180,50942710,protein_coding,-1,47530,chrX_50895180_50942710
Rap2c,X,51003912,51018018,protein_coding,-1,14106,chrX_51003912_51018018
Mbnl3,X,51117269,51206532,protein_coding,-1,89263,chrX_51117269_51206532
Hs6st2,X,51387212,51681856,protein_coding,-1,294644,chrX_51387212_51681856
Usp26,X,51753959,51801233,protein_coding,-1,47274,chrX_51753959_51801233
1700080O16Rik,X,51968695,51972772,protein_coding,-1,4077,chrX_51968695_51972772
Gpc4,X,52053021,52165252,protein_coding,-1,112231,chrX_52053021_52165252
Gpc3,X,52272426,52613950,protein_coding,-1,341524,chrX_52272426_52613950
Gm14582,X,52296181,52333679,antisense,1,37498,chrX_52296181_52333679
A630012P03Rik,X,52575843,52619047,antisense,1,43204,chrX_52575843_52619047
Ccdc160,X,52791200,52799468,protein_coding,1,8268,chrX_52791200_52799468
Phf6,X,52912266,52956943,protein_coding,1,44677,chrX_52912266_52956943
Hprt,X,52988137,53021659,protein_coding,1,33522,chrX_52988137_53021659
Plac1,X,53069995,53240111,protein_coding,-1,170116,chrX_53069995_53240111
Fam122b,X,53243415,53269805,protein_coding,-1,26390,chrX_53243415_53269805
Fam122c,X,53273424,53331185,protein_coding,1,57761,chrX_53273424_53331185
Mospd1,X,53344598,53370502,protein_coding,-1,25904,chrX_53344598_53370502
Etd,X,53434918,53443576,protein_coding,1,8658,chrX_53434918_53443576
Gm14597,X,53490177,53608979,protein_coding,-1,118802,chrX_53490177_53608979
Rtl8c,X,53521122,53608432,protein_coding,1,87310,chrX_53521122_53608432
Rtl8a,X,53555578,53643682,protein_coding,-1,88104,chrX_53555578_53643682
Rtl8b,X,53582267,53670408,protein_coding,-1,88141,chrX_53582267_53670408
1700013H16Rik,X,53742901,53757831,protein_coding,-1,14930,chrX_53742901_53757831
Xlr,X,53777118,53797706,protein_coding,-1,20588,chrX_53777118_53797706
Gm16405,X,54531208,54548016,protein_coding,1,16808,chrX_54531208_54548016
Slxl1,X,55226876,55243723,protein_coding,1,16847,chrX_55226876_55243723
3830403N18Rik,X,56136572,56153498,protein_coding,1,16926,chrX_56136572_56153498
Gm773,X,56189827,56212881,protein_coding,-1,23054,chrX_56189827_56212881
1600025M17Rik,X,56317608,56320664,lincRNA,1,3056,chrX_56317608_56320664
Zfp449,X,56346400,56365674,protein_coding,1,19274,chrX_56346400_56365674
Gm2155,X,56371620,56374790,antisense,-1,3170,chrX_56371620_56374790
Smim10l2a,X,56374586,56377799,protein_coding,1,3213,chrX_56374586_56377799
Ints6l,X,56454857,56507843,protein_coding,1,52986,chrX_56454857_56507843
Gm648,X,56543874,56549606,protein_coding,-1,5732,chrX_56543874_56549606
Mmgt1,X,56585512,56598069,protein_coding,-1,12557,chrX_56585512_56598069
Slc9a6,X,56609757,56664230,protein_coding,1,54473,chrX_56609757_56664230
Fhl1,X,56731787,56793346,protein_coding,1,61559,chrX_56731787_56793346
Map7d3,X,56797858,56822326,protein_coding,-1,24468,chrX_56797858_56822326
Adgrg4,X,56870163,57001558,protein_coding,1,131395,chrX_56870163_57001558
Htatsf1,X,57053583,57067183,protein_coding,1,13600,chrX_57053583_57067183
Vgll1,X,57088106,57106540,protein_coding,1,18434,chrX_57088106_57106540
Gm14718,X,57200643,57204378,antisense,1,3735,chrX_57200643_57204378
Cd40lg,X,57212143,57224042,protein_coding,1,11899,chrX_57212143_57224042
Arhgef6,X,57231485,57338729,protein_coding,-1,107244,chrX_57231485_57338729
Rbmx,X,57383530,57393036,protein_coding,-1,9506,chrX_57383530_57393036
Gm364,X,57409154,57488767,protein_coding,1,79613,chrX_57409154_57488767
Gpr101,X,57496668,57503757,protein_coding,-1,7089,chrX_57496668_57503757
Zic3,X,58022700,58041736,protein_coding,1,19036,chrX_58022700_58041736
4930550L24Rik,X,58909360,58920304,protein_coding,1,10944,chrX_58909360_58920304
Fgf13,X,59062145,59568071,protein_coding,-1,505926,chrX_59062145_59568071
F9,X,59999464,60030759,protein_coding,1,31295,chrX_59999464_60030759
Mcf2,X,60055956,60179089,protein_coding,-1,123133,chrX_60055956_60179089
Atp11c,X,60223290,60592698,protein_coding,-1,369408,chrX_60223290_60592698
Gm14661,CHR_MG3231_PATCH,60555974,60807993,antisense;lncRNA,1,252019,chrCHR_MG3231_PATCH_60555974_60807993
Sox3,X,60891366,60893430,protein_coding,-1,2064,chrX_60891366_60893430
Gm14662,X,60893653,60898067,antisense,1,4414,chrX_60893653_60898067
Gm14664,X,61041741,61076068,lincRNA,1,34327,chrX_61041741_61076068
Cdr1,X,61184005,61185558,protein_coding,-1,1553,chrX_61184005_61185558
Ldoc1,X,61709497,61710955,protein_coding,1,1458,chrX_61709497_61710955
Gm6760,X,64151405,64152198,protein_coding,-1,793,chrX_64151405_64152198
3830417A13Rik,X,64173548,64178778,protein_coding,1,5230,chrX_64173548_64178778
Slitrk4,X,64264885,64276996,protein_coding,-1,12111,chrX_64264885_64276996
4930447F04Rik,X,66303361,66304224,protein_coding,-1,863,chrX_66303361_66304224
Slitrk2,X,66649318,66661393,protein_coding,1,12075,chrX_66649318_66661393
Fmr1,X,68678541,68717963,protein_coding,1,39422,chrX_68678541_68717963
Fmr1nb,X,68761839,68804567,protein_coding,1,42728,chrX_68761839_68804567
Gm14698,X,68821093,68825318,protein_coding,1,4225,chrX_68821093_68825318
Gm14705,X,69356596,69361269,antisense,-1,4673,chrX_69356596_69361269
Aff2,X,69360294,69868037,protein_coding,1,507743,chrX_69360294_69868037
1700111N16Rik,X,69929259,70143588,antisense,-1,214329,chrX_69929259_70143588
Ids,X,70343069,70365084,protein_coding,-1,22015,chrX_70343069_70365084
1110012L19Rik,X,70385877,70389417,protein_coding,1,3540,chrX_70385877_70389417
Tmem185a,X,70459753,70477180,protein_coding,-1,17427,chrX_70459753_70477180
Mamld1,X,71050240,71156056,protein_coding,1,105816,chrX_71050240_71156056
Mtm1,X,71210767,71315691,protein_coding,1,104924,chrX_71210767_71315691
Mtmr1,X,71364760,71419196,protein_coding,1,54436,chrX_71364760_71419196
Cd99l2,X,71420060,71492849,protein_coding,-1,72789,chrX_71420060_71492849
Gm16189,X,71439714,71469851,antisense,1,30137,chrX_71439714_71469851
Hmgb3,X,71555918,71560676,protein_coding,1,4758,chrX_71555918_71560676
Vma21,X,71815924,71839757,protein_coding,1,23833,chrX_71815924_71839757
Gm1141,X,71920947,71940870,protein_coding,1,19923,chrX_71920947_71940870
Prrg3,X,71962624,71972722,protein_coding,1,10098,chrX_71962624_71972722
Fate1,X,71972986,71989046,protein_coding,1,16060,chrX_71972986_71989046
Cnga2,X,71991849,72010218,protein_coding,1,18369,chrX_71991849_72010218
Gabre,X,72255999,72274803,protein_coding,-1,18804,chrX_72255999_72274803
Gabra3,X,72432681,72656848,protein_coding,-1,224167,chrX_72432681_72656848
Gabrq,X,72825178,72842602,protein_coding,1,17424,chrX_72825178_72842602
Cetn2,X,72913532,72918411,protein_coding,-1,4879,chrX_72913532_72918411
Nsdhl,X,72918557,72958514,protein_coding,1,39957,chrX_72918557_72958514
Gm14684,X,72981823,72982344,lincRNA,1,521,chrX_72981823_72982344
Zfp185,X,72987339,73031543,protein_coding,1,44204,chrX_72987339_73031543
Pnma5,X,73033981,73037103,protein_coding,-1,3122,chrX_73033981_73037103
Pnma3,X,73064787,73068191,protein_coding,1,3404,chrX_73064787_73068191
Xlr4a,X,73074345,73082478,protein_coding,-1,8133,chrX_73074345_73082478
Xlr3a,X,73086293,73097095,protein_coding,-1,10802,chrX_73086293_73097095
Xlr5a,X,73107635,73292976,protein_coding,-1,185341,chrX_73107635_73292976
Xlr3b,X,73192207,73202930,protein_coding,1,10723,chrX_73192207_73202930
Xlr4b,X,73214333,73222453,protein_coding,1,8120,chrX_73214333_73222453
F8a,X,73228291,73230795,protein_coding,1,2504,chrX_73228291_73230795
Gm45015,X,73334996,73336840,protein_coding,-1,1844,chrX_73334996_73336840
Zfp275,X,73342621,73359080,protein_coding,1,16459,chrX_73342621_73359080
Gm18336,X,73396439,73398736,protein_coding,-1,2297,chrX_73396439_73398736
Gm26726,X,73402211,73411436,antisense,-1,9225,chrX_73402211_73411436
Zfp92,X,73411096,73428385,protein_coding,1,17289,chrX_73411096_73428385
Haus7,X,73437315,73459044,protein_coding,-1,21729,chrX_73437315_73459044
Bgn,X,73483602,73495933,protein_coding,1,12331,chrX_73483602_73495933
Atp2b3,X,73503086,73571005,protein_coding,1,67919,chrX_73503086_73571005
Dusp9,X,73639419,73643514,protein_coding,1,4095,chrX_73639419_73643514
Pnck,X,73655994,73660117,protein_coding,-1,4123,chrX_73655994_73660117
Slc6a8,X,73673150,73682502,protein_coding,1,9352,chrX_73673150_73682502
Bcap31,X,73686178,73716175,protein_coding,-1,29997,chrX_73686178_73716175
Abcd1,X,73716597,73738534,protein_coding,1,21937,chrX_73716597_73738534
Plxnb3,X,73757090,73772514,protein_coding,1,15424,chrX_73757090_73772514
Srpk3,X,73774405,73778925,protein_coding,1,4520,chrX_73774405_73778925
Idh3g,X,73778963,73786897,protein_coding,-1,7934,chrX_73778963_73786897
Ssr4,X,73787028,73790830,protein_coding,1,3802,chrX_73787028_73790830
Pdzd4,X,73793359,73824969,protein_coding,-1,31610,chrX_73793359_73824969
L1cam,X,73853778,73896105,protein_coding,-1,42327,chrX_73853778_73896105
Arhgap4,X,73891442,73921870,protein_coding,-1,30428,chrX_73891442_73921870
Avpr2,X,73892102,73895502,protein_coding,1,3400,chrX_73892102_73895502
Naa10,X,73916873,73921944,protein_coding,-1,5071,chrX_73916873_73921944
Renbp,X,73922121,73930850,protein_coding,-1,8729,chrX_73922121_73930850
Hcfc1,X,73942792,73966357,protein_coding,-1,23565,chrX_73942792_73966357
Irak1,X,74013914,74023918,protein_coding,-1,10004,chrX_74013914_74023918
Mecp2,X,74026592,74135363,protein_coding,-1,108771,chrX_74026592_74135363
Opn1mw,X,74127464,74150760,protein_coding,1,23296,chrX_74127464_74150760
Tex28,X,74150944,74167838,protein_coding,-1,16894,chrX_74150944_74167838
Tktl1,X,74177259,74208500,protein_coding,1,31241,chrX_74177259_74208500
Flna,X,74223461,74249820,protein_coding,-1,26359,chrX_74223461_74249820
Emd,X,74254687,74261548,protein_coding,1,6861,chrX_74254687_74261548
Rpl10,X,74270812,74273135,protein_coding,1,2323,chrX_74270812_74273135
Dnase1l1,X,74273217,74282337,protein_coding,-1,9120,chrX_74273217_74282337
Taz,X,74281912,74290151,protein_coding,1,8239,chrX_74281912_74290151
Atp6ap1,X,74297097,74304721,protein_coding,1,7624,chrX_74297097_74304721
Gdi1,X,74304998,74311862,protein_coding,1,6864,chrX_74304998_74311862
Fam50a,X,74313033,74320149,protein_coding,1,7116,chrX_74313033_74320149
Plxna3,X,74329066,74344689,protein_coding,1,15623,chrX_74329066_74344689
Lage3,X,74351276,74353618,protein_coding,-1,2342,chrX_74351276_74353618
Ubl4a,X,74365718,74373218,protein_coding,-1,7500,chrX_74365718_74373218
Slc10a3,X,74369217,74373349,protein_coding,-1,4132,chrX_74369217_74373349
Fam3a,X,74384719,74393272,protein_coding,-1,8553,chrX_74384719_74393272
Ikbkg,X,74393290,74453854,protein_coding,1,60564,chrX_74393290_74453854
G6pdx,X,74409483,74429194,protein_coding,-1,19711,chrX_74409483_74429194
Gm5640,X,74639119,74645635,protein_coding,-1,6516,chrX_74639119_74645635
Gm5936,X,74837196,74843355,protein_coding,1,6159,chrX_74837196_74843355
Gab3,X,74966843,75085458,protein_coding,-1,118615,chrX_74966843_75085458
Dkc1,X,75095854,75109777,protein_coding,1,13923,chrX_75095854_75109777
Mpp1,X,75109733,75131016,protein_coding,-1,21283,chrX_75109733_75131016
Smim9,X,75146056,75163770,protein_coding,-1,17714,chrX_75146056_75163770
F8,X,75172715,75382615,protein_coding,-1,209900,chrX_75172715_75382615
Fundc2,X,75382399,75396459,protein_coding,1,14060,chrX_75382399_75396459
Cmc4,X,75404846,75416584,protein_coding,-1,11738,chrX_75404846_75416584
Brcc3,X,75416628,75454001,protein_coding,1,37373,chrX_75416628_75454001
Vbp1,X,75514299,75534942,protein_coding,1,20643,chrX_75514299_75534942
Rab39b,X,75572046,75578231,protein_coding,-1,6185,chrX_75572046_75578231
Gm15063,X,75573452,75575268,antisense,1,1816,chrX_75573452_75575268
Pls3,X,75785654,75875182,protein_coding,-1,89528,chrX_75785654_75875182
Gm14715,X,75916131,75930227,lincRNA,-1,14096,chrX_75916131_75930227
Gm14717,X,76246984,76261392,antisense,-1,14408,chrX_76246984_76261392
Cldn34d,X,76582610,76602924,protein_coding,-1,20314,chrX_76582610_76602924
Tbl1x,X,77511013,77662983,protein_coding,1,151970,chrX_77511013_77662983
Prkx,X,77761411,77796278,protein_coding,-1,34867,chrX_77761411_77796278
Pbsn,X,77837901,77853623,protein_coding,-1,15722,chrX_77837901_77853623
5430402E10Rik,X,77919786,77925062,protein_coding,-1,5276,chrX_77919786_77925062
Obp1b,X,78186777,78192292,protein_coding,1,5515,chrX_78186777_78192292
Gm14743,X,78240462,78245921,protein_coding,-1,5459,chrX_78240462_78245921
Prrg1,X,78449613,78583896,protein_coding,-1,134283,chrX_78449613_78583896
Mageb16,X,79623231,79671435,protein_coding,-1,48204,chrX_79623231_79671435
Tmem47,X,81070698,81097872,protein_coding,1,27174,chrX_81070698_81097872
4930595M18Rik,X,81419575,81458121,protein_coding,-1,38546,chrX_81419575_81458121
Dmd,X,82948870,85206141,protein_coding,1,2257271,chrX_82948870_85206141
Tsga8,X,83486678,83487924,protein_coding,-1,1246,chrX_83486678_83487924
Fthl17a,X,85249679,85270288,protein_coding,1,20609,chrX_85249679_85270288
Tab3,X,85574022,85634469,protein_coding,1,60447,chrX_85574022_85634469
Gk,X,85701937,85776819,protein_coding,-1,74882,chrX_85701937_85776819
Gm14764,X,85744348,85749764,antisense,1,5416,chrX_85744348_85749764
Gm14762,X,85825892,85834831,lincRNA,1,8939,chrX_85825892_85834831
5430427O19Rik,X,85870354,85891499,protein_coding,1,21145,chrX_85870354_85891499
Samt3,X,86044199,86047313,protein_coding,1,3114,chrX_86044199_86047313
Mageb4,X,86250254,86305093,protein_coding,-1,54839,chrX_86250254_86305093
Il1rapl1,X,86740870,88115645,protein_coding,-1,1374775,chrX_86740870_88115645
Gm27000,X,88759471,88760312,lincRNA,-1,841,chrX_88759471_88760312
4930415L06Rik,X,89930098,89932852,protein_coding,-1,2754,chrX_89930098_89932852
Mageb18,X,92118879,92599572,protein_coding,-1,480693,chrX_92118879_92599572
Arx,X,93286445,93298357,protein_coding,1,11912,chrX_93286445_93298357
Pola1,X,93304767,93632155,protein_coding,-1,327388,chrX_93304767_93632155
Pcyt1b,X,93654863,93749951,protein_coding,1,95088,chrX_93654863_93749951
Pdk3,X,93764607,93832201,protein_coding,-1,67594,chrX_93764607_93832201
AU015836,X,93968659,93975470,protein_coding,1,6811,chrX_93968659_93975470
Gm14798,X,94028854,94099304,antisense,1,70450,chrX_94028854_94099304
Zfx,X,94074631,94123702,protein_coding,-1,49071,chrX_94074631_94123702
Eif2s3x,X,94188707,94212862,protein_coding,-1,24155,chrX_94188707_94212862
Klhl15,X,94234599,94277724,protein_coding,1,43125,chrX_94234599_94277724
Fam90a1b,X,94355053,94366777,protein_coding,-1,11724,chrX_94355053_94366777
Apoo,X,94367117,94417093,protein_coding,1,49976,chrX_94367117_94417093
Gm14827,X,94442732,94447727,lincRNA,1,4995,chrX_94442732_94447727
Maged1,X,94535474,94542143,protein_coding,-1,6669,chrX_94535474_94542143
Gspt2,X,94636069,94643244,protein_coding,1,7175,chrX_94636069_94643244
Zxdb,X,94724569,94730187,protein_coding,1,5618,chrX_94724569_94730187
Gm39526,X,94731399,94745359,lincRNA,1,13960,chrX_94731399_94745359
Spin4,X,95022510,95026682,protein_coding,-1,4172,chrX_95022510_95026682
Arhgef9,X,95048935,95196856,protein_coding,-1,147921,chrX_95048935_95196856
Amer1,X,95420318,95444872,protein_coding,-1,24554,chrX_95420318_95444872
Asb12,X,95470201,95557987,protein_coding,-1,87786,chrX_95470201_95557987
Zc4h2,X,95639193,95658509,protein_coding,-1,19316,chrX_95639193_95658509
Zc3h12b,X,95711678,95932637,protein_coding,1,220959,chrX_95711678_95932637
Las1l,X,95935335,95956962,protein_coding,-1,21627,chrX_95935335_95956962
Msn,X,96096042,96168552,protein_coding,1,72510,chrX_96096042_96168552
F630028O10Rik,X,96239926,96243636,antisense,1,3710,chrX_96239926_96243636
Vsig4,X,96247203,96293438,protein_coding,-1,46235,chrX_96247203_96293438
Hsf3,X,96306178,96456294,protein_coding,-1,150116,chrX_96306178_96456294
Heph,X,96455359,96574485,protein_coding,1,119126,chrX_96455359_96574485
Gpr165,X,96713441,96719388,protein_coding,1,5947,chrX_96713441_96719388
Pgr15l,X,97072596,97082104,protein_coding,1,9508,chrX_97072596_97082104
Eda2r,X,97333840,97377216,protein_coding,-1,43376,chrX_97333840_97377216
Ar,X,98148769,98323215,protein_coding,1,174446,chrX_98148769_98323215
Ophn1,X,98554277,98891025,protein_coding,-1,336748,chrX_98554277_98891025
Yipf6,X,98936316,98949017,protein_coding,1,12701,chrX_98936316_98949017
Stard8,X,99003248,99074728,protein_coding,1,71480,chrX_99003248_99074728
Efnb1,X,99136130,99148991,protein_coding,1,12861,chrX_99136130_99148991
Gm14812,X,99405331,99443797,lincRNA,-1,38466,chrX_99405331_99443797
Pja1,X,99465734,99471273,protein_coding,-1,5539,chrX_99465734_99471273
Tmem28,X,99821021,99848790,protein_coding,1,27769,chrX_99821021_99848790
Eda,X,99975606,100400762,protein_coding,1,425156,chrX_99975606_100400762
Awat2,X,100402221,100442717,protein_coding,-1,40496,chrX_100402221_100442717
Igbp1,X,100494291,100516125,protein_coding,1,21834,chrX_100494291_100516125
Dgat2l6,X,100524838,100546144,protein_coding,1,21306,chrX_100524838_100546144
Awat1,X,100572251,100578205,protein_coding,1,5954,chrX_100572251_100578205
Arr3,X,100605497,100618493,protein_coding,1,12996,chrX_100605497_100618493
Pdzd11,X,100622883,100626568,protein_coding,-1,3685,chrX_100622883_100626568
Kif4,X,100625737,100727214,protein_coding,1,101477,chrX_100625737_100727214
Gdpd2,X,100729873,100738895,protein_coding,1,9022,chrX_100729873_100738895
Gm14902,X,100741093,100749421,lincRNA,1,8328,chrX_100741093_100749421
Dlg3,X,100767722,100818410,protein_coding,1,50688,chrX_100767722_100818410
Tex11,X,100838648,101059667,protein_coding,-1,221019,chrX_100838648_101059667
Slc7a3,X,101079210,101086020,protein_coding,-1,6810,chrX_101079210_101086020
Snx12,X,101097786,101222563,protein_coding,-1,124777,chrX_101097786_101222563
Foxo4,X,101254528,101260873,protein_coding,1,6345,chrX_101254528_101260873
Med12,X,101274030,101297465,protein_coding,1,23435,chrX_101274030_101297465
Nlgn3,X,101299168,101325963,protein_coding,1,26795,chrX_101299168_101325963
Gjb1,X,101376378,101385629,protein_coding,1,9251,chrX_101376378_101385629
Zmym3,X,101404384,101420849,protein_coding,-1,16465,chrX_101404384_101420849
Nono,X,101429318,101448591,protein_coding,1,19273,chrX_101429318_101448591
Itgb1bp2,X,101449088,101453541,protein_coding,1,4453,chrX_101449088_101453541
Taf1,X,101532734,101601789,protein_coding,1,69055,chrX_101532734_101601789
Ogt,X,101640060,101684351,protein_coding,1,44291,chrX_101640060_101684351
Gm4779,X,101790053,101794423,protein_coding,-1,4370,chrX_101790053_101794423
8030474K03Rik,X,101794656,101798642,protein_coding,1,3986,chrX_101794656_101798642
Nhsl2,X,101849385,102092055,protein_coding,1,242670,chrX_101849385_102092055
Rtl5,X,102066544,102071304,protein_coding,-1,4760,chrX_102066544_102071304
Pin4,X,102119447,102127669,protein_coding,1,8222,chrX_102119447_102127669
Ercc6l,X,102141716,102157091,protein_coding,-1,15375,chrX_102141716_102157091
Rps4x,X,102184941,102189394,protein_coding,-1,4453,chrX_102184941_102189394
Cited1,X,102247381,102252181,protein_coding,-1,4800,chrX_102247381_102252181
Hdac8,X,102284639,102505359,protein_coding,-1,220720,chrX_102284639_102505359
Phka1,X,102513975,102644246,protein_coding,-1,130271,chrX_102513975_102644246
Dmrtc1b,X,102707865,102715209,protein_coding,1,7344,chrX_102707865_102715209
1700031F05Rik,X,102859186,102867971,protein_coding,-1,8785,chrX_102859186_102867971
Dmrtc1a,X,102903216,102908687,protein_coding,-1,5471,chrX_102903216_102908687
1700018G05Rik,X,102928372,102929094,protein_coding,1,722,chrX_102928372_102929094
Nap1l2,X,103184176,103186640,protein_coding,-1,2464,chrX_103184176_103186640
Cdx4,X,103321398,103330592,protein_coding,1,9194,chrX_103321398_103330592
Chic1,X,103356476,103396092,protein_coding,1,39616,chrX_103356476_103396092
Gm26952,X,103381957,103383169,antisense,-1,1212,chrX_103381957_103383169
Tsx,X,103414467,103424580,protein_coding,1,10113,chrX_103414467_103424580
Gm26992,X,103422010,103481705,protein_coding,1,59695,chrX_103422010_103481705
Tsix,X,103431517,103484957,antisense,1,53440,chrX_103431517_103484957
Xist,X,103460366,103483254,lincRNA,-1,22888,chrX_103460366_103483254
Jpx,X,103493556,103565696,lincRNA,1,72140,chrX_103493556_103565696
Ftx,X,103560907,103623790,lincRNA,-1,62883,chrX_103560907_103623790
Zcchc13,X,103630586,103631670,protein_coding,1,1084,chrX_103630586_103631670
Slc16a2,X,103697414,103821983,protein_coding,-1,124569,chrX_103697414_103821983
Rlim,X,103957163,103981284,protein_coding,-1,24121,chrX_103957163_103981284
Nexmif,X,104077434,104201185,protein_coding,-1,123751,chrX_104077434_104201185
Abcb7,X,104280657,104413856,protein_coding,-1,133199,chrX_104280657_104413856
Uprt,X,104482818,104507490,protein_coding,1,24672,chrX_104482818_104507490
Zdhhc15,X,104536969,104671064,protein_coding,-1,134095,chrX_104536969_104671064
1700121L16Rik,X,104816776,104842455,lincRNA,1,25679,chrX_104816776_104842455
Magee2,X,104854952,104857267,protein_coding,-1,2315,chrX_104854952_104857267
Pbdc1,X,105079756,105117090,protein_coding,1,37334,chrX_105079756_105117090
Magee1,X,105120378,105123927,protein_coding,1,3549,chrX_105120378_105123927
5330434G04Rik,X,105348282,105391776,lincRNA,-1,43494,chrX_105348282_105391776
Fgf16,X,105764279,105774939,protein_coding,1,10660,chrX_105764279_105774939
Atrx,X,105797615,105929403,protein_coding,-1,131788,chrX_105797615_105929403
Magt1,X,105968084,106011906,protein_coding,-1,43822,chrX_105968084_106011906
Cox7b,X,106015700,106022450,protein_coding,1,6750,chrX_106015700_106022450
Atp7a,X,106027276,106124926,protein_coding,1,97650,chrX_106027276_106124926
Tlr13,X,106143204,106160493,protein_coding,1,17289,chrX_106143204_106160493
Pgk1,X,106187100,106203699,protein_coding,1,16599,chrX_106187100_106203699
Taf9b,X,106206883,106221158,protein_coding,-1,14275,chrX_106206883_106221158
Fnd3c2,X,106235246,106255376,protein_coding,-1,20130,chrX_106235246_106255376
Fndc3c1,X,106420041,106485401,protein_coding,-1,65360,chrX_106420041_106485401
Cysltr1,X,106574346,106603679,protein_coding,-1,29333,chrX_106574346_106603679
Gm5127,X,106583186,106710557,protein_coding,1,127371,chrX_106583186_106710557
Lpar4,X,106920625,106933900,protein_coding,1,13275,chrX_106920625_106933900
P2ry10b,X,107148927,107173661,protein_coding,1,24734,chrX_107148927_107173661
Gpr174,X,107255878,107296769,protein_coding,1,40891,chrX_107255878_107296769
Itm2a,X,107397099,107403376,protein_coding,-1,6277,chrX_107397099_107403376
Tbx22,X,107667964,107688978,protein_coding,1,21014,chrX_107667964_107688978
2610002M06Rik,X,107782751,107816334,protein_coding,-1,33583,chrX_107782751_107816334
Brwd3,X,108737016,108834372,protein_coding,-1,97356,chrX_108737016_108834372
Hmgn5,X,109004534,109013404,protein_coding,-1,8870,chrX_109004534_109013404
Sh3bgrl,X,109095365,109197873,protein_coding,1,102508,chrX_109095365_109197873
Gm44593,X,110634586,110812324,lincRNA,-1,177738,chrX_110634586_110812324
Pou3f4,X,110814280,110817207,protein_coding,1,2927,chrX_110814280_110817207
Cylc1,X,111110418,111126018,protein_coding,1,15600,chrX_111110418_111126018
Rps6ka6,X,111254283,111537959,protein_coding,-1,283676,chrX_111254283_111537959
Hdx,X,111569931,111697079,protein_coding,-1,127148,chrX_111569931_111697079
Gm45194,X,111891389,112240590,protein_coding,1,349201,chrX_111891389_112240590
Apool,X,112311334,112372755,protein_coding,1,61421,chrX_112311334_112372755
Satl1,X,112384303,112406779,protein_coding,-1,22476,chrX_112384303_112406779
2010106E10Rik,X,112495274,112558343,protein_coding,1,63069,chrX_112495274_112558343
Zfp711,X,112600526,112635070,protein_coding,1,34544,chrX_112600526_112635070
Pof1b,X,112638431,112698651,protein_coding,-1,60220,chrX_112638431_112698651
Gm14936,X,112980864,113009754,lincRNA,-1,28890,chrX_112980864_113009754
Chm,X,113040593,113185517,protein_coding,-1,144924,chrX_113040593_113185517
Dach2,X,113297510,113836386,protein_coding,1,538876,chrX_113297510_113836386
Klhl4,X,114474333,114560829,protein_coding,1,86496,chrX_114474333_114560829
Ube2dnl1,X,114905012,114905941,protein_coding,1,929,chrX_114905012_114905941
Cpxcr1,X,116448944,116478783,protein_coding,1,29839,chrX_116448944_116478783
Gm14929,X,119747626,119749677,lincRNA,-1,2051,chrX_119747626_119749677
Pabpc5,X,119927196,119930165,protein_coding,1,2969,chrX_119927196_119930165
Pcdh11x,X,120290259,120910619,protein_coding,1,620360,chrX_120290259_120910619
Nap1l3,X,122394565,122397401,protein_coding,-1,2836,chrX_122394565_122397401
Cldn34c1,X,123103495,123188795,protein_coding,1,85300,chrX_123103495_123188795
Gm14951,X,123253138,123260815,lincRNA,1,7677,chrX_123253138_123260815
Cldn34c2,X,123576286,123602172,protein_coding,1,25886,chrX_123576286_123602172
Cldn34c3,X,123793665,123813803,unprocessed_pseudogene,1,20138,chrX_123793665_123813803
Vmn2r121,X,124124961,124135952,protein_coding,-1,10991,chrX_124124961_124135952
4932411N23Rik,X,126812462,126815868,protein_coding,-1,3406,chrX_126812462_126815868
Gm382,X,127039972,127063986,protein_coding,1,24014,chrX_127039972_127063986
Cldn34c4,X,127721182,127736554,protein_coding,-1,15372,chrX_127721182_127736554
Diaph2,X,129749742,130465834,protein_coding,1,716092,chrX_129749742_130465834
Pcdh19,X,133582860,133688987,protein_coding,-1,106127,chrX_133582860_133688987
Tnmd,X,133850980,133865577,protein_coding,1,14597,chrX_133850980_133865577
Tspan6,X,133891068,133898429,protein_coding,-1,7361,chrX_133891068_133898429
Srpx2,X,133908426,133932446,protein_coding,1,24020,chrX_133908426_133932446
Sytl4,X,133936385,133981812,protein_coding,-1,45427,chrX_133936385_133981812
Cstf2,X,134059187,134086819,protein_coding,1,27632,chrX_134059187_134086819
Nox1,X,134086421,134221956,protein_coding,-1,135535,chrX_134086421_134221956
Arl13a,X,134187501,134208028,protein_coding,1,20527,chrX_134187501_134208028
Trmt2b,X,134222339,134276984,protein_coding,-1,54645,chrX_134222339_134276984
Tmem35a,X,134295225,134305969,protein_coding,1,10744,chrX_134295225_134305969
Cenpi,X,134308084,134362639,protein_coding,1,54555,chrX_134308084_134362639
Drp2,X,134404551,134456573,protein_coding,1,52022,chrX_134404551_134456573
Taf7l,X,134460118,134476490,protein_coding,-1,16372,chrX_134460118_134476490
Timm8a1,X,134537256,134541865,protein_coding,-1,4609,chrX_134537256_134541865
Btk,X,134542336,134583570,protein_coding,-1,41234,chrX_134542336_134583570
Rpl36a,X,134585654,134588062,protein_coding,1,2408,chrX_134585654_134588062
Gla,X,134588149,134601125,protein_coding,-1,12976,chrX_134588149_134601125
Hnrnph2,X,134601179,134607060,protein_coding,1,5881,chrX_134601179_134607060
Armcx4,X,134686519,134696757,protein_coding,1,10238,chrX_134686519_134696757
Armcx1,X,134717963,134721917,protein_coding,1,3954,chrX_134717963_134721917
Armcx6,X,134748461,134751417,protein_coding,-1,2956,chrX_134748461_134751417
Armcx3,X,134756595,134761455,protein_coding,1,4860,chrX_134756595_134761455
Armcx2,X,134804145,134809221,protein_coding,-1,5076,chrX_134804145_134809221
Nxf2,X,134944526,134964754,protein_coding,-1,20228,chrX_134944526_134964754
Zmat1,X,134971372,135009209,protein_coding,-1,37837,chrX_134971372_135009209
Gm15023,X,135167624,135177632,protein_coding,-1,10008,chrX_135167624_135177632
Tceal6,X,135208687,135210687,protein_coding,-1,2000,chrX_135208687_135210687
Pramel3,X,135302307,135312652,protein_coding,1,10345,chrX_135302307_135312652
Gm5128,X,135373284,135383393,protein_coding,1,10109,chrX_135373284_135383393
Gm7903,X,135433835,135443830,protein_coding,1,9995,chrX_135433835_135443830
AV320801,X,135494588,135504594,protein_coding,1,10006,chrX_135494588_135504594
Nxf7,X,135579555,135598777,protein_coding,-1,19222,chrX_135579555_135598777
Prame,X,135613002,135627705,protein_coding,-1,14703,chrX_135613002_135627705
Tcp11x2,X,135654698,135693790,protein_coding,-1,39092,chrX_135654698_135693790
Gprasp1,X,135742733,135803474,protein_coding,1,60741,chrX_135742733_135803474
Bhlhb9,X,135797594,135891081,protein_coding,1,93487,chrX_135797594_135891081
Arxes2,X,135993824,135995355,protein_coding,1,1531,chrX_135993824_135995355
Arxes1,X,136033367,136034946,protein_coding,1,1579,chrX_136033367_136034946
Bex2,X,136066564,136068236,protein_coding,-1,1672,chrX_136066564_136068236
Nxf3,X,136072099,136085255,protein_coding,-1,13156,chrX_136072099_136085255
Bex4,X,136138996,136140443,protein_coding,1,1447,chrX_136138996_136140443
Tceal8,X,136168984,136172342,protein_coding,-1,3358,chrX_136168984_136172342
Tceal5,X,136200948,136203876,protein_coding,-1,2928,chrX_136200948_136203876
Bex1,X,136213972,136215513,protein_coding,-1,1541,chrX_136213972_136215513
Tceal7,X,136214779,136226100,protein_coding,1,11321,chrX_136214779_136226100
Tceal9,X,136245079,136247139,protein_coding,1,2060,chrX_136245079_136247139
Bex3,X,136270253,136271978,protein_coding,1,1725,chrX_136270253_136271978
Kir3dl2,X,136448107,136544056,protein_coding,-1,95949,chrX_136448107_136544056
Kir3dl1,X,136517999,136534309,protein_coding,1,16310,chrX_136517999_136534309
Tceal3,X,136590842,136668378,protein_coding,1,77536,chrX_136590842_136668378
Tceal1,X,136707982,136711478,protein_coding,1,3496,chrX_136707982_136711478
Morf4l2,X,136732942,136743690,protein_coding,-1,10748,chrX_136732942_136743690
Glra4,X,136757674,136780141,protein_coding,-1,22467,chrX_136757674_136780141
Plp1,X,136822671,136839733,protein_coding,1,17062,chrX_136822671_136839733
Rab9b,X,136858147,136868755,protein_coding,-1,10608,chrX_136858147_136868755
Tmsb15l,X,136954988,136976869,protein_coding,-1,21881,chrX_136954988_136976869
Tmsb15b1,X,136974022,136976874,protein_coding,-1,2852,chrX_136974022_136976874
Slc25a53,X,136981116,137038302,protein_coding,-1,57186,chrX_136981116_137038302
Zcchc18,X,136993155,136998472,protein_coding,1,5317,chrX_136993155_136998472
Fam199x,X,137049594,137082503,protein_coding,1,32909,chrX_137049594_137082503
Esx1,X,137115397,137122083,protein_coding,-1,6686,chrX_137115397_137122083
Il1rapl2,X,137570608,138846946,protein_coding,1,1276338,chrX_137570608_138846946
Tex13a,X,138208165,138209580,protein_coding,-1,1415,chrX_138208165_138209580
Nrk,X,138914430,139010532,protein_coding,1,96102,chrX_138914430_139010532
Rnf128,X,139563316,139673145,protein_coding,1,109829,chrX_139563316_139673145
Tbc1d8b,X,139684996,139753405,protein_coding,1,68409,chrX_139684996_139753405
Gm15013,X,139713681,139714481,protein_coding,-1,800,chrX_139713681_139714481
Cldn2,X,139800828,139811386,protein_coding,1,10558,chrX_139800828_139811386
Morc4,X,139821632,139871677,protein_coding,-1,50045,chrX_139821632_139871677
Rbm41,X,139889511,139998595,protein_coding,-1,109084,chrX_139889511_139998595
Nup62cl,X,140006805,140062712,protein_coding,-1,55907,chrX_140006805_140062712
Pih1h3b,X,140062879,140106797,protein_coding,1,43918,chrX_140062879_140106797
Gm15046,X,140178698,140277862,lincRNA,-1,99164,chrX_140178698_140277862
Frmpd3,X,140342263,140435467,protein_coding,1,93204,chrX_140342263_140435467
Prps1,X,140456613,140476140,protein_coding,1,19527,chrX_140456613_140476140
Tsc22d3,X,140539528,140600659,protein_coding,-1,61131,chrX_140539528_140600659
Mid2,X,140664599,140767715,protein_coding,1,103116,chrX_140664599_140767715
Eif2c5,X,140776235,140796880,lincRNA;lncRNA,1,20645,chrX_140776235_140796880
Tex13b,X,140808307,140813433,protein_coding,-1,5126,chrX_140808307_140813433
Vsig1,X,140907608,140939472,protein_coding,1,31864,chrX_140907608_140939472
Psmd10,X,140948429,140956728,protein_coding,-1,8299,chrX_140948429_140956728
Atg4a,X,140956907,141164270,protein_coding,1,207363,chrX_140956907_141164270
Col4a6,X,141047650,141474076,protein_coding,-1,426426,chrX_141047650_141474076
Col4a5,X,141475385,141689234,protein_coding,1,213849,chrX_141475385_141689234
Irs4,X,141710998,141725263,protein_coding,-1,14265,chrX_141710998_141725263
Gm15298,X,141900582,141902455,lincRNA,-1,1873,chrX_141900582_141902455
Gucy2f,X,142081160,142196931,protein_coding,-1,115771,chrX_142081160_142196931
Nxt2,X,142226770,142239692,protein_coding,1,12922,chrX_142226770_142239692
Kcne1l,X,142304752,142306294,protein_coding,-1,1542,chrX_142304752_142306294
Acsl4,X,142317993,142390535,protein_coding,-1,72542,chrX_142317993_142390535
Tmem164,X,142681406,142843494,protein_coding,1,162088,chrX_142681406_142843494
Ammecr1,X,142851146,142966728,protein_coding,-1,115582,chrX_142851146_142966728
Rtl9,X,143099594,143104297,protein_coding,1,4703,chrX_143099594_143104297
Chrdl1,X,143285674,143394262,protein_coding,-1,108588,chrX_143285674_143394262
Pak3,X,143518591,143797796,protein_coding,1,279205,chrX_143518591_143797796
Capn6,X,143802231,143827414,protein_coding,-1,25183,chrX_143802231_143827414
Dcx,X,143855842,143933311,protein_coding,-1,77469,chrX_143855842_143933311
A730046J19Rik,X,144153695,144166274,protein_coding,1,12579,chrX_144153695_144166274
Alg13,X,144317804,144374450,protein_coding,1,56646,chrX_144317804_144374450
Trpc5,X,144381671,144688180,protein_coding,-1,306509,chrX_144381671_144688180
Trpc5os,X,144456581,144477066,protein_coding,1,20485,chrX_144456581_144477066
Rtl4,X,144688907,145122411,protein_coding,1,433504,chrX_144688907_145122411
Lhfpl1,X,145290359,145349089,protein_coding,-1,58730,chrX_145290359_145349089
Amot,X,145446425,145505181,protein_coding,-1,58756,chrX_145446425_145505181
Htr2c,X,146962513,147197277,protein_coding,1,234764,chrX_146962513_147197277
Il13ra2,X,147383476,147429192,protein_coding,-1,45716,chrX_147383476_147429192
Lrch2,X,147470375,147554081,protein_coding,-1,83706,chrX_147470375_147554081
Gm15128,X,147765991,147833456,protein_coding,1,67465,chrX_147765991_147833456
Gm15080,X,147992993,148033174,protein_coding,1,40181,chrX_147992993_148033174
Gm15107,X,148180724,148224710,protein_coding,1,43986,chrX_148180724_148224710
Gm15127,X,148663598,148703849,protein_coding,1,40251,chrX_148663598_148703849
Luzp4,X,148857640,148924139,protein_coding,1,66499,chrX_148857640_148924139
Ott,X,149074282,149138152,protein_coding,1,63870,chrX_149074282_149138152
Gm15093,X,149272377,149305003,protein_coding,1,32626,chrX_149272377_149305003
Gm15085,X,149447617,149487784,protein_coding,1,40167,chrX_149447617_149487784
Gm10439,X,149594570,149636764,protein_coding,1,42194,chrX_149594570_149636764
Gm15097,X,149784473,149826694,protein_coding,1,42221,chrX_149784473_149826694
Gm15091,X,149941655,149984982,protein_coding,1,43327,chrX_149941655_149984982
Gm15104,X,150312601,150333065,lincRNA,-1,20464,chrX_150312601_150333065
Tmem29,X,150397773,150459154,protein_coding,-1,61381,chrX_150397773_150459154
Apex2,X,150519519,150589868,protein_coding,-1,70349,chrX_150519519_150589868
Alas2,X,150547375,150570638,protein_coding,1,23263,chrX_150547375_150570638
Pfkfb1,X,150588229,150643878,protein_coding,1,55649,chrX_150588229_150643878
Tro,X,150645304,150657583,protein_coding,-1,12279,chrX_150645304_150657583
Maged2,X,150806370,150814345,protein_coding,-1,7975,chrX_150806370_150814345
Gnl3l,X,150983141,151017322,protein_coding,-1,34181,chrX_150983141_151017322
Fgd1,X,151046150,151089521,protein_coding,1,43371,chrX_151046150_151089521
Tsr2,X,151087094,151096543,protein_coding,-1,9449,chrX_151087094_151096543
Gm15138,X,151169700,151171764,lincRNA,1,2064,chrX_151169700_151171764
Wnk3,X,151198078,151320152,protein_coding,1,122074,chrX_151198078_151320152
A230072E10Rik,X,151291974,151344846,antisense,-1,52872,chrX_151291974_151344846
Fam120c,X,151344175,151471842,protein_coding,1,127667,chrX_151344175_151471842
Phf8,X,151520672,151633859,protein_coding,1,113187,chrX_151520672_151633859
Huwe1,X,151800807,151935417,protein_coding,1,134610,chrX_151800807_151935417
Hsd17b10,X,152001845,152004442,protein_coding,1,2597,chrX_152001845_152004442
Ribc1,X,152004582,152016295,protein_coding,-1,11713,chrX_152004582_152016295
Smc1a,X,152016428,152062694,protein_coding,1,46266,chrX_152016428_152062694
Iqsec2,X,152144268,152225236,protein_coding,1,80968,chrX_152144268_152225236
Kdm5c,X,152233020,152274535,protein_coding,1,41515,chrX_152233020_152274535
Kantr,X,152294828,152327495,protein_coding,-1,32667,chrX_152294828_152327495
Tspyl2,X,152336852,152342425,protein_coding,-1,5573,chrX_152336852_152342425
Gpr173,X,152343598,152368704,protein_coding,-1,25106,chrX_152343598_152368704
Shroom2,X,152609509,152769465,protein_coding,-1,159956,chrX_152609509_152769465
Gpr143,X,152781921,152808646,protein_coding,1,26725,chrX_152781921_152808646
Usp51,X,153006469,153009416,protein_coding,1,2947,chrX_153006469_153009416
Mageh1,X,153036166,153037575,protein_coding,-1,1409,chrX_153036166_153037575
Foxr2,X,153118786,153132861,protein_coding,1,14075,chrX_153118786_153132861
Rragb,X,153139981,153171943,protein_coding,1,31962,chrX_153139981_153171943
Klf8,X,153237466,153396132,protein_coding,1,158666,chrX_153237466_153396132
Ubqln2,X,153498227,153501570,protein_coding,1,3343,chrX_153498227_153501570
Kctd12b,X,153685154,153696391,protein_coding,-1,11237,chrX_153685154_153696391
Gm45022,X,153721157,153723881,antisense,-1,2724,chrX_153721157_153723881
Nbdy,X,153723590,153741920,protein_coding,1,18330,chrX_153723590_153741920
Spin2c,X,153832225,153834243,protein_coding,1,2018,chrX_153832225_153834243
Magea6,X,154924012,154935987,protein_coding,-1,11975,chrX_154924012_154935987
Magea8,X,154985775,154995850,protein_coding,-1,10075,chrX_154985775_154995850
Magea2,X,155027201,155093666,protein_coding,-1,66465,chrX_155027201_155093666
Sat1,X,155213132,155216449,protein_coding,-1,3317,chrX_155213132_155216449
Acot9,X,155262443,155297654,protein_coding,1,35211,chrX_155262443_155297654
Prdx4,X,155323918,155340754,protein_coding,-1,16836,chrX_155323918_155340754
Ptchd1,X,155573455,155623814,protein_coding,-1,50359,chrX_155573455_155623814
Gm15156,X,155622789,155623361,antisense,1,572,chrX_155622789_155623361
Gm15155,X,155624741,156345887,protein_coding,1,721146,chrX_155624741_156345887
Phex,X,157162075,157415312,protein_coding,-1,253237,chrX_157162075_157415312
Sms,X,157443855,157492287,protein_coding,-1,48432,chrX_157443855_157492287
Mbtps2,X,157535371,157598715,protein_coding,-1,63344,chrX_157535371_157598715
Smpx,X,157698910,157752591,protein_coding,1,53681,chrX_157698910_157752591
Gm15169,X,157757427,157798019,antisense,-1,40592,chrX_157757427_157798019
Klhl34,X,157818435,157820369,protein_coding,1,1934,chrX_157818435_157820369
Cnksr2,X,157821436,158043294,protein_coding,-1,221858,chrX_157821436_158043294
Rps6ka3,X,159210307,159368244,protein_coding,1,157937,chrX_159210307_159368244
Eif1ax,X,159372178,159389928,protein_coding,1,17750,chrX_159372178_159389928
Map7d2,X,159414572,159498757,protein_coding,1,84185,chrX_159414572_159498757
Bclaf3,X,159526688,159593081,protein_coding,1,66393,chrX_159526688_159593081
Sh3kbp1,X,159627272,159978069,protein_coding,1,350797,chrX_159627272_159978069
Map3k15,X,159988433,160123351,protein_coding,1,134918,chrX_159988433_160123351
Pdha1,X,160122209,160138413,protein_coding,-1,16204,chrX_160122209_160138413
Adgrg2,X,160390690,160498070,protein_coding,1,107380,chrX_160390690_160498070
Gm15241,X,160488549,160499870,antisense,-1,11321,chrX_160488549_160499870
Phka2,X,160502166,160598878,protein_coding,1,96712,chrX_160502166_160598878
Gm15243,X,160527501,160533045,antisense,-1,5544,chrX_160527501_160533045
Ppef1,X,160623094,160735765,protein_coding,-1,112671,chrX_160623094_160735765
Rs1,X,160768013,160799663,protein_coding,1,31650,chrX_160768013_160799663
Cdkl5,X,160771923,160994704,protein_coding,-1,222781,chrX_160771923_160994704
Scml2,X,161082525,161258213,protein_coding,1,175688,chrX_161082525_161258213
Gm15262,X,161287456,161366252,protein_coding,1,78796,chrX_161287456_161366252
Rai2,X,161717069,161779496,protein_coding,1,62427,chrX_161717069_161779496
Scml1,X,161814690,161832176,transcribed_unitary_pseudogene,-1,17486,chrX_161814690_161832176
Nhs,X,161833296,162159730,protein_coding,-1,326434,chrX_161833296_162159730
Reps2,X,162411954,162643649,protein_coding,-1,231695,chrX_162411954_162643649
Rbbp7,X,162760402,162779092,protein_coding,1,18690,chrX_162760402_162779092
Txlng,X,162778919,162829454,protein_coding,-1,50535,chrX_162778919_162829454
Syap1,X,162857057,162888447,protein_coding,-1,31390,chrX_162857057_162888447
Ctps2,X,162901238,163032508,protein_coding,1,131270,chrX_162901238_163032508
S100g,X,162961992,162964599,protein_coding,-1,2607,chrX_162961992_162964599
Grpr,X,163513904,163549677,protein_coding,-1,35773,chrX_163513904_163549677
Rnf138rt1,X,163760139,163761329,protein_coding,-1,1190,chrX_163760139_163761329
Ap1s2,X,163909017,163933666,protein_coding,1,24649,chrX_163909017_163933666
Zrsr2,X,163935443,163958661,protein_coding,-1,23218,chrX_163935443_163958661
Car5b,X,163976822,164027997,protein_coding,-1,51175,chrX_163976822_164027997
Siah1b,X,164070705,164076493,protein_coding,-1,5788,chrX_164070705_164076493
Ace2,X,164139332,164188420,protein_coding,1,49088,chrX_164139332_164188420
Bmx,X,164192842,164258193,protein_coding,-1,65351,chrX_164192842_164258193
Pir,X,164269371,164373011,protein_coding,1,103640,chrX_164269371_164373011
Vegfd,X,164373378,164402650,protein_coding,1,29272,chrX_164373378_164402650
Piga,X,164419787,164433916,protein_coding,1,14129,chrX_164419787_164433916
Asb11,X,164436994,164459170,protein_coding,1,22176,chrX_164436994_164459170
Asb9,X,164506327,164539752,protein_coding,1,33425,chrX_164506327_164539752
Mospd2,X,164936169,164980375,protein_coding,-1,44206,chrX_164936169_164980375
Fancb,X,164980592,164997272,protein_coding,1,16680,chrX_164980592_164997272
Gm17604,X,165003765,165004829,protein_coding,-1,1064,chrX_165003765_165004829
Glra2,X,165129017,165327393,protein_coding,-1,198376,chrX_165129017_165327393
Gemin8,X,166170454,166190512,protein_coding,1,20058,chrX_166170454_166190512
Gpm6b,X,166238911,166388988,protein_coding,1,150077,chrX_166238911_166388988
Ofd1,X,166390033,166440704,protein_coding,-1,50671,chrX_166390033_166440704
Trappc2,X,166440574,166453140,protein_coding,1,12566,chrX_166440574_166453140
Rab9,X,166457253,166479867,protein_coding,-1,22614,chrX_166457253_166479867
Tceanc,X,166499812,166518567,protein_coding,-1,18755,chrX_166499812_166518567
Egfl6,X,166523007,166585720,protein_coding,-1,62713,chrX_166523007_166585720
Gm15226,X,166618102,166621542,lincRNA,-1,3440,chrX_166618102_166621542
Gm1720,X,166662025,166689812,lincRNA,1,27787,chrX_166662025_166689812
Gm15230,X,166857669,166864449,lincRNA,-1,6780,chrX_166857669_166864449
Gm8817,X,167063194,167070380,lincRNA,-1,7186,chrX_167063194_167070380
Gm15232,X,167088093,167102090,lincRNA,-1,13997,chrX_167088093_167102090
Gm15228,X,167164097,167171278,lincRNA,1,7181,chrX_167164097_167171278
Tmsb4x,X,167207093,167209315,protein_coding,-1,2222,chrX_167207093_167209315
Tlr8,X,167242696,167264329,protein_coding,-1,21633,chrX_167242696_167264329
Tlr7,X,167304929,167330558,protein_coding,-1,25629,chrX_167304929_167330558
Prps2,X,167346322,167382749,protein_coding,-1,36427,chrX_167346322_167382749
Gm15239,X,167361455,167364421,antisense,1,2966,chrX_167361455_167364421
Frmpd4,X,167471309,168577231,protein_coding,-1,1105922,chrX_167471309_168577231
Msl3,X,168654117,168673898,protein_coding,-1,19781,chrX_168654117_168673898
Arhgap6,X,168795099,169304435,protein_coding,1,509336,chrX_168795099_169304435
Gm15261,X,169037674,169106536,antisense,-1,68862,chrX_169037674_169106536
Amelx,X,169176114,169187200,protein_coding,-1,11086,chrX_169176114_169187200
Hccs,X,169250193,169320372,protein_coding,-1,70179,chrX_169250193_169320372
Gm15245,X,169447830,169475913,lincRNA,1,28083,chrX_169447830_169475913
Mid1,X,169685199,170005736,protein_coding,1,320537,chrX_169685199_170005736
4933400A11Rik,X,169776257,169779635,protein_coding,-1,3378,chrX_169776257_169779635
Gm15726,X,169979047,169985232,antisense,-1,6185,chrX_169979047_169985232
Gm15247,X,169985801,169986939,antisense,-1,1138,chrX_169985801_169986939
Asmt,X,170672644,170678054,protein_coding,1,5410,chrX_170672644_170678054
Hnf4g,3,3508030,3658052,protein_coding,1,150022,chr3_3508030_3658052
1110015O18Rik,3,4797558,4814911,lincRNA,1,17353,chr3_4797558_4814911
Gm17308,3,5090276,5094776,lincRNA,1,4500,chr3_5090276_5094776
2700069I18Rik,3,5177586,5220841,antisense,-1,43255,chr3_5177586_5220841
Zfhx4,3,5218526,5415857,protein_coding,1,197331,chr3_5218526_5415857
Pex2,3,5560188,5576239,protein_coding,-1,16051,chr3_5560188_5576239
Gm8797,3,5750806,5751295,protein_coding,1,489,chr3_5750806_5751295
Gm37350,3,5880832,5885503,lincRNA,-1,4671,chr3_5880832_5885503
Pkia,3,7366669,7445366,protein_coding,1,78697,chr3_7366669_7445366
Zc2hc1a,3,7503483,7553836,protein_coding,1,50353,chr3_7503483_7553836
Il7,3,7569994,7613760,protein_coding,-1,43766,chr3_7569994_7613760
Gm16685,3,7612705,7690001,antisense,1,77296,chr3_7612705_7690001
1700010I02Rik,3,7925303,7954889,lincRNA,-1,29586,chr3_7925303_7954889
Stmn2,3,8509360,8561606,protein_coding,1,52246,chr3_8509360_8561606
Gm32496,3,8628051,8632454,lincRNA,1,4403,chr3_8628051_8632454
Hey1,3,8663359,8667256,protein_coding,-1,3897,chr3_8663359_8667256
C230057A21Rik,3,8732870,8736360,lincRNA,-1,3490,chr3_8732870_8736360
Mrps28,3,8802146,8923918,protein_coding,-1,121772,chr3_8802146_8923918
Tpd52,3,8925593,9004723,protein_coding,-1,79130,chr3_8925593_9004723
4930539M17Rik,3,9061964,9071074,lincRNA,1,9110,chr3_9061964_9071074
Zbtb10,3,9250602,9285333,protein_coding,1,34731,chr3_9250602_9285333
C030034L19Rik,3,9403064,9437233,lincRNA,1,34169,chr3_9403064_9437233
Zfp704,3,9427020,9610085,protein_coding,-1,183065,chr3_9427020_9610085
Pag1,3,9687479,9833679,protein_coding,-1,146200,chr3_9687479_9833679
Gm16337,3,9757607,9786142,lincRNA,1,28535,chr3_9757607_9786142
Fabp5,3,10012548,10016607,protein_coding,1,4059,chr3_10012548_10016607
Gm38335,3,10022311,10025539,lincRNA,-1,3228,chr3_10022311_10025539
Gm9833,3,10088110,10092565,protein_coding,1,4455,chr3_10088110_10092565
Fabp4,3,10204088,10208576,protein_coding,-1,4488,chr3_10204088_10208576
Fabp12,3,10244209,10301183,protein_coding,-1,56974,chr3_10244209_10301183
Impa1,3,10311956,10331439,protein_coding,-1,19483,chr3_10311956_10331439
Gm38303,3,10321712,10335681,protein_coding,-1,13969,chr3_10321712_10335681
Zfand1,3,10339953,10351317,protein_coding,-1,11364,chr3_10339953_10351317
Chmp4c,3,10366907,10428856,protein_coding,1,61949,chr3_10366907_10428856
Snx16,3,10417817,10440102,protein_coding,-1,22285,chr3_10417817_10440102
Gm10745,3,11823229,11844359,lincRNA,-1,21130,chr3_11823229_11844359
Gm2464,3,13470439,13471829,lincRNA,-1,1390,chr3_13470439_13471829
Ralyl,3,13471655,14182287,protein_coding,1,710632,chr3_13471655_14182287
Slc7a12,3,14480697,14505830,protein_coding,1,25133,chr3_14480697_14505830
Lrrcc1,3,14533788,14572658,protein_coding,1,38870,chr3_14533788_14572658
E2f5,3,14578641,14606309,protein_coding,1,27668,chr3_14578641_14606309
Car13,3,14641727,14663002,protein_coding,1,21275,chr3_14641727_14663002
Car1,3,14766216,14808368,protein_coding,-1,42152,chr3_14766216_14808368
Car3,3,14863512,14872523,protein_coding,1,9011,chr3_14863512_14872523
Car2,3,14886273,14900770,protein_coding,1,14497,chr3_14886273_14900770
A930001A20Rik,3,14971201,15002727,lincRNA,1,31526,chr3_14971201_15002727
Gm33819,3,15153065,15171442,lincRNA,-1,18377,chr3_15153065_15171442
Gm9733,3,15296551,15332302,protein_coding,-1,35751,chr3_15296551_15332302
Sirpb1a,3,15371653,15426520,protein_coding,-1,54867,chr3_15371653_15426520
Sirpb1b,3,15495751,15575065,protein_coding,-1,79314,chr3_15495751_15575065
Sirpb1c,3,15795145,15874777,protein_coding,-1,79632,chr3_15795145_15874777
Gm5150,3,15946870,16032686,protein_coding,-1,85816,chr3_15946870_16032686
Ythdf3,3,16183212,16217037,protein_coding,1,33825,chr3_16183212_16217037
Gm30340,3,17328694,17334425,lincRNA,-1,5731,chr3_17328694_17334425
Mir124-2hg,3,17789921,17808970,lincRNA,1,19049,chr3_17789921_17808970
Bhlhe22,3,18054174,18057517,protein_coding,1,3343,chr3_18054174_18057517
Cyp7b1,3,18071950,18243338,protein_coding,-1,171388,chr3_18071950_18243338
Gm30667,3,18341667,18461254,lincRNA,-1,119587,chr3_18341667_18461254
4930433B08Rik,3,18468287,18480477,lincRNA,-1,12190,chr3_18468287_18480477
Armc1,3,19131402,19163065,protein_coding,-1,31663,chr3_19131402_19163065
Mtfr1,3,19187327,19220817,protein_coding,1,33490,chr3_19187327_19220817
Pde7a,3,19223108,19311322,protein_coding,-1,88214,chr3_19223108_19311322
Gm16093,3,19227780,19240987,antisense,1,13207,chr3_19227780_19240987
Dnajc5b,3,19508595,19610862,protein_coding,1,102267,chr3_19508595_19610862
1700064H15Rik,3,19610368,19628677,protein_coding,-1,18309,chr3_19610368_19628677
Trim55,3,19644474,19692421,protein_coding,1,47947,chr3_19644474_19692421
Crh,3,19693401,19695396,protein_coding,-1,1995,chr3_19693401_19695396
4632415L05Rik,3,19894886,19901033,transcribed_unprocessed_pseudogene,1,6147,chr3_19894886_19901033
Cp,3,19957054,20009145,protein_coding,1,52091,chr3_19957054_20009145
Hps3,3,19995945,20035315,protein_coding,-1,39370,chr3_19995945_20035315
Hltf,3,20057811,20118490,protein_coding,1,60679,chr3_20057811_20118490
Gyg,3,20122084,20155317,protein_coding,-1,33233,chr3_20122084_20155317
Cpa3,3,20215620,20242181,protein_coding,-1,26561,chr3_20215620_20242181
Cpb1,3,20248264,20275733,protein_coding,-1,27469,chr3_20248264_20275733
Agtr1b,3,20314473,20367177,protein_coding,-1,52704,chr3_20314473_20367177
Gm31466,3,20503098,20506208,lincRNA,-1,3110,chr3_20503098_20506208
Gm29137,3,21268372,21269090,lincRNA,-1,718,chr3_21268372_21269090
Gm31693,3,21702815,21712460,lincRNA,1,9645,chr3_21702815_21712460
Gm43674,3,21997678,21998468,lincRNA,-1,790,chr3_21997678_21998468
Gm43672,3,22074412,22076142,lincRNA,-1,1730,chr3_22074412_22076142
Tbl1xr1,3,22076652,22216594,protein_coding,1,139942,chr3_22076652_22216594
Gm38324,3,22285081,22297830,lincRNA,-1,12749,chr3_22285081_22297830
4930412E21Rik,3,23461050,23521398,lincRNA,1,60348,chr3_23461050_23521398
Naaladl2,3,23798102,25144261,protein_coding,-1,1346159,chr3_23798102_25144261
Nlgn1,3,25426215,26332460,protein_coding,-1,906245,chr3_25426215_26332460
A830092H15Rik,3,26331150,26333377,antisense,1,2227,chr3_26331150_26333377
Spata16,3,26637620,26983212,protein_coding,1,345592,chr3_26637620_26983212
Ect2,3,27097222,27153878,protein_coding,-1,56656,chr3_27097222_27153878
1700125G22Rik,3,27154026,27157019,lincRNA,1,2993,chr3_27154026_27157019
Nceh1,3,27182965,27284608,protein_coding,1,101643,chr3_27182965_27284608
Tnfsf10,3,27317028,27342427,protein_coding,1,25399,chr3_27317028_27342427
Fndc3b,3,27416162,27711307,protein_coding,-1,295145,chr3_27416162_27711307
Tmem212,3,27866066,27896368,protein_coding,-1,30302,chr3_27866066_27896368
Pld1,3,27938695,28133362,protein_coding,1,194667,chr3_27938695_28133362
Gm42196,3,28176553,28212209,lincRNA,1,35656,chr3_28176553_28212209
Tnik,3,28263214,28675858,protein_coding,1,412644,chr3_28263214_28675858
Slc2a2,3,28697903,28731359,protein_coding,1,33456,chr3_28697903_28731359
1700112D23Rik,3,28702667,28781108,antisense,-1,78441,chr3_28702667_28781108
Eif5a2,3,28781276,28798846,protein_coding,1,17570,chr3_28781276_28798846
Gm32950,3,28802804,28805336,lincRNA,-1,2532,chr3_28802804_28805336
Rpl22l1,3,28805436,28807424,protein_coding,1,1988,chr3_28805436_28807424
Gm33051,3,28807205,28813985,antisense,-1,6780,chr3_28807205_28813985
Gm37867,3,28852033,28854257,lincRNA,-1,2224,chr3_28852033_28854257
Gm1527,3,28892617,28926724,protein_coding,1,34107,chr3_28892617_28926724
Egfem1,3,29082023,29691209,protein_coding,1,609186,chr3_29082023_29691209
Gm33206,3,29773466,29893177,lincRNA,-1,119711,chr3_29773466_29893177
Mannr,3,29891014,29924191,lincRNA,1,33177,chr3_29891014_29924191
Mecom,3,29951296,30548008,protein_coding,-1,596712,chr3_29951296_30548008
Mecomos,3,30012379,30054808,antisense,1,42429,chr3_30012379_30054808
Gm38258,3,30552697,30564243,lincRNA,-1,11546,chr3_30552697_30564243
Actrt3,3,30597073,30599939,protein_coding,-1,2866,chr3_30597073_30599939
Mynn,3,30602065,30619873,protein_coding,1,17808,chr3_30602065_30619873
Lrrc34,3,30624267,30647869,protein_coding,-1,23602,chr3_30624267_30647869
Lrriq4,3,30644507,30672431,protein_coding,1,27924,chr3_30644507_30672431
Lrrc31,3,30679058,30699843,protein_coding,-1,20785,chr3_30679058_30699843
Gm15462,3,30686085,30692366,antisense,1,6281,chr3_30686085_30692366
Samd7,3,30746293,30767174,protein_coding,1,20881,chr3_30746293_30767174
4933429H19Rik,3,30792570,30793564,antisense,-1,994,chr3_30792570_30793564
Sec62,3,30792875,30821263,protein_coding,1,28388,chr3_30792875_30821263
Gpr160,3,30855950,30897192,protein_coding,1,41242,chr3_30855950_30897192
Phc3,3,30899371,30969415,protein_coding,-1,70044,chr3_30899371_30969415
Prkci,3,30995747,31052959,protein_coding,1,57212,chr3_30995747_31052959
Skil,3,31095058,31122577,protein_coding,1,27519,chr3_31095058_31122577
Cldn11,3,31149920,31164324,protein_coding,1,14404,chr3_31149920_31164324
Slc7a14,3,31202858,31310378,protein_coding,-1,107520,chr3_31202858_31310378
Gm15496,3,31285587,31316891,antisense,1,31304,chr3_31285587_31316891
Gm38025,3,31341012,31345280,lincRNA,1,4268,chr3_31341012_31345280
Kcnmb2,3,31902507,32200180,protein_coding,1,297673,chr3_31902507_32200180
Zmat3,3,32334792,32366014,protein_coding,-1,31222,chr3_32334792_32366014
Pik3ca,3,32397671,32468486,protein_coding,1,70815,chr3_32397671_32468486
Kcnmb3,3,32471588,32492231,protein_coding,-1,20643,chr3_32471588_32492231
Zfp639,3,32510259,32520833,protein_coding,1,10574,chr3_32510259_32520833
Gm37592,3,32511803,32512344,antisense,-1,541,chr3_32511803_32512344
Mfn1,3,32529465,32579239,protein_coding,1,49774,chr3_32529465_32579239
Gnb4,3,32580332,32616585,protein_coding,-1,36253,chr3_32580332_32616585
Gm37640,3,32610861,32613513,antisense,1,2652,chr3_32610861_32613513
Actl6a,3,32706298,32726973,protein_coding,1,20675,chr3_32706298_32726973
Mrpl47,3,32725397,32737605,protein_coding,-1,12208,chr3_32725397_32737605
Ndufb5,3,32736990,32751566,protein_coding,1,14576,chr3_32736990_32751566
Usp13,3,32817546,32938071,protein_coding,1,120525,chr3_32817546_32938071
Gm37459,3,32939314,32983301,antisense,1,43987,chr3_32939314_32983301
Pex5l,3,32949408,33143247,protein_coding,-1,193839,chr3_32949408_33143247
4930419G24Rik,3,33024777,33088607,antisense,1,63830,chr3_33024777_33088607
Gm43666,3,33703355,33759616,lincRNA,-1,56261,chr3_33703355_33759616
Ttc14,3,33799832,33814860,protein_coding,1,15028,chr3_33799832_33814860
Ccdc39,3,33812362,33844310,protein_coding,-1,31948,chr3_33812362_33844310
Gm43140,3,33817256,33817946,antisense,1,690,chr3_33817256_33817946
4930431L21Rik,3,33866813,33897584,lincRNA,-1,30771,chr3_33866813_33897584
Gm43077,3,34017708,34019882,lincRNA,-1,2174,chr3_34017708_34019882
Fxr1,3,34019943,34070322,protein_coding,1,50379,chr3_34019943_34070322
Dnajc19,3,34056020,34081321,protein_coding,-1,25301,chr3_34056020_34081321
Gm38505,3,34298172,34351712,lincRNA,-1,53540,chr3_34298172_34351712
Gm34599,3,34416495,34418162,lincRNA,1,1667,chr3_34416495_34418162
Gm20515,3,34427373,34435097,lincRNA,-1,7724,chr3_34427373_34435097
Gm29135,3,34481428,34482207,lincRNA,-1,779,chr3_34481428_34482207
Gm42695,3,34565265,34572202,lincRNA,-1,6937,chr3_34565265_34572202
Gm42205,3,34598519,34602248,lincRNA,-1,3729,chr3_34598519_34602248
Sox2,3,34650405,34652461,protein_coding,1,2056,chr3_34650405_34652461
Gm3143,3,34699640,34716662,lincRNA,-1,17022,chr3_34699640_34716662
Gm38509,3,34772075,34782346,lincRNA,1,10271,chr3_34772075_34782346
Gm21388,3,34826616,34879284,lincRNA,1,52668,chr3_34826616_34879284
1700017M07Rik,3,35256462,35276131,lincRNA,-1,19669,chr3_35256462_35276131
Gm6639,3,35597152,35666163,lincRNA,-1,69011,chr3_35597152_35666163
Atp11b,3,35754106,35856276,protein_coding,1,102170,chr3_35754106_35856276
Dcun1d1,3,35892105,35937445,protein_coding,-1,45340,chr3_35892105_35937445
Gm15952,3,35933045,35990840,antisense,1,57795,chr3_35933045_35990840
Mccc1,3,35959312,36000678,protein_coding,-1,41366,chr3_35959312_36000678
Mccc1os,3,35999833,36025106,antisense,1,25273,chr3_35999833_36025106
Ccdc144b,3,36007244,36053547,protein_coding,-1,46303,chr3_36007244_36053547
Acad9,3,36065979,36092853,protein_coding,1,26874,chr3_36065979_36092853
Qrfpr,3,36179424,36222313,protein_coding,-1,42889,chr3_36179424_36222313
Gm43255,3,36203289,36205623,antisense,1,2334,chr3_36203289_36205623
Anxa5,3,36448923,36475894,protein_coding,-1,26971,chr3_36448923_36475894
1810062G17Rik,3,36475937,36482299,protein_coding,1,6362,chr3_36475937_36482299
Gm11548,3,36499804,36506809,lincRNA,-1,7005,chr3_36499804_36506809
Gm11549,3,36515057,36532384,protein_coding,-1,17327,chr3_36515057_36532384
Exosc9,3,36552606,36565727,protein_coding,1,13121,chr3_36552606_36565727
Ccna2,3,36564865,36572150,protein_coding,-1,7285,chr3_36564865_36572150
Bbs7,3,36573142,36613477,protein_coding,-1,40335,chr3_36573142_36613477
Trpc3,3,36620482,36690167,protein_coding,-1,69685,chr3_36620482_36690167
4932438A13Rik,3,36863104,37053033,protein_coding,1,189929,chr3_36863104_37053033
Gm12531,3,37052215,37060035,antisense,-1,7820,chr3_37052215_37060035
Adad1,3,37063527,37121930,protein_coding,1,58403,chr3_37063527_37121930
Il2,3,37120523,37125959,protein_coding,-1,5436,chr3_37120523_37125959
Gm12532,3,37182885,37188593,lincRNA,1,5708,chr3_37182885_37188593
Il21,3,37222759,37232636,protein_coding,-1,9877,chr3_37222759_37232636
Cetn4,3,37307749,37312708,protein_coding,-1,4959,chr3_37307749_37312708
Bbs12,3,37312554,37321453,protein_coding,1,8899,chr3_37312554_37321453
Fgf2os,3,37335332,37349740,antisense,-1,14408,chr3_37335332_37349740
Fgf2,3,37348346,37410108,protein_coding,1,61762,chr3_37348346_37410108
Nudt6,3,37404910,37420211,protein_coding,-1,15301,chr3_37404910_37420211
Spata5,3,37419896,37579096,protein_coding,1,159200,chr3_37419896_37579096
Spry1,3,37639947,37644598,protein_coding,1,4651,chr3_37639947_37644598
Gm5148,3,37714190,37724490,protein_coding,-1,10300,chr3_37714190_37724490
Gm42921,3,37761037,37767297,lincRNA,1,6260,chr3_37761037_37767297
Gm20755,3,37898813,37992728,lincRNA,1,93915,chr3_37898813_37992728
Gm43821,3,38094629,38130191,lincRNA,-1,35562,chr3_38094629_38130191
Gm36823,3,38426552,38443874,lincRNA,-1,17322,chr3_38426552_38443874
Ankrd50,3,38449259,38484844,protein_coding,-1,35585,chr3_38449259_38484844
C230034O21Rik,3,38874570,38888259,antisense,-1,13689,chr3_38874570_38888259
Fat4,3,38886940,39011985,protein_coding,1,125045,chr3_38886940_39011985
Gm43539,3,39008602,39009681,antisense,-1,1079,chr3_39008602_39009681
1700017G19Rik,3,40504867,40522912,lincRNA;lncRNA,-1,18045,chr3_40504867_40522912
Intu,3,40531286,40704774,protein_coding,1,173488,chr3_40531286_40704774
Slc25a31,3,40609136,40726096,protein_coding,1,116960,chr3_40609136_40726096
Hspa4l,3,40645663,40796103,protein_coding,1,150440,chr3_40645663_40796103
Plk4,3,40700300,40816883,protein_coding,1,116583,chr3_40700300_40816883
Mfsd8,3,40718384,40846886,protein_coding,-1,128502,chr3_40718384_40846886
Abhd18,3,40747251,40938138,protein_coding,1,190887,chr3_40747251_40938138
1700034I23Rik,3,40800477,40902543,protein_coding,-1,102066,chr3_40800477_40902543
Larp1b,3,40949828,41040234,protein_coding,1,90406,chr3_40949828_41040234
Pgrmc2,3,41066326,41083046,protein_coding,-1,16720,chr3_41066326_41083046
Gm40038,3,41163048,41172663,lincRNA,-1,9615,chr3_41163048_41172663
Gm16508,3,41286061,41290590,lincRNA,-1,4529,chr3_41286061_41290590
1700052H01Rik,3,41354147,41393589,lincRNA,1,39442,chr3_41354147_41393589
Gm40040,3,41477577,41482391,lincRNA,-1,4814,chr3_41477577_41482391
Platr4,3,41484024,41493192,lincRNA,-1,9168,chr3_41484024_41493192
Jade1,3,41555731,41616864,protein_coding,1,61133,chr3_41555731_41616864
Gm31266,3,41562279,41563698,antisense,-1,1419,chr3_41562279_41563698
Sclt1,3,41626720,41742514,protein_coding,-1,115794,chr3_41626720_41742514
D3Ertd751e,3,41742611,41803320,protein_coding,1,60709,chr3_41742611_41803320
Pcdh10,3,45378398,45435623,protein_coding,1,57225,chr3_45378398_45435623
1700027H10Rik,3,45416584,45439310,antisense,-1,22726,chr3_45416584_45439310
Pabpc4l,3,46442197,46448219,protein_coding,-1,6022,chr3_46442197_46448219
Gm37190,3,48748510,48760949,lincRNA,-1,12439,chr3_48748510_48760949
Gm31415,3,49062378,49085259,lincRNA,1,22881,chr3_49062378_49085259
Gm20557,3,49325680,49367359,lincRNA,1,41679,chr3_49325680_49367359
Pcdh18,3,49743296,49757325,protein_coding,-1,14029,chr3_49743296_49757325
Slc7a11,3,49892526,50443614,protein_coding,-1,551088,chr3_49892526_50443614
Gm37854,3,50001972,50010783,antisense,1,8811,chr3_50001972_50010783
Gm29230,3,51058910,51074856,lincRNA,-1,15946,chr3_51058910_51074856
Gm38246,3,51103660,51105170,lincRNA,1,1510,chr3_51103660_51105170
Noct,3,51224447,51251644,protein_coding,1,27197,chr3_51224447_51251644
Elf2,3,51252720,51340663,protein_coding,-1,87943,chr3_51252720_51340663
Gm5103,3,51378024,51386324,lincRNA,1,8300,chr3_51378024_51386324
Mgarp,3,51388412,51396738,protein_coding,-1,8326,chr3_51388412_51396738
Ndufc1,3,51404677,51408988,protein_coding,-1,4311,chr3_51404677_51408988
Naa15,3,51415148,51476507,protein_coding,1,61359,chr3_51415148_51476507
Rab33b,3,51483920,51496232,protein_coding,1,12312,chr3_51483920_51496232
Setd7,3,51515319,51560879,protein_coding,-1,45560,chr3_51515319_51560879
Mgst2,3,51660360,51682677,protein_coding,1,22317,chr3_51660360_51682677
Maml3,3,51685907,52105076,protein_coding,-1,419169,chr3_51685907_52105076
Gm37229,3,51812951,51819309,antisense,1,6358,chr3_51812951_51819309
Gm20089,3,51980941,51990075,antisense,1,9134,chr3_51980941_51990075
Gm37202,3,52134047,52221997,lincRNA,-1,87950,chr3_52134047_52221997
Gm37170,3,52198248,52200489,lincRNA,1,2241,chr3_52198248_52200489
Foxo1,3,52268336,52353221,protein_coding,1,84885,chr3_52268336_52353221
Gm20402,3,52268435,52269435,antisense,-1,1000,chr3_52268435_52269435
Gm30173,3,52516964,52550219,lincRNA,1,33255,chr3_52516964_52550219
Gm2447,3,52739716,52776656,lincRNA,1,36940,chr3_52739716_52776656
Gm30292,3,52789004,52797785,lincRNA,-1,8781,chr3_52789004_52797785
Gm20750,3,52906756,52927666,lincRNA,-1,20910,chr3_52906756_52927666
Cog6,3,52981875,53017237,protein_coding,-1,35362,chr3_52981875_53017237
Gm42901,3,53038585,53041755,antisense,-1,3170,chr3_53038585_53041755
Lhfp,3,53041528,53261679,protein_coding,1,220151,chr3_53041528_53261679
Gm43803,3,53110396,53113411,antisense,-1,3015,chr3_53110396_53113411
Nhlrc3,3,53448583,53463332,protein_coding,-1,14749,chr3_53448583_53463332
Gm16206,3,53452619,53457797,antisense,1,5178,chr3_53452619_53457797
Proser1,3,53463666,53481755,protein_coding,1,18089,chr3_53463666_53481755
Stoml3,3,53488653,53508502,protein_coding,1,19849,chr3_53488653_53508502
Frem2,3,53513938,53657355,protein_coding,-1,143417,chr3_53513938_53657355
Gm30735,3,53725477,53733018,lincRNA,1,7541,chr3_53725477_53733018
C820005J03Rik,3,53756731,53772950,lincRNA,1,16219,chr3_53756731_53772950
Ufm1,3,53853376,53863830,protein_coding,-1,10454,chr3_53853376_53863830
Gm31026,3,53924835,53943528,lincRNA,1,18693,chr3_53924835_53943528
Trpc4,3,54156035,54318471,protein_coding,1,162436,chr3_54156035_54318471
Postn,3,54361109,54391037,protein_coding,1,29928,chr3_54361109_54391037
Supt20,3,54692807,54728766,protein_coding,1,35959,chr3_54692807_54728766
Gm21958,3,54713176,54714353,protein_coding,-1,1177,chr3_54713176_54714353
Exosc8,3,54728678,54735393,protein_coding,-1,6715,chr3_54728678_54735393
Alg5,3,54735539,54751318,protein_coding,1,15779,chr3_54735539_54751318
Smad9,3,54755582,54801257,protein_coding,1,45675,chr3_54755582_54801257
Rfxap,3,54803115,54807791,protein_coding,-1,4676,chr3_54803115_54807791
Sertm1,3,54897068,54915887,protein_coding,-1,18819,chr3_54897068_54915887
Ccna1,3,55045469,55055501,protein_coding,-1,10032,chr3_55045469_55055501
4931419H13Rik,3,55055242,55084002,antisense,1,28760,chr3_55055242_55084002
Spg20,3,55112108,55137322,protein_coding,1,25214,chr3_55112108_55137322
Ccdc169,3,55137339,55172935,protein_coding,1,35596,chr3_55137339_55172935
Sohlh2,3,55182028,55209957,protein_coding,1,27929,chr3_55182028_55209957
Dclk1,3,55242364,55539068,protein_coding,1,296704,chr3_55242364_55539068
Gm42609,3,55377457,55403122,antisense,-1,25665,chr3_55377457_55403122
Gm21954,3,55461985,55472210,protein_coding,-1,10225,chr3_55461985_55472210
Gm43549,3,55578105,55582730,lincRNA,-1,4625,chr3_55578105_55582730
Nbea,3,55625195,56183701,protein_coding,-1,558506,chr3_55625195_56183701
Mab21l1,3,55782510,55785001,protein_coding,1,2491,chr3_55782510_55785001
Gm43376,3,55890306,55936699,antisense,1,46393,chr3_55890306_55936699
Tm4sf1,3,57285611,57301988,protein_coding,-1,16377,chr3_57285611_57301988
Tm4sf4,3,57425314,57441677,protein_coding,1,16363,chr3_57425314_57441677
Wwtr1,3,57455649,57575910,protein_coding,-1,120261,chr3_57455649_57575910
Gm26671,3,57612697,57625824,lincRNA,-1,13127,chr3_57612697_57625824
Commd2,3,57644349,57651715,protein_coding,-1,7366,chr3_57644349_57651715
Ankub1,3,57657393,57692799,protein_coding,-1,35406,chr3_57657393_57692799
Rnf13,3,57736062,57835233,protein_coding,1,99171,chr3_57736062_57835233
Pfn2,3,57841895,57848079,protein_coding,-1,6184,chr3_57841895_57848079
Gm40055,3,57953655,57958225,lincRNA,-1,4570,chr3_57953655_57958225
4921539H07Rik,3,58117053,58167616,lincRNA,1,50563,chr3_58117053_58167616
1700007F19Rik,3,58141707,58163807,lincRNA,-1,22100,chr3_58141707_58163807
Tsc22d2,3,58414715,58466783,protein_coding,1,52068,chr3_58414715_58466783
Serp1,3,58519817,58525892,protein_coding,-1,6075,chr3_58519817_58525892
Eif2a,3,58525821,58557501,protein_coding,1,31680,chr3_58525821_58557501
Selenot,3,58576636,58593133,protein_coding,1,16497,chr3_58576636_58593133
Erich6,3,58616300,58637207,protein_coding,-1,20907,chr3_58616300_58637207
Siah2,3,58674938,58692400,protein_coding,-1,17462,chr3_58674938_58692400
4930593A02Rik,3,58692589,58797331,lincRNA,1,104742,chr3_58692589_58797331
Mindy4b-ps,3,58788407,58822311,protein_coding,-1,33904,chr3_58788407_58822311
Clrn1,3,58844028,58885340,protein_coding,-1,41312,chr3_58844028_58885340
Gm43570,3,59002471,59006158,antisense,-1,3687,chr3_59002471_59006158
Med12l,3,59005825,59318682,protein_coding,1,312857,chr3_59005825_59318682
Gpr171,3,59096448,59101821,protein_coding,-1,5373,chr3_59096448_59101821
P2ry14,3,59113855,59153618,protein_coding,-1,39763,chr3_59113855_59153618
Gpr87,3,59178923,59195104,protein_coding,-1,16181,chr3_59178923_59195104
P2ry13,3,59207892,59210882,protein_coding,-1,2990,chr3_59207892_59210882
P2ry12,3,59216272,59262871,protein_coding,-1,46599,chr3_59216272_59262871
Igsf10,3,59316735,59344394,protein_coding,-1,27659,chr3_59316735_59344394
Gm38186,3,59344271,59351167,antisense,1,6896,chr3_59344271_59351167
Aadacl2,3,60006743,60025420,protein_coding,1,18677,chr3_60006743_60025420
Aadac,3,60025717,60040160,protein_coding,1,14443,chr3_60025717_60040160
Mbnl1,3,60472830,60629750,protein_coding,1,156920,chr3_60472830_60629750
Gm38326,3,60788361,60794730,lincRNA,1,6369,chr3_60788361_60794730
Gm37035,3,61001639,61003786,antisense,-1,2147,chr3_61001639_61003786
P2ry1,3,61002795,61008982,protein_coding,1,6187,chr3_61002795_61008982
Gm37696,3,61358549,61361897,antisense,-1,3348,chr3_61358549_61361897
Rap2b,3,61361638,61368430,protein_coding,1,6792,chr3_61361638_61368430
B430305J03Rik,3,61362250,61365951,protein_coding,-1,3701,chr3_61362250_61365951
9330121J05Rik,3,62337524,62340532,antisense,-1,3008,chr3_62337524_62340532
Arhgef26,3,62338344,62462221,protein_coding,1,123877,chr3_62338344_62462221
Dhx36,3,62468013,62507004,protein_coding,-1,38991,chr3_62468013_62507004
Gpr149,3,62529077,62605140,protein_coding,-1,76063,chr3_62529077_62605140
Mme,3,63241537,63386030,protein_coding,1,144493,chr3_63241537_63386030
Gm34240,3,63439251,63457897,lincRNA,1,18646,chr3_63439251_63457897
Plch1,3,63696234,63899472,protein_coding,-1,203238,chr3_63696234_63899472
E130311K13Rik,3,63914684,63929472,protein_coding,-1,14788,chr3_63914684_63929472
Slc33a1,3,63933507,63964768,protein_coding,-1,31261,chr3_63933507_63964768
Gm26850,3,63963633,63968659,antisense,1,5026,chr3_63963633_63968659
Gmps,3,63976106,64022579,protein_coding,1,46473,chr3_63976106_64022579
Vmn2r1,3,64081547,64109484,protein_coding,1,27937,chr3_64081547_64109484
Vmn2r2,3,64115278,64141928,protein_coding,-1,26650,chr3_64115278_64141928
Vmn2r3,3,64257215,64289709,protein_coding,-1,32494,chr3_64257215_64289709
Vmn2r4,3,64383044,64415368,protein_coding,-1,32324,chr3_64383044_64415368
Vmn2r5,3,64488609,64509842,protein_coding,-1,21233,chr3_64488609_64509842
Vmn2r6,3,64531310,64565830,protein_coding,-1,34520,chr3_64531310_64565830
Vmn2r7,3,64685044,64844765,protein_coding,-1,159721,chr3_64685044_64844765
Kcnab1,3,64949196,65378223,protein_coding,1,429027,chr3_64949196_65378223
A330015K06Rik,3,65133060,65302685,antisense,-1,169625,chr3_65133060_65302685
A730090N16Rik,3,65324776,65349429,antisense,-1,24653,chr3_65324776_65349429
Ssr3,3,65379655,65392623,protein_coding,-1,12968,chr3_65379655_65392623
Tiparp,3,65528410,65555518,protein_coding,1,27108,chr3_65528410_65555518
Lekr1,3,65666228,65831355,protein_coding,1,165127,chr3_65666228_65831355
Gm37359,3,65829116,65872281,antisense,-1,43165,chr3_65829116_65872281
Ccnl1,3,65946151,65958249,protein_coding,-1,12098,chr3_65946151_65958249
Gm37305,3,65957758,65962036,antisense,1,4278,chr3_65957758_65962036
Veph1,3,66053558,66296837,protein_coding,-1,243279,chr3_66053558_66296837
Ptx3,3,66219910,66225805,protein_coding,1,5895,chr3_66219910_66225805
Shox2,3,66971727,66981771,protein_coding,-1,10044,chr3_66971727_66981771
Rsrc1,3,66981390,67358396,protein_coding,1,377006,chr3_66981390_67358396
Gm17402,3,67365461,67375163,protein_coding,-1,9702,chr3_67365461_67375163
Mlf1,3,67374097,67400003,protein_coding,1,25906,chr3_67374097_67400003
Gfm1,3,67430096,67476529,protein_coding,1,46433,chr3_67430096_67476529
Lxn,3,67457998,67463926,protein_coding,-1,5928,chr3_67457998_67463926
Rarres1,3,67478972,67515523,protein_coding,-1,36551,chr3_67478972_67515523
Gm35299,3,67551329,67553425,lincRNA,-1,2096,chr3_67551329_67553425
Mfsd1,3,67582741,67604237,protein_coding,1,21496,chr3_67582741_67604237
Iqcj,3,67892220,68056593,protein_coding,1,164373,chr3_67892220_68056593
Schip1,3,68064802,68626481,protein_coding,1,561679,chr3_68064802_68626481
Il12a,3,68690644,68698547,protein_coding,1,7903,chr3_68690644_68698547
4930535E02Rik,3,68759906,68761433,lincRNA,-1,1527,chr3_68759906_68761433
1110032F04Rik,3,68869586,68872163,protein_coding,1,2577,chr3_68869586_68872163
Ift80,3,68892499,69004570,protein_coding,-1,112071,chr3_68892499_69004570
Smc4,3,69004738,69034623,protein_coding,1,29885,chr3_69004738_69034623
Trim59,3,69035288,69044755,protein_coding,-1,9467,chr3_69035288_69044755
Kpna4,3,69067149,69127113,protein_coding,-1,59964,chr3_69067149_69127113
Gm1647,3,69131233,69157177,lincRNA,1,25944,chr3_69131233_69157177
Ppm1l,3,69316861,69560802,protein_coding,1,243941,chr3_69316861_69560802
B3galnt1,3,69574158,69598960,protein_coding,-1,24802,chr3_69574158_69598960
Nmd3,3,69721985,69756373,protein_coding,1,34388,chr3_69721985_69756373
Sptssb,3,69819542,69859940,protein_coding,-1,40398,chr3_69819542_69859940
Otol1,3,70007613,70028708,protein_coding,1,21095,chr3_70007613_70028708
Sis,3,72888557,72967863,protein_coding,-1,79306,chr3_72888557_72967863
Slitrk3,3,73047265,73057803,protein_coding,-1,10538,chr3_73047265_73057803
Gm20754,3,73066316,73594830,lincRNA,1,528514,chr3_73066316_73594830
4930509J09Rik,3,73351206,73481651,lincRNA,-1,130445,chr3_73351206_73481651
Bche,3,73635808,73708415,protein_coding,-1,72607,chr3_73635808_73708415
Gm20356,3,74009217,74017277,lincRNA,-1,8060,chr3_74009217_74017277
Zbbx,3,75037907,75165034,protein_coding,-1,127127,chr3_75037907_75165034
Serpini2,3,75242370,75270078,protein_coding,-1,27708,chr3_75242370_75270078
Wdr49,3,75274988,75482156,protein_coding,-1,207168,chr3_75274988_75482156
Pdcd10,3,75516490,75556856,protein_coding,-1,40366,chr3_75516490_75556856
Serpini1,3,75557547,75643495,protein_coding,1,85948,chr3_75557547_75643495
Platr10,3,75647446,75655731,lincRNA,-1,8285,chr3_75647446_75655731
Gm29133,3,75748197,75787653,protein_coding,1,39456,chr3_75748197_75787653
Golim4,3,75875084,75956949,protein_coding,-1,81865,chr3_75875084_75956949
Gm37256,3,75956101,76001136,lincRNA,1,45035,chr3_75956101_76001136
Fstl5,3,76074270,76710019,protein_coding,1,635749,chr3_76074270_76710019
Rapgef2,3,79062516,79286517,protein_coding,-1,224001,chr3_79062516_79286517
4921511C10Rik,3,79212919,79253913,antisense,1,40994,chr3_79212919_79253913
6430573P05Rik,3,79287173,79289848,lincRNA,1,2675,chr3_79287173_79289848
Gm17359,3,79336661,79464129,protein_coding,1,127468,chr3_79336661_79464129
Fnip2,3,79455974,79567796,protein_coding,-1,111822,chr3_79455974_79567796
4930589L23Rik,3,79568192,79572580,lincRNA,1,4388,chr3_79568192_79572580
Ppid,3,79591342,79603650,protein_coding,1,12308,chr3_79591342_79603650
Etfdh,3,79603788,79629500,protein_coding,-1,25712,chr3_79603788_79629500
4930579G24Rik,3,79629079,79632820,protein_coding,1,3741,chr3_79629079_79632820
Rxfp1,3,79641611,79737880,protein_coding,-1,96269,chr3_79641611_79737880
Tmem144,3,79812564,79852773,protein_coding,-1,40209,chr3_79812564_79852773
Gm36569,3,79859293,79886806,antisense,-1,27513,chr3_79859293_79886806
A330069K06Rik,3,80054892,80213085,lincRNA,1,158193,chr3_80054892_80213085
Gm37892,3,80202492,80205598,antisense,-1,3106,chr3_80202492_80205598
Gm37971,3,80285123,80334595,lincRNA,-1,49472,chr3_80285123_80334595
Gria2,3,80681450,80802835,protein_coding,-1,121385,chr3_80681450_80802835
Glrb,3,80843599,80913660,protein_coding,-1,70061,chr3_80843599_80913660
Gm42468,3,80962960,80971627,lincRNA,1,8667,chr3_80962960_80971627
Gm42476,3,81032954,81033774,lincRNA,1,820,chr3_81032954_81033774
Pdgfc,3,81036416,81214040,protein_coding,1,177624,chr3_81036416_81214040
Gm16000,3,81037408,81040437,antisense,-1,3029,chr3_81037408_81040437
A830029E22Rik,3,81802025,81805161,lincRNA,1,3136,chr3_81802025_81805161
Ctso,3,81932601,81956725,protein_coding,1,24124,chr3_81932601_81956725
Tdo2,3,81957090,81976202,protein_coding,-1,19112,chr3_81957090_81976202
Asic5,3,81982290,82021233,protein_coding,1,38943,chr3_81982290_82021233
Gucy1b1,3,82032006,82074689,protein_coding,-1,42683,chr3_82032006_82074689
Gucy1a1,3,82092427,82145789,protein_coding,-1,53362,chr3_82092427_82145789
Map9,3,82358044,82395268,protein_coding,1,37224,chr3_82358044_82395268
Npy2r,3,82538383,82548084,protein_coding,-1,9701,chr3_82538383_82548084
Gm43348,3,82794975,82812234,lincRNA,-1,17259,chr3_82794975_82812234
Rbm46,3,82837228,82876483,protein_coding,-1,39255,chr3_82837228_82876483
Rbm46os,3,82876705,82943638,antisense,1,66933,chr3_82876705_82943638
Lrat,3,82892579,82903973,protein_coding,-1,11394,chr3_82892579_82903973
Gm30097,3,82926665,83008488,lincRNA,-1,81823,chr3_82926665_83008488
Fgg,3,83007724,83015049,protein_coding,1,7325,chr3_83007724_83015049
Plrg1,3,83055522,83072355,protein_coding,1,16833,chr3_83055522_83072355
Gm10710,3,83125276,83129246,lincRNA,-1,3970,chr3_83125276_83129246
Dchs2,3,83127948,83357209,protein_coding,1,229261,chr3_83127948_83357209
Gm38096,3,83403402,83405790,lincRNA,1,2388,chr3_83403402_83405790
1700028M03Rik,3,83555363,83574122,lincRNA,-1,18759,chr3_83555363_83574122
Sfrp2,3,83766321,83774316,protein_coding,1,7995,chr3_83766321_83774316
Gm26771,3,83773853,83789956,antisense,-1,16103,chr3_83773853_83789956
Tlr2,3,83836272,83841767,protein_coding,-1,5495,chr3_83836272_83841767
Tmem131l,3,83897655,84040175,protein_coding,-1,142520,chr3_83897655_84040175
Mnd1,3,84087933,84155786,protein_coding,-1,67853,chr3_84087933_84155786
Trim2,3,84160439,84306877,protein_coding,-1,146438,chr3_84160439_84306877
Gm6525,3,84174104,84175132,protein_coding,1,1028,chr3_84174104_84175132
4930565D16Rik,3,84349376,84379921,lincRNA,-1,30545,chr3_84349376_84379921
Fhdc1,3,84442198,84480429,protein_coding,-1,38231,chr3_84442198_84480429
Arfip1,3,84496093,84582625,protein_coding,-1,86532,chr3_84496093_84582625
Gm37240,3,84496426,85887518,protein_coding,-1,1391092,chr3_84496426_85887518
Tigd4,3,84593574,84597032,protein_coding,1,3458,chr3_84593574_84597032
Tmem154,3,84666192,84704575,protein_coding,1,38383,chr3_84666192_84704575
Fbxw7,3,84815268,84979198,protein_coding,1,163930,chr3_84815268_84979198
1700036G14Rik,3,85317519,85332030,antisense,1,14511,chr3_85317519_85332030
Gatb,3,85574119,85655622,protein_coding,1,81503,chr3_85574119_85655622
Sh3d19,3,85971109,86130526,protein_coding,1,159417,chr3_85971109_86130526
Prss48,3,85993810,86002491,protein_coding,-1,8681,chr3_85993810_86002491
Rps3a1,3,86137940,86142702,protein_coding,-1,4762,chr3_86137940_86142702
Gm37933,3,86142757,86145545,lincRNA,1,2788,chr3_86142757_86145545
Lrba,3,86224680,86782692,protein_coding,1,558012,chr3_86224680_86782692
Mab21l2,3,86545581,86548629,protein_coding,-1,3048,chr3_86545581_86548629
Gm37876,3,86768071,86778653,antisense,-1,10582,chr3_86768071_86778653
Dclk2,3,86786151,86920852,protein_coding,-1,134701,chr3_86786151_86920852
Cd1d1,3,86995834,86999441,protein_coding,-1,3607,chr3_86995834_86999441
Kirrel,3,87078593,87174747,protein_coding,-1,96154,chr3_87078593_87174747
Gm37855,3,87157693,87162455,lincRNA,1,4762,chr3_87157693_87162455
Fcrls,3,87250758,87263738,protein_coding,-1,12980,chr3_87250758_87263738
Cd5l,3,87357881,87371073,protein_coding,1,13192,chr3_87357881_87371073
Fcrl1,3,87376387,87402934,protein_coding,1,26547,chr3_87376387_87402934
Fcrl5,3,87435773,87500678,protein_coding,1,64905,chr3_87435773_87500678
Etv3,3,87525407,87540156,protein_coding,1,14749,chr3_87525407_87540156
Arhgef11,3,87617559,87738034,protein_coding,1,120475,chr3_87617559_87738034
Lrrc71,3,87736923,87748625,protein_coding,-1,11702,chr3_87736923_87748625
Pear1,3,87747890,87824306,protein_coding,-1,76416,chr3_87747890_87824306
Insrr,3,87796951,87816101,protein_coding,1,19150,chr3_87796951_87816101
Sh2d2a,3,87846755,87855722,protein_coding,1,8967,chr3_87846755_87855722
Prcc,3,87858903,87885608,protein_coding,-1,26705,chr3_87858903_87885608
Hdgf,3,87906321,87916132,protein_coding,1,9811,chr3_87906321_87916132
Mrpl24,3,87919506,87923672,protein_coding,1,4166,chr3_87919506_87923672
Rrnad1,3,87922601,87930717,protein_coding,-1,8116,chr3_87922601_87930717
Isg20l2,3,87930314,87940686,protein_coding,1,10372,chr3_87930314_87940686
Crabp2,3,87948666,87953376,protein_coding,1,4710,chr3_87948666_87953376
Nes,3,87971078,87980451,protein_coding,1,9373,chr3_87971078_87980451
Bcan,3,87987531,88000230,protein_coding,-1,12699,chr3_87987531_88000230
Hapln2,3,88021750,88027583,protein_coding,-1,5833,chr3_88021750_88027583
Gpatch4,3,88043108,88055993,protein_coding,1,12885,chr3_88043108_88055993
Naxe,3,88056520,88058495,protein_coding,-1,1975,chr3_88056520_88058495
Ttc24,3,88069410,88078304,protein_coding,-1,8894,chr3_88069410_88078304
Iqgap3,3,88081971,88121048,protein_coding,1,39077,chr3_88081971_88121048
Mef2d,3,88142372,88172086,protein_coding,1,29714,chr3_88142372_88172086
1700113A16Rik,3,88171556,88177785,antisense,-1,6229,chr3_88171556_88177785
AI849053,3,88199102,88204595,lincRNA,-1,5493,chr3_88199102_88204595
Gm3764,3,88206813,88229959,lincRNA,1,23146,chr3_88206813_88229959
Gm38392,3,88243380,88287210,protein_coding,-1,43830,chr3_88243380_88287210
Tsacc,3,88282757,88296999,protein_coding,-1,14242,chr3_88282757_88296999
Cct3,3,88297116,88321767,protein_coding,1,24651,chr3_88297116_88321767
Glmp,3,88325023,88331313,protein_coding,1,6290,chr3_88325023_88331313
Tmem79,3,88328655,88336148,protein_coding,-1,7493,chr3_88328655_88336148
Smg5,3,88336260,88362338,protein_coding,1,26078,chr3_88336260_88362338
Paqr6,3,88364584,88368541,protein_coding,1,3957,chr3_88364584_88368541
Bglap3,3,88368616,88372743,protein_coding,-1,4127,chr3_88368616_88372743
Bglap2,3,88377736,88378699,protein_coding,-1,963,chr3_88377736_88378699
Bglap,3,88383501,88384464,protein_coding,-1,963,chr3_88383501_88384464
Pmf1,3,88394143,88410331,protein_coding,-1,16188,chr3_88394143_88410331
Slc25a44,3,88410498,88425139,protein_coding,-1,14641,chr3_88410498_88425139
Sema4a,3,88435959,88461182,protein_coding,-1,25223,chr3_88435959_88461182
Lmna,3,88480147,88509956,protein_coding,-1,29809,chr3_88480147_88509956
Gm37584,3,88526066,88527355,lincRNA,-1,1289,chr3_88526066_88527355
Mex3a,3,88532395,88541396,protein_coding,1,9001,chr3_88532395_88541396
Rab25,3,88542029,88548300,protein_coding,-1,6271,chr3_88542029_88548300
Lamtor2,3,88549819,88553074,protein_coding,-1,3255,chr3_88549819_88553074
Ubqln4,3,88553758,88569725,protein_coding,1,15967,chr3_88553758_88569725
Ssr2,3,88575876,88588419,protein_coding,1,12543,chr3_88575876_88588419
Arhgef2,3,88605966,88648052,protein_coding,1,42086,chr3_88605966_88648052
Gm20652,3,88616457,88621061,antisense,-1,4604,chr3_88616457_88621061
Gm43714,3,88685024,88686397,antisense,-1,1373,chr3_88685024_88686397
Rit1,3,88716838,88731049,protein_coding,1,14211,chr3_88716838_88731049
Syt11,3,88744700,88775164,protein_coding,-1,30464,chr3_88744700_88775164
Gon4l,3,88835231,88910103,protein_coding,1,74872,chr3_88835231_88910103
Gm43713,3,88845025,88900001,antisense,-1,54976,chr3_88845025_88900001
Msto1,3,88905107,88913999,protein_coding,-1,8892,chr3_88905107_88913999
Dap3,3,88920803,88951181,protein_coding,-1,30378,chr3_88920803_88951181
Ash1l,3,88950622,89079375,protein_coding,1,128753,chr3_88950622_89079375
Gm43738,3,89081939,89101099,protein_coding,-1,19160,chr3_89081939_89101099
Fdps,3,89093588,89101959,protein_coding,-1,8371,chr3_89093588_89101959
Pklr,3,89136142,89146784,protein_coding,1,10642,chr3_89136142_89146784
Hcn3,3,89146074,89160196,protein_coding,-1,14122,chr3_89146074_89160196
Clk2,3,89164795,89176921,protein_coding,1,12126,chr3_89164795_89176921
Scamp3,3,89177473,89182765,protein_coding,1,5292,chr3_89177473_89182765
Gm16069,3,89180755,89182293,antisense,-1,1538,chr3_89180755_89182293
Fam189b,3,89183143,89189295,protein_coding,1,6152,chr3_89183143_89189295
Gba,3,89202928,89208966,protein_coding,1,6038,chr3_89202928_89208966
Mtx1,3,89209081,89227088,protein_coding,-1,18007,chr3_89209081_89227088
Thbs3,3,89215180,89226837,protein_coding,1,11657,chr3_89215180_89226837
Muc1,3,89229057,89233381,protein_coding,1,4324,chr3_89229057_89233381
Trim46,3,89234177,89246309,protein_coding,-1,12132,chr3_89234177_89246309
Krtcap2,3,89245966,89249906,protein_coding,1,3940,chr3_89245966_89249906
Dpm3,3,89259358,89267079,protein_coding,1,7721,chr3_89259358_89267079
Slc50a1,3,89268246,89270570,protein_coding,-1,2324,chr3_89268246_89270570
Efna1,3,89271733,89281142,protein_coding,-1,9409,chr3_89271733_89281142
Efna3,3,89313899,89322965,protein_coding,-1,9066,chr3_89313899_89322965
Gm15998,3,89315439,89318907,antisense,1,3468,chr3_89315439_89318907
Efna4,3,89333390,89338028,protein_coding,-1,4638,chr3_89333390_89338028
4731419I09Rik,3,89337850,89347831,antisense,1,9981,chr3_89337850_89347831
Adam15,3,89338542,89349996,protein_coding,-1,11454,chr3_89338542_89349996
Dcst1,3,89350219,89365253,protein_coding,-1,15034,chr3_89350219_89365253
Dcst2,3,89361975,89377549,protein_coding,1,15574,chr3_89361975_89377549
Zbtb7b,3,89377644,89394776,protein_coding,-1,17132,chr3_89377644_89394776
Gm15417,3,89391850,89398779,antisense,1,6929,chr3_89391850_89398779
Lenep,3,89400988,89402793,protein_coding,-1,1805,chr3_89400988_89402793
Flad1,3,89401004,89411870,protein_coding,-1,10866,chr3_89401004_89411870
Cks1b,3,89415472,89418383,protein_coding,-1,2911,chr3_89415472_89418383
Shc1,3,89418443,89430027,protein_coding,1,11584,chr3_89418443_89430027
Pygo2,3,89430214,89435128,protein_coding,1,4914,chr3_89430214_89435128
Pbxip1,3,89436706,89450952,protein_coding,1,14246,chr3_89436706_89450952
Pmvk,3,89454541,89469013,protein_coding,1,14472,chr3_89454541_89469013
Kcnn3,3,89520164,89675132,protein_coding,1,154968,chr3_89520164_89675132
Adar,3,89715022,89753446,protein_coding,1,38424,chr3_89715022_89753446
Chrnb2,3,89746195,89764632,protein_coding,-1,18437,chr3_89746195_89764632
4632404H12Rik,3,89767511,89773240,lincRNA,-1,5729,chr3_89767511_89773240
Ube2q1,3,89773616,89784000,protein_coding,1,10384,chr3_89773616_89784000
She,3,89831370,89858834,protein_coding,1,27464,chr3_89831370_89858834
Il6ra,3,89864059,89913196,protein_coding,-1,49137,chr3_89864059_89913196
Gm42809,3,89912916,89914053,antisense,1,1137,chr3_89912916_89914053
Atp8b2,3,89939481,89963508,protein_coding,-1,24027,chr3_89939481_89963508
Hax1,3,89995446,89998780,protein_coding,-1,3334,chr3_89995446_89998780
Gm19710,3,89998760,90021445,lincRNA,1,22685,chr3_89998760_90021445
Ubap2l,3,90000140,90052628,protein_coding,-1,52488,chr3_90000140_90052628
4933434E20Rik,3,90051636,90066069,protein_coding,1,14433,chr3_90051636_90066069
Tpm3,3,90072649,90100902,protein_coding,1,28253,chr3_90072649_90100902
Nup210l,3,90104132,90212048,protein_coding,1,107916,chr3_90104132_90212048
Rps27,3,90212522,90213651,protein_coding,-1,1129,chr3_90212522_90213651
Rab13,3,90213695,90226385,protein_coding,1,12690,chr3_90213695_90226385
Jtb,3,90231597,90235838,protein_coding,1,4241,chr3_90231597_90235838
Creb3l4,3,90237500,90243512,protein_coding,-1,6012,chr3_90237500_90243512
Slc39a1,3,90248172,90253612,protein_coding,1,5440,chr3_90248172_90253612
Crtc2,3,90254163,90264125,protein_coding,1,9962,chr3_90254163_90264125
Dennd4b,3,90265185,90280669,protein_coding,1,15484,chr3_90265185_90280669
4930537H20Rik,3,90292301,90293983,antisense,-1,1682,chr3_90292301_90293983
Gatad2b,3,90293178,90363407,protein_coding,1,70229,chr3_90293178_90363407
Slc27a3,3,90385239,90389938,protein_coding,-1,4699,chr3_90385239_90389938
Ints3,3,90391388,90433622,protein_coding,-1,42234,chr3_90391388_90433622
Npr1,3,90450591,90465866,protein_coding,-1,15275,chr3_90450591_90465866
Gm16048,3,90451583,90457095,antisense,1,5512,chr3_90451583_90457095
Ilf2,3,90476126,90488379,protein_coding,1,12253,chr3_90476126_90488379
Snapin,3,90488026,90491033,protein_coding,-1,3007,chr3_90488026_90491033
Chtop,3,90498956,90509498,protein_coding,-1,10542,chr3_90498956_90509498
S100a1,3,90511034,90514392,protein_coding,-1,3358,chr3_90511034_90514392
S100a13,3,90514435,90524581,protein_coding,1,10146,chr3_90514435_90524581
S100a16,3,90537254,90543151,protein_coding,1,5897,chr3_90537254_90543151
S100a3,3,90584659,90602702,protein_coding,1,18043,chr3_90584659_90602702
S100a4,3,90603771,90606045,protein_coding,1,2274,chr3_90603771_90606045
S100a6,3,90612882,90624181,protein_coding,1,11299,chr3_90612882_90624181
S100a7a,3,90654017,90658669,protein_coding,1,4652,chr3_90654017_90658669
S100a8,3,90668978,90670035,protein_coding,1,1057,chr3_90668978_90670035
S100a9,3,90692632,90695721,protein_coding,-1,3089,chr3_90692632_90695721
Pglyrp4,3,90726906,90741517,protein_coding,1,14611,chr3_90726906_90741517
Pglyrp3,3,92014583,92031582,protein_coding,1,16999,chr3_92014583_92031582
Lor,3,92080271,92083142,protein_coding,-1,2871,chr3_92080271_92083142
Gm35439,3,92170221,92177907,lincRNA,1,7686,chr3_92170221_92177907
Sprr2a2,3,92215920,92256724,protein_coding,1,40804,chr3_92215920_92256724
Sprr2a3,3,92285417,92291405,protein_coding,1,5988,chr3_92285417_92291405
Sprr2d,3,92339140,92340873,protein_coding,1,1733,chr3_92339140_92340873
Gm9774,3,92428032,92429423,protein_coding,-1,1391,chr3_92428032_92429423
Sprr3,3,92456502,92458720,protein_coding,-1,2218,chr3_92456502_92458720
2310046K23Rik,3,92532505,92534511,protein_coding,-1,2006,chr3_92532505_92534511
Smcp,3,92583867,92588997,protein_coding,-1,5130,chr3_92583867_92588997
Crct1,3,93014205,93015687,protein_coding,-1,1482,chr3_93014205_93015687
Flg2,3,93197278,93221391,protein_coding,1,24113,chr3_93197278_93221391
Flg,3,93273523,93293686,protein_coding,1,20163,chr3_93273523_93293686
Gm37245,3,93306468,93465359,lincRNA,-1,158891,chr3_93306468_93465359
Hrnr,3,93319749,93333570,protein_coding,1,13821,chr3_93319749_93333570
Rptn,3,93393699,93399442,protein_coding,1,5743,chr3_93393699_93399442
Tchh,3,93442330,93449077,protein_coding,1,6747,chr3_93442330_93449077
S100a11,3,93520488,93526287,protein_coding,1,5799,chr3_93520488_93526287
S100a10,3,93555080,93564643,protein_coding,1,9563,chr3_93555080_93564643
Tdpoz1,3,93669333,93676310,protein_coding,-1,6977,chr3_93669333_93676310
Gm9117,3,93936633,93943543,protein_coding,-1,6910,chr3_93936633_93943543
Them4,3,94310089,94332540,protein_coding,1,22451,chr3_94310089_94332540
Them5,3,94342099,94347352,protein_coding,1,5253,chr3_94342099_94347352
C2cd4d,3,94362438,94364566,protein_coding,1,2128,chr3_94362438_94364566
Gm38411,3,94368612,94377245,antisense,-1,8633,chr3_94368612_94377245
Rorc,3,94372794,94398276,protein_coding,1,25482,chr3_94372794_94398276
Gm43401,3,94392971,94402848,antisense,-1,9877,chr3_94392971_94402848
Lingo4,3,94398517,94404501,protein_coding,1,5984,chr3_94398517_94404501
1700040D17Rik,3,94409395,94412919,lincRNA,-1,3524,chr3_94409395_94412919
Tdrkh,3,94413273,94434668,protein_coding,1,21395,chr3_94413273_94434668
Oaz3,3,94432414,94443915,protein_coding,-1,11501,chr3_94432414_94443915
Mrpl9,3,94443318,94451130,protein_coding,1,7812,chr3_94443318_94451130
Riiad1,3,94464983,94480341,protein_coding,-1,15358,chr3_94464983_94480341
Celf3,3,94478295,94492198,protein_coding,1,13903,chr3_94478295_94492198
Snx27,3,94497544,94582716,protein_coding,-1,85172,chr3_94497544_94582716
Tuft1,3,94612757,94658872,protein_coding,-1,46115,chr3_94612757_94658872
Gm10972,3,94643098,94643596,processed_pseudogene,1,498,chr3_94643098_94643596
Gm15234,3,94658961,94660115,lincRNA,1,1154,chr3_94658961_94660115
Selenbp2,3,94693556,94704413,protein_coding,1,10857,chr3_94693556_94704413
Cgn,3,94760069,94786515,protein_coding,-1,26446,chr3_94760069_94786515
Pogz,3,94837567,94882326,protein_coding,1,44759,chr3_94837567_94882326
Psmb4,3,94884093,94886961,protein_coding,-1,2868,chr3_94884093_94886961
Selenbp1,3,94933056,94944758,protein_coding,1,11702,chr3_94933056_94944758
Rfx5,3,94954075,94961561,protein_coding,1,7486,chr3_94954075_94961561
B230398E01Rik,3,94959034,94962048,antisense,-1,3014,chr3_94959034_94962048
Pi4kb,3,94974731,95006843,protein_coding,1,32112,chr3_94974731_95006843
A730011C13Rik,3,94994410,94997350,antisense,-1,2940,chr3_94994410_94997350
Gm15265,3,94998800,95004869,antisense,-1,6069,chr3_94998800_95004869
Zfp687,3,95006590,95015448,protein_coding,-1,8858,chr3_95006590_95015448
Psmd4,3,95032694,95042614,protein_coding,-1,9920,chr3_95032694_95042614
Pip5k1a,3,95058530,95106930,protein_coding,-1,48400,chr3_95058530_95106930
Vps72,3,95111022,95123051,protein_coding,1,12029,chr3_95111022_95123051
Tmod4,3,95124476,95129209,protein_coding,1,4733,chr3_95124476_95129209
Scnm1,3,95129536,95134011,protein_coding,-1,4475,chr3_95129536_95134011
Lysmd1,3,95134088,95139518,protein_coding,1,5430,chr3_95134088_95139518
Tnfaip8l2,3,95139521,95142360,protein_coding,-1,2839,chr3_95139521_95142360
Sema6c,3,95160457,95174024,protein_coding,1,13567,chr3_95160457_95174024
Gabpb2,3,95181766,95217916,protein_coding,-1,36150,chr3_95181766_95217916
Gm16740,3,95217457,95226658,antisense,1,9201,chr3_95217457_95226658
Mllt11,3,95219135,95232171,protein_coding,-1,13036,chr3_95219135_95232171
Cdc42se1,3,95228732,95236409,protein_coding,1,7677,chr3_95228732_95236409
Gm128,3,95236920,95241598,protein_coding,-1,4678,chr3_95236920_95241598
Bnipl,3,95241271,95251193,protein_coding,-1,9922,chr3_95241271_95251193
Prune1,3,95253674,95282076,protein_coding,-1,28402,chr3_95253674_95282076
Mindy1,3,95281345,95296166,protein_coding,1,14821,chr3_95281345_95296166
Anxa9,3,95296096,95307176,protein_coding,-1,11080,chr3_95296096_95307176
6330562C20Rik,3,95307076,95315127,antisense,-1,8051,chr3_95307076_95315127
Cers2,3,95314791,95323599,protein_coding,1,8808,chr3_95314791_95323599
Setdb1,3,95323525,95357202,protein_coding,-1,33677,chr3_95323525_95357202
4930558C23Rik,3,95386461,95402841,protein_coding,-1,16380,chr3_95386461_95402841
Gm4349,3,95427671,95431087,transcribed_unprocessed_pseudogene,1,3416,chr3_95427671_95431087
Arnt,3,95434388,95497240,protein_coding,1,62852,chr3_95434388_95497240
Ctsk,3,95499256,95509362,protein_coding,1,10106,chr3_95499256_95509362
Ctss,3,95526786,95556403,protein_coding,1,29617,chr3_95526786_95556403
Hormad1,3,95559677,95587671,protein_coding,1,27994,chr3_95559677_95587671
Golph3l,3,95588934,95619247,protein_coding,1,30313,chr3_95588934_95619247
Ensa,3,95624993,95632102,protein_coding,1,7109,chr3_95624993_95632102
Mcl1,3,95658788,95663176,protein_coding,1,4388,chr3_95658788_95663176
Adamtsl4,3,95676201,95687917,protein_coding,-1,11716,chr3_95676201_95687917
Ecm1,3,95734147,95739569,protein_coding,-1,5422,chr3_95734147_95739569
Tars2,3,95739976,95760206,protein_coding,-1,20230,chr3_95739976_95760206
Rprd2,3,95760341,95818863,protein_coding,-1,58522,chr3_95760341_95818863
Prpf3,3,95830124,95855885,protein_coding,-1,25761,chr3_95830124_95855885
Gm26594,3,95855966,95861485,lincRNA,1,5519,chr3_95855966_95861485
Mrps21,3,95862634,95871519,protein_coding,-1,8885,chr3_95862634_95871519
C920021L13Rik,3,95871522,95889093,antisense,1,17571,chr3_95871522_95889093
Ciart,3,95878503,95882251,protein_coding,-1,3748,chr3_95878503_95882251
BC028528,3,95883954,95892005,protein_coding,-1,8051,chr3_95883954_95892005
Aph1a,3,95893969,95898288,protein_coding,1,4319,chr3_95893969_95898288
Car14,3,95897768,95904691,protein_coding,-1,6923,chr3_95897768_95904691
Anp32e,3,95929246,95947390,protein_coding,1,18144,chr3_95929246_95947390
Plekho1,3,95988429,95996001,protein_coding,-1,7572,chr3_95988429_95996001
Vps45,3,95999832,96058466,protein_coding,-1,58634,chr3_95999832_96058466
Otud7b,3,96104527,96161129,protein_coding,1,56602,chr3_96104527_96161129
Mtmr11,3,96162004,96171718,protein_coding,1,9714,chr3_96162004_96171718
Gm17690,3,96167464,96172416,antisense,-1,4952,chr3_96167464_96172416
Sf3b4,3,96172332,96177564,protein_coding,1,5232,chr3_96172332_96177564
Sv2a,3,96181151,96195521,protein_coding,1,14370,chr3_96181151_96195521
Bola1,3,96196588,96219709,protein_coding,-1,23121,chr3_96196588_96219709
Gm15444,3,96209627,96220168,antisense,-1,10541,chr3_96209627_96220168
Gm20632,3,96239393,96241819,antisense,1,2426,chr3_96239393_96241819
Gm20633,3,96243550,96246380,antisense,-1,2830,chr3_96243550_96246380
Gm20628,3,96267075,96270289,antisense,-1,3214,chr3_96267075_96270289
Gm42743,3,96269721,96279001,lincRNA,1,9280,chr3_96269721_96279001
Fcgr1,3,96282909,96293969,protein_coding,-1,11060,chr3_96282909_96293969
Platr30,3,96345287,96358480,lincRNA,1,13193,chr3_96345287_96358480
BC107364,3,96433788,96452306,protein_coding,-1,18518,chr3_96433788_96452306
Gm10685,3,96458209,96470656,lincRNA,1,12447,chr3_96458209_96470656
Gm15441,3,96555765,96566801,antisense,-1,11036,chr3_96555765_96566801
Txnip,3,96557957,96561883,protein_coding,1,3926,chr3_96557957_96561883
Gm16253,3,96576984,96580663,protein_coding,1,3679,chr3_96576984_96580663
Polr3gl,3,96577872,96594181,protein_coding,-1,16309,chr3_96577872_96594181
Ankrd34a,3,96596636,96599775,protein_coding,1,3139,chr3_96596636_96599775
Lix1l,3,96601149,96626171,protein_coding,1,25022,chr3_96601149_96626171
Rbm8a,3,96629933,96633791,protein_coding,1,3858,chr3_96629933_96633791
Gm42957,3,96635474,96653101,protein_coding,1,17627,chr3_96635474_96653101
Itga10,3,96645584,96664519,protein_coding,1,18935,chr3_96645584_96664519
Ankrd35,3,96670131,96691032,protein_coding,1,20901,chr3_96670131_96691032
Pias3,3,96696384,96706070,protein_coding,1,9686,chr3_96696384_96706070
Nudt17,3,96706067,96708562,protein_coding,-1,2495,chr3_96706067_96708562
Polr3c,3,96711490,96727628,protein_coding,-1,16138,chr3_96711490_96727628
Rnf115,3,96727664,96791638,protein_coding,1,63974,chr3_96727664_96791638
Cd160,3,96798763,96829351,protein_coding,-1,30588,chr3_96798763_96829351
Pdzk1,3,96829284,96870926,protein_coding,1,41642,chr3_96829284_96870926
Gpr89,3,96868281,96905346,protein_coding,-1,37065,chr3_96868281_96905346
Gja5,3,96904693,97077416,protein_coding,1,172723,chr3_96904693_97077416
Gja8,3,96913566,96926020,protein_coding,-1,12454,chr3_96913566_96926020
4930573H18Rik,3,97046656,97092785,antisense,-1,46129,chr3_97046656_97092785
Acp6,3,97158777,97177299,protein_coding,1,18522,chr3_97158777_97177299
Bcl9,3,97203662,97297917,protein_coding,-1,94255,chr3_97203662_97297917
Olfr1402,3,97407450,97422020,protein_coding,-1,14570,chr3_97407450_97422020
Chd1l,3,97560742,97610203,protein_coding,-1,49461,chr3_97560742_97610203
Fmo5,3,97628804,97655282,protein_coding,1,26478,chr3_97628804_97655282
Prkab2,3,97658193,97673812,protein_coding,1,15619,chr3_97658193_97673812
Gm17651,3,97673031,97674694,protein_coding,-1,1663,chr3_97673031_97674694
Pde4dip,3,97689824,97888707,protein_coding,-1,198883,chr3_97689824_97888707
Gm31305,3,97730339,97736166,antisense,1,5827,chr3_97730339_97736166
Gm15999,3,97892231,97901089,lincRNA,-1,8858,chr3_97892231_97901089
Sec22b,3,97901190,97923276,protein_coding,1,22086,chr3_97901190_97923276
Gm5544,3,97930173,97967018,lincRNA,1,36845,chr3_97930173_97967018
Notch2,3,98013527,98150361,protein_coding,1,136834,chr3_98013527_98150361
Reg4,3,98222156,98236748,protein_coding,1,14592,chr3_98222156_98236748
Hmgcs2,3,98280435,98310738,protein_coding,1,30303,chr3_98280435_98310738
Phgdh,3,98313170,98339990,protein_coding,-1,26820,chr3_98313170_98339990
Zfp697,3,98382461,98753812,protein_coding,1,371351,chr3_98382461_98753812
Gm4450,3,98445675,98457126,protein_coding,-1,11451,chr3_98445675_98457126
Gm10681,3,98552542,98588807,protein_coding,-1,36265,chr3_98552542_98588807
Hsd3b5,3,98618634,98630252,protein_coding,-1,11618,chr3_98618634_98630252
Hsd3b2,3,98709255,98724543,protein_coding,-1,15288,chr3_98709255_98724543
Hsd3b3,3,98741523,98763127,protein_coding,-1,21604,chr3_98741523_98763127
Hsd3b6,3,98805504,98814443,protein_coding,-1,8939,chr3_98805504_98814443
Hsd3b1,3,98852194,98859794,protein_coding,-1,7600,chr3_98852194_98859794
Hao2,3,98874521,98893239,protein_coding,-1,18718,chr3_98874521_98893239
5730437C11Rik,3,98937649,98941256,lincRNA,-1,3607,chr3_98937649_98941256
Gm12440,3,99049822,99053744,lincRNA,1,3922,chr3_99049822_99053744
Wars2,3,99141068,99239186,protein_coding,1,98118,chr3_99141068_99239186
Tbx15,3,99240381,99354259,protein_coding,1,113878,chr3_99240381_99354259
Gm43120,3,99254698,99261285,antisense,-1,6587,chr3_99254698_99261285
Spag17,3,99885406,100143322,protein_coding,1,257916,chr3_99885406_100143322
Spag17os,3,100100684,100106895,antisense,-1,6211,chr3_100100684_100106895
Wdr3,3,100138180,100162407,protein_coding,-1,24227,chr3_100138180_100162407
Gdap2,3,100162381,100206981,protein_coding,1,44600,chr3_100162381_100206981
Gm12474,3,100489664,100523920,lincRNA,1,34256,chr3_100489664_100523920
Man1a2,3,100562208,100685503,protein_coding,-1,123295,chr3_100562208_100685503
Gm43464,3,100692706,100700084,lincRNA,1,7378,chr3_100692706_100700084
Vtcn1,3,100825459,100896922,protein_coding,1,71463,chr3_100825459_100896922
Trim45,3,100922202,100936920,protein_coding,1,14718,chr3_100922202_100936920
Ttf2,3,100938860,100969663,protein_coding,-1,30803,chr3_100938860_100969663
Cd101,3,100993529,101029556,protein_coding,-1,36027,chr3_100993529_101029556
Ptgfrn,3,101040232,101110278,protein_coding,-1,70046,chr3_101040232_101110278
Cd2,3,101275899,101287939,protein_coding,-1,12040,chr3_101275899_101287939
Igsf3,3,101377083,101463059,protein_coding,1,85976,chr3_101377083_101463059
Gm42538,3,101424615,101426936,antisense,-1,2321,chr3_101424615_101426936
Atp1a1,3,101576219,101604684,protein_coding,-1,28465,chr3_101576219_101604684
Gm43135,3,101691789,101699632,lincRNA,1,7843,chr3_101691789_101699632
Gm43134,3,101748124,101750009,lincRNA,1,1885,chr3_101748124_101750009
Mab21l3,3,101813076,101848959,protein_coding,-1,35883,chr3_101813076_101848959
Slc22a15,3,101855776,101924453,protein_coding,-1,68677,chr3_101855776_101924453
Nhlh2,3,102010076,102015492,protein_coding,1,5416,chr3_102010076_102015492
Casq2,3,102086415,102146514,protein_coding,1,60099,chr3_102086415_102146514
Vangl1,3,102153583,102204693,protein_coding,-1,51110,chr3_102153583_102204693
A230001M10Rik,3,102262405,102445132,lincRNA,1,182727,chr3_102262405_102445132
Ngf,3,102469919,102521013,protein_coding,1,51094,chr3_102469919_102521013
Gm42678,3,102599373,102601593,lincRNA,1,2220,chr3_102599373_102601593
Gm42682,3,102714252,102715516,lincRNA,1,1264,chr3_102714252_102715516
Tspan2os,3,102720231,102735417,antisense,-1,15186,chr3_102720231_102735417
Tspan2,3,102734529,102801513,protein_coding,1,66984,chr3_102734529_102801513
Tshb,3,102775465,102782718,protein_coding,-1,7253,chr3_102775465_102782718
Gm42681,3,102783179,102784789,antisense,-1,1610,chr3_102783179_102784789
Sycp1,3,102818499,102936100,protein_coding,-1,117601,chr3_102818499_102936100
Nr1h5,3,102939658,102964133,protein_coding,-1,24475,chr3_102939658_102964133
Sike1,3,102995708,103008459,protein_coding,1,12751,chr3_102995708_103008459
Csde1,3,103020426,103058186,protein_coding,1,37760,chr3_103020426_103058186
Nras,3,103058285,103067914,protein_coding,1,9629,chr3_103058285_103067914
Gm43062,3,103071174,103072492,lincRNA,1,1318,chr3_103071174_103072492
Ampd1,3,103074014,103099720,protein_coding,1,25706,chr3_103074014_103099720
Dennd2c,3,103102604,103169769,protein_coding,1,67165,chr3_103102604_103169769
Bcas2,3,103171655,103179166,protein_coding,1,7511,chr3_103171655_103179166
Trim33,3,103279293,103358775,protein_coding,1,79482,chr3_103279293_103358775
Syt6,3,103575231,103645569,protein_coding,1,70338,chr3_103575231_103645569
Atg4a-ps,3,103643954,103646068,protein_coding,-1,2114,chr3_103643954_103646068
Olfml3,3,103722222,103738001,protein_coding,-1,15779,chr3_103722222_103738001
Gm10964,3,103739366,103746376,protein_coding,1,7010,chr3_103739366_103746376
Hipk1,3,103739815,103791563,protein_coding,-1,51748,chr3_103739815_103791563
Gm15886,3,103771952,103789402,antisense,1,17450,chr3_103771952_103789402
Dclre1b,3,103800605,103809444,protein_coding,-1,8839,chr3_103800605_103809444
Ap4b1,3,103809520,103822025,protein_coding,1,12505,chr3_103809520_103822025
Gm43064,3,103809573,103838648,protein_coding,1,29075,chr3_103809573_103838648
Bcl2l15,3,103832601,103854618,protein_coding,1,22017,chr3_103832601_103854618
Ptpn22,3,103859795,103912247,protein_coding,1,52452,chr3_103859795_103912247
Rsbn1,3,103914120,103966636,protein_coding,1,52516,chr3_103914120_103966636
Phtf1os,3,103964536,103968581,antisense,-1,4045,chr3_103964536_103968581
Phtf1,3,103968110,104024598,protein_coding,1,56488,chr3_103968110_104024598
Magi3,3,104013259,104220374,protein_coding,-1,207115,chr3_104013259_104220374
Gm5546,3,104350635,104366613,lincRNA,-1,15978,chr3_104350635_104366613
Lrig2,3,104396418,104511918,protein_coding,-1,115500,chr3_104396418_104511918
Gm38412,3,104409161,104417535,antisense,1,8374,chr3_104409161_104417535
Slc16a1,3,104638668,104658462,protein_coding,1,19794,chr3_104638668_104658462
Gm29561,3,104661343,104664139,lincRNA,-1,2796,chr3_104661343_104664139
Ppm1j,3,104781056,104786018,protein_coding,1,4962,chr3_104781056_104786018
Rhoc,3,104788375,104794459,protein_coding,1,6084,chr3_104788375_104794459
Mov10,3,104794836,104818563,protein_coding,-1,23727,chr3_104794836_104818563
Capza1,3,104822779,104864505,protein_coding,-1,41726,chr3_104822779_104864505
St7l,3,104864005,104930064,protein_coding,1,66059,chr3_104864005_104930064
Wnt2b,3,104945272,104961921,protein_coding,-1,16649,chr3_104945272_104961921
Gm40117,3,104994032,105004005,antisense,1,9973,chr3_104994032_105004005
Cttnbp2nl,3,105001915,105053146,protein_coding,-1,51231,chr3_105001915_105053146
4930564D02Rik,3,105066844,105078806,protein_coding,1,11962,chr3_105066844_105078806
Kcnd3os,3,105441595,105452955,antisense,-1,11360,chr3_105441595_105452955
Kcnd3,3,105452330,105674002,protein_coding,1,221672,chr3_105452330_105674002
Ddx20,3,105678270,105687574,protein_coding,-1,9304,chr3_105678270_105687574
Gm43848,3,105725901,105727147,lincRNA,-1,1246,chr3_105725901_105727147
Rap1a,3,105727267,105801336,protein_coding,-1,74069,chr3_105727267_105801336
Tmigd3,3,105870903,105924042,protein_coding,1,53139,chr3_105870903_105924042
I830077J02Rik,3,105924358,105932664,protein_coding,-1,8306,chr3_105924358_105932664
Wdr77,3,105959369,105970037,protein_coding,1,10668,chr3_105959369_105970037
Ovgp1,3,105973711,105987423,protein_coding,1,13712,chr3_105973711_105987423
Pifo,3,105996957,106014646,protein_coding,-1,17689,chr3_105996957_106014646
Gm42722,3,106001561,106017539,antisense,1,15978,chr3_106001561_106017539
Chil5,3,106016919,106032814,protein_coding,-1,15895,chr3_106016919_106032814
Chia1,3,106113229,106132120,protein_coding,1,18891,chr3_106113229_106132120
Chil3,3,106147554,106167564,protein_coding,-1,20010,chr3_106147554_106167564
Chil4,3,106201490,106219507,protein_coding,-1,18017,chr3_106201490_106219507
Chil6,3,106387384,106406182,protein_coding,-1,18798,chr3_106387384_106406182
Dennd2d,3,106482405,106503030,protein_coding,1,20625,chr3_106482405_106503030
Cept1,3,106502260,106547802,protein_coding,-1,45542,chr3_106502260_106547802
Dram2,3,106547798,106575890,protein_coding,1,28092,chr3_106547798_106575890
Lrif1,3,106684987,106736577,protein_coding,1,51590,chr3_106684987_106736577
Cd53,3,106759921,106790149,protein_coding,-1,30228,chr3_106759921_106790149
Olfr266,3,106820485,106826287,protein_coding,-1,5802,chr3_106820485_106826287
Gm35507,3,106827307,106879361,lincRNA,-1,52054,chr3_106827307_106879361
Gm27008,3,106934382,107093894,antisense,-1,159512,chr3_106934382_107093894
Kcna3,3,107036169,107038070,protein_coding,1,1901,chr3_107036169_107038070
AI504432,3,107039504,107054347,lincRNA,1,14843,chr3_107039504_107054347
Kcna2,3,107101146,107115005,protein_coding,1,13859,chr3_107101146_107115005
Kcna10,3,107183056,107195721,protein_coding,1,12665,chr3_107183056_107195721
Cym,3,107211293,107221732,protein_coding,-1,10439,chr3_107211293_107221732
A630076J17Rik,3,107230614,107234723,protein_coding,1,4109,chr3_107230614_107234723
Prok1,3,107232797,107239707,protein_coding,-1,6910,chr3_107232797_107239707
Lamtor5,3,107278858,107284082,protein_coding,1,5224,chr3_107278858_107284082
Slc16a4,3,107291230,107312115,protein_coding,1,20885,chr3_107291230_107312115
Rbm15,3,107325421,107333673,protein_coding,-1,8252,chr3_107325421_107333673
Kcnc4,3,107438303,107459552,protein_coding,-1,21249,chr3_107438303_107459552
Slc6a17,3,107467543,107518018,protein_coding,-1,50475,chr3_107467543_107518018
Alx3,3,107595031,107605776,protein_coding,1,10745,chr3_107595031_107605776
Strip1,3,107612532,107631694,protein_coding,-1,19162,chr3_107612532_107631694
Gm10961,3,107631322,107633090,protein_coding,1,1768,chr3_107631322_107633090
Ahcyl1,3,107663118,107696560,protein_coding,-1,33442,chr3_107663118_107696560
Csf1,3,107741048,107760469,protein_coding,-1,19421,chr3_107741048_107760469
Gm36211,3,107820221,107833539,lincRNA,-1,13318,chr3_107820221_107833539
Eps8l3,3,107877229,107892900,protein_coding,1,15671,chr3_107877229_107892900
4933431E20Rik,3,107888850,107896213,antisense,-1,7363,chr3_107888850_107896213
Gstm5,3,107895821,107898686,protein_coding,1,2865,chr3_107895821_107898686
Gstm7,3,107926334,107931817,protein_coding,-1,5483,chr3_107926334_107931817
Gstm6,3,107938847,107943749,protein_coding,-1,4902,chr3_107938847_107943749
Gstm2,3,107981702,107986453,protein_coding,-1,4751,chr3_107981702_107986453
Gstm1,3,108012255,108017973,protein_coding,-1,5718,chr3_108012255_108017973
Gm12498,3,108018294,108025249,lincRNA,-1,6955,chr3_108018294_108025249
Gstm4,3,108040408,108044894,protein_coding,-1,4486,chr3_108040408_108044894
Ampd2,3,108074062,108086651,protein_coding,-1,12589,chr3_108074062_108086651
Gm12500,3,108085584,108088011,antisense,1,2427,chr3_108085584_108088011
Gnat2,3,108092789,108101432,protein_coding,1,8643,chr3_108092789_108101432
Gnai3,3,108107280,108146146,protein_coding,-1,38866,chr3_108107280_108146146
Gpr61,3,108148321,108154882,protein_coding,-1,6561,chr3_108148321_108154882
Gm12524,3,108166443,108185907,lincRNA,1,19464,chr3_108166443_108185907
Amigo1,3,108186335,108192286,protein_coding,1,5951,chr3_108186335_108192286
Cyb561d1,3,108195687,108201212,protein_coding,-1,5525,chr3_108195687_108201212
Atxn7l2,3,108202222,108210934,protein_coding,-1,8712,chr3_108202222_108210934
Sypl2,3,108211472,108226648,protein_coding,-1,15176,chr3_108211472_108226648
Gm40123,3,108226787,108240247,lincRNA,1,13460,chr3_108226787_108240247
1700010K24Rik,3,108248909,108256985,antisense,-1,8076,chr3_108248909_108256985
Psma5,3,108256926,108279974,protein_coding,1,23048,chr3_108256926_108279974
Gm12523,3,108283898,108284843,antisense,-1,945,chr3_108283898_108284843
Sort1,3,108284082,108361511,protein_coding,1,77429,chr3_108284082_108361511
Gm12525,3,108361551,108362256,lincRNA,1,705,chr3_108361551_108362256
Mybphl,3,108364911,108380057,protein_coding,1,15146,chr3_108364911_108380057
Psrc1,3,108383839,108388231,protein_coding,1,4392,chr3_108383839_108388231
Celsr2,3,108390851,108415552,protein_coding,-1,24701,chr3_108390851_108415552
Sars,3,108424865,108445209,protein_coding,-1,20344,chr3_108424865_108445209
5330417C22Rik,3,108455694,108536536,protein_coding,-1,80842,chr3_108455694_108536536
1700013F07Rik,3,108534150,108544723,protein_coding,1,10573,chr3_108534150_108544723
Tmem167b,3,108556425,108562466,protein_coding,-1,6041,chr3_108556425_108562466
Taf13,3,108571698,108583222,protein_coding,1,11524,chr3_108571698_108583222
Wdr47,3,108591279,108645719,protein_coding,1,54440,chr3_108591279_108645719
Clcc1,3,108653913,108678840,protein_coding,1,24927,chr3_108653913_108678840
Gpsm2,3,108678638,108722309,protein_coding,-1,43671,chr3_108678638_108722309
Gm27244,3,108708908,108712653,antisense,1,3745,chr3_108708908_108712653
Aknad1,3,108739658,108782309,protein_coding,1,42651,chr3_108739658_108782309
Stxbp3,3,108793176,108840526,protein_coding,-1,47350,chr3_108793176_108840526
Fndc7,3,108853678,108890008,protein_coding,-1,36330,chr3_108853678_108890008
Prpf38b,3,108902805,108911727,protein_coding,-1,8922,chr3_108902805_108911727
Henmt1,3,108940059,108960774,protein_coding,1,20715,chr3_108940059_108960774
Gm9857,3,108939873,108940446,antisense,-1,573,chr3_108939873_108940446
Fam102b,3,108970997,109027607,protein_coding,-1,56610,chr3_108970997_109027607
Gm43221,3,109000024,109002094,antisense,1,2070,chr3_109000024_109002094
Slc25a54,3,109080469,109116687,protein_coding,1,36218,chr3_109080469_109116687
Slc25a24,3,109123149,109168457,protein_coding,1,45308,chr3_109123149_109168457
Vav3,3,109340653,109685698,protein_coding,1,345045,chr3_109340653_109685698
Ntng1,3,109780040,110144011,protein_coding,-1,363971,chr3_109780040_110144011
Prmt6,3,110246109,110250998,protein_coding,-1,4889,chr3_110246109_110250998
C130013H08Rik,3,110250015,110253706,antisense,1,3691,chr3_110250015_110253706
Gm6602,3,111881903,112082001,lincRNA,1,200098,chr3_111881903_112082001
Amy1,3,113555710,113606699,protein_coding,-1,50989,chr3_113555710_113606699
Rnpc3,3,113605067,113630149,protein_coding,-1,25082,chr3_113605067_113630149
Col11a1,3,114030540,114220718,protein_coding,1,190178,chr3_114030540_114220718
Olfm3,3,114904078,115125722,protein_coding,1,221644,chr3_114904078_115125722
S1pr1,3,115710433,115715072,protein_coding,-1,4639,chr3_115710433_115715072
Gm9889,3,115715150,115716728,lincRNA,1,1578,chr3_115715150_115716728
Dph5,3,115887837,115934361,protein_coding,1,46524,chr3_115887837_115934361
Slc30a7,3,115938973,116007406,protein_coding,-1,68433,chr3_115938973_116007406
Extl2,3,116007462,116029017,protein_coding,1,21555,chr3_116007462_116029017
Vcam1,3,116109949,116129688,protein_coding,-1,19739,chr3_116109949_116129688
Gm43109,3,116128451,116141016,antisense,1,12565,chr3_116128451_116141016
Gm26544,3,116150479,116165821,lincRNA,1,15342,chr3_116150479_116165821
Gpr88,3,116249654,116253503,protein_coding,-1,3849,chr3_116249654_116253503
Cdc14a,3,116272553,116428745,protein_coding,-1,156192,chr3_116272553_116428745
Rtca,3,116488963,116508208,protein_coding,-1,19245,chr3_116488963_116508208
Dbt,3,116513070,116549981,protein_coding,1,36911,chr3_116513070_116549981
Lrrc39,3,116562973,116583134,protein_coding,1,20161,chr3_116562973_116583134
Trmt13,3,116581093,116614587,protein_coding,-1,33494,chr3_116581093_116614587
Sass6,3,116594982,116631004,protein_coding,1,36022,chr3_116594982_116631004
Gm42893,3,116629173,116630984,antisense,-1,1811,chr3_116629173_116630984
Mfsd14a,3,116631164,116662677,protein_coding,-1,31513,chr3_116631164_116662677
Gm42457,3,116631671,116632209,antisense,1,538,chr3_116631671_116632209
Gm43191,3,116641902,116681260,protein_coding,-1,39358,chr3_116641902_116681260
4930512P04Rik,3,116663732,116664155,lincRNA,1,423,chr3_116663732_116664155
Slc35a3,3,116669470,116712831,protein_coding,-1,43361,chr3_116669470_116712831
Agl,3,116739999,116808166,protein_coding,-1,68167,chr3_116739999_116808166
Frrs1,3,116859464,116908177,protein_coding,1,48713,chr3_116859464_116908177
Palmd,3,116918258,116968987,protein_coding,-1,50729,chr3_116918258_116968987
4930455H04Rik,3,116968267,116984406,protein_coding,1,16139,chr3_116968267_116984406
1700061I17Rik,3,117060522,117077765,lincRNA,-1,17243,chr3_117060522_117077765
Gm42891,3,117255132,117255820,lincRNA,1,688,chr3_117255132_117255820
Plppr4,3,117319139,117360876,protein_coding,-1,41737,chr3_117319139_117360876
Plppr5,3,117485084,117689507,protein_coding,1,204423,chr3_117485084_117689507
Snx7,3,117781647,117868936,protein_coding,-1,87289,chr3_117781647_117868936
4921521D15Rik,3,117969130,117973526,lincRNA,1,4396,chr3_117969130_117973526
Gm9916,3,118434770,118435997,lincRNA,1,1227,chr3_118434770_118435997
Dpyd,3,118562129,119432924,protein_coding,1,870795,chr3_118562129_119432924
Ptbp2,3,119718742,119784466,protein_coding,-1,65724,chr3_119718742_119784466
6530403H02Rik,3,120604109,120886733,lincRNA,-1,282624,chr3_120604109_120886733
Rwdd3,3,121155398,121171695,protein_coding,-1,16297,chr3_121155398_121171695
Alg14,3,121291773,121363094,protein_coding,1,71321,chr3_121291773_121363094
Cnn3,3,121426497,121458207,protein_coding,1,31710,chr3_121426497_121458207
Slc44a3,3,121459528,121532404,protein_coding,-1,72876,chr3_121459528_121532404
A530020G20Rik,3,121531619,121536206,antisense,1,4587,chr3_121531619_121536206
Gm43608,3,121701501,121710246,lincRNA,-1,8745,chr3_121701501_121710246
F3,3,121723537,121735048,protein_coding,1,11511,chr3_121723537_121735048
Abcd3,3,121758774,121815302,protein_coding,-1,56528,chr3_121758774_121815302
Arhgap29,3,121952541,122016753,protein_coding,1,64212,chr3_121952541_122016753
Abca4,3,122044443,122180123,protein_coding,1,135680,chr3_122044443_122180123
Gclm,3,122245557,122270732,protein_coding,1,25175,chr3_122245557_122270732
Dnttip2,3,122274388,122285271,protein_coding,1,10883,chr3_122274388_122285271
Gm40190,3,122293439,122303613,lincRNA,1,10174,chr3_122293439_122303613
Bcar3,3,122294136,122530191,protein_coding,1,236055,chr3_122294136_122530191
Gm4610,3,122377097,122391811,antisense,-1,14714,chr3_122377097_122391811
Gm42836,3,122426443,122459060,antisense,-1,32617,chr3_122426443_122459060
Fnbp1l,3,122538719,122619715,protein_coding,-1,80996,chr3_122538719_122619715
Gm43569,3,122565050,122574740,antisense,1,9690,chr3_122565050_122574740
Gm43568,3,122622255,122630168,lincRNA,-1,7913,chr3_122622255_122630168
Pde5a,3,122728947,122859374,protein_coding,1,130427,chr3_122728947_122859374
4933405D12Rik,3,122864737,122924116,antisense,-1,59379,chr3_122864737_122924116
Fabp2,3,122895072,122899506,protein_coding,1,4434,chr3_122895072_122899506
1810037I17Rik,3,122924203,122926184,protein_coding,1,1981,chr3_122924203_122926184
Usp53,3,122931493,122984510,protein_coding,-1,53017,chr3_122931493_122984510
Myoz2,3,123006206,123035015,protein_coding,-1,28809,chr3_123006206_123035015
Synpo2,3,123076519,123236149,protein_coding,-1,159630,chr3_123076519_123236149
Sec24d,3,123267455,123365641,protein_coding,1,98186,chr3_123267455_123365641
Mettl14,3,123368297,123386108,protein_coding,-1,17811,chr3_123368297_123386108
Gm35065,3,123444328,123447447,antisense,-1,3119,chr3_123444328_123447447
Prss12,3,123446913,123506597,protein_coding,1,59684,chr3_123446913_123506597
Ndst3,3,123526166,123690853,protein_coding,-1,164687,chr3_123526166_123690853
Gm43731,3,124246237,124318984,lincRNA,1,72747,chr3_124246237_124318984
Tram1l1,3,124320855,124324743,protein_coding,1,3888,chr3_124320855_124324743
1700006A11Rik,3,124400989,124426040,protein_coding,-1,25051,chr3_124400989_124426040
1700003H04Rik,3,124556352,124581101,protein_coding,-1,24749,chr3_124556352_124581101
Gm42825,3,124839509,124936860,lincRNA,1,97351,chr3_124839509_124936860
Ndst4,3,125404076,125728899,protein_coding,1,324823,chr3_125404076_125728899
Ugt8a,3,125865271,125938619,protein_coding,-1,73348,chr3_125865271_125938619
Arsj,3,126363684,126440375,protein_coding,1,76691,chr3_126363684_126440375
Gm17225,3,126432883,126439269,antisense,-1,6386,chr3_126432883_126439269
Camk2d,3,126596302,126846326,protein_coding,1,250024,chr3_126596302_126846326
Gm15551,3,126667329,126669044,antisense,-1,1715,chr3_126667329_126669044
Ank2,3,126921612,127499350,protein_coding,-1,577738,chr3_126921612_127499350
Gm16958,3,127161304,127168288,antisense,1,6984,chr3_127161304_127168288
Larp7,3,127536714,127553349,protein_coding,-1,16635,chr3_127536714_127553349
Zgrf1,3,127553489,127618023,protein_coding,1,64534,chr3_127553489_127618023
Gm43729,3,127556228,127557561,antisense,-1,1333,chr3_127556228_127557561
Neurog2,3,127633135,127635631,protein_coding,1,2496,chr3_127633135_127635631
Alpk1,3,127670310,127780527,protein_coding,-1,110217,chr3_127670310_127780527
Tifa,3,127789805,127832164,protein_coding,1,42359,chr3_127789805_127832164
Ap1ar,3,127807007,127837523,protein_coding,-1,30516,chr3_127807007_127837523
Gm43653,3,127836911,127838644,antisense,1,1733,chr3_127836911_127838644
Gm35585,3,127861599,127865261,lincRNA,1,3662,chr3_127861599_127865261
Fam241a,3,127869058,127896324,protein_coding,-1,27266,chr3_127869058_127896324
9830132P13Rik,3,127916172,127955220,lincRNA,1,39048,chr3_127916172_127955220
Gm35667,3,127970709,127972881,lincRNA,1,2172,chr3_127970709_127972881
Gm43824,3,128610987,128887161,lincRNA,1,276174,chr3_128610987_128887161
Pitx2,3,129199878,129219591,protein_coding,1,19713,chr3_129199878_129219591
Enpep,3,129269175,129332720,protein_coding,-1,63545,chr3_129269175_129332720
Gm35986,3,129527467,129532388,antisense,-1,4921,chr3_129527467_129532388
Elovl6,3,129532355,129638495,protein_coding,1,106140,chr3_129532355_129638495
Egf,3,129677565,129755316,protein_coding,-1,77751,chr3_129677565_129755316
Gm42697,3,129728845,129740188,antisense,1,11343,chr3_129728845_129740188
Gm42650,3,129745340,129750168,antisense,1,4828,chr3_129745340_129750168
6330410L21Rik,3,129753758,129763884,antisense,1,10126,chr3_129753758_129763884
Lrit3,3,129787881,129804030,protein_coding,-1,16149,chr3_129787881_129804030
Rrh,3,129804408,129822587,protein_coding,-1,18179,chr3_129804408_129822587
Gar1,3,129824912,129831396,protein_coding,-1,6484,chr3_129824912_129831396
Cfi,3,129835884,129875332,protein_coding,1,39448,chr3_129835884_129875332
Pla2g12a,3,129878606,129895825,protein_coding,1,17219,chr3_129878606_129895825
Casp6,3,129901425,129914103,protein_coding,1,12678,chr3_129901425_129914103
Mcub,3,129914960,129970206,protein_coding,-1,55246,chr3_129914960_129970206
Sec24b,3,129982759,130061553,protein_coding,-1,78794,chr3_129982759_130061553
Col25a1,3,130131501,130599877,protein_coding,1,468376,chr3_130131501_130599877
Etnppl,3,130617448,130637521,protein_coding,1,20073,chr3_130617448_130637521
Ostc,3,130695912,130709444,protein_coding,-1,13532,chr3_130695912_130709444
Rpl34,3,130726831,130730398,protein_coding,-1,3567,chr3_130726831_130730398
Gm42997,3,130730460,130771643,lincRNA,1,41183,chr3_130730460_130771643
2010110G14Rik,3,130838455,130937337,lincRNA,-1,98882,chr3_130838455_130937337
Lef1,3,131110471,131224356,protein_coding,1,113885,chr3_131110471_131224356
Hadh,3,131233419,131272101,protein_coding,-1,38682,chr3_131233419_131272101
Cyp2u1,3,131288441,131303227,protein_coding,-1,14786,chr3_131288441_131303227
4930534D22Rik,CHR_MG3714_PATCH,131302643,131316661,antisense;lncRNA,1,14018,chrCHR_MG3714_PATCH_131302643_131316661
Sgms2,3,131318985,131491411,protein_coding,-1,172426,chr3_131318985_131491411
Papss1,3,131564768,131643671,protein_coding,1,78903,chr3_131564768_131643671
Gm29865,3,131759805,132030743,lincRNA,1,270938,chr3_131759805_132030743
Dkk2,3,132085292,132180304,protein_coding,1,95012,chr3_132085292_132180304
Gimd1,3,132629820,132645351,protein_coding,1,15531,chr3_132629820_132645351
Aimp1,3,132660481,132684370,protein_coding,-1,23889,chr3_132660481_132684370
Tbck,3,132684144,132841688,protein_coding,1,157544,chr3_132684144_132841688
Gm29811,3,132842202,132878596,lincRNA,-1,36394,chr3_132842202_132878596
Npnt,3,132881745,132950291,protein_coding,-1,68546,chr3_132881745_132950291
Gstcd,3,132981752,133092033,protein_coding,-1,110281,chr3_132981752_133092033
Ints12,3,133091840,133110988,protein_coding,1,19148,chr3_133091840_133110988
Arhgef38,3,133112278,133234949,protein_coding,-1,122671,chr3_133112278_133234949
Gm43254,3,133307518,133310008,lincRNA,-1,2490,chr3_133307518_133310008
Ppa2,3,133310110,133378235,protein_coding,1,68125,chr3_133310110_133378235
Tet2,3,133463679,133545139,protein_coding,-1,81460,chr3_133463679_133545139
Gm42567,3,133545097,133585053,antisense,1,39956,chr3_133545097_133585053
Gm40153,3,133645808,133663391,lincRNA,-1,17583,chr3_133645808_133663391
Gm6135,3,133789515,133791504,lincRNA,-1,1989,chr3_133789515_133791504
Gm30484,3,133815919,133818518,lincRNA,-1,2599,chr3_133815919_133818518
Gm26691,3,133830668,134240641,antisense,-1,409973,chr3_133830668_134240641
Gm43192,3,134160365,134191976,lincRNA,1,31611,chr3_134160365_134191976
Gm30648,3,134199948,134213238,lincRNA,1,13290,chr3_134199948_134213238
Cxxc4,3,134236484,134262161,protein_coding,1,25677,chr3_134236484_134262161
4930539C22Rik,3,134404143,134423635,lincRNA,-1,19492,chr3_134404143_134423635
Gm26820,3,134462087,134630765,lincRNA,-1,168678,chr3_134462087_134630765
Tacr3,3,134829007,134934579,protein_coding,1,105572,chr3_134829007_134934579
Cenpe,3,135212537,135273611,protein_coding,1,61074,chr3_135212537_135273611
Bdh2,3,135281221,135304426,protein_coding,1,23205,chr3_135281221_135304426
Slc9b2,3,135307700,135345387,protein_coding,1,37687,chr3_135307700_135345387
Slc9b1,3,135348029,135397827,protein_coding,1,49798,chr3_135348029_135397827
Cisd2,3,135406412,135423925,protein_coding,-1,17513,chr3_135406412_135423925
4930539J05Rik,3,135436209,135438665,antisense,-1,2456,chr3_135436209_135438665
Ube2d3,3,135438149,135468198,protein_coding,1,30049,chr3_135438149_135468198
Manba,3,135485611,135571404,protein_coding,1,85793,chr3_135485611_135571404
Nfkb1,3,135584655,135691547,protein_coding,-1,106892,chr3_135584655_135691547
Slc39a8,3,135825279,135888572,protein_coding,1,63293,chr3_135825279_135888572
Gm31243,3,135904344,136167184,antisense,1,262840,chr3_135904344_136167184
Bank1,3,136053363,136326066,protein_coding,-1,272703,chr3_136053363_136326066
1700030L20Rik,3,136435270,136449349,lincRNA,-1,14079,chr3_136435270_136449349
Ppp3ca,3,136670124,136937727,protein_coding,1,267603,chr3_136670124_136937727
Gm43357,3,136943237,136946544,lincRNA,-1,3307,chr3_136943237_136946544
Gm567,3,137289639,137300708,lincRNA,1,11069,chr3_137289639_137300708
Emcn,3,137341067,137432185,protein_coding,1,91118,chr3_137341067_137432185
Gm4861,3,137550045,137552622,lincRNA,-1,2577,chr3_137550045_137552622
Ddit4l,3,137621612,137628333,protein_coding,1,6721,chr3_137621612_137628333
Gm21962,3,137671524,137672540,protein_coding,1,1016,chr3_137671524_137672540
Gm42610,3,137690987,137699128,lincRNA,1,8141,chr3_137690987_137699128
Gm31678,3,137795265,137803469,lincRNA,-1,8204,chr3_137795265_137803469
Gm43403,3,137862589,137864374,antisense,-1,1785,chr3_137862589_137864374
Dnajb14,3,137867675,137916557,protein_coding,1,48882,chr3_137867675_137916557
Gm40155,3,137875925,137878126,antisense,-1,2201,chr3_137875925_137878126
Gm43689,3,137918019,137918445,lincRNA,-1,426,chr3_137918019_137918445
Lamtor3,3,137918506,137928900,protein_coding,1,10394,chr3_137918506_137928900
Dapp1,3,137931007,137981545,protein_coding,-1,50538,chr3_137931007_137981545
Gm19708,3,138000939,138016044,lincRNA,1,15105,chr3_138000939_138016044
Gm5105,3,138048761,138067388,protein_coding,-1,18627,chr3_138048761_138067388
1110002E22Rik,3,138065052,138081506,protein_coding,1,16454,chr3_138065052_138081506
Mttp,3,138089854,138144968,protein_coding,-1,55114,chr3_138089854_138144968
Gm43691,3,138103916,138114717,antisense,1,10801,chr3_138103916_138114717
Trmt10a,3,138143448,138159821,protein_coding,1,16373,chr3_138143448_138159821
4930579F01Rik,3,138164078,138239663,protein_coding,-1,75585,chr3_138164078_138239663
0610031O16Rik,3,138210716,138240405,antisense,-1,29689,chr3_138210716_138240405
Gm16559,3,138281408,138307022,antisense,-1,25614,chr3_138281408_138307022
Adh6a,3,138313286,138331134,protein_coding,1,17848,chr3_138313286_138331134
Adh6b,3,138341775,138358861,protein_coding,1,17086,chr3_138341775_138358861
Adh4,3,138415466,138430892,protein_coding,1,15426,chr3_138415466_138430892
Adh5,3,138443093,138455499,protein_coding,1,12406,chr3_138443093_138455499
Metap1,3,138458956,138489515,protein_coding,-1,30559,chr3_138458956_138489515
Eif4e,3,138526179,138559696,protein_coding,1,33517,chr3_138526179_138559696
4930425O10Rik,3,138711535,138726984,lincRNA,-1,15449,chr3_138711535_138726984
Tspan5,3,138742195,138907905,protein_coding,1,165710,chr3_138742195_138907905
Rap1gds1,3,138925902,139075201,protein_coding,-1,149299,chr3_138925902_139075201
Stpg2,3,139205694,139710299,protein_coding,1,504605,chr3_139205694_139710299
Gm32693,3,139777153,139780759,lincRNA,-1,3606,chr3_139777153_139780759
Gm43678,3,139812111,139812764,lincRNA,-1,653,chr3_139812111_139812764
Gm43049,3,140692038,140760704,lincRNA,-1,68666,chr3_140692038_140760704
Gm32754,3,140904998,140908467,lincRNA,-1,3469,chr3_140904998_140908467
Gm15688,3,141457976,141465333,antisense,-1,7357,chr3_141457976_141465333
Unc5c,3,141465216,141834924,protein_coding,1,369708,chr3_141465216_141834924
Gm15689,3,141662889,141682900,antisense,-1,20011,chr3_141662889_141682900
Bmpr1b,3,141837136,142169425,protein_coding,-1,332289,chr3_141837136_142169425
Pdlim5,3,142239590,142395696,protein_coding,-1,156106,chr3_142239590_142395696
Gbp5,3,142493978,142522344,protein_coding,1,28366,chr3_142493978_142522344
Gbp7,3,142530342,142550149,protein_coding,1,19807,chr3_142530342_142550149
Gbp3,3,142560026,142573209,protein_coding,1,13183,chr3_142560026_142573209
Gbp2b,3,142594847,142619179,protein_coding,1,24332,chr3_142594847_142619179
Gbp2,3,142620602,142638008,protein_coding,1,17406,chr3_142620602_142638008
Kyat3,3,142701051,142746870,protein_coding,1,45819,chr3_142701051_142746870
Gm15540,3,142743661,142744681,antisense,-1,1020,chr3_142743661_142744681
Gtf2b,3,142765045,142783606,protein_coding,1,18561,chr3_142765045_142783606
Pkn2,3,142790902,142882004,protein_coding,-1,91102,chr3_142790902_142882004
9530052C20Rik,3,142882495,142892921,lincRNA,1,10426,chr3_142882495_142892921
4930519L02Rik,3,143017660,143040752,lincRNA,1,23092,chr3_143017660_143040752
Gm43614,3,143107948,143157903,lincRNA,1,49955,chr3_143107948_143157903
A830019L24Rik,3,143243055,143259884,lincRNA,1,16829,chr3_143243055_143259884
Gm43613,3,143330420,143332032,lincRNA,1,1612,chr3_143330420_143332032
Gm43612,3,143368576,143371782,lincRNA,1,3206,chr3_143368576_143371782
1700001N15Rik,3,143409401,143411532,lincRNA,1,2131,chr3_143409401_143411532
Gm43616,3,143575533,143577001,lincRNA,-1,1468,chr3_143575533_143577001
Gm33651,3,143576614,143589170,lincRNA,1,12556,chr3_143576614_143589170
Gm33758,3,143603805,143624575,lincRNA,1,20770,chr3_143603805_143624575
Gm42704,3,143650310,143652087,lincRNA,1,1777,chr3_143650310_143652087
Gm6260,3,143670892,143712210,lincRNA,-1,41318,chr3_143670892_143712210
Gm42705,3,143743377,143827012,lincRNA,1,83635,chr3_143743377_143827012
Gm42707,3,143878393,143954774,lincRNA,-1,76381,chr3_143878393_143954774
Gm42708,3,143898047,143898951,lincRNA,1,904,chr3_143898047_143898951
Gm34078,3,144101904,144135754,lincRNA,-1,33850,chr3_144101904_144135754
Lmo4,3,144188530,144205220,protein_coding,-1,16690,chr3_144188530_144205220
Gm43447,3,144320214,144321748,lincRNA,1,1534,chr3_144320214_144321748
Hs2st1,3,144429706,144570181,protein_coding,-1,140475,chr3_144429706_144570181
Selenof,3,144570304,144597680,protein_coding,1,27376,chr3_144570304_144597680
Sh3glb1,3,144683678,144720335,protein_coding,-1,36657,chr3_144683678_144720335
Clca3a1,3,144729677,144760977,protein_coding,-1,31300,chr3_144729677_144760977
Gm34866,3,144749482,144750087,antisense,1,605,chr3_144749482_144750087
Clca3a2,3,144796559,144819494,protein_coding,-1,22935,chr3_144796559_144819494
Gm43240,3,144808376,144813538,antisense,1,5162,chr3_144808376_144813538
Clca3b,3,144822623,144849357,protein_coding,-1,26734,chr3_144822623_144849357
Clca4b,3,144910921,144932529,protein_coding,-1,21608,chr3_144910921_144932529
Gm16233,3,144947561,144954878,antisense,1,7317,chr3_144947561_144954878
Clca4a,3,144952480,144975045,protein_coding,-1,22565,chr3_144952480_144975045
Clca1,3,145003817,145032776,protein_coding,-1,28959,chr3_145003817_145032776
Clca2,3,145070263,145099443,protein_coding,-1,29180,chr3_145070263_145099443
Odf2l,3,145118588,145153915,protein_coding,1,35327,chr3_145118588_145153915
Col24a1,3,145292472,145552011,protein_coding,1,259539,chr3_145292472_145552011
9530034A14Rik,3,145416012,145418044,antisense,-1,2032,chr3_145416012_145418044
Znhit6,3,145576205,145604795,protein_coding,1,28590,chr3_145576205_145604795
Gm17501,3,145650312,145677580,lincRNA,1,27268,chr3_145650312_145677580
Ddah1,3,145758675,145894277,protein_coding,1,135602,chr3_145758675_145894277
Bcl10,3,145922804,145934356,protein_coding,1,11552,chr3_145922804_145934356
2410004B18Rik,3,145938014,145944829,protein_coding,1,6815,chr3_145938014_145944829
Syde2,3,145987870,146021720,protein_coding,1,33850,chr3_145987870_146021720
Wdr63,3,146040526,146108130,protein_coding,-1,67604,chr3_146040526_146108130
Mcoln3,3,146117450,146141806,protein_coding,1,24356,chr3_146117450_146141806
Mcoln2,3,146149833,146195513,protein_coding,1,45680,chr3_146149833_146195513
Lpar3,3,146220963,146286186,protein_coding,1,65223,chr3_146220963_146286186
Gm10636,3,146367153,146378944,lincRNA,-1,11791,chr3_146367153_146378944
Ssx2ip,3,146404642,146440144,protein_coding,1,35502,chr3_146404642_146440144
Ctbs,3,146449795,146465849,protein_coding,1,16054,chr3_146449795_146465849
Spata1,3,146457196,146499753,protein_coding,-1,42557,chr3_146457196_146499753
Gng5,3,146499807,146505572,protein_coding,1,5765,chr3_146499807_146505572
Rpf1,3,146505956,146521429,protein_coding,-1,15473,chr3_146505956_146521429
Uox,3,146570426,146632305,protein_coding,1,61879,chr3_146570426_146632305
Dnase2b,3,146580985,146615596,protein_coding,-1,34611,chr3_146580985_146615596
Gm16325,3,146641932,146651715,antisense,1,9783,chr3_146641932_146651715
Samd13,3,146645195,146685592,protein_coding,-1,40397,chr3_146645195_146685592
Prkacb,3,146729574,146812990,protein_coding,-1,83416,chr3_146729574_146812990
Ttll7,3,146852367,146984009,protein_coding,1,131642,chr3_146852367_146984009
Gm29771,3,147096184,147128749,lincRNA,1,32565,chr3_147096184_147128749
Gm36831,3,147389712,147400995,lincRNA,1,11283,chr3_147389712_147400995
Gm36888,3,147620811,147635647,lincRNA,-1,14836,chr3_147620811_147635647
Adgrl2,3,148815583,148990555,protein_coding,-1,174972,chr3_148815583_148990555
Gm43573,3,148989152,149004031,antisense,1,14879,chr3_148989152_149004031
Gm10287,3,149221687,149225745,lincRNA,-1,4058,chr3_149221687_149225745
Gm30382,3,149284418,149445301,lincRNA,-1,160883,chr3_149284418_149445301
Gm5149,3,149304829,149345840,lincRNA,1,41011,chr3_149304829_149345840
Gm31121,3,149562882,149660396,lincRNA,-1,97514,chr3_149562882_149660396
Gm43470,3,150588739,150612176,lincRNA,1,23437,chr3_150588739_150612176
Gm43468,3,151071387,151074558,lincRNA,1,3171,chr3_151071387_151074558
Gm42949,3,151333349,151337638,lincRNA,1,4289,chr3_151333349_151337638
Adgrl4,3,151437887,151545086,protein_coding,1,107199,chr3_151437887_151545086
Ifi44,3,151730922,151749960,protein_coding,-1,19038,chr3_151730922_151749960
Ptgfr,3,151796502,151837630,protein_coding,-1,41128,chr3_151796502_151837630
Gm43617,3,151887303,151895101,lincRNA,1,7798,chr3_151887303_151895101
Gm43619,3,151988454,151992332,lincRNA,1,3878,chr3_151988454_151992332
Gipc2,3,152093533,152166230,protein_coding,-1,72697,chr3_152093533_152166230
Gm31881,3,152106439,152107383,antisense,1,944,chr3_152106439_152107383
Dnajb4,3,152178511,152210302,protein_coding,-1,31791,chr3_152178511_152210302
Fubp1,3,152210422,152236826,protein_coding,1,26404,chr3_152210422_152236826
Nexn,3,152236982,152266350,protein_coding,-1,29368,chr3_152236982_152266350
Miga1,3,152273849,152340407,protein_coding,-1,66558,chr3_152273849_152340407
Usp33,3,152346478,152393617,protein_coding,1,47139,chr3_152346478_152393617
Zzz3,3,152395473,152462826,protein_coding,1,67353,chr3_152395473_152462826
Ak5,3,152462815,152668360,protein_coding,-1,205545,chr3_152462815_152668360
AI115009,3,152666913,152681432,antisense,1,14519,chr3_152666913_152681432
Pigk,3,152714100,152980408,protein_coding,1,266308,chr3_152714100_152980408
St6galnac5,3,152817081,152982246,protein_coding,-1,165165,chr3_152817081_152982246
1700094M23Rik,3,153162728,153182815,lincRNA,-1,20087,chr3_153162728_153182815
St6galnac3,3,153198266,153725174,protein_coding,-1,526908,chr3_153198266_153725174
Asb17os,3,153836902,153852424,antisense,-1,15522,chr3_153836902_153852424
Asb17,3,153844209,153855082,protein_coding,1,10873,chr3_153844209_153855082
Msh4,3,153857149,153906138,protein_coding,-1,48989,chr3_153857149_153906138
Rabggtb,3,153907287,153913009,protein_coding,-1,5722,chr3_153907287_153913009
Gm43400,3,153913095,153916858,antisense,1,3763,chr3_153913095_153916858
Acadm,3,153922357,153944632,protein_coding,-1,22275,chr3_153922357_153944632
Slc44a5,3,153973436,154271722,protein_coding,1,298286,chr3_153973436_154271722
Lhx8,3,154306294,154330659,protein_coding,-1,24365,chr3_154306294_154330659
Tyw3,3,154576431,154597104,protein_coding,-1,20673,chr3_154576431_154597104
Cryz,3,154596711,154623182,protein_coding,1,26471,chr3_154596711_154623182
Erich3,3,154663859,154767790,protein_coding,1,103931,chr3_154663859_154767790
Gm20389,3,154708658,154711343,antisense,-1,2685,chr3_154708658_154711343
Tnni3k,3,154786291,155055407,protein_coding,-1,269116,chr3_154786291_155055407
Fpgt,3,155084918,155093403,protein_coding,-1,8485,chr3_155084918_155093403
Lrriq3,3,155093434,155194280,protein_coding,1,100846,chr3_155093434_155194280
9330178D15Rik,3,155976354,156008592,lincRNA,1,32238,chr3_155976354_156008592
4930570G19Rik,3,156546753,156561746,lincRNA,-1,14993,chr3_156546753_156561746
Negr1,3,156561794,157316445,protein_coding,1,754651,chr3_156561794_157316445
Gm15577,3,156903863,156920780,antisense,-1,16917,chr3_156903863_156920780
4930592C13Rik,3,157527515,157534090,antisense,-1,6575,chr3_157527515_157534090
Zranb2,3,157534160,157548410,protein_coding,1,14250,chr3_157534160_157548410
Ptger3,3,157566892,157645888,protein_coding,1,78996,chr3_157566892_157645888
Gm33466,3,157720404,157726408,lincRNA,-1,6004,chr3_157720404_157726408
Cth,3,157894248,157925077,protein_coding,-1,30829,chr3_157894248_157925077
1810013D15Rik,3,157925220,157938355,antisense,1,13135,chr3_157925220_157938355
Ankrd13c,3,157947239,158008034,protein_coding,1,60795,chr3_157947239_158008034
Srsf11,3,158010473,158036639,protein_coding,-1,26166,chr3_158010473_158036639
Lrrc40,3,158036662,158068487,protein_coding,1,31825,chr3_158036662_158068487
B230334C09Rik,3,158067186,158076112,antisense,-1,8926,chr3_158067186_158076112
Lrrc7,3,158082891,158562221,protein_coding,-1,479330,chr3_158082891_158562221
Gm20752,3,159076364,159308081,lincRNA,1,231717,chr3_159076364_159308081
Depdc1a,3,159495433,159529955,protein_coding,1,34522,chr3_159495433_159529955
Rpe65,3,159599175,159625321,protein_coding,1,26146,chr3_159599175_159625321
Wls,3,159839672,159938664,protein_coding,1,98992,chr3_159839672_159938664
AI838599,4,3242055,3258092,lincRNA,1,16037,chr4_3242055_3258092
Tmem68,4,3549041,3574853,protein_coding,-1,25812,chr4_3549041_3574853
Tgs1,4,3574875,3616619,protein_coding,1,41744,chr4_3574875_3616619
2210414B05Rik,4,3656508,3663108,lincRNA,1,6600,chr4_3656508_3663108
Lyn,4,3678115,3813122,protein_coding,1,135007,chr4_3678115_3813122
Rps20,4,3831334,3835665,protein_coding,-1,4331,chr4_3831334_3835665
Mos,4,3870657,3872105,protein_coding,-1,1448,chr4_3870657_3872105
Plag1,4,3900996,3938423,protein_coding,-1,37427,chr4_3900996_3938423
Chchd7,4,3938888,3951046,protein_coding,1,12158,chr4_3938888_3951046
Gm11808,4,3973092,3973595,protein_coding,-1,503,chr4_3973092_3973595
Sdr16c5,4,3995936,4019663,protein_coding,-1,23727,chr4_3995936_4019663
Sdr16c6,4,4055929,4077522,protein_coding,-1,21593,chr4_4055929_4077522
Penk,4,4133531,4138819,protein_coding,-1,5288,chr4_4133531_4138819
Impad1,4,4762484,4793355,protein_coding,-1,30871,chr4_4762484_4793355
4930423M02Rik,4,5632328,5642284,lincRNA,1,9956,chr4_5632328_5642284
Fam110b,4,5644090,6108223,protein_coding,1,464133,chr4_5644090_6108223
Ubxn2b,4,6191098,6221688,protein_coding,1,30590,chr4_6191098_6221688
4930430E12Rik,4,6352105,6357530,antisense,-1,5425,chr4_6352105_6357530
Sdcbp,4,6365650,6408423,protein_coding,1,42773,chr4_6365650_6408423
Nsmaf,4,6396207,6454271,protein_coding,-1,58064,chr4_6396207_6454271
Tox,4,6686353,6991557,protein_coding,-1,305204,chr4_6686353_6991557
Gm11802,4,6688169,6704160,antisense,1,15991,chr4_6688169_6704160
8430436N08Rik,4,7560688,7573801,lincRNA,1,13113,chr4_7560688_7573801
Gm11795,4,7759670,7763930,lincRNA,1,4260,chr4_7759670_7763930
Car8,4,8143362,8239041,protein_coding,-1,95679,chr4_8143362_8239041
Rab2a,4,8535644,8607778,protein_coding,1,72134,chr4_8535644_8607778
Chd7,4,8690406,8867659,protein_coding,1,177253,chr4_8690406_8867659
Clvs1,4,9269293,9451691,protein_coding,1,182398,chr4_9269293_9451691
Gm11816,4,9283972,9287391,antisense,-1,3419,chr4_9283972_9287391
Gm11817,4,9431961,9447199,antisense,-1,15238,chr4_9431961_9447199
Asph,4,9448069,9669344,protein_coding,-1,221275,chr4_9448069_9669344
Gdf6,4,9844372,9862345,protein_coding,1,17973,chr4_9844372_9862345
1700123O12Rik,4,10479962,10797811,lincRNA,-1,317849,chr4_10479962_10797811
2610301B20Rik,4,10874498,10899425,protein_coding,1,24927,chr4_10874498_10899425
Plekhf2,4,10988662,11007927,protein_coding,-1,19265,chr4_10988662_11007927
Ndufaf6,4,11051045,11076205,protein_coding,-1,25160,chr4_11051045_11076205
Trp53inp1,4,11156431,11174379,protein_coding,1,17948,chr4_11156431_11174379
Ccne2,4,11191351,11204779,protein_coding,1,13428,chr4_11191351_11204779
Ints8,4,11199158,11254258,protein_coding,-1,55100,chr4_11199158_11254258
Dpy19l4,4,11261315,11322137,protein_coding,-1,60822,chr4_11261315_11322137
Esrp1,4,11331933,11386783,protein_coding,-1,54850,chr4_11331933_11386783
Virma,4,11485958,11550684,protein_coding,1,64726,chr4_11485958_11550684
Gm11831,4,11501456,11502839,antisense,-1,1383,chr4_11501456_11502839
Rad54b,4,11558922,11615805,protein_coding,1,56883,chr4_11558922_11615805
Gm11832,4,11611139,11615007,antisense,-1,3868,chr4_11611139_11615007
Gem,4,11704457,11714752,protein_coding,1,10295,chr4_11704457_11714752
Cdh17,4,11758147,11817895,protein_coding,1,59748,chr4_11758147_11817895
Pdp1,4,11958184,11966452,protein_coding,-1,8268,chr4_11958184_11966452
Gm11840,4,11999474,12009043,lincRNA,-1,9569,chr4_11999474_12009043
Gm11842,4,12027505,12040894,antisense,1,13389,chr4_12027505_12040894
Tmem67,4,12039355,12090020,protein_coding,-1,50665,chr4_12039355_12090020
Rbm12b2,4,12089439,12096243,protein_coding,1,6804,chr4_12089439_12096243
Rbm12b1,4,12140264,12146731,protein_coding,1,6467,chr4_12140264_12146731
Fam92a,4,12153409,12172015,protein_coding,-1,18606,chr4_12153409_12172015
Gm11846,4,12271399,12314583,lincRNA,1,43184,chr4_12271399_12314583
Triqk,4,12906838,12983553,protein_coding,1,76715,chr4_12906838_12983553
Gm11820,4,13076140,13096806,lincRNA,1,20666,chr4_13076140_13096806
Runx1t1,4,13743436,13893649,protein_coding,1,150213,chr4_13743436_13893649
Gm11823,4,13919954,13995193,lincRNA,-1,75239,chr4_13919954_13995193
1700120G11Rik,4,14219496,14237450,lincRNA,-1,17954,chr4_14219496_14237450
Slc26a7,4,14502430,14621805,protein_coding,-1,119375,chr4_14502430_14621805
Lrrc69,4,14623620,14796060,protein_coding,-1,172440,chr4_14623620_14796060
Otud6b,4,14809498,14826587,protein_coding,-1,17089,chr4_14809498_14826587
Gm11837,4,14929908,14953030,antisense,1,23122,chr4_14929908_14953030
Necab1,4,14952245,15149794,protein_coding,-1,197549,chr4_14952245_15149794
Gm11844,4,15022582,15031987,antisense,1,9405,chr4_15022582_15031987
Tmem64,4,15265831,15286753,protein_coding,1,20922,chr4_15265831_15286753
Calb1,4,15881264,15908064,protein_coding,1,26800,chr4_15881264_15908064
Decr1,4,15917240,15945507,protein_coding,-1,28267,chr4_15917240_15945507
Nbn,4,15957925,15992589,protein_coding,1,34664,chr4_15957925_15992589
Osgin2,4,15997121,16013888,protein_coding,-1,16767,chr4_15997121_16013888
Ripk2,4,16122733,16163647,protein_coding,-1,40914,chr4_16122733_16163647
Gm11861,4,16464876,16509323,lincRNA,1,44447,chr4_16464876_16509323
Gm11851,4,17656675,17657963,lincRNA,-1,1288,chr4_17656675_17657963
Mmp16,4,17852893,18119145,protein_coding,1,266252,chr4_17852893_18119145
Cnbd1,4,18860454,19122526,protein_coding,-1,262072,chr4_18860454_19122526
Cngb3,4,19280850,19510623,protein_coding,1,229773,chr4_19280850_19510623
Cpne3,4,19519254,19570108,protein_coding,-1,50854,chr4_19519254_19570108
Rmdn1,4,19575162,19606932,protein_coding,1,31770,chr4_19575162_19606932
Gm12353,4,19605451,19651130,protein_coding,1,45679,chr4_19605451_19651130
Wwp1,4,19608303,19708993,protein_coding,-1,100690,chr4_19608303_19708993
Slc7a13,4,19818725,19842218,protein_coding,1,23493,chr4_19818725_19842218
Atp6v0d2,4,19876841,19922605,protein_coding,-1,45764,chr4_19876841_19922605
4930480G23Rik,4,19933841,20005671,transcribed_unitary_pseudogene,-1,71830,chr4_19933841_20005671
Ttpa,4,20007938,20030785,protein_coding,1,22847,chr4_20007938_20030785
Ggh,4,20042052,20066750,protein_coding,1,24698,chr4_20042052_20066750
Nkain3,4,20118874,20778866,protein_coding,-1,659992,chr4_20118874_20778866
Gm11872,4,20343706,20347818,antisense,1,4112,chr4_20343706_20347818
Prdm13,4,21677480,21685963,protein_coding,-1,8483,chr4_21677480_21685963
Ccnc,4,21727701,21759922,protein_coding,1,32221,chr4_21727701_21759922
Tstd3,4,21757382,21767212,protein_coding,-1,9830,chr4_21757382_21767212
Usp45,4,21767156,21837872,protein_coding,1,70716,chr4_21767156_21837872
Pnisr,4,21847583,21876475,protein_coding,1,28892,chr4_21847583_21876475
Coq3,4,21879673,21912162,protein_coding,1,32489,chr4_21879673_21912162
Faxc,4,21931329,21996839,protein_coding,1,65510,chr4_21931329_21996839
Fbxl4,4,22357543,22434091,protein_coding,1,76548,chr4_22357543_22434091
Pou3f2,4,22482780,22488366,protein_coding,-1,5586,chr4_22482780_22488366
Gm30731,4,22490548,22493126,lincRNA,1,2578,chr4_22490548_22493126
1700025O08Rik,4,22928167,22938435,lincRNA,-1,10268,chr4_22928167_22938435
Gm11884,4,23260784,23392503,lincRNA,1,131719,chr4_23260784_23392503
Gm28448,4,23933488,23933954,lincRNA,-1,466,chr4_23933488_23933954
Gm27243,4,24430370,24430890,lincRNA,-1,520,chr4_24430370_24430890
Mms22l,4,24496451,24602950,protein_coding,1,106499,chr4_24496451_24602950
Klhl32,4,24612554,24851124,protein_coding,-1,238570,chr4_24612554_24851124
Gm11899,4,24792680,24800310,antisense,1,7630,chr4_24792680_24800310
Ndufaf4,4,24898083,24905001,protein_coding,1,6918,chr4_24898083_24905001
Gpr63,4,24966407,25009233,protein_coding,1,42826,chr4_24966407_25009233
Fhl5,4,25199908,25242876,protein_coding,-1,42968,chr4_25199908_25242876
Ufl1,4,25248600,25281821,protein_coding,-1,33221,chr4_25248600_25281821
Fut9,4,25609332,25800244,protein_coding,-1,190912,chr4_25609332_25800244
Manea,4,26324506,26346891,protein_coding,-1,22385,chr4_26324506_26346891
4930548K13Rik,4,26635820,26705449,lincRNA,-1,69629,chr4_26635820_26705449
Epha7,4,28813131,28967499,protein_coding,1,154368,chr4_28813131_28967499
Gm11915,4,28814297,28815076,antisense,-1,779,chr4_28814297_28815076
Gm11917,4,29068079,29088811,lincRNA,1,20732,chr4_29068079_29088811
Gm11924,4,30432112,30523783,lincRNA,1,91671,chr4_30432112_30523783
4930556G01Rik,4,30664596,30796663,lincRNA,1,132067,chr4_30664596_30796663
Map3k7,4,31964097,32023467,protein_coding,1,59370,chr4_31964097_32023467
Bach2,4,32238804,32586108,protein_coding,1,347304,chr4_32238804_32586108
Bach2os,4,32559680,32571708,antisense,-1,12028,chr4_32559680_32571708
Gja10,4,32596960,32602760,protein_coding,-1,5800,chr4_32596960_32602760
Casp8ap2,4,32615451,32653265,protein_coding,1,37814,chr4_32615451_32653265
Mdn1,4,32657119,32775217,protein_coding,1,118098,chr4_32657119_32775217
Lyrm2,4,32800253,32801559,protein_coding,1,1306,chr4_32800253_32801559
Ankrd6,4,32804035,32950841,protein_coding,-1,146806,chr4_32804035_32950841
Rragd,4,32983037,33022180,protein_coding,1,39143,chr4_32983037_33022180
Ube2j1,4,33031416,33052363,protein_coding,1,20947,chr4_33031416_33052363
Gabrr2,4,33062999,33095865,protein_coding,1,32866,chr4_33062999_33095865
Gabrr1,4,33132521,33163588,protein_coding,1,31067,chr4_33132521_33163588
Pm20d2,4,33174230,33189737,protein_coding,-1,15507,chr4_33174230_33189737
Srsf12,4,33208991,33233340,protein_coding,1,24349,chr4_33208991_33233340
Pnrc1,4,33245423,33290163,protein_coding,-1,44740,chr4_33245423_33290163
Rngtt,4,33310311,33502614,protein_coding,1,192303,chr4_33310311_33502614
Cnr1,4,33924593,33948831,protein_coding,1,24238,chr4_33924593_33948831
Spaca1,4,34024874,34050191,protein_coding,-1,25317,chr4_34024874_34050191
Gm12753,4,34130854,34134800,lincRNA,1,3946,chr4_34130854_34134800
Akirin2,4,34550937,34566908,protein_coding,1,15971,chr4_34550937_34566908
Orc3,4,34570796,34614944,protein_coding,-1,44148,chr4_34570796_34614944
Rars2,4,34614957,34660167,protein_coding,1,45210,chr4_34614957_34660167
Slc35a1,4,34663257,34687438,protein_coding,-1,24181,chr4_34663257_34687438
Cfap206,4,34688559,34730206,protein_coding,-1,41647,chr4_34688559_34730206
Gm136,4,34743784,34756263,protein_coding,-1,12479,chr4_34743784_34756263
Smim8,4,34768664,34778423,protein_coding,-1,9759,chr4_34768664_34778423
Zfp292,4,34803113,34882960,protein_coding,-1,79847,chr4_34803113_34882960
Cga,4,34893779,34907370,protein_coding,1,13591,chr4_34893779_34907370
Mob3b,4,34949074,35157484,protein_coding,-1,208410,chr4_34949074_35157484
Gm12364,4,34962220,34966965,antisense,1,4745,chr4_34962220_34966965
Ifnk,4,35152056,35154005,protein_coding,1,1949,chr4_35152056_35154005
Lingo2,4,35706647,36951747,protein_coding,-1,1245100,chr4_35706647_36951747
Gm12371,4,36952966,36988032,lincRNA,1,35066,chr4_36952966_36988032
Gm12374,4,37249403,37332515,lincRNA,1,83112,chr4_37249403_37332515
Gm12381,4,38571667,38855483,lincRNA,-1,283816,chr4_38571667_38855483
Gm17094,4,39398045,39450249,antisense,-1,52204,chr4_39398045_39450249
Aco1,4,40143081,40198338,protein_coding,1,55257,chr4_40143081_40198338
Ddx58,4,40203773,40239828,protein_coding,-1,36055,chr4_40203773_40239828
Topors,4,40259601,40269850,protein_coding,-1,10249,chr4_40259601_40269850
Smim27,4,40269579,40270940,protein_coding,1,1361,chr4_40269579_40270940
Ndufb6,4,40270591,40279421,protein_coding,-1,8830,chr4_40270591_40279421
4930509K18Rik,4,40313232,40317719,lincRNA,1,4487,chr4_40313232_40317719
Tmem215,4,40472180,40477168,protein_coding,1,4988,chr4_40472180_40477168
4933428C19Rik,4,40482840,40525548,lincRNA,-1,42708,chr4_40482840_40525548
Aptx,4,40682382,40703194,protein_coding,-1,20812,chr4_40682382_40703194
Dnaja1,4,40722150,40737149,protein_coding,1,14999,chr4_40722150_40737149
Smu1,4,40736542,40757923,protein_coding,-1,21381,chr4_40736542_40757923
B4galt1,4,40804602,40854005,protein_coding,-1,49403,chr4_40804602_40854005
Spink4,4,40920052,40931395,protein_coding,1,11343,chr4_40920052_40931395
Bag1,4,40936398,40948294,protein_coding,-1,11896,chr4_40936398_40948294
Chmp5,4,40948407,40965303,protein_coding,1,16896,chr4_40948407_40965303
Nfx1,4,40970906,41025993,protein_coding,1,55087,chr4_40970906_41025993
Aqp7,4,41033074,41048139,protein_coding,-1,15065,chr4_41033074_41048139
Aqp3,4,41092722,41098183,protein_coding,-1,5461,chr4_41092722_41098183
Nol6,4,41114427,41124455,protein_coding,-1,10028,chr4_41114427_41124455
Ube2r2,4,41135743,41193380,protein_coding,1,57637,chr4_41135743_41193380
Ubap2,4,41194313,41275144,protein_coding,-1,80831,chr4_41194313_41275144
Dcaf12,4,41291300,41314889,protein_coding,-1,23589,chr4_41291300_41314889
Ubap1,4,41348996,41390525,protein_coding,1,41529,chr4_41348996_41390525
Kif24,4,41390745,41464887,protein_coding,-1,74142,chr4_41390745_41464887
Nudt2,4,41465151,41480926,protein_coding,1,15775,chr4_41465151_41480926
1110017D15Rik,4,41505009,41517333,protein_coding,-1,12324,chr4_41505009_41517333
Fam219aos,4,41517437,41518929,antisense,1,1492,chr4_41517437_41518929
Fam219a,4,41517691,41569538,protein_coding,-1,51847,chr4_41517691_41569538
Dnaic1,4,41569775,41638158,protein_coding,1,68383,chr4_41569775_41638158
Enho,4,41638144,41640324,protein_coding,-1,2180,chr4_41638144_41640324
Gm12406,4,41639378,41641416,antisense,1,2038,chr4_41639378_41641416
Gm12405,4,41642185,41643077,antisense,1,892,chr4_41642185_41643077
Cntfr,4,41657498,41697089,protein_coding,-1,39591,chr4_41657498_41697089
Il11ra1,4,41699989,41769474,protein_coding,1,69485,chr4_41699989_41769474
Rpp25l,4,41712033,41713534,protein_coding,-1,1501,chr4_41712033_41713534
Dctn3,4,41714798,41723170,protein_coding,-1,8372,chr4_41714798_41723170
Arid3c,4,41723836,41731142,protein_coding,-1,7306,chr4_41723836_41731142
Sigmar1,4,41738493,41756157,protein_coding,-1,17664,chr4_41738493_41756157
Gm13307,4,41893278,41942092,antisense,-1,48814,chr4_41893278_41942092
Gm20878,4,41941572,41943124,protein_coding,1,1552,chr4_41941572_41943124
Gm3892,4,42055152,42089708,antisense,1,34556,chr4_42055152_42089708
Gm13299,4,42121613,42153435,antisense,-1,31822,chr4_42121613_42153435
Gm13306,4,42153436,42158839,protein_coding,1,5403,chr4_42153436_42158839
Gm13305,4,42158842,42168603,protein_coding,-1,9761,chr4_42158842_42168603
Gm10600,4,42232136,42233438,transcribed_unprocessed_pseudogene,1,1302,chr4_42232136_42233438
Fam205a3,4,42318272,42324068,protein_coding,1,5796,chr4_42318272_42324068
Gm2163,4,42466972,42468868,unprocessed_pseudogene,1,1896,chr4_42466972_42468868
Gm2564,4,42629897,42631507,unprocessed_pseudogene,1,1610,chr4_42629897_42631507
Ccl27b,4,42655251,42655998,protein_coding,1,747,chr4_42655251_42655998
4930578G10Rik,4,42735545,42846248,protein_coding,1,110703,chr4_42735545_42846248
Gm12394,4,42781928,42856771,protein_coding,-1,74843,chr4_42781928_42856771
Fam205c,4,42868004,42874234,protein_coding,-1,6230,chr4_42868004_42874234
Phf24,4,42916660,42944752,protein_coding,1,28092,chr4_42916660_42944752
Dnajb5,4,42949814,42959425,protein_coding,1,9611,chr4_42949814_42959425
1700022I11Rik,4,42969604,42983640,protein_coding,1,14036,chr4_42969604_42983640
Vcp,4,42979963,43000507,protein_coding,-1,20544,chr4_42979963_43000507
Fancg,4,43002343,43010506,protein_coding,-1,8163,chr4_43002343_43010506
Pigo,4,43017635,43025819,protein_coding,-1,8184,chr4_43017635_43025819
Stoml2,4,43027690,43031710,protein_coding,-1,4020,chr4_43027690_43031710
Fam214b,4,43032414,43046220,protein_coding,-1,13806,chr4_43032414_43046220
Gm26881,4,43045966,43053254,antisense,1,7288,chr4_43045966_43053254
Unc13b,4,43058953,43264871,protein_coding,1,205918,chr4_43058953_43264871
Atp8b5,4,43267159,43373833,protein_coding,1,106674,chr4_43267159_43373833
Rusc2,4,43381979,43427088,protein_coding,1,45109,chr4_43381979_43427088
Fam166b,4,43427019,43429134,protein_coding,-1,2115,chr4_43427019_43429134
Tesk1,4,43441939,43448064,protein_coding,1,6125,chr4_43441939_43448064
Cd72,4,43446462,43454628,protein_coding,-1,8166,chr4_43446462_43454628
Sit1,4,43482081,43483734,protein_coding,-1,1653,chr4_43482081_43483734
Ccdc107,4,43492900,43495921,protein_coding,1,3021,chr4_43492900_43495921
Arhgef39,4,43496142,43499695,protein_coding,-1,3553,chr4_43496142_43499695
Gm12454,4,43504428,43508747,antisense,-1,4319,chr4_43504428_43508747
Car9,4,43506966,43513729,protein_coding,1,6763,chr4_43506966_43513729
Tpm2,4,43514711,43523765,protein_coding,-1,9054,chr4_43514711_43523765
Tln1,4,43531519,43562691,protein_coding,-1,31172,chr4_43531519_43562691
Creb3,4,43562332,43567060,protein_coding,1,4728,chr4_43562332_43567060
Gba2,4,43566928,43578873,protein_coding,-1,11945,chr4_43566928_43578873
Rgp1,4,43578715,43587487,protein_coding,1,8772,chr4_43578715_43587487
Msmp,4,43583216,43584494,protein_coding,-1,1278,chr4_43583216_43584494
Gm12472,4,43588072,43608755,antisense,1,20683,chr4_43588072_43608755
Gm12473,4,43631539,43641533,antisense,-1,9994,chr4_43631539_43641533
Npr2,4,43631935,43651244,protein_coding,1,19309,chr4_43631935_43651244
Spag8,4,43651335,43653594,protein_coding,-1,2259,chr4_43651335_43653594
Hint2,4,43654227,43656466,protein_coding,-1,2239,chr4_43654227_43656466
Fam221b,4,43659622,43669145,protein_coding,-1,9523,chr4_43659622_43669145
Tmem8b,4,43668971,43692668,protein_coding,1,23697,chr4_43668971_43692668
Olfr70,4,43694784,43700807,protein_coding,-1,6023,chr4_43694784_43700807
Olfr71,4,43704562,43710255,protein_coding,-1,5693,chr4_43704562_43710255
Hrct1,4,43727188,43728639,protein_coding,1,1451,chr4_43727188_43728639
Spaar,4,43730034,43759462,protein_coding,1,29428,chr4_43730034_43759462
Reck,4,43875530,43944806,protein_coding,1,69276,chr4_43875530_43944806
Glipr2,4,43957401,43979118,protein_coding,1,21717,chr4_43957401_43979118
Clta,4,44004452,44032846,protein_coding,1,28394,chr4_44004452_44032846
Gne,4,44034075,44084177,protein_coding,-1,50102,chr4_44034075_44084177
Rnf38,4,44126210,44233789,protein_coding,-1,107579,chr4_44126210_44233789
Melk,4,44300876,44364675,protein_coding,1,63799,chr4_44300876_44364675
Pax5,4,44524757,44710487,protein_coding,-1,185730,chr4_44524757_44710487
Gm12462,4,44664415,44685347,antisense,1,20932,chr4_44664415_44685347
Zcchc7,4,44755877,44932215,protein_coding,1,176338,chr4_44755877_44932215
Gm12678,4,44943753,44948330,lincRNA,1,4577,chr4_44943753_44948330
Gm12679,4,44970576,44978319,antisense,-1,7743,chr4_44970576_44978319
Grhpr,4,44981395,44990734,protein_coding,1,9339,chr4_44981395_44990734
Zbtb5,4,44991242,45012412,protein_coding,-1,21170,chr4_44991242_45012412
1700055D18Rik,4,45011687,45015406,antisense,1,3719,chr4_45011687_45015406
Polr1e,4,45018583,45036565,protein_coding,1,17982,chr4_45018583_45036565
Fbxo10,4,45034247,45084604,protein_coding,-1,50357,chr4_45034247_45084604
Tomm5,4,45105208,45108114,protein_coding,-1,2906,chr4_45105208_45108114
Frmpd1,4,45184875,45285936,protein_coding,1,101061,chr4_45184875_45285936
Frmpd1os,4,45234723,45243990,antisense,-1,9267,chr4_45234723_45243990
Trmt10b,4,45297127,45316131,protein_coding,1,19004,chr4_45297127_45316131
Exosc3,4,45316613,45342732,protein_coding,-1,26119,chr4_45316613_45342732
Dcaf10,4,45342101,45379759,protein_coding,1,37658,chr4_45342101_45379759
Slc25a51,4,45395923,45408766,protein_coding,-1,12843,chr4_45395923_45408766
Shb,4,45423278,45532470,protein_coding,-1,109192,chr4_45423278_45532470
Gm12408,4,45639744,45646111,lincRNA,1,6367,chr4_45639744_45646111
Gm829,4,45683589,45723338,lincRNA,1,39749,chr4_45683589_45723338
Aldh1b1,4,45799022,45804604,protein_coding,1,5582,chr4_45799022_45804604
Igfbpl1,4,45809468,45826923,protein_coding,-1,17455,chr4_45809468_45826923
Stra6l,4,45848664,45887008,protein_coding,1,38344,chr4_45848664_45887008
Ccdc180,4,45890303,45950774,protein_coding,1,60471,chr4_45890303_45950774
Tdrd7,4,45965334,46034761,protein_coding,1,69427,chr4_45965334_46034761
Tmod1,4,46038935,46116032,protein_coding,1,77097,chr4_46038935_46116032
Tstd2,4,46114746,46138694,protein_coding,-1,23948,chr4_46114746_46138694
Ncbp1,4,46138613,46172403,protein_coding,1,33790,chr4_46138613_46172403
Xpa,4,46155347,46196311,protein_coding,-1,40964,chr4_46155347_46196311
Gm12446,4,46300007,46345515,antisense,-1,45508,chr4_46300007_46345515
Trmo,4,46376505,46389437,protein_coding,-1,12932,chr4_46376505_46389437
Hemgn,4,46393989,46413506,protein_coding,-1,19517,chr4_46393989_46413506
Anp32b,4,46450902,46472657,protein_coding,1,21755,chr4_46450902_46472657
Nans,4,46489248,46503632,protein_coding,1,14384,chr4_46489248_46503632
Trim14,4,46493781,46536141,protein_coding,-1,42360,chr4_46493781_46536141
Coro2a,4,46536937,46602202,protein_coding,-1,65265,chr4_46536937_46602202
Tbc1d2,4,46604390,46650209,protein_coding,-1,45819,chr4_46604390_46650209
Gabbr2,4,46662305,46991873,protein_coding,-1,329568,chr4_46662305_46991873
Gm568,4,47008316,47010781,lincRNA,-1,2465,chr4_47008316_47010781
Anks6,4,47015669,47057427,protein_coding,-1,41758,chr4_47015669_47057427
Galnt12,4,47091909,47123070,protein_coding,1,31161,chr4_47091909_47123070
Gm12426,4,47197487,47208459,antisense,-1,10972,chr4_47197487_47208459
Col15a1,4,47208161,47313167,protein_coding,1,105006,chr4_47208161_47313167
Tgfbr1,4,47353222,47414931,protein_coding,1,61709,chr4_47353222_47414931
Alg2,4,47465067,47474333,protein_coding,-1,9266,chr4_47465067_47474333
Sec61b,4,47474658,47483242,protein_coding,1,8584,chr4_47474658_47483242
Gm12434,4,47996456,47998261,lincRNA,1,1805,chr4_47996456_47998261
Nr4a3,4,48045153,48086447,protein_coding,1,41294,chr4_48045153_48086447
Stx17,4,48124915,48186507,protein_coding,1,61592,chr4_48124915_48186507
Erp44,4,48193323,48279558,protein_coding,-1,86235,chr4_48193323_48279558
Invs,4,48279760,48431954,protein_coding,1,152194,chr4_48279760_48431954
Tex10,4,48430858,48473459,protein_coding,-1,42601,chr4_48430858_48473459
Msantd3,4,48539935,48561919,protein_coding,1,21984,chr4_48539935_48561919
Tmeff1,4,48585174,48663131,protein_coding,1,77957,chr4_48585174_48663131
Cavin4,4,48663514,48673502,protein_coding,1,9988,chr4_48663514_48673502
Gm12436,4,48898593,48963237,lincRNA,1,64644,chr4_48898593_48963237
Plppr1,4,49059273,49340259,protein_coding,1,280986,chr4_49059273_49340259
Acnat2,4,49379840,49408151,protein_coding,-1,28311,chr4_49379840_49408151
Acnat1,4,49447105,49473912,protein_coding,-1,26807,chr4_49447105_49473912
Baat,4,49489422,49506557,protein_coding,-1,17135,chr4_49489422_49506557
Mrpl50,4,49512596,49521093,protein_coding,-1,8497,chr4_49512596_49521093
Zfp189,4,49521176,49531517,protein_coding,1,10341,chr4_49521176_49531517
Aldob,4,49535995,49549546,protein_coding,-1,13551,chr4_49535995_49549546
Tmem246,4,49584506,49597876,protein_coding,-1,13370,chr4_49584506_49597876
Rnf20,4,49632006,49656887,protein_coding,1,24881,chr4_49632006_49656887
Grin3a,4,49661611,49845744,protein_coding,-1,184133,chr4_49661611_49845744
Cylc2,4,51216678,51250622,protein_coding,1,33944,chr4_51216678_51250622
C630028M04Rik,4,51968094,52051110,lincRNA,-1,83016,chr4_51968094_52051110
Smc2os,4,52430285,52438965,antisense,-1,8680,chr4_52430285_52438965
Smc2,4,52439243,52488260,protein_coding,1,49017,chr4_52439243_52488260
Vma21-ps,4,52496939,52497244,processed_pseudogene,-1,305,chr4_52496939_52497244
Toporsl,4,52596274,52612430,protein_coding,1,16156,chr4_52596274_52612430
Olfr275,4,52814604,52828269,protein_coding,1,13665,chr4_52814604_52828269
Olfr273,4,52852154,52859236,protein_coding,-1,7082,chr4_52852154_52859236
Olfr272,4,52910207,52919178,protein_coding,-1,8971,chr4_52910207_52919178
Olfr270,4,52964547,52972474,protein_coding,1,7927,chr4_52964547_52972474
Nipsnap3a,4,52989272,53001162,protein_coding,1,11890,chr4_52989272_53001162
Nipsnap3b,4,53011880,53022060,protein_coding,1,10180,chr4_53011880_53022060
Abca1,4,53030787,53159895,protein_coding,-1,129108,chr4_53030787_53159895
4930522O17Rik,4,53246196,53251115,antisense,1,4919,chr4_53246196_53251115
Gm12496,4,53401948,53404030,lincRNA,-1,2082,chr4_53401948_53404030
Slc44a1,4,53440413,53622478,protein_coding,1,182065,chr4_53440413_53622478
1700060J05Rik,4,53562983,53564697,antisense,-1,1714,chr4_53562983_53564697
Fsd1l,4,53631471,53707009,protein_coding,1,75538,chr4_53631471_53707009
Fktn,4,53713998,53777890,protein_coding,1,63892,chr4_53713998_53777890
Tal2,4,53779705,53788712,protein_coding,1,9007,chr4_53779705_53788712
Tmem38b,4,53826045,53862019,protein_coding,1,35974,chr4_53826045_53862019
Gm12484,4,54151831,54163678,lincRNA,-1,11847,chr4_54151831_54163678
Gm12478,4,54646542,54689451,lincRNA,1,42909,chr4_54646542_54689451
Zfp462,4,54945048,55083563,protein_coding,1,138515,chr4_54945048_55083563
Gm12514,4,55131208,55279479,lincRNA,-1,148271,chr4_55131208_55279479
Rad23b,4,55350043,55392237,protein_coding,1,42194,chr4_55350043_55392237
Gm12505,4,55410443,55418842,lincRNA,-1,8399,chr4_55410443_55418842
Gm12510,4,55450684,55465814,lincRNA,-1,15130,chr4_55450684_55465814
Klf4,4,55527143,55532466,protein_coding,-1,5323,chr4_55527143_55532466
Gm12511,4,55563265,55599296,lincRNA,1,36031,chr4_55563265_55599296
Gm12506,4,55605149,55636901,lincRNA,1,31752,chr4_55605149_55636901
Gm12519,4,55969023,55993739,lincRNA,-1,24716,chr4_55969023_55993739
2310081O03Rik,4,56220617,56224521,lincRNA,-1,3904,chr4_56220617_56224521
Actl7b,4,56740005,56741443,protein_coding,-1,1438,chr4_56740005_56741443
Actl7a,4,56743413,56744925,protein_coding,1,1512,chr4_56743413_56744925
Ctnnal1,4,56810935,56865188,protein_coding,-1,54253,chr4_56810935_56865188
Tmem245,4,56866923,56947437,protein_coding,-1,80514,chr4_56866923_56947437
Frrs1l,4,56957173,56990391,protein_coding,-1,33218,chr4_56957173_56990391
Epb41l4b,4,56991972,57143437,protein_coding,-1,151465,chr4_56991972_57143437
Gm12530,4,57172071,57176554,antisense,1,4483,chr4_57172071_57176554
Ptpn3,4,57190841,57301837,protein_coding,-1,110996,chr4_57190841_57301837
Gm12536,4,57300096,57307305,lincRNA,1,7209,chr4_57300096_57307305
1700042G15Rik,4,57360868,57364292,lincRNA,-1,3424,chr4_57360868_57364292
Pakap,4,57434247,57896984,protein_coding,1,462737,chr4_57434247_57896984
D630039A03Rik,4,57908483,57916297,protein_coding,-1,7814,chr4_57908483_57916297
Txn1,4,57943373,57956411,protein_coding,-1,13038,chr4_57943373_57956411
Txndc8,4,57984027,58009124,protein_coding,-1,25097,chr4_57984027_58009124
Svep1,4,58042442,58206859,protein_coding,-1,164417,chr4_58042442_58206859
Musk,4,58285960,58374303,protein_coding,1,88343,chr4_58285960_58374303
Lpar1,4,58435255,58553898,protein_coding,-1,118643,chr4_58435255_58553898
Gm12580,4,58648392,58658592,lincRNA,-1,10200,chr4_58648392_58658592
Olfr267,4,58782704,58787716,protein_coding,-1,5012,chr4_58782704_58787716
Zkscan16,4,58943628,58958355,protein_coding,1,14727,chr4_58943628_58958355
Ptgr1,4,58965439,58987119,protein_coding,-1,21680,chr4_58965439_58987119
Dnajc25,4,58995062,59025573,protein_coding,1,30511,chr4_58995062_59025573
Gm20503,4,59003210,59041888,protein_coding,1,38678,chr4_59003210_59041888
Gng10,4,59035088,59041903,protein_coding,1,6815,chr4_59035088_59041903
Ugcg,4,59189257,59222833,protein_coding,1,33576,chr4_59189257_59222833
Gm12596,4,59260051,59263269,lincRNA,1,3218,chr4_59260051_59263269
Susd1,4,59314683,59438633,protein_coding,-1,123950,chr4_59314683_59438633
Ptbp3,4,59471868,59549364,protein_coding,-1,77496,chr4_59471868_59549364
Hsdl2,4,59581563,59618689,protein_coding,1,37126,chr4_59581563_59618689
E130308A19Rik,4,59626211,59761439,protein_coding,1,135228,chr4_59626211_59761439
Inip,4,59769637,59801589,protein_coding,-1,31952,chr4_59769637_59801589
Snx30,4,59805840,59904737,protein_coding,1,98897,chr4_59805840_59904737
Gm12542,4,59889986,59894924,antisense,-1,4938,chr4_59889986_59894924
Slc46a2,4,59905126,59915056,protein_coding,-1,9930,chr4_59905126_59915056
Mup6,4,59964294,60007274,protein_coding,1,42980,chr4_59964294_60007274
Mup2,4,60135932,60154289,protein_coding,-1,18357,chr4_60135932_60154289
Mup18,4,61670177,61674136,protein_coding,-1,3959,chr4_61670177_61674136
Mup5,4,61831319,61835233,protein_coding,-1,3914,chr4_61831319_61835233
Mup3,4,62083476,62087342,protein_coding,-1,3866,chr4_62083476_62087342
Gm12909,4,62088288,62090524,antisense,1,2236,chr4_62088288_62090524
Gm12910,4,62112931,62120929,antisense,1,7998,chr4_62112931_62120929
Zfp37,4,62189540,62231047,protein_coding,-1,41507,chr4_62189540_62231047
Slc31a2,4,62262562,62298411,protein_coding,1,35849,chr4_62262562_62298411
Fkbp15,4,62300342,62360548,protein_coding,-1,60206,chr4_62300342_62360548
Slc31a1,4,62360727,62391769,protein_coding,1,31042,chr4_62360727_62391769
Cdc26,4,62383654,62408642,protein_coding,-1,24988,chr4_62383654_62408642
Prpf4,4,62408797,62426990,protein_coding,1,18193,chr4_62408797_62426990
Rnf183,4,62427540,62435252,protein_coding,-1,7712,chr4_62427540_62435252
Wdr31,4,62448653,62470896,protein_coding,-1,22243,chr4_62448653_62470896
Bspry,4,62480053,62497298,protein_coding,1,17245,chr4_62480053_62497298
Hdhd3,4,62499008,62503467,protein_coding,-1,4459,chr4_62499008_62503467
Alad,4,62509169,62519918,protein_coding,-1,10749,chr4_62509169_62519918
Pole3,4,62522649,62525068,protein_coding,-1,2419,chr4_62522649_62525068
4933430I17Rik,4,62525369,62547993,protein_coding,1,22624,chr4_62525369_62547993
Rgs3,4,62559847,62704001,protein_coding,1,144154,chr4_62559847_62704001
Gm11209,4,62627677,62633712,antisense,-1,6035,chr4_62627677_62633712
Gm11210,4,62705981,62725737,lincRNA,1,19756,chr4_62705981_62725737
Gm11211,4,62723516,62727537,lincRNA,-1,4021,chr4_62723516_62727537
Zfp618,4,62965573,63139708,protein_coding,1,174135,chr4_62965573_63139708
Ambp,4,63143275,63154799,protein_coding,-1,11524,chr4_63143275_63154799
Col27a1,4,63214004,63334991,protein_coding,1,120987,chr4_63214004_63334991
Orm2,4,63362449,63365878,protein_coding,1,3429,chr4_63362449_63365878
Akna,4,63367125,63403354,protein_coding,-1,36229,chr4_63367125_63403354
Aknaos,4,63381358,63394018,antisense,1,12660,chr4_63381358_63394018
Whrn,4,63414910,63495991,protein_coding,-1,81081,chr4_63414910_63495991
Atp6v1g1,4,63544772,63550750,protein_coding,1,5978,chr4_63544772_63550750
Tmem268,4,63558781,63586357,protein_coding,1,27576,chr4_63558781_63586357
Gm11213,4,63596901,63605261,protein_coding,-1,8360,chr4_63596901_63605261
Tex48,4,63607089,63622428,protein_coding,-1,15339,chr4_63607089_63622428
Gm11482,4,63634421,63639440,lincRNA,1,5019,chr4_63634421_63639440
Gm11214,4,63662359,63663379,protein_coding,-1,1020,chr4_63662359_63663379
Tnfsf15,4,63724603,63745113,protein_coding,-1,20510,chr4_63724603_63745113
Tnfsf8,4,63831308,63861347,protein_coding,-1,30039,chr4_63831308_63861347
Tnc,4,63959785,64047015,protein_coding,-1,87230,chr4_63959785_64047015
Gm11216,4,64075533,64083814,lincRNA,1,8281,chr4_64075533_64083814
Gm11217,4,64254053,64276603,lincRNA,-1,22550,chr4_64254053_64276603
Pappa,4,65124174,65357509,protein_coding,1,233335,chr4_65124174_65357509
Astn2,4,65380803,66404611,protein_coding,-1,1023808,chr4_65380803_66404611
Trim32,4,65604986,65616238,protein_coding,1,11252,chr4_65604986_65616238
Tlr4,4,66827584,66930284,protein_coding,1,102700,chr4_66827584_66930284
Gm11751,4,68023031,68137113,lincRNA,1,114082,chr4_68023031_68137113
Gm12911,4,68312657,68321961,lincRNA,-1,9304,chr4_68312657_68321961
Brinp1,4,68761514,68954397,protein_coding,-1,192883,chr4_68761514_68954397
Cdk5rap2,4,70216856,70410443,protein_coding,-1,193587,chr4_70216856_70410443
Megf9,4,70427065,70534995,protein_coding,-1,107930,chr4_70427065_70534995
Gm11228,4,71075109,71131133,lincRNA,-1,56024,chr4_71075109_71131133
Gm11234,4,71980477,71999559,lincRNA,1,19082,chr4_71980477_71999559
Tle1,4,72117142,72200919,protein_coding,-1,83777,chr4_72117142_72200919
Gm11250,4,72168768,72169449,antisense,1,681,chr4_72168768_72169449
Aldoart1,4,72850583,72852634,protein_coding,-1,2051,chr4_72850583_72852634
Gm11238,4,73607881,73657291,protein_coding,1,49410,chr4_73607881_73657291
Rasef,4,73714579,73790994,protein_coding,-1,76415,chr4_73714579_73790994
2310002L09Rik,4,73939371,73950846,protein_coding,-1,11475,chr4_73939371_73950846
Frmd3,4,74013442,74202214,protein_coding,1,188772,chr4_74013442_74202214
Kdm4c,4,74242497,74405860,protein_coding,1,163363,chr4_74242497_74405860
A230083N12Rik,4,74250324,74251714,antisense,-1,1390,chr4_74250324_74251714
Dmac1,4,75277354,75278305,protein_coding,-1,951,chr4_75277354_75278305
Ptprd,4,75941238,78211961,protein_coding,-1,2270723,chr4_75941238_78211961
Gm42303,4,76451231,76490113,antisense,1,38882,chr4_76451231_76490113
Gm11261,4,78659858,78661588,lincRNA,-1,1730,chr4_78659858_78661588
Tyrp1,4,80834123,80851719,protein_coding,1,17596,chr4_80834123_80851719
Lurap1l,4,80910646,80955628,protein_coding,1,44982,chr4_80910646_80955628
Mpdz,4,81278500,81442815,protein_coding,-1,164315,chr4_81278500_81442815
Gm11412,4,81743146,81746701,lincRNA,1,3555,chr4_81743146_81746701
Gm11264,4,82033312,82065890,lincRNA,-1,32578,chr4_82033312_82065890
Gm5860,4,82065431,82102808,lincRNA,1,37377,chr4_82065431_82102808
Nfib,4,82290173,82705750,protein_coding,-1,415577,chr4_82290173_82705750
Gm11266,4,82508016,82547292,antisense,1,39276,chr4_82508016_82547292
Zdhhc21,4,82798738,82859958,protein_coding,-1,61220,chr4_82798738_82859958
Cer1,4,82881751,82885148,protein_coding,-1,3397,chr4_82881751_82885148
Frem1,4,82897920,83052339,protein_coding,-1,154419,chr4_82897920_83052339
Ttc39b,4,83220300,83324255,protein_coding,-1,103955,chr4_83220300_83324255
Gm11413,4,83378317,83390668,antisense,-1,12351,chr4_83378317_83390668
Gm11184,4,83383064,83392205,lincRNA,1,9141,chr4_83383064_83392205
Snapc3,4,83417724,83467676,protein_coding,1,49952,chr4_83417724_83467676
Psip1,4,83455680,83486459,protein_coding,-1,30779,chr4_83455680_83486459
Ccdc171,4,83525545,83864670,protein_coding,1,339125,chr4_83525545_83864670
Bnc2,4,84275095,84675275,protein_coding,-1,400180,chr4_84275095_84675275
Cntln,4,84884309,85131921,protein_coding,1,247612,chr4_84884309_85131921
Sh3gl2,4,85205126,85639195,protein_coding,1,434069,chr4_85205126_85639195
Adamtsl1,4,85514172,86428385,protein_coding,1,914213,chr4_85514172_86428385
Saxo1,4,86444641,86558328,protein_coding,-1,113687,chr4_86444641_86558328
Rraga,4,86575668,86577285,protein_coding,1,1617,chr4_86575668_86577285
Haus6,4,86578855,86612055,protein_coding,-1,33200,chr4_86578855_86612055
Plin2,4,86648386,86670060,protein_coding,-1,21674,chr4_86648386_86670060
Dennd4c,4,86748555,86850603,protein_coding,1,102048,chr4_86748555_86850603
Rps6,4,86854660,86857412,protein_coding,-1,2752,chr4_86854660_86857412
Acer2,4,86874396,86934822,protein_coding,1,60426,chr4_86874396_86934822
Slc24a2,4,86983124,87230477,protein_coding,-1,247353,chr4_86983124_87230477
Gm12600,4,87298362,87301270,lincRNA,1,2908,chr4_87298362_87301270
Mllt3,4,87769925,88033364,protein_coding,-1,263439,chr4_87769925_88033364
Gm12631,4,88033501,88034998,antisense,1,1497,chr4_88033501_88034998
Focad,4,88094629,88411011,protein_coding,1,316382,chr4_88094629_88411011
Hacd4,4,88396144,88438928,protein_coding,-1,42784,chr4_88396144_88438928
C87499,4,88627320,88634411,protein_coding,-1,7091,chr4_88627320_88634411
Ifnab,4,88690302,88691359,protein_coding,-1,1057,chr4_88690302_88691359
Klhl9,4,88718292,88722465,protein_coding,-1,4173,chr4_88718292_88722465
Gm26566,4,88721805,88722842,protein_coding,1,1037,chr4_88721805_88722842
Gm13274,4,88722757,88757579,antisense,-1,34822,chr4_88722757_88757579
Wincr1,4,89050308,89084614,lincRNA,1,34306,chr4_89050308_89084614
Mtap,4,89137122,89181081,protein_coding,1,43959,chr4_89137122_89181081
Gm12606,4,89235699,89273403,lincRNA,-1,37704,chr4_89235699_89273403
Cdkn2a,4,89274471,89294653,protein_coding,-1,20182,chr4_89274471_89294653
Cdkn2b,4,89306299,89311039,protein_coding,-1,4740,chr4_89306299_89311039
Dmrta1,4,89679436,89694772,protein_coding,1,15336,chr4_89679436_89694772
Zfp352,4,90218820,90225702,protein_coding,1,6882,chr4_90218820_90225702
Elavl2,4,91250763,91400785,protein_coding,-1,150022,chr4_91250763_91400785
Gm12670,4,91646315,91651152,lincRNA,1,4837,chr4_91646315_91651152
Gm12637,4,92528551,92548304,lincRNA,1,19753,chr4_92528551_92548304
Tusc1,4,93334138,93335511,protein_coding,-1,1373,chr4_93334138_93335511
Gm12649,4,93453258,93671070,lincRNA,-1,217812,chr4_93453258_93671070
Gm12648,4,94089576,94425588,lincRNA,-1,336012,chr4_94089576_94425588
Caap1,4,94500081,94556796,protein_coding,-1,56715,chr4_94500081_94556796
Plaa,4,94567514,94603244,protein_coding,-1,35730,chr4_94567514_94603244
Ift74,4,94614491,94693229,protein_coding,1,78738,chr4_94614491_94693229
Lrrc19,4,94636653,94650144,protein_coding,-1,13491,chr4_94636653_94650144
Tek,4,94739289,94874976,protein_coding,1,135687,chr4_94739289_94874976
Eqtn,4,94907267,94928843,protein_coding,-1,21576,chr4_94907267_94928843
Mysm1,4,94942040,94979100,protein_coding,-1,37060,chr4_94942040_94979100
Gm12694,4,94979203,95028544,antisense,1,49341,chr4_94979203_95028544
Jun,4,95049034,95052222,protein_coding,-1,3188,chr4_95049034_95052222
Junos,4,95051534,95167318,antisense,1,115784,chr4_95051534_95167318
4930551L18Rik,4,95089083,95091419,lincRNA,-1,2336,chr4_95089083_95091419
Gm12708,4,95193313,95209727,lincRNA,1,16414,chr4_95193313_95209727
Fggy,4,95557507,95926939,protein_coding,1,369432,chr4_95557507_95926939
Hook1,4,95967240,96025413,protein_coding,1,58173,chr4_95967240_96025413
Cyp2j13,4,96027534,96077546,protein_coding,-1,50012,chr4_96027534_96077546
Cyp2j12,4,96099318,96141152,protein_coding,-1,41834,chr4_96099318_96141152
Cyp2j7,4,96195197,96236659,protein_coding,-1,41462,chr4_96195197_96236659
Cyp2j11,4,96294508,96348662,protein_coding,-1,54154,chr4_96294508_96348662
Cyp2j8,4,96444596,96507386,protein_coding,-1,62790,chr4_96444596_96507386
Cyp2j6,4,96516138,96553661,protein_coding,-1,37523,chr4_96516138_96553661
Cyp2j9,4,96568429,96591578,protein_coding,-1,23149,chr4_96568429_96591578
Cyp2j5,4,96628773,96664154,protein_coding,-1,35381,chr4_96628773_96664154
Gm12695,4,96723647,96785186,protein_coding,-1,61539,chr4_96723647_96785186
E130114P18Rik,4,97568133,97778078,protein_coding,-1,209945,chr4_97568133_97778078
Nfia,4,97772734,98118874,protein_coding,1,346140,chr4_97772734_98118874
0610025J13Rik,4,98321398,98331791,antisense,1,10393,chr4_98321398_98331791
Tm2d1,4,98355370,98383306,protein_coding,-1,27936,chr4_98355370_98383306
Patj,4,98395785,98719603,protein_coding,1,323818,chr4_98395785_98719603
L1td1,4,98726734,98738480,protein_coding,1,11746,chr4_98726734_98738480
Kank4,4,98754898,98817537,protein_coding,-1,62639,chr4_98754898_98817537
Kank4os,4,98793768,98798900,antisense,1,5132,chr4_98793768_98798900
I0C0044D17Rik,4,98818475,98823840,protein_coding,-1,5365,chr4_98818475_98823840
Usp1,4,98923810,98935543,protein_coding,1,11733,chr4_98923810_98935543
Dock7,4,98936671,99120915,protein_coding,-1,184244,chr4_98936671_99120915
Angptl3,4,99030954,99046111,protein_coding,1,15157,chr4_99030954_99046111
Gm12705,4,99116414,99118301,antisense,1,1887,chr4_99116414_99118301
Gm12681,4,99146914,99161642,lincRNA,-1,14728,chr4_99146914_99161642
Atg4c,4,99193934,99259787,protein_coding,1,65853,chr4_99193934_99259787
Gm12689,4,99295900,99297258,protein_coding,1,1358,chr4_99295900_99297258
Gm12682,CHR_MG3618_PATCH,99662541,99712972,antisense;lncRNA,-1,50431,chrCHR_MG3618_PATCH_99662541_99712972
Alg6,4,99715664,99763460,protein_coding,1,47796,chr4_99715664_99763460
Itgb3bp,4,99765402,99929813,protein_coding,-1,164411,chr4_99765402_99929813
Efcab7,4,99829198,99912788,protein_coding,1,83590,chr4_99829198_99912788
Pgm2,5,64092950,64128351,protein_coding,1,35401,chr5_64092950_64128351
Gm12702,4,100052520,100065984,lincRNA,1,13464,chr4_100052520_100065984
Ror1,4,100095791,100444765,protein_coding,1,348974,chr4_100095791_100444765
Ube2u,4,100478849,100550147,protein_coding,1,71298,chr4_100478849_100550147
Ube2uos,4,100523247,100527801,antisense,-1,4554,chr4_100523247_100527801
Cachd1,4,100776675,101029220,protein_coding,1,252545,chr4_100776675_101029220
Raver2,4,101068983,101152370,protein_coding,1,83387,chr4_101068983_101152370
Jak1,4,101152367,101265282,protein_coding,-1,112915,chr4_101152367_101265282
Gm12796,4,101292414,101321745,lincRNA,-1,29331,chr4_101292414_101321745
E130102H24Rik,4,101346531,101356735,lincRNA,-1,10204,chr4_101346531_101356735
0610043K17Rik,4,101353783,101399181,lincRNA,1,45398,chr4_101353783_101399181
Gm12798,4,101403081,101407856,lincRNA,1,4775,chr4_101403081_101407856
Ak4,4,101419277,101466995,protein_coding,1,47718,chr4_101419277_101466995
Dnajc6,4,101496631,101642799,protein_coding,1,146168,chr4_101496631_101642799
Leprot,4,101647718,101659364,protein_coding,1,11646,chr4_101647718_101659364
Lepr,4,101717404,101815352,protein_coding,1,97948,chr4_101717404_101815352
B020004J07Rik,4,101834969,101844023,protein_coding,-1,9054,chr4_101834969_101844023
C130073F10Rik,4,101890020,101893789,protein_coding,-1,3769,chr4_101890020_101893789
Gm12790,4,101967453,101981049,protein_coding,-1,13596,chr4_101967453_101981049
Pde4b,4,102087543,102607259,protein_coding,1,519716,chr4_102087543_102607259
Sgip1,4,102741297,102973628,protein_coding,1,232331,chr4_102741297_102973628
Gm12709,4,102967266,102989755,antisense,-1,22489,chr4_102967266_102989755
Tctex1d1,4,102978606,103005594,protein_coding,1,26988,chr4_102978606_103005594
BB031773,4,103004106,103011965,antisense,-1,7859,chr4_103004106_103011965
Insl5,4,103017872,103026842,protein_coding,-1,8970,chr4_103017872_103026842
Wdr78,4,103038065,103114555,protein_coding,-1,76490,chr4_103038065_103114555
Mier1,4,103114390,103165754,protein_coding,1,51364,chr4_103114390_103165754
Slc35d1,4,103170649,103215164,protein_coding,-1,44515,chr4_103170649_103215164
Gm44037,4,103217702,103219592,lincRNA,1,1890,chr4_103217702_103219592
4921539E11Rik,4,103230445,103290863,protein_coding,-1,60418,chr4_103230445_103290863
4930456L15Rik,4,103290959,103311832,lincRNA,1,20873,chr4_103290959_103311832
Oma1,4,103313812,103371868,protein_coding,1,58056,chr4_103313812_103371868
Gm12718,4,103382500,103492040,lincRNA,1,109540,chr4_103382500_103492040
Dab1,4,103619359,104744844,protein_coding,1,1125485,chr4_103619359_104744844
C8b,4,104766317,104804548,protein_coding,1,38231,chr4_104766317_104804548
C8a,4,104815679,104876398,protein_coding,-1,60719,chr4_104815679_104876398
Gm17662,4,104857329,104859137,protein_coding,1,1808,chr4_104857329_104859137
Fyb2,4,104913456,105016863,protein_coding,1,103407,chr4_104913456_105016863
Prkaa2,4,105029874,105109890,protein_coding,-1,80016,chr4_105029874_105109890
Plpp3,4,105157347,105232764,protein_coding,1,75417,chr4_105157347_105232764
Gm12728,4,105789869,105794711,protein_coding,1,4842,chr4_105789869_105794711
Gm12729,4,106088714,106105068,lincRNA,-1,16354,chr4_106088714_106105068
Usp24,4,106316213,106441322,protein_coding,1,125109,chr4_106316213_106441322
Pcsk9,4,106442329,106464329,protein_coding,-1,22000,chr4_106442329_106464329
Bsnd,4,106483456,106492283,protein_coding,-1,8827,chr4_106483456_106492283
Tmem61,4,106498813,106540546,protein_coding,-1,41733,chr4_106498813_106540546
2700068H02Rik,4,106554669,106557897,antisense,-1,3228,chr4_106554669_106557897
Dhcr24,4,106561038,106589113,protein_coding,1,28075,chr4_106561038_106589113
Gm12744,4,106587097,106589108,antisense,-1,2011,chr4_106587097_106589108
Lexm,4,106590909,106617241,protein_coding,-1,26332,chr4_106590909_106617241
Ttc22,4,106622432,106640189,protein_coding,1,17757,chr4_106622432_106640189
Pars2,4,106651069,106655282,protein_coding,1,4213,chr4_106651069_106655282
Ttc4,4,106662256,106678944,protein_coding,-1,16688,chr4_106662256_106678944
Mroh7,4,106680417,106730925,protein_coding,-1,50508,chr4_106680417_106730925
Fam151a,4,106733889,106748292,protein_coding,1,14403,chr4_106733889_106748292
Acot11,4,106744555,106804998,protein_coding,-1,60443,chr4_106744555_106804998
Gm12746,4,106841761,106847920,lincRNA,-1,6159,chr4_106841761_106847920
Ssbp3,4,106910701,107049694,protein_coding,1,138993,chr4_106910701_107049694
Gm12786,4,107017935,107022499,antisense,-1,4564,chr4_107017935_107022499
Mrpl37,4,107055874,107066868,protein_coding,-1,10994,chr4_107055874_107066868
Cyb5rl,4,107066988,107088268,protein_coding,1,21280,chr4_107066988_107088268
Cdcp2,4,107096891,107113125,protein_coding,1,16234,chr4_107096891_107113125
Gm12802,4,107126613,107136252,antisense,1,9639,chr4_107126613_107136252
Tceanc2,4,107134155,107179116,protein_coding,-1,44961,chr4_107134155_107179116
Tmem59,4,107178399,107200996,protein_coding,1,22597,chr4_107178399_107200996
Ldlrad1,4,107209180,107218060,protein_coding,1,8880,chr4_107209180_107218060
Lrrc42,4,107233514,107253532,protein_coding,-1,20018,chr4_107233514_107253532
Hspb11,4,107253593,107279938,protein_coding,1,26345,chr4_107253593_107279938
Dio1,4,107291465,107307169,protein_coding,-1,15704,chr4_107291465_107307169
Yipf1,4,107314363,107359823,protein_coding,1,45460,chr4_107314363_107359823
Gm12869,4,107349039,107351353,antisense,-1,2314,chr4_107349039_107351353
Ndc1,4,107367784,107416346,protein_coding,1,48562,chr4_107367784_107416346
Glis1,4,107434591,107635061,protein_coding,1,200470,chr4_107434591_107635061
Dmrtb1,4,107676290,107684230,protein_coding,-1,7940,chr4_107676290_107684230
1700047F07Rik,4,107689701,107758985,lincRNA,1,69284,chr4_107689701_107758985
Gm12907,4,107765080,107770601,lincRNA,1,5521,chr4_107765080_107770601
4933424M12Rik,4,107783720,107789921,lincRNA,1,6201,chr4_107783720_107789921
Lrp8,4,107801869,107876840,protein_coding,1,74971,chr4_107801869_107876840
Lrp8os2,4,107806033,107823022,antisense,-1,16989,chr4_107806033_107823022
Lrp8os1,4,107827896,107830844,antisense,-1,2948,chr4_107827896_107830844
Magoh,4,107879755,107887424,protein_coding,1,7669,chr4_107879755_107887424
Cpt2,4,107903981,107923610,protein_coding,-1,19629,chr4_107903981_107923610
4930407G08Rik,4,107953932,107960721,lincRNA,1,6789,chr4_107953932_107960721
Slc1a7,4,107968332,108013532,protein_coding,1,45200,chr4_107968332_108013532
Podn,4,108014791,108096445,protein_coding,-1,81654,chr4_108014791_108096445
Scp2,4,108043839,108144998,protein_coding,-1,101159,chr4_108043839_108144998
Echdc2,4,108165437,108179308,protein_coding,1,13871,chr4_108165437_108179308
Zyg11a,4,108181738,108218048,protein_coding,-1,36310,chr4_108181738_108218048
Zyg11b,4,108229724,108301096,protein_coding,-1,71372,chr4_108229724_108301096
Coa7,4,108328140,108341544,protein_coding,1,13404,chr4_108328140_108341544
Gpx7,4,108400390,108406961,protein_coding,-1,6571,chr4_108400390_108406961
Prpf38a,4,108563172,108579336,protein_coding,-1,16164,chr4_108563172_108579336
Orc1,4,108579423,108614833,protein_coding,1,35410,chr4_108579423_108614833
Cc2d1b,4,108619940,108634123,protein_coding,1,14183,chr4_108619940_108634123
Gm17354,4,108633843,108637441,lincRNA,-1,3598,chr4_108633843_108637441
Zfyve9,4,108637466,108780798,protein_coding,-1,143332,chr4_108637466_108780798
3110021N24Rik,4,108719649,108781904,protein_coding,1,62255,chr4_108719649_108781904
Btf3l4,4,108814295,108833614,protein_coding,-1,19319,chr4_108814295_108833614
Txndc12,4,108834601,108862127,protein_coding,1,27526,chr4_108834601_108862127
Rab3b,4,108879063,108943324,protein_coding,1,64261,chr4_108879063_108943324
8030443G20Rik,4,108942843,108972077,antisense,-1,29234,chr4_108942843_108972077
Nrd1,4,109000655,109061777,protein_coding,1,61122,chr4_109000655_109061777
Osbpl9,4,109061145,109202272,protein_coding,-1,141127,chr4_109061145_109202272
Calr4,4,109234485,109254571,protein_coding,1,20086,chr4_109234485_109254571
Eps15,4,109280268,109387817,protein_coding,1,107549,chr4_109280268_109387817
Ttc39aos1,4,109403794,109406155,antisense,-1,2361,chr4_109403794_109406155
Ttc39a,4,109406623,109444745,protein_coding,1,38122,chr4_109406623_109444745
Rnf11,4,109451098,109484728,protein_coding,-1,33630,chr4_109451098_109484728
4930522H14Rik,4,109505337,109531297,protein_coding,-1,25960,chr4_109505337_109531297
Cdkn2c,4,109660876,109667189,protein_coding,-1,6313,chr4_109660876_109667189
Faf1,4,109676588,109963960,protein_coding,1,287372,chr4_109676588_109963960
Dmrta2os,4,109976738,109977813,antisense,-1,1075,chr4_109976738_109977813
Dmrta2,4,109978053,109983687,protein_coding,1,5634,chr4_109978053_109983687
Elavl4,4,110203722,110351909,protein_coding,-1,148187,chr4_110203722_110351909
Agbl4,4,110397661,111664324,protein_coding,1,1266663,chr4_110397661_111664324
Spata6,4,111719984,111829184,protein_coding,1,109200,chr4_111719984_111829184
Slc5a9,4,111875375,111902918,protein_coding,-1,27543,chr4_111875375_111902918
Skint8,4,111919392,111950358,protein_coding,1,30966,chr4_111919392_111950358
Skint7,4,111972923,111988223,protein_coding,1,15300,chr4_111972923_111988223
Skint1,4,112006269,112029538,protein_coding,1,23269,chr4_112006269_112029538
Skint4,4,112072016,112168076,protein_coding,1,96060,chr4_112072016_112168076
Skint3,4,112232245,112300468,protein_coding,1,68223,chr4_112232245_112300468
Skint9,4,112385969,112433985,protein_coding,-1,48016,chr4_112385969_112433985
Skint2,4,112557194,112652248,protein_coding,1,95054,chr4_112557194_112652248
Skint10,4,112711147,112774866,protein_coding,-1,63719,chr4_112711147_112774866
Skint6,4,112804616,113286973,protein_coding,-1,482357,chr4_112804616_113286973
Gm12823,4,112923696,112945317,antisense,1,21621,chr4_112923696_112945317
Skint5,4,113477891,113999503,protein_coding,-1,521612,chr4_113477891_113999503
Skint11,4,114163384,114245028,protein_coding,1,81644,chr4_114163384_114245028
Trabd2b,4,114406724,114615098,protein_coding,1,208374,chr4_114406724_114615098
Gm12829,4,114680804,114687595,lincRNA,1,6791,chr4_114680804_114687595
9130410C08Rik,4,114817161,114902859,antisense,-1,85698,chr4_114817161_114902859
Gm12830,4,114821722,114856166,protein_coding,1,34444,chr4_114821722_114856166
Cmpk1,4,114959336,114987241,protein_coding,-1,27905,chr4_114959336_114987241
Stil,4,115000159,115043196,protein_coding,1,43037,chr4_115000159_115043196
Tal1,4,115056426,115071755,protein_coding,1,15329,chr4_115056426_115071755
Pdzk1ip1,4,115088708,115093899,protein_coding,1,5191,chr4_115088708_115093899
Cyp4x1,4,115106323,115134281,protein_coding,-1,27958,chr4_115106323_115134281
Cyp4x1os,4,115133832,115137864,antisense,1,4032,chr4_115133832_115137864
Cyp4a29,4,115242084,115254557,protein_coding,1,12473,chr4_115242084_115254557
Cyp4a12a,4,115299046,115332815,protein_coding,1,33769,chr4_115299046_115332815
Cyp4a12b,4,115411624,115439034,protein_coding,1,27410,chr4_115411624_115439034
Cyp4a30b,4,115452604,115471062,protein_coding,1,18458,chr4_115452604_115471062
Cyp4a10,4,115518264,115533649,protein_coding,1,15385,chr4_115518264_115533649
Cyp4a31,4,115563649,115579015,protein_coding,1,15366,chr4_115563649_115579015
Cyp4a32,4,115600969,115621602,protein_coding,1,20633,chr4_115600969_115621602
Cyp4b1,4,115624725,115647723,protein_coding,-1,22998,chr4_115624725_115647723
Efcab14,4,115737744,115777327,protein_coding,1,39583,chr4_115737744_115777327
Tex38,4,115779834,115781018,protein_coding,-1,1184,chr4_115779834_115781018
Atpaf1,4,115784812,115822655,protein_coding,1,37843,chr4_115784812_115822655
Mob3c,4,115828092,115836185,protein_coding,1,8093,chr4_115828092_115836185
Mknk1,4,115839198,115879250,protein_coding,1,40052,chr4_115839198_115879250
Gm29434,4,115878317,115878576,antisense,-1,259,chr4_115878317_115878576
Kncn,4,115884400,115889526,protein_coding,1,5126,chr4_115884400_115889526
6430628N08Rik,4,115890665,115899227,protein_coding,1,8562,chr4_115890665_115899227
Dmbx1,4,115915119,115939926,protein_coding,-1,24807,chr4_115915119_115939926
Faah,4,115967145,116017926,protein_coding,-1,50781,chr4_115967145_116017926
Nsun4,4,116032842,116053876,protein_coding,-1,21034,chr4_116032842_116053876
Uqcrh,4,116066965,116075071,protein_coding,-1,8106,chr4_116066965_116075071
Lrrc41,4,116075269,116097043,protein_coding,1,21774,chr4_116075269_116097043
Rad54l,4,116094264,116123690,protein_coding,-1,29426,chr4_116094264_116123690
Pomgnt1,4,116123840,116159849,protein_coding,1,36009,chr4_116123840_116159849
Lurap1,4,116132406,116151338,protein_coding,-1,18932,chr4_116132406_116151338
Tspan1,4,116161869,116167601,protein_coding,-1,5732,chr4_116161869_116167601
Gm49337,4,116173384,116299841,protein_coding,1,126457,chr4_116173384_116299841
Pik3r3,4,116221618,116303056,protein_coding,1,81438,chr4_116221618_116303056
Mast2,4,116306762,116464183,protein_coding,-1,157421,chr4_116306762_116464183
Ipp,4,116507549,116538243,protein_coding,1,30694,chr4_116507549_116538243
Tmem69,4,116551633,116555936,protein_coding,-1,4303,chr4_116551633_116555936
Gm12953,4,116551740,116552627,antisense,1,887,chr4_116551740_116552627
Gpbp1l1,4,116557658,116593882,protein_coding,1,36224,chr4_116557658_116593882
Ccdc17,4,116596654,116600266,protein_coding,1,3612,chr4_116596654_116600266
Nasp,4,116601052,116627941,protein_coding,-1,26889,chr4_116601052_116627941
Akr1a1,4,116636510,116651680,protein_coding,-1,15170,chr4_116636510_116651680
Prdx1,4,116685544,116700822,protein_coding,1,15278,chr4_116685544_116700822
Mmachc,4,116702279,116708406,protein_coding,-1,6127,chr4_116702279_116708406
Ccdc163,4,116708509,116751206,protein_coding,1,42697,chr4_116708509_116751206
Tesk2,4,116720948,116805956,protein_coding,1,85008,chr4_116720948_116805956
Toe1,4,116794310,116807640,protein_coding,-1,13330,chr4_116794310_116807640
Mutyh,4,116807723,116819440,protein_coding,1,11717,chr4_116807723_116819440
Hpdl,4,116819904,116821707,protein_coding,-1,1803,chr4_116819904_116821707
Gm12996,4,116824903,116830603,antisense,1,5700,chr4_116824903_116830603
Zswim5,4,116877376,116989264,protein_coding,1,111888,chr4_116877376_116989264
Urod,4,116989965,116994413,protein_coding,-1,4448,chr4_116989965_116994413
Hectd3,4,116995317,117005277,protein_coding,1,9960,chr4_116995317_117005277
1700021J08Rik,4,117002166,117003012,antisense,-1,846,chr4_117002166_117003012
Eif2b3,4,117019402,117087306,protein_coding,1,67904,chr4_117019402_117087306
Ptch2,4,117096075,117116101,protein_coding,1,20026,chr4_117096075_117116101
Btbd19,4,117119219,117125725,protein_coding,-1,6506,chr4_117119219_117125725
Tctex1d4,4,117126794,117128738,protein_coding,1,1944,chr4_117126794_117128738
Plk3,4,117128655,117133963,protein_coding,-1,5308,chr4_117128655_117133963
Rps8,4,117153827,117156243,protein_coding,-1,2416,chr4_117153827_117156243
Kif2c,4,117159639,117182639,protein_coding,-1,23000,chr4_117159639_117182639
Armh1,4,117213334,117252125,protein_coding,-1,38791,chr4_117213334_117252125
Tmem53,4,117251951,117268582,protein_coding,1,16631,chr4_117251951_117268582
Rnf220,4,117271463,117497052,protein_coding,-1,225589,chr4_117271463_117497052
Gm12843,4,117295817,117297725,antisense,1,1908,chr4_117295817_117297725
Gm12828,4,117445950,117455040,antisense,1,9090,chr4_117445950_117455040
Eri3,4,117550365,117674297,protein_coding,1,123932,chr4_117550365_117674297
Dmap1,4,117674681,117682273,protein_coding,-1,7592,chr4_117674681_117682273
Klf17,4,117757836,117765648,protein_coding,-1,7812,chr4_117757836_117765648
Slc6a9,4,117834506,117875198,protein_coding,1,40692,chr4_117834506_117875198
Ccdc24,4,117866524,117872557,protein_coding,-1,6033,chr4_117866524_117872557
B4galt2,4,117869260,117883487,protein_coding,-1,14227,chr4_117869260_117883487
Gm12841,4,117883621,117885995,antisense,1,2374,chr4_117883621_117885995
Atp6v0b,4,117884326,117887333,protein_coding,-1,3007,chr4_117884326_117887333
Dph2,4,117888643,117892032,protein_coding,-1,3389,chr4_117888643_117892032
Ipo13,4,117894486,117914999,protein_coding,-1,20513,chr4_117894486_117914999
Artn,4,117926162,117929763,protein_coding,-1,3601,chr4_117926162_117929763
St3gal3,4,117932154,118134914,protein_coding,-1,202760,chr4_117932154_118134914
9530034E10Rik,4,117975036,117993972,antisense,1,18936,chr4_117975036_117993972
Kdm4a,4,118136957,118180043,protein_coding,-1,43086,chr4_118136957_118180043
Ptprf,4,118208213,118291405,protein_coding,-1,83192,chr4_118208213_118291405
Szt2,4,118362743,118409273,protein_coding,-1,46530,chr4_118362743_118409273
Med8,4,118409337,118415782,protein_coding,1,6445,chr4_118409337_118415782
Elovl1,4,118428093,118432953,protein_coding,1,4860,chr4_118428093_118432953
Cdc20,4,118432901,118437352,protein_coding,-1,4451,chr4_118432901_118437352
Mpl,4,118442415,118457513,protein_coding,-1,15098,chr4_118442415_118457513
Tie1,4,118471191,118490061,protein_coding,-1,18870,chr4_118471191_118490061
2610528J11Rik,4,118526999,118530228,protein_coding,1,3229,chr4_118526999_118530228
Tmem125,4,118540941,118544044,protein_coding,-1,3103,chr4_118540941_118544044
Cfap57,4,118554551,118620777,protein_coding,-1,66226,chr4_118554551_118620777
Ebna1bp2,4,118620799,118627776,protein_coding,1,6977,chr4_118620799_118627776
Gm12853,4,118632847,118636062,antisense,-1,3215,chr4_118632847_118636062
Olfr62,4,118658952,118668042,protein_coding,1,9090,chr4_118658952_118668042
Olfr1341,4,118703523,118713438,protein_coding,1,9915,chr4_118703523_118713438
Olfr1340,4,118720138,118729395,protein_coding,1,9257,chr4_118720138_118729395
Olfr1338,4,118751975,118758737,protein_coding,-1,6762,chr4_118751975_118758737
Olfr1333,4,118827659,118836279,protein_coding,-1,8620,chr4_118827659_118836279
Olfr1330,4,118888597,118899597,protein_coding,1,11000,chr4_118888597_118899597
Gm12865,4,118984058,118997198,lincRNA,-1,13140,chr4_118984058_118997198
Gm12866,4,119054790,119069111,lincRNA,-1,14321,chr4_119054790_119069111
Slc2a1,4,119108711,119137983,protein_coding,1,29272,chr4_119108711_119137983
Gm12867,4,119130292,119131001,antisense,-1,709,chr4_119130292_119131001
Gm12868,4,119133749,119138801,antisense,-1,5052,chr4_119133749_119138801
Zfp691,4,119169513,119174195,protein_coding,-1,4682,chr4_119169513_119174195
Ermap,4,119175457,119190011,protein_coding,-1,14554,chr4_119175457_119190011
Svbp,4,119195306,119201298,protein_coding,1,5992,chr4_119195306_119201298
AU022252,4,119203570,119232712,protein_coding,-1,29142,chr4_119203570_119232712
P3h1,4,119232915,119248975,protein_coding,1,16060,chr4_119232915_119248975
Gm12927,4,119252522,119256975,antisense,-1,4453,chr4_119252522_119256975
Cldn19,4,119255414,119262438,protein_coding,1,7024,chr4_119255414_119262438
Ybx1,4,119277981,119294604,protein_coding,-1,16623,chr4_119277981_119294604
Ppih,4,119300010,119320546,protein_coding,-1,20536,chr4_119300010_119320546
Ccdc30,4,119322466,119415521,protein_coding,-1,93055,chr4_119322466_119415521
Ppcs,4,119418530,119422420,protein_coding,-1,3890,chr4_119418530_119422420
Zmynd12,4,119422814,119467444,protein_coding,1,44630,chr4_119422814_119467444
Rimkla,4,119465283,119492628,protein_coding,-1,27345,chr4_119465283_119492628
Frg2f1,4,119530308,119539529,protein_coding,-1,9221,chr4_119530308_119539529
Foxj3,4,119537004,119629119,protein_coding,1,92115,chr4_119537004_119629119
Guca2a,4,119637704,119639471,protein_coding,1,1767,chr4_119637704_119639471
Guca2b,4,119656607,119658954,protein_coding,-1,2347,chr4_119656607_119658954
Hivep3,4,119733784,120138045,protein_coding,1,404261,chr4_119733784_120138045
Edn2,4,120161206,120167360,protein_coding,1,6154,chr4_120161206_120167360
Foxo6,4,120267079,120287349,protein_coding,-1,20270,chr4_120267079_120287349
Foxo6os,4,120291350,120303892,antisense,1,12542,chr4_120291350_120303892
Scmh1,4,120405281,120530186,protein_coding,1,124905,chr4_120405281_120530186
Slfnl1,4,120532231,120536661,protein_coding,1,4430,chr4_120532231_120536661
Ctps,4,120539868,120570276,protein_coding,-1,30408,chr4_120539868_120570276
Gm8439,4,120588745,120609673,protein_coding,1,20928,chr4_120588745_120609673
Gm12860,4,120615840,120622682,lincRNA,1,6842,chr4_120615840_120622682
Gm45579,4,120644219,120648137,lincRNA,-1,3918,chr4_120644219_120648137
Cited4,4,120666572,120667820,protein_coding,1,1248,chr4_120666572_120667820
Kcnq4,4,120696138,120748612,protein_coding,-1,52474,chr4_120696138_120748612
Nfyc,4,120757438,120831572,protein_coding,-1,74134,chr4_120757438_120831572
Rims3,4,120854816,120896579,protein_coding,1,41763,chr4_120854816_120896579
Exo5,4,120921196,120925017,protein_coding,-1,3821,chr4_120921196_120925017
Zfp69,4,120930137,120951699,protein_coding,-1,21562,chr4_120930137_120951699
Smap2,4,120968317,121017247,protein_coding,-1,48930,chr4_120968317_121017247
Col9a2,4,121039385,121055322,protein_coding,1,15937,chr4_121039385_121055322
Zmpste24,4,121059237,121098241,protein_coding,-1,39004,chr4_121059237_121098241
Tmco2,4,121105651,121109226,protein_coding,-1,3575,chr4_121105651_121109226
Rlf,4,121145373,121215084,protein_coding,-1,69711,chr4_121145373_121215084
Gm12888,4,121316316,121324917,protein_coding,-1,8601,chr4_121316316_121324917
Gm12886,4,121414735,121423099,protein_coding,-1,8364,chr4_121414735_121423099
Gm12887,4,121614271,121622103,protein_coding,-1,7832,chr4_121614271_121622103
9530002B09Rik,4,122689275,122705129,protein_coding,1,15854,chr4_122689275_122705129
Ppt1,4,122836242,122859175,protein_coding,1,22933,chr4_122836242_122859175
Cap1,4,122859047,122886056,protein_coding,-1,27009,chr4_122859047_122886056
Mfsd2a,4,122946850,122961188,protein_coding,-1,14338,chr4_122946850_122961188
Mycl,4,122995652,123002485,protein_coding,1,6833,chr4_122995652_123002485
Trit1,4,123016597,123054949,protein_coding,1,38352,chr4_123016597_123054949
Gm12923,4,123092765,123094028,antisense,-1,1263,chr4_123092765_123094028
Bmp8b,4,123105165,123132099,protein_coding,1,26934,chr4_123105165_123132099
Ppie,4,123127115,123139951,protein_coding,-1,12836,chr4_123127115_123139951
Hpcal4,4,123183227,123194701,protein_coding,1,11474,chr4_123183227_123194701
Nt5c1a,4,123201504,123216275,protein_coding,1,14771,chr4_123201504_123216275
Heyl,4,123233556,123249875,protein_coding,1,16319,chr4_123233556_123249875
Pabpc4,4,123262351,123298925,protein_coding,1,36574,chr4_123262351_123298925
Bmp8a,4,123312645,123343252,protein_coding,-1,30607,chr4_123312645_123343252
Macf1,4,123349633,123684360,protein_coding,-1,334727,chr4_123349633_123684360
Gm12925,4,123665881,123671217,antisense,1,5336,chr4_123665881_123671217
Ndufs5,4,123712710,123718202,protein_coding,-1,5492,chr4_123712710_123718202
Akirin1,4,123734559,123750345,protein_coding,-1,15786,chr4_123734559_123750345
Rhbdl2,4,123787874,123829904,protein_coding,1,42030,chr4_123787874_123829904
1700121C08Rik,4,123833622,123859513,antisense,-1,25891,chr4_123833622_123859513
4933427I04Rik,4,123859679,123863165,lincRNA,1,3486,chr4_123859679_123863165
Mycbp,4,123904832,123912269,protein_coding,1,7437,chr4_123904832_123912269
Gm12905,4,123905062,123918023,processed_transcript,-1,12961,chr4_123905062_123918023
Rragc,4,123917446,123936997,protein_coding,1,19551,chr4_123917446_123936997
1700021L23Rik,4,124302837,124311461,lincRNA,-1,8624,chr4_124302837_124311461
1700057H15Rik,4,124414416,124485959,lincRNA,-1,71543,chr4_124414416_124485959
Gm2164,4,124528924,124657169,antisense,-1,128245,chr4_124528924_124657169
4933407E24Rik,4,124569190,124574645,lincRNA,1,5455,chr4_124569190_124574645
Pou3f1,4,124656807,124660655,protein_coding,1,3848,chr4_124656807_124660655
Utp11,4,124678160,124693600,protein_coding,-1,15440,chr4_124678160_124693600
Fhl3,4,124700701,124708611,protein_coding,1,7910,chr4_124700701_124708611
Sf3a3,4,124714776,124732460,protein_coding,1,17684,chr4_124714776_124732460
Inpp5b,4,124741850,124801511,protein_coding,1,59661,chr4_124741850_124801511
Mtf1,4,124802104,124849800,protein_coding,1,47696,chr4_124802104_124849800
1110065P20Rik,4,124849080,124851196,protein_coding,-1,2116,chr4_124849080_124851196
Yrdc,4,124850679,124855242,protein_coding,1,4563,chr4_124850679_124855242
Maneal,4,124855239,124862171,protein_coding,-1,6932,chr4_124855239_124862171
Epha10,4,124880899,124917800,protein_coding,1,36901,chr4_124880899_124917800
1700125G02Rik,4,124890888,124894782,antisense,-1,3894,chr4_124890888_124894782
Cdca8,4,124918465,124939311,protein_coding,-1,20846,chr4_124918465_124939311
9930104L06Rik,4,124937048,124944656,protein_coding,1,7608,chr4_124937048_124944656
Gm12930,4,124957647,124987009,antisense,-1,29362,chr4_124957647_124987009
Rspo1,4,124986430,125009099,protein_coding,1,22669,chr4_124986430_125009099
Gnl2,4,125016585,125055380,protein_coding,1,38795,chr4_125016585_125055380
Dnali1,4,125055338,125065703,protein_coding,-1,10365,chr4_125055338_125065703
Snip1,4,125066672,125074042,protein_coding,1,7370,chr4_125066672_125074042
Gm12932,4,125082857,125084947,antisense,-1,2090,chr4_125082857_125084947
Meaf6,4,125085134,125113238,protein_coding,1,28104,chr4_125085134_125113238
Zc3h12a,4,125118423,125127840,protein_coding,-1,9417,chr4_125118423_125127840
1700041M05Rik,4,125228597,125242052,lincRNA,1,13455,chr4_125228597_125242052
Grik3,4,125490700,125714173,protein_coding,1,223473,chr4_125490700_125714173
2610028E06Rik,4,125887851,125922417,lincRNA,-1,34566,chr4_125887851_125922417
Csf3r,4,126024550,126044440,protein_coding,1,19890,chr4_126024550_126044440
Mrps15,4,126046925,126055532,protein_coding,1,8607,chr4_126046925_126055532
Oscp1,4,126058565,126092195,protein_coding,1,33630,chr4_126058565_126092195
Lsm10,4,126096623,126098584,protein_coding,1,1961,chr4_126096623_126098584
Stk40,4,126103957,126141029,protein_coding,1,37072,chr4_126103957_126141029
Eva1b,4,126147744,126149875,protein_coding,1,2131,chr4_126147744_126149875
Sh3d21,4,126150602,126163491,protein_coding,-1,12889,chr4_126150602_126163491
Thrap3,4,126164082,126202760,protein_coding,-1,38678,chr4_126164082_126202760
Map7d1,4,126232167,126256343,protein_coding,-1,24176,chr4_126232167_126256343
Trappc3,4,126262325,126275883,protein_coding,1,13558,chr4_126262325_126275883
Col8a2,4,126286793,126314330,protein_coding,1,27537,chr4_126286793_126314330
Adprhl2,4,126316047,126321703,protein_coding,-1,5656,chr4_126316047_126321703
Tekt2,4,126322121,126325688,protein_coding,-1,3567,chr4_126322121_126325688
Ago3,4,126331704,126429556,protein_coding,-1,97852,chr4_126331704_126429556
Ago1,4,126435012,126468583,protein_coding,-1,33571,chr4_126435012_126468583
Ago4,4,126489541,126533472,protein_coding,-1,43931,chr4_126489541_126533472
Clspn,4,126556935,126593903,protein_coding,1,36968,chr4_126556935_126593903
5730409E04Rik,4,126609818,126614371,protein_coding,1,4553,chr4_126609818_126614371
Psmb2,4,126677630,126709714,protein_coding,1,32084,chr4_126677630_126709714
Tfap2e,4,126716006,126736240,protein_coding,-1,20234,chr4_126716006_126736240
Ncdn,4,126743750,126753438,protein_coding,-1,9688,chr4_126743750_126753438
AU040320,4,126753544,126870070,protein_coding,1,116526,chr4_126753544_126870070
Zmym4,4,126861939,126968135,protein_coding,-1,106196,chr4_126861939_126968135
Sfpq,4,127021324,127037013,protein_coding,1,15689,chr4_127021324_127037013
Zmym1,4,127047094,127061152,protein_coding,-1,14058,chr4_127047094_127061152
Zmym6,4,127077383,127124372,protein_coding,1,46989,chr4_127077383_127124372
Tmem35b,4,127123691,127129644,protein_coding,1,5953,chr4_127123691_127129644
Dlgap3,4,127169204,127237022,protein_coding,1,67818,chr4_127169204_127237022
Smim12,4,127243784,127247809,protein_coding,1,4025,chr4_127243784_127247809
Gja4,4,127311421,127314039,protein_coding,-1,2618,chr4_127311421_127314039
A630031M04Rik,4,127474848,127570502,lincRNA,1,95654,chr4_127474848_127570502
1700112K13Rik,4,127810638,127812173,lincRNA,-1,1535,chr4_127810638_127812173
CK137956,4,127927592,127970951,protein_coding,-1,43359,chr4_127927592_127970951
Csmd2,4,127987857,128567656,protein_coding,1,579799,chr4_127987857_128567656
Csmd2os,4,128133523,128166967,antisense,-1,33444,chr4_128133523_128166967
Hmgb4,4,128260212,128260957,protein_coding,-1,745,chr4_128260212_128260957
Zscan20,4,128583539,128610098,protein_coding,-1,26559,chr4_128583539_128610098
Phc2,4,128654702,128752881,protein_coding,1,98179,chr4_128654702_128752881
A3galt2,4,128755364,128769298,protein_coding,1,13934,chr4_128755364_128769298
Zfp362,4,128773088,128806045,protein_coding,-1,32957,chr4_128773088_128806045
Gm12968,4,128846197,128873698,lincRNA,1,27501,chr4_128846197_128873698
Trim62,4,128883580,128911328,protein_coding,1,27748,chr4_128883580_128911328
Azin2,4,128930233,128962442,protein_coding,-1,32209,chr4_128930233_128962442
Gm15904,4,128936005,128940195,antisense,1,4190,chr4_128936005_128940195
Ak2,4,128991958,129011529,protein_coding,1,19571,chr4_128991958_129011529
1700086P04Rik,4,129050097,129057983,lincRNA,-1,7886,chr4_129050097_129057983
Rnf19b,4,129058271,129085886,protein_coding,1,27615,chr4_129058271_129085886
Tmem54,4,129105548,129111626,protein_coding,1,6078,chr4_129105548_129111626
Hpca,4,129111570,129122036,protein_coding,-1,10466,chr4_129111570_129122036
Gm15906,4,129135091,129136910,lincRNA,1,1819,chr4_129135091_129136910
Fndc5,4,129136999,129144593,protein_coding,1,7594,chr4_129136999_129144593
S100pbp,4,129148005,129189727,protein_coding,-1,41722,chr4_129148005_129189727
Yars,4,129189760,129219607,protein_coding,1,29847,chr4_129189760_129219607
C77080,4,129219578,129261404,protein_coding,-1,41826,chr4_129219578_129261404
Gm12976,4,129261965,129265010,lincRNA,1,3045,chr4_129261965_129265010
Sync,4,129287617,129308559,protein_coding,1,20942,chr4_129287617_129308559
Rbbp4,4,129307100,129335370,protein_coding,-1,28270,chr4_129307100_129335370
Zbtb8os,4,129335695,129354547,protein_coding,1,18852,chr4_129335695_129354547
Zbtb8a,4,129353628,129378116,protein_coding,-1,24488,chr4_129353628_129378116
Zbtb8b,4,129425765,129440853,protein_coding,-1,15088,chr4_129425765_129440853
Bsdc1,4,129461581,129488498,protein_coding,1,26917,chr4_129461581_129488498
Tssk3,4,129489014,129491022,protein_coding,-1,2008,chr4_129489014_129491022
Fam229a,4,129491190,129491956,protein_coding,1,766,chr4_129491190_129491956
Gm12979,4,129491969,129509746,antisense,-1,17777,chr4_129491969_129509746
Marcksl1,4,129513581,129515985,protein_coding,1,2404,chr4_129513581_129515985
Hdac1,4,129516104,129542713,protein_coding,-1,26609,chr4_129516104_129542713
Lck,4,129548344,129573641,protein_coding,-1,25297,chr4_129548344_129573641
Fam167b,4,129576815,129578549,protein_coding,-1,1734,chr4_129576815_129578549
Eif3i,4,129591960,129600648,protein_coding,-1,8688,chr4_129591960_129600648
Tmem234,4,129600668,129624059,protein_coding,1,23391,chr4_129600668_129624059
Dcdc2b,4,129608331,129614257,protein_coding,-1,5926,chr4_129608331_129614257
Iqcc,4,129615126,129619099,protein_coding,-1,3973,chr4_129615126_129619099
Ccdc28b,4,129619274,129623947,protein_coding,-1,4673,chr4_129619274_129623947
Txlna,4,129626078,129641065,protein_coding,-1,14987,chr4_129626078_129641065
Kpna6,4,129643980,129672767,protein_coding,-1,28787,chr4_129643980_129672767
Tmem39b,4,129676355,129696838,protein_coding,-1,20483,chr4_129676355_129696838
Khdrbs1,4,129703164,129742303,protein_coding,-1,39139,chr4_129703164_129742303
Ptp4a2,4,129811219,129850003,protein_coding,1,38784,chr4_129811219_129850003
E330017L17Rik,4,129906216,129919787,lincRNA,1,13571,chr4_129906216_129919787
Spocd1,4,129929249,129957115,protein_coding,1,27866,chr4_129929249_129957115
1700003M07Rik,4,129960374,129963657,lincRNA,1,3283,chr4_129960374_129963657
Adgrb2,4,129984870,130022633,protein_coding,1,37763,chr4_129984870_130022633
Gm12963,4,130024256,130047774,antisense,-1,23518,chr4_130024256_130047774
Col16a1,4,130047840,130099283,protein_coding,1,51443,chr4_130047840_130099283
Pef1,4,130102558,130128135,protein_coding,1,25577,chr4_130102558_130128135
Hcrtr1,4,130130217,130139359,protein_coding,-1,9142,chr4_130130217_130139359
Tinagl1,4,130164454,130175122,protein_coding,-1,10668,chr4_130164454_130175122
Serinc2,4,130253495,130279205,protein_coding,-1,25710,chr4_130253495_130279205
Gm10570,4,130306556,130308674,antisense,-1,2118,chr4_130306556_130308674
Fabp3,4,130308595,130315463,protein_coding,1,6868,chr4_130308595_130315463
Zcchc17,4,130315383,130359943,protein_coding,-1,44560,chr4_130315383_130359943
Snrnp40,4,130360132,130390026,protein_coding,1,29894,chr4_130360132_130390026
Nkain1,4,130531602,130574173,protein_coding,-1,42571,chr4_130531602_130574173
Pum1,4,130615207,130781564,protein_coding,1,166357,chr4_130615207_130781564
Gm12972,4,130786069,130787855,lincRNA,1,1786,chr4_130786069_130787855
Sdc3,4,130792537,130826319,protein_coding,1,33782,chr4_130792537_130826319
Gm26716,4,130824394,130826313,antisense,-1,1919,chr4_130824394_130826313
Laptm5,4,130913125,130936141,protein_coding,1,23016,chr4_130913125_130936141
Matn1,4,130944385,130955475,protein_coding,1,11090,chr4_130944385_130955475
Gm12973,4,130974790,131001339,lincRNA,1,26549,chr4_130974790_131001339
A930031H19Rik,4,131000832,131010474,lincRNA,-1,9642,chr4_131000832_131010474
Gm831,4,131487197,131505527,lincRNA,1,18330,chr4_131487197_131505527
Gm12962,4,131647048,131677845,lincRNA,-1,30797,chr4_131647048_131677845
Gm16080,4,131694607,131710508,lincRNA,-1,15901,chr4_131694607_131710508
Ptpru,4,131768457,131838288,protein_coding,-1,69831,chr4_131768457_131838288
Mecr,4,131843470,131867786,protein_coding,1,24316,chr4_131843470_131867786
Srsf4,4,131873617,131901706,protein_coding,1,28089,chr4_131873617_131901706
Tmem200b,4,131921200,131923140,protein_coding,1,1940,chr4_131921200_131923140
Epb41,4,131923413,132075321,protein_coding,-1,151908,chr4_131923413_132075321
Gm13063,4,132048178,132048961,lincRNA,1,783,chr4_132048178_132048961
Gm10300,4,132074697,132076992,antisense,1,2295,chr4_132074697_132076992
Oprd1,4,132110726,132144486,protein_coding,-1,33760,chr4_132110726_132144486
Ythdf2,4,132184912,132212303,protein_coding,-1,27391,chr4_132184912_132212303
Gmeb1,4,132221025,132261602,protein_coding,-1,40577,chr4_132221025_132261602
Gm28874,4,132265708,132268841,lincRNA,1,3133,chr4_132265708_132268841
Taf12,4,132274375,132295766,protein_coding,1,21391,chr4_132274375_132295766
Rab42,4,132302197,132303385,protein_coding,-1,1188,chr4_132302197_132303385
Snhg12,4,132308623,132311024,lincRNA,1,2401,chr4_132308623_132311024
Trnau1ap,4,132311763,132329538,protein_coding,-1,17775,chr4_132311763_132329538
Rcc1,4,132331919,132353605,protein_coding,-1,21686,chr4_132331919_132353605
Gm17300,4,132351772,132353382,lincRNA,1,1610,chr4_132351772_132353382
Phactr4,4,132355923,132422489,protein_coding,-1,66566,chr4_132355923_132422489
Med18,4,132458731,132463921,protein_coding,-1,5190,chr4_132458731_132463921
Sesn2,4,132492032,132510501,protein_coding,-1,18469,chr4_132492032_132510501
Atpif1,4,132530555,132533659,protein_coding,-1,3104,chr4_132530555_132533659
Gm12999,4,132532687,132533601,antisense,1,914,chr4_132532687_132533601
Dnajc8,4,132535550,132553742,protein_coding,1,18192,chr4_132535550_132553742
Ptafr,4,132564067,132582683,protein_coding,1,18616,chr4_132564067_132582683
Eya3,4,132638987,132724765,protein_coding,1,85778,chr4_132638987_132724765
Xkr8,4,132724897,132732546,protein_coding,-1,7649,chr4_132724897_132732546
Smpdl3b,4,132732966,132757252,protein_coding,-1,24286,chr4_132732966_132757252
Rpa2,4,132768332,132778752,protein_coding,1,10420,chr4_132768332_132778752
Themis2,4,132781843,132796387,protein_coding,-1,14544,chr4_132781843_132796387
Ppp1r8,4,132826929,132843169,protein_coding,-1,16240,chr4_132826929_132843169
Stx12,4,132853501,132884509,protein_coding,-1,31008,chr4_132853501_132884509
Fam76a,4,132899213,132922558,protein_coding,-1,23345,chr4_132899213_132922558
Fgr,4,132974095,133001910,protein_coding,1,27815,chr4_132974095_133001910
Ahdc1,4,133011260,133078110,protein_coding,1,66850,chr4_133011260_133078110
Wasf2,4,133130505,133199756,protein_coding,1,69251,chr4_133130505_133199756
Gpr3,4,133209340,133212536,protein_coding,-1,3196,chr4_133209340_133212536
Cd164l2,4,133212131,133224555,protein_coding,1,12424,chr4_133212131_133224555
Map3k6,4,133240818,133252929,protein_coding,1,12111,chr4_133240818_133252929
Sytl1,4,133253090,133263113,protein_coding,-1,10023,chr4_133253090_133263113
Tmem222,4,133266045,133277792,protein_coding,-1,11747,chr4_133266045_133277792
Wdtc1,4,133292459,133353481,protein_coding,-1,61022,chr4_133292459_133353481
Slc9a1,4,133369706,133423702,protein_coding,1,53996,chr4_133369706_133423702
Gm13257,4,133479356,133482526,antisense,-1,3170,chr4_133479356_133482526
Trnp1,4,133491100,133498550,protein_coding,-1,7450,chr4_133491100_133498550
Kdf1,4,133518963,133530790,protein_coding,1,11827,chr4_133518963_133530790
Nudc,4,133532542,133545996,protein_coding,-1,13454,chr4_133532542_133545996
Nr0b2,4,133553376,133556536,protein_coding,1,3160,chr4_133553376_133556536
Gpatch3,4,133574745,133584243,protein_coding,1,9498,chr4_133574745_133584243
Gpn2,4,133584362,133591735,protein_coding,1,7373,chr4_133584362_133591735
Sfn,4,133600556,133602168,protein_coding,-1,1612,chr4_133600556_133602168
Zdhhc18,4,133605299,133650154,protein_coding,-1,44855,chr4_133605299_133650154
Pigv,4,133660387,133672647,protein_coding,-1,12260,chr4_133660387_133672647
Arid1a,4,133679008,133756769,protein_coding,-1,77761,chr4_133679008_133756769
Gm12974,4,133816420,133817614,lincRNA,1,1194,chr4_133816420_133817614
Rps6ka1,4,133847290,133887797,protein_coding,-1,40507,chr4_133847290_133887797
Gm12977,4,133871830,133876533,antisense,1,4703,chr4_133871830_133876533
Hmgn2,4,133964738,133968650,protein_coding,-1,3912,chr4_133964738_133968650
Dhdds,4,133969028,134000918,protein_coding,-1,31890,chr4_133969028_134000918
Lin28a,4,134003330,134018841,protein_coding,-1,15511,chr4_134003330_134018841
Zfp683,4,134053838,134058996,protein_coding,1,5158,chr4_134053838_134058996
Crybg2,4,134060815,134092504,protein_coding,1,31689,chr4_134060815_134092504
Cd52,4,134082448,134095082,protein_coding,-1,12634,chr4_134082448_134095082
Ubxn11,4,134102570,134127593,protein_coding,1,25023,chr4_134102570_134127593
Sh3bgrl3,4,134127406,134128789,protein_coding,-1,1383,chr4_134127406_134128789
Cep85,4,134129858,134187112,protein_coding,-1,57254,chr4_134129858_134187112
Catsper4,4,134211970,134227383,protein_coding,-1,15413,chr4_134211970_134227383
Cnksr1,4,134228041,134238399,protein_coding,-1,10358,chr4_134228041_134238399
Zfp593,4,134243289,134245592,protein_coding,-1,2303,chr4_134243289_134245592
E130218I03Rik,4,134243662,134245873,protein_coding,1,2211,chr4_134243662_134245873
Gm30191,4,134246935,134250042,protein_coding,1,3107,chr4_134246935_134250042
Grrp1,4,134251110,134254106,protein_coding,-1,2996,chr4_134251110_134254106
Pdik1l,4,134275002,134287895,protein_coding,-1,12893,chr4_134275002_134287895
Trim63,4,134315120,134329629,protein_coding,1,14509,chr4_134315120_134329629
Slc30a2,4,134343181,134354484,protein_coding,1,11303,chr4_134343181_134354484
Extl1,4,134356372,134383850,protein_coding,-1,27478,chr4_134356372_134383850
Pafah2,4,134396320,134427413,protein_coding,1,31093,chr4_134396320_134427413
1700021N21Rik,4,134448766,134450171,antisense,-1,1405,chr4_134448766_134450171
Stmn1,4,134468320,134473843,protein_coding,1,5523,chr4_134468320_134473843
Paqr7,4,134496697,134510235,protein_coding,1,13538,chr4_134496697_134510235
Aunip,4,134510999,134523927,protein_coding,1,12928,chr4_134510999_134523927
Mtfr1l,4,134525550,134535387,protein_coding,-1,9837,chr4_134525550_134535387
Selenon,4,134537892,134552166,protein_coding,-1,14274,chr4_134537892_134552166
Man1c1,4,134561690,134704290,protein_coding,-1,142600,chr4_134561690_134704290
Ldlrap1,4,134741554,134768024,protein_coding,-1,26470,chr4_134741554_134768024
Rhd,4,134864536,134896172,protein_coding,1,31636,chr4_134864536_134896172
Tmem50a,4,134897849,134915024,protein_coding,-1,17175,chr4_134897849_134915024
Rsrp1,4,134923592,134927671,protein_coding,1,4079,chr4_134923592_134927671
Syf2,4,134930898,134937548,protein_coding,1,6650,chr4_134930898_134937548
Runx3,4,135120652,135177990,protein_coding,1,57338,chr4_135120652_135177990
Clic4,4,135213969,135272814,protein_coding,-1,58845,chr4_135213969_135272814
Srrm1,4,135320484,135353321,protein_coding,-1,32837,chr4_135320484_135353321
Ncmap,4,135369576,135398227,protein_coding,-1,28651,chr4_135369576_135398227
Rcan3,4,135412308,135433853,protein_coding,-1,21545,chr4_135412308_135433853
Nipal3,4,135445420,135495038,protein_coding,-1,49618,chr4_135445420_135495038
Stpg1,4,135494790,135537803,protein_coding,1,43013,chr4_135494790_135537803
Grhl3,4,135541888,135573630,protein_coding,-1,31742,chr4_135541888_135573630
Ifnlr1,4,135686287,135708181,protein_coding,1,21894,chr4_135686287_135708181
Il22ra1,4,135728172,135752140,protein_coding,1,23968,chr4_135728172_135752140
Myom3,4,135759715,135815564,protein_coding,1,55849,chr4_135759715_135815564
Srsf10,4,135855747,135869908,protein_coding,1,14161,chr4_135855747_135869908
Pnrc2,4,135870918,135873850,protein_coding,-1,2932,chr4_135870918_135873850
Cnr2,4,135895394,135920207,protein_coding,1,24813,chr4_135895394_135920207
Fuca1,4,135920735,135940311,protein_coding,1,19576,chr4_135920735_135940311
Hmgcl,4,135946448,135962617,protein_coding,1,16169,chr4_135946448_135962617
Gale,4,135963727,135968178,protein_coding,1,4451,chr4_135963727_135968178
Lypla2,4,135968224,135972626,protein_coding,-1,4402,chr4_135968224_135972626
Pithd1,4,135975460,135987264,protein_coding,-1,11804,chr4_135975460_135987264
Eloa,4,136003368,136021763,protein_coding,-1,18395,chr4_136003368_136021763
Gm13008,4,136003566,136010937,antisense,1,7371,chr4_136003566_136010937
Rpl11,4,136028265,136053428,protein_coding,-1,25163,chr4_136028265_136053428
Id3,4,136143497,136145755,protein_coding,1,2258,chr4_136143497_136145755
E2f2,4,136172394,136196057,protein_coding,1,23663,chr4_136172394_136196057
Asap3,4,136206365,136245216,protein_coding,1,38851,chr4_136206365_136245216
Tcea3,4,136247729,136274898,protein_coding,1,27169,chr4_136247729_136274898
Zfp46,4,136284683,136293942,protein_coding,1,9259,chr4_136284683_136293942
Hnrnpr,4,136310942,136359447,protein_coding,1,48505,chr4_136310942_136359447
Gm27022,4,136347847,136349441,lincRNA,-1,1594,chr4_136347847_136349441
Htr1d,4,136423524,136444398,protein_coding,1,20874,chr4_136423524_136444398
6030445D17Rik,4,136462250,136463977,lincRNA,1,1727,chr4_136462250_136463977
Luzp1,4,136469761,136554780,protein_coding,1,85019,chr4_136469761_136554780
Kdm1a,4,136550540,136602723,protein_coding,-1,52183,chr4_136550540_136602723
Tex46,4,136610437,136613226,protein_coding,1,2789,chr4_136610437_136613226
Lactbl1,4,136622621,136639110,protein_coding,1,16489,chr4_136622621_136639110
Ephb2,4,136647539,136835988,protein_coding,-1,188449,chr4_136647539_136835988
C1qb,4,136880129,136886187,protein_coding,-1,6058,chr4_136880129_136886187
C1qc,4,136889804,136893065,protein_coding,-1,3261,chr4_136889804_136893065
C1qa,4,136895917,136898803,protein_coding,-1,2886,chr4_136895917_136898803
Epha8,4,136929419,136956816,protein_coding,-1,27397,chr4_136929419_136956816
Zbtb40,4,136979732,137048801,protein_coding,-1,69069,chr4_136979732_137048801
Gm13003,4,137159082,137165066,lincRNA,-1,5984,chr4_137159082_137165066
Wnt4,4,137277489,137299726,protein_coding,1,22237,chr4_137277489_137299726
Cdc42,4,137319696,137357720,protein_coding,-1,38024,chr4_137319696_137357720
2810405F17Rik,4,137387266,137388382,lincRNA,-1,1116,chr4_137387266_137388382
Cela3a,4,137401554,137409791,protein_coding,-1,8237,chr4_137401554_137409791
Cela3b,4,137420999,137430540,protein_coding,-1,9541,chr4_137420999_137430540
Hspg2,4,137468769,137570630,protein_coding,1,101861,chr4_137468769_137570630
Ldlrad2,4,137570876,137582104,protein_coding,-1,11228,chr4_137570876_137582104
Usp48,4,137593755,137658537,protein_coding,1,64782,chr4_137593755_137658537
Rap1gap,4,137664726,137729861,protein_coding,1,65135,chr4_137664726_137729861
Rap1gapos,4,137696979,137706606,antisense,-1,9627,chr4_137696979_137706606
Alpl,4,137741733,137796384,protein_coding,-1,54651,chr4_137741733_137796384
Ece1,4,137862237,137965229,protein_coding,1,102992,chr4_137862237_137965229
Gm13012,4,137882370,137883937,antisense,-1,1567,chr4_137882370_137883937
Eif4g3,4,137993022,138208508,protein_coding,1,215486,chr4_137993022_138208508
1700095J12Rik,4,138137595,138138518,antisense,-1,923,chr4_138137595_138138518
2310026L22Rik,4,138215714,138216189,lincRNA,1,475,chr4_138215714_138216189
Hp1bp3,4,138216296,138244683,protein_coding,1,28387,chr4_138216296_138244683
Sh2d5,4,138250403,138261332,protein_coding,1,10929,chr4_138250403_138261332
Kif17,4,138250435,138301967,protein_coding,1,51532,chr4_138250435_138301967
Ddost,4,138304730,138312628,protein_coding,1,7898,chr4_138304730_138312628
Pink1,4,138313409,138326307,protein_coding,-1,12898,chr4_138313409_138326307
Cda,4,138338424,138367992,protein_coding,-1,29568,chr4_138338424_138367992
Fam43b,4,138394092,138396528,protein_coding,-1,2436,chr4_138394092_138396528
AB041806,4,138395198,138397714,antisense,1,2516,chr4_138395198_138397714
Mul1,4,138434671,138442265,protein_coding,1,7594,chr4_138434671_138442265
Camk2n1,4,138454314,138460123,protein_coding,1,5809,chr4_138454314_138460123
Vwa5b1,4,138565360,138635884,protein_coding,-1,70524,chr4_138565360_138635884
Ubxn10,4,138709837,138737167,protein_coding,-1,27330,chr4_138709837_138737167
Pla2g2c,4,138724792,138746132,protein_coding,1,21340,chr4_138724792_138746132
Pla2g2f,4,138750533,138757626,protein_coding,-1,7093,chr4_138750533_138757626
Pla2g2d,4,138775735,138782046,protein_coding,1,6311,chr4_138775735_138782046
Pla2g5,4,138799244,138863482,protein_coding,-1,64238,chr4_138799244_138863482
Gm13030,4,138870992,138873964,protein_coding,-1,2972,chr4_138870992_138873964
Pla2g2e,4,138877942,138882817,protein_coding,1,4875,chr4_138877942_138882817
Otud3,4,138895379,138913945,protein_coding,-1,18566,chr4_138895379_138913945
Tmco4,4,138972888,139059171,protein_coding,1,86283,chr4_138972888_139059171
Htr6,4,139061108,139075570,protein_coding,-1,14462,chr4_139061108_139075570
Gm45533,4,139075824,139076208,antisense,1,384,chr4_139075824_139076208
Nbl1,4,139082284,139092993,protein_coding,-1,10709,chr4_139082284_139092993
Gm16287,4,139175405,139180655,antisense,-1,5250,chr4_139175405_139180655
Capzb,4,139192899,139291818,protein_coding,1,98919,chr4_139192899_139291818
Pqlc2,4,139294029,139310708,protein_coding,-1,16679,chr4_139294029_139310708
Akr7a5,4,139310744,139318426,protein_coding,1,7682,chr4_139310744_139318426
Mrto4,4,139347435,139352576,protein_coding,-1,5141,chr4_139347435_139352576
Emc1,4,139352587,139378730,protein_coding,1,26143,chr4_139352587_139378730
Ubr4,4,139352609,139489588,protein_coding,1,136979,chr4_139352609_139489588
Iffo2,4,139530548,139620382,protein_coding,1,89834,chr4_139530548_139620382
Gm21969,4,139603186,139662691,protein_coding,1,59505,chr4_139603186_139662691
Tas1r2,4,139653538,139670280,protein_coding,1,16742,chr4_139653538_139670280
Pax7,4,139737062,139833528,protein_coding,-1,96466,chr4_139737062_139833528
Gm1667,4,139910488,139912133,lincRNA,1,1645,chr4_139910488_139912133
Gm13028,4,139923349,139933170,lincRNA,1,9821,chr4_139923349_139933170
4933427I22Rik,4,139926111,139943519,lincRNA,-1,17408,chr4_139926111_139943519
Klhdc7a,4,139960220,139968026,protein_coding,-1,7806,chr4_139960220_139968026
Igsf21,4,140026846,140246784,protein_coding,-1,219938,chr4_140026846_140246784
Gm13027,4,140131877,140133351,antisense,1,1474,chr4_140131877_140133351
Gm13029,4,140142873,140144633,antisense,1,1760,chr4_140142873_140144633
Gm13016,4,140380630,140385574,lincRNA,1,4944,chr4_140380630_140385574
Gm13021,4,140422524,140431931,lincRNA,1,9407,chr4_140422524_140431931
Gm13026,4,140437963,140461291,lincRNA,1,23328,chr4_140437963_140461291
Arhgef10l,4,140514485,140666012,protein_coding,-1,151527,chr4_140514485_140666012
Gm13025,4,140679753,140684617,lincRNA,1,4864,chr4_140679753_140684617
Rcc2,4,140700541,140723220,protein_coding,1,22679,chr4_140700541_140723220
Padi6,4,140727355,140742643,protein_coding,-1,15288,chr4_140727355_140742643
Padi4,4,140745865,140774236,protein_coding,-1,28371,chr4_140745865_140774236
Padi3,4,140785365,140810648,protein_coding,-1,25283,chr4_140785365_140810648
Padi1,4,140812983,140845778,protein_coding,-1,32795,chr4_140812983_140845778
4930515B02Rik,4,140872693,140878055,lincRNA,1,5362,chr4_140872693_140878055
Padi2,4,140906344,140952586,protein_coding,1,46242,chr4_140906344_140952586
Gm13031,4,140947666,140957902,antisense,-1,10236,chr4_140947666_140957902
Sdhb,4,140961203,140979193,protein_coding,1,17990,chr4_140961203_140979193
Atp13a2,4,140986873,141007330,protein_coding,1,20457,chr4_140986873_141007330
Mfap2,4,141010418,141015984,protein_coding,1,5566,chr4_141010418_141015984
Crocc,4,141016637,141060550,protein_coding,-1,43913,chr4_141016637_141060550
Necap2,4,141066512,141078357,protein_coding,-1,11845,chr4_141066512_141078357
Spata21,4,141088333,141112760,protein_coding,1,24427,chr4_141088333_141112760
Szrd1,4,141113001,141139775,protein_coding,-1,26774,chr4_141113001_141139775
4921514A10Rik,4,141115660,141118087,antisense,1,2427,chr4_141115660_141118087
Fbxo42,4,141147913,141204062,protein_coding,1,56149,chr4_141147913_141204062
Arhgef19,4,141239499,141257564,protein_coding,1,18065,chr4_141239499_141257564
Gm13055,4,141261762,141266016,antisense,-1,4254,chr4_141261762_141266016
Gm13056,4,141278439,141279794,lincRNA,1,1355,chr4_141278439_141279794
Epha2,4,141301240,141329384,protein_coding,1,28144,chr4_141301240_141329384
Fam131c,4,141368220,141384175,protein_coding,1,15955,chr4_141368220_141384175
Clcnka,4,141384610,141398724,protein_coding,-1,14114,chr4_141384610_141398724
Gm13075,4,141398829,141411191,antisense,1,12362,chr4_141398829_141411191
Clcnkb,4,141404353,141416014,protein_coding,-1,11661,chr4_141404353_141416014
Hspb7,4,141420779,141425311,protein_coding,1,4532,chr4_141420779_141425311
Srarp,4,141432672,141436105,protein_coding,-1,3433,chr4_141432672_141436105
Zbtb17,4,141444654,141467930,protein_coding,1,23276,chr4_141444654_141467930
Spen,4,141467890,141538597,protein_coding,-1,70707,chr4_141467890_141538597
Fblim1,4,141576062,141606096,protein_coding,-1,30034,chr4_141576062_141606096
Tmem82,4,141613376,141618633,protein_coding,-1,5257,chr4_141613376_141618633
AI507597,4,141614026,141615604,antisense,1,1578,chr4_141614026_141615604
Slc25a34,4,141618824,141623821,protein_coding,-1,4997,chr4_141618824_141623821
Plekhm2,4,141625734,141664899,protein_coding,-1,39165,chr4_141625734_141664899
Ddi2,4,141677549,141723419,protein_coding,-1,45870,chr4_141677549_141723419
Agmat,4,141746672,141759263,protein_coding,1,12591,chr4_141746672_141759263
Dnajc16,4,141760189,141790931,protein_coding,-1,30742,chr4_141760189_141790931
Casp9,4,141793612,141815976,protein_coding,1,22364,chr4_141793612_141815976
Ctrc,4,141814962,141846359,protein_coding,-1,31397,chr4_141814962_141846359
Efhd2,4,141858142,141874920,protein_coding,-1,16778,chr4_141858142_141874920
Gm29367,4,141875707,141877033,lincRNA,1,1326,chr4_141875707_141877033
Fhad1os2,4,141885654,141897282,antisense,1,11628,chr4_141885654_141897282
Fhad1,4,141890438,142015082,protein_coding,-1,124644,chr4_141890438_142015082
Fhad1os1,4,141982992,141986797,antisense,1,3805,chr4_141982992_141986797
4930455G09Rik,CHR_MG51_PATCH,142017898,142028996,antisense;lncRNA,1,11098,chrCHR_MG51_PATCH_142017898_142028996
Tmem51,4,142030992,142084304,protein_coding,-1,53312,chr4_142030992_142084304
Tmem51os1,CHR_MG51_PATCH,142083972,142088099,antisense;lncRNA,1,4127,chrCHR_MG51_PATCH_142083972_142088099
Kazn,4,142102390,142239401,protein_coding,-1,137011,chr4_142102390_142239401
Gm13062,CHR_MG51_PATCH,142180602,142184139,antisense;lncRNA,1,3537,chrCHR_MG51_PATCH_142180602_142184139
Gm13052,4,142307765,142346475,lincRNA;lncRNA,-1,38710,chr4_142307765_142346475
Prdm2,4,143107391,143212995,protein_coding,-1,105604,chr4_143107391_143212995
Pdpn,4,143267431,143299564,protein_coding,-1,32133,chr4_143267431_143299564
Lrrc38,4,143349757,143371032,protein_coding,1,21275,chr4_143349757_143371032
Pramel1,4,143394428,143400160,protein_coding,1,5732,chr4_143394428_143400160
Pramef8,4,143412426,143421091,protein_coding,1,8665,chr4_143412426_143421091
Oog4,4,143437164,143450324,protein_coding,-1,13160,chr4_143437164_143450324
BC080695,4,143527062,143573798,protein_coding,1,46736,chr4_143527062_143573798
Gm13078,4,143719455,143729158,protein_coding,1,9703,chr4_143719455_143729158
Gm13023,4,143789352,143795575,protein_coding,1,6223,chr4_143789352_143795575
Gm13103,4,143846497,143853637,protein_coding,1,7140,chr4_143846497_143853637
Oog3,4,144157557,144162663,protein_coding,-1,5106,chr4_144157557_144162663
Pramel5,4,144270633,144280488,protein_coding,-1,9855,chr4_144270633_144280488
Gm13119,4,144357942,144364419,protein_coding,1,6477,chr4_144357942_144364419
Pramef20,4,144372760,144377933,protein_coding,-1,5173,chr4_144372760_144377933
Pramef12,4,144391674,144408464,protein_coding,-1,16790,chr4_144391674_144408464
1700012P22Rik,4,144418189,144438772,protein_coding,-1,20583,chr4_144418189_144438772
Aadacl3,4,144453771,144463756,protein_coding,-1,9985,chr4_144453771_144463756
Aadacl4,4,144613707,144623398,protein_coding,1,9691,chr4_144613707_144623398
Dhrs3,4,144892827,144928209,protein_coding,1,35382,chr4_144892827_144928209
Vps13d,4,144972622,145195005,protein_coding,-1,222383,chr4_144972622_145195005
Tnfrsf1b,4,145213463,145246870,protein_coding,-1,33407,chr4_145213463_145246870
Tnfrsf8,4,145267137,145315164,protein_coding,-1,48027,chr4_145267137_145315164
Zfp990,4,145510759,145539188,protein_coding,1,28429,chr4_145510759_145539188
Gm13212,4,145585166,145625345,protein_coding,1,40179,chr4_145585166_145625345
Zfp980,4,145670685,145704441,protein_coding,1,33756,chr4_145670685_145704441
Zfp986,4,145868794,145899975,protein_coding,1,31181,chr4_145868794_145899975
Zfp987,4,146097298,146126621,protein_coding,1,29323,chr4_146097298_146126621
Zfp600,4,146156824,146198755,protein_coding,1,41931,chr4_146156824_146198755
Gm13166,4,146251829,146278434,lincRNA;lncRNA,1,26605,chr4_146251829_146278434
Zfp992,4,146449023,146618179,protein_coding,1,169156,chr4_146449023_146618179
Zfp981,4,146502027,146539395,protein_coding,1,37368,chr4_146502027_146539395
Zfp993,4,146610961,146658160,protein_coding,1,47199,chr4_146610961_146658160
Rex2,4,147021850,147060794,protein_coding,1,38944,chr4_147021850_147060794
Zfp991,4,147132038,147180579,protein_coding,1,48541,chr4_147132038_147180579
Zfp982,4,147492417,147513486,protein_coding,1,21069,chr4_147492417_147513486
Zfp985,4,147553277,147585198,protein_coding,1,31921,chr4_147553277_147585198
Zfp979,4,147611937,147642513,protein_coding,-1,30576,chr4_147611937_147642513
Zfp534,4,147673502,147702553,protein_coding,-1,29051,chr4_147673502_147702553
Zfp984,4,147753974,147809788,protein_coding,-1,55814,chr4_147753974_147809788
Gm20707,4,147782319,147809840,lincRNA,-1,27521,chr4_147782319_147809840
Zfp933,4,147822986,147848366,protein_coding,-1,25380,chr4_147822986_147848366
Miip,4,147860778,147868816,protein_coding,-1,8038,chr4_147860778_147868816
Fv1,4,147868979,147870358,protein_coding,1,1379,chr4_147868979_147870358
Mfn2,4,147873599,147904704,protein_coding,-1,31105,chr4_147873599_147904704
Plod1,4,147909753,147936767,protein_coding,-1,27014,chr4_147909753_147936767
2510039O18Rik,4,147940895,147947314,protein_coding,1,6419,chr4_147940895_147947314
Nppb,4,147985788,147987205,protein_coding,1,1417,chr4_147985788_147987205
Nppa,4,148000722,148002079,protein_coding,1,1357,chr4_148000722_148002079
Gm13054,4,148001091,148004014,antisense,-1,2923,chr4_148001091_148004014
Clcn6,4,148004259,148038821,protein_coding,-1,34562,chr4_148004259_148038821
Mthfr,4,148039077,148059551,protein_coding,1,20474,chr4_148039077_148059551
Gm13201,4,148071392,148075420,antisense,-1,4028,chr4_148071392_148075420
Agtrap,4,148077061,148088031,protein_coding,-1,10970,chr4_148077061_148088031
Draxin,4,148098437,148130698,protein_coding,-1,32261,chr4_148098437_148130698
Mad2l2,4,148130384,148145699,protein_coding,1,15315,chr4_148130384_148145699
Fbxo6,4,148145716,148152140,protein_coding,-1,6424,chr4_148145716_148152140
Fbxo44,4,148152800,148160482,protein_coding,-1,7682,chr4_148152800_148160482
Fbxo2,4,148160621,148166424,protein_coding,1,5803,chr4_148160621_148166424
Disp3,4,148240264,148287965,protein_coding,-1,47701,chr4_148240264_148287965
Gm13206,4,148306853,148316569,lincRNA,1,9716,chr4_148306853_148316569
Gm13200,4,148356379,148359460,lincRNA,-1,3081,chr4_148356379_148359460
Ubiad1,4,148434495,148444771,protein_coding,-1,10276,chr4_148434495_148444771
Mtor,4,148448611,148557683,protein_coding,1,109072,chr4_148448611_148557683
Angptl7,4,148495183,148500460,protein_coding,-1,5277,chr4_148495183_148500460
Exosc10,4,148558429,148582401,protein_coding,1,23972,chr4_148558429_148582401
Gm13209,4,148584721,148586007,antisense,-1,1286,chr4_148584721_148586007
Srm,4,148591503,148594993,protein_coding,1,3490,chr4_148591503_148594993
Masp2,4,148602554,148615499,protein_coding,1,12945,chr4_148602554_148615499
Tardbp,4,148612382,148627019,protein_coding,-1,14637,chr4_148612382_148627019
Gm572,4,148643317,148671572,protein_coding,1,28255,chr4_148643317_148671572
Casz1,4,148804429,148954889,protein_coding,1,150460,chr4_148804429_148954889
Gm13205,4,148947492,148948914,antisense,-1,1422,chr4_148947492_148948914
Gm17029,4,148960297,148984671,antisense,1,24374,chr4_148960297_148984671
Pex14,4,148960535,149099876,protein_coding,-1,139341,chr4_148960535_149099876
Dffa,4,149104146,149120647,protein_coding,1,16501,chr4_149104146_149120647
Cort,4,149125034,149126763,protein_coding,-1,1729,chr4_149125034_149126763
Cenps,4,149127121,149137629,protein_coding,-1,10508,chr4_149127121_149137629
Pgd,4,149149991,149166771,protein_coding,-1,16780,chr4_149149991_149166771
Kif1b,4,149176319,149307693,protein_coding,-1,131374,chr4_149176319_149307693
Ube4b,4,149328416,149426749,protein_coding,-1,98333,chr4_149328416_149426749
Ube4bos3,4,149334639,149335897,antisense,1,1258,chr4_149334639_149335897
Ube4bos2,4,149338087,149338531,antisense,1,444,chr4_149338087_149338531
Ube4bos1,4,149347885,149365277,antisense,1,17392,chr4_149347885_149365277
Rbp7,4,149449687,149454978,protein_coding,-1,5291,chr4_149449687_149454978
Nmnat1,4,149467572,149485202,protein_coding,-1,17630,chr4_149467572_149485202
Lzic,4,149485229,149496668,protein_coding,1,11439,chr4_149485229_149496668
Ctnnbip1,4,149518236,149566437,protein_coding,1,48201,chr4_149518236_149566437
Gm13066,4,149565620,149567790,antisense,-1,2170,chr4_149565620_149567790
Clstn1,4,149586468,149648899,protein_coding,1,62431,chr4_149586468_149648899
Pik3cd,4,149649168,149702571,protein_coding,-1,53403,chr4_149649168_149702571
Tmem201,4,149715375,149738044,protein_coding,-1,22669,chr4_149715375_149738044
Slc25a33,4,149744036,149774277,protein_coding,-1,30241,chr4_149744036_149774277
Gm13068,4,149748518,149749607,antisense,1,1089,chr4_149748518_149749607
Gm16188,4,149776252,149783332,lincRNA,1,7080,chr4_149776252_149783332
Spsb1,4,149896283,149955043,protein_coding,-1,58760,chr4_149896283_149955043
Gm13070,4,149904006,149908149,antisense,1,4143,chr4_149904006_149908149
H6pd,4,149979475,150009023,protein_coding,-1,29548,chr4_149979475_150009023
Gm13067,4,150049013,150056976,lincRNA,1,7963,chr4_150049013_150056976
Gpr157,4,150087365,150105927,protein_coding,1,18562,chr4_150087365_150105927
Gm13093,4,150113879,150119263,lincRNA,-1,5384,chr4_150113879_150119263
Slc2a5,4,150119283,150144169,protein_coding,1,24886,chr4_150119283_150144169
Slc2a7,4,150148972,150168482,protein_coding,1,19510,chr4_150148972_150168482
Car6,4,150187015,150201332,protein_coding,-1,14317,chr4_150187015_150201332
Eno1,4,150236721,150248879,protein_coding,1,12158,chr4_150236721_150248879
Rere,4,150281646,150621966,protein_coding,1,340320,chr4_150281646_150621966
Gm13091,4,150566869,150568544,antisense,-1,1675,chr4_150566869_150568544
Slc45a1,4,150628572,150652174,protein_coding,-1,23602,chr4_150628572_150652174
Gm16079,4,150668248,150678792,lincRNA,-1,10544,chr4_150668248_150678792
Gm13049,4,150825733,150839575,lincRNA,1,13842,chr4_150825733_150839575
1700045H11Rik,4,150828225,150854949,antisense,-1,26724,chr4_150828225_150854949
Errfi1,4,150853919,150868892,protein_coding,1,14973,chr4_150853919_150868892
Park7,4,150897133,150914437,protein_coding,-1,17304,chr4_150897133_150914437
Tnfrsf9,4,150914562,150946102,protein_coding,1,31540,chr4_150914562_150946102
Camta1,4,150917322,151861876,protein_coding,-1,944554,chr4_150917322_151861876
Uts2,4,150997097,151001810,protein_coding,1,4713,chr4_150997097_151001810
Gm13090,4,151089570,151091449,protein_coding,1,1879,chr4_151089570_151091449
4930589P08Rik,4,151376470,151379582,antisense,1,3112,chr4_151376470_151379582
Dnajc11,4,151933691,151982137,protein_coding,1,48446,chr4_151933691_151982137
Thap3,4,151982639,151988997,protein_coding,-1,6358,chr4_151982639_151988997
Phf13,4,151989633,151996258,protein_coding,-1,6625,chr4_151989633_151996258
Klhl21,4,152008803,152017680,protein_coding,1,8877,chr4_152008803_152017680
Zbtb48,4,152019774,152027671,protein_coding,-1,7897,chr4_152019774_152027671
Tas1r1,4,152027914,152038568,protein_coding,-1,10654,chr4_152027914_152038568
Nol9,4,152039321,152061494,protein_coding,1,22173,chr4_152039321_152061494
Plekhg5,4,152072498,152115400,protein_coding,1,42902,chr4_152072498_152115400
Tnfrsf25,4,152115934,152120119,protein_coding,1,4185,chr4_152115934_152120119
Espn,4,152120331,152152371,protein_coding,-1,32040,chr4_152120331_152152371
Acot7,4,152178134,152271855,protein_coding,1,93721,chr4_152178134_152271855
Gpr153,4,152274232,152285337,protein_coding,1,11105,chr4_152274232_152285337
Hes3,4,152285972,152291662,protein_coding,-1,5690,chr4_152285972_152291662
Icmt,4,152297227,152307121,protein_coding,1,9894,chr4_152297227_152307121
Rnf207,4,152307019,152318993,protein_coding,-1,11974,chr4_152307019_152318993
Rpl22,4,152325742,152334071,protein_coding,1,8329,chr4_152325742_152334071
Chd5,4,152338651,152390194,protein_coding,1,51543,chr4_152338651_152390194
Kcnab2,4,152390742,152477910,protein_coding,-1,87168,chr4_152390742_152477910
Gm16333,4,152410800,152411262,antisense,1,462,chr4_152410800_152411262
Nphp4,4,152476706,152563183,protein_coding,1,86477,chr4_152476706_152563183
Ajap1,4,153373221,153482811,protein_coding,-1,109590,chr4_153373221_153482811
BC039966,4,153947633,153950503,antisense,-1,2870,chr4_153947633_153950503
A430005L14Rik,4,153957237,153961925,protein_coding,1,4688,chr4_153957237_153961925
Dffb,4,153964449,153975126,protein_coding,-1,10677,chr4_153964449_153975126
Cep104,4,153975194,154008732,protein_coding,1,33538,chr4_153975194_154008732
Lrrc47,4,154011731,154021513,protein_coding,1,9782,chr4_154011731_154021513
Smim1,4,154020470,154026230,protein_coding,-1,5760,chr4_154020470_154026230
Ccdc27,4,154026639,154042677,protein_coding,-1,16038,chr4_154026639_154042677
Trp73,4,154056249,154140208,protein_coding,-1,83959,chr4_154056249_154140208
Wrap73,4,154142372,154167420,protein_coding,1,25048,chr4_154142372_154167420
Tprgl,4,154157485,154160666,protein_coding,-1,3181,chr4_154157485_154160666
Megf6,4,154170730,154275713,protein_coding,1,104983,chr4_154170730_154275713
Arhgef16,4,154278486,154301676,protein_coding,-1,23190,chr4_154278486_154301676
Prdm16,4,154316125,154636873,protein_coding,-1,320748,chr4_154316125_154636873
B230104I21Rik,4,154336127,154349918,lincRNA,1,13791,chr4_154336127_154349918
Gm13133,4,154550282,154557645,antisense,1,7363,chr4_154550282_154557645
Ttc34,4,154837459,154867127,protein_coding,1,29668,chr4_154837459_154867127
Gm13112,4,154864506,154872003,antisense,-1,7497,chr4_154864506_154872003
Mmel1,4,154869585,154895528,protein_coding,1,25943,chr4_154869585_154895528
Tnfrsf14,4,154921933,154928563,protein_coding,-1,6630,chr4_154921933_154928563
Hes5,4,154960923,154962371,protein_coding,1,1448,chr4_154960923_154962371
Pank4,4,154964123,154980938,protein_coding,1,16815,chr4_154964123_154980938
Plch2,4,154983115,155056784,protein_coding,-1,73669,chr4_154983115_155056784
Gm10564,4,155042046,155045422,antisense,1,3376,chr4_155042046_155045422
Pex10,4,155067016,155072433,protein_coding,1,5417,chr4_155067016_155072433
Rer1,4,155074110,155086382,protein_coding,-1,12272,chr4_155074110_155086382
Morn1,4,155086577,155145505,protein_coding,1,58928,chr4_155086577_155145505
Ski,4,155154075,155222592,protein_coding,-1,68517,chr4_155154075_155222592
Faap20,4,155249802,155256687,protein_coding,1,6885,chr4_155249802_155256687
Prkcz,4,155260129,155361361,protein_coding,-1,101232,chr4_155260129_155361361
Gm27200,4,155343683,155344465,antisense,1,782,chr4_155343683_155344465
Gabrd,4,155384980,155398112,protein_coding,-1,13132,chr4_155384980_155398112
Cfap74,4,155409190,155466823,protein_coding,1,57633,chr4_155409190_155466823
Tmem52,4,155469114,155470858,protein_coding,1,1744,chr4_155469114_155470858
Gnb1,4,155491361,155559269,protein_coding,1,67908,chr4_155491361_155559269
Nadk,4,155562378,155591001,protein_coding,1,28623,chr4_155562378_155591001
Slc35e2,4,155601416,155623340,protein_coding,1,21924,chr4_155601416_155623340
Gm10563,4,155614413,155645408,protein_coding,-1,30995,chr4_155614413_155645408
Cdk11b,4,155624854,155649938,protein_coding,1,25084,chr4_155624854_155649938
Mmp23,4,155650655,155653384,protein_coding,-1,2729,chr4_155650655_155653384
Mib2,4,155654677,155669198,protein_coding,-1,14521,chr4_155654677_155669198
Fndc10,4,155694342,155696481,protein_coding,1,2139,chr4_155694342_155696481
Ssu72,4,155704800,155733879,protein_coding,1,29079,chr4_155704800_155733879
1500002C15Rik,4,155732545,155734727,antisense,-1,2182,chr4_155732545_155734727
Tmem240,4,155734800,155740564,protein_coding,1,5764,chr4_155734800_155740564
Atad3a,4,155740641,155761093,protein_coding,-1,20452,chr4_155740641_155761093
Atad3aos,4,155761178,155769264,antisense,1,8086,chr4_155761178_155769264
Vwa1,4,155768149,155774698,protein_coding,-1,6549,chr4_155768149_155774698
Tmem88b,4,155781591,155785874,protein_coding,-1,4283,chr4_155781591_155785874
Ankrd65,4,155790439,155799503,protein_coding,1,9064,chr4_155790439_155799503
Mrpl20,4,155802878,155809975,protein_coding,1,7097,chr4_155802878_155809975
Ccnl2,4,155812489,155824543,protein_coding,1,12054,chr4_155812489_155824543
Aurkaip1,4,155831272,155833130,protein_coding,1,1858,chr4_155831272_155833130
Mxra8,4,155839680,155844088,protein_coding,1,4408,chr4_155839680_155844088
Dvl1,4,155847402,155859303,protein_coding,1,11901,chr4_155847402_155859303
Tas1r3,4,155859268,155863362,protein_coding,-1,4094,chr4_155859268_155863362
Cptp,4,155864723,155869440,protein_coding,-1,4717,chr4_155864723_155869440
Ints11,4,155869546,155889103,protein_coding,1,19557,chr4_155869546_155889103
Pusl1,4,155887879,155891781,protein_coding,-1,3902,chr4_155887879_155891781
Acap3,4,155891822,155907251,protein_coding,1,15429,chr4_155891822_155907251
Ube2j2,4,155943831,155959604,protein_coding,1,15773,chr4_155943831_155959604
C1qtnf12,4,155962318,155966629,protein_coding,1,4311,chr4_155962318_155966629
B3galt6,4,155989466,155992649,protein_coding,-1,3183,chr4_155989466_155992649
Sdf4,4,155992872,156013610,protein_coding,1,20738,chr4_155992872_156013610
Tnfrsf4,4,156013843,156016612,protein_coding,1,2769,chr4_156013843_156016612
Gm16008,4,156022008,156031643,antisense,-1,9635,chr4_156022008_156031643
Tnfrsf18,4,156026164,156028895,protein_coding,1,2731,chr4_156026164_156028895
Ttll10,4,156034840,156059414,protein_coding,-1,24574,chr4_156034840_156059414
9430015G10Rik,4,156109982,156127265,protein_coding,1,17283,chr4_156109982_156127265
Rnf223,4,156130513,156133420,protein_coding,1,2907,chr4_156130513_156133420
Agrn,4,156165290,156197488,protein_coding,-1,32198,chr4_156165290_156197488
Isg15,4,156199455,156200796,protein_coding,-1,1341,chr4_156199455_156200796
AW011738,4,156203270,156210563,processed_transcript,1,7293,chr4_156203270_156210563
Perm1,4,156215868,156221307,protein_coding,1,5439,chr4_156215868_156221307
Plekhn1,4,156221456,156234857,protein_coding,-1,13401,chr4_156221456_156234857
Noc2l,4,156235919,156247616,protein_coding,1,11697,chr4_156235919_156247616
Samd11,4,156246966,156255657,protein_coding,-1,8691,chr4_156246966_156255657
Gm47252,4,156254501,156255352,antisense,1,851,chr4_156254501_156255352
Gm36548,5,3270319,3284584,lincRNA,1,14265,chr5_3270319_3284584
Cdk6,5,3341485,3531008,protein_coding,1,189523,chr5_3341485_3531008
Gm17590,5,3472861,3480873,antisense,-1,8012,chr5_3472861_3480873
Gm42435,5,3498625,3500072,antisense,-1,1447,chr5_3498625_3500072
Fam133b,5,3543833,3570238,protein_coding,1,26405,chr5_3543833_3570238
1700109H08Rik,5,3571566,3584356,protein_coding,1,12790,chr5_3571566_3584356
Rbm48,5,3583978,3596585,protein_coding,-1,12607,chr5_3583978_3596585
2510017J16Rik,5,3585112,3586374,antisense,1,1262,chr5_3585112_3586374
Pex1,5,3596066,3637232,protein_coding,1,41166,chr5_3596066_3637232
Gm43825,5,3624630,3625363,antisense,-1,733,chr5_3624630_3625363
4833413G10Rik,5,3629777,3631722,antisense,-1,1945,chr5_3629777_3631722
Gatad1,5,3632932,3657185,protein_coding,-1,24253,chr5_3632932_3657185
Tmbim7,5,3651181,3680325,protein_coding,1,29144,chr5_3651181_3680325
Ankib1,5,3690000,3802925,protein_coding,-1,112925,chr5_3690000_3802925
Krit1,5,3803184,3845564,protein_coding,1,42380,chr5_3803184_3845564
Lrrd1,5,3845173,3866596,protein_coding,1,21423,chr5_3845173_3866596
Mterf1a,5,3890581,3893933,protein_coding,-1,3352,chr5_3890581_3893933
Akap9,5,3928054,4081310,protein_coding,1,153256,chr5_3928054_4081310
Cyp51,5,4081145,4104746,protein_coding,-1,23601,chr5_4081145_4104746
Mterf1b,5,4192367,4197651,protein_coding,1,5284,chr5_4192367_4197651
Fzd1,5,4753839,4758035,protein_coding,-1,4196,chr5_4753839_4758035
Gm42744,5,4784753,4799094,lincRNA,-1,14341,chr5_4784753_4799094
Cdk14,5,4803391,5420312,protein_coding,-1,616921,chr5_4803391_5420312
1700015F17Rik,5,5437827,5479143,protein_coding,-1,41316,chr5_5437827_5479143
Cldn12,5,5489537,5514958,protein_coding,-1,25421,chr5_5489537_5514958
Gtpbp10,5,5537454,5559538,protein_coding,-1,22084,chr5_5537454_5559538
Gm8773,5,5573799,5576203,protein_coding,1,2404,chr5_5573799_5576203
Cfap69,5,5579278,5664239,protein_coding,-1,84961,chr5_5579278_5664239
Steap2,5,5664829,5694578,protein_coding,-1,29749,chr5_5664829_5694578
Steap1,5,5736317,5749326,protein_coding,-1,13009,chr5_5736317_5749326
Gm40263,5,6414399,6427065,lincRNA,1,12666,chr5_6414399_6427065
Zfp804b,5,6769010,7344756,protein_coding,-1,575746,chr5_6769010_7344756
Tex47,5,7304119,7311491,protein_coding,1,7372,chr5_7304119_7311491
Gm30835,5,7680108,7960346,lincRNA,-1,280238,chr5_7680108_7960346
Steap4,5,7960457,7982213,protein_coding,1,21756,chr5_7960457_7982213
Gm15731,5,8037294,8052707,antisense,-1,15413,chr5_8037294_8052707
Sri,5,8046078,8069379,protein_coding,1,23301,chr5_8046078_8069379
Adam22,5,8072352,8368160,protein_coding,-1,295808,chr5_8072352_8368160
Dbf4,5,8396973,8422716,protein_coding,-1,25743,chr5_8396973_8422716
Slc25a40,5,8422850,8454797,protein_coding,1,31947,chr5_8422850_8454797
Rundc3b,5,8490334,8622952,protein_coding,-1,132618,chr5_8490334_8622952
Abcb1a,5,8660077,8748575,protein_coding,1,88498,chr5_8660077_8748575
Gm5106,5,8773577,8798523,antisense,-1,24946,chr5_8773577_8798523
Abcb1b,5,8798147,8866315,protein_coding,1,68168,chr5_8798147_8866315
Abcb4,5,8893717,8959231,protein_coding,1,65514,chr5_8893717_8959231
Crot,5,8966033,8997324,protein_coding,-1,31291,chr5_8966033_8997324
Gm15611,5,8998402,8999669,lincRNA,-1,1267,chr5_8998402_8999669
Gm40264,5,9034780,9061316,lincRNA,1,26536,chr5_9034780_9061316
Tmem243,5,9100668,9160986,protein_coding,1,60318,chr5_9100668_9160986
Dmtf1,5,9118801,9161776,protein_coding,-1,42975,chr5_9118801_9161776
Gm15734,5,9264222,9266022,lincRNA,-1,1800,chr5_9264222_9266022
9330182L06Rik,5,9266118,9481825,protein_coding,1,215707,chr5_9266118_9481825
Grm3,5,9485541,9725170,protein_coding,-1,239629,chr5_9485541_9725170
Gm10482,5,10187866,10237890,lincRNA,1,50024,chr5_10187866_10237890
Gm31831,5,10249092,10349408,lincRNA,1,100316,chr5_10249092_10349408
Gm8871,5,10947805,11044948,protein_coding,1,97143,chr5_10947805_11044948
Gm32554,5,11165537,11181825,lincRNA,-1,16288,chr5_11165537_11181825
Gm33093,5,11238536,11254753,lincRNA,-1,16217,chr5_11238536_11254753
Gm32877,5,11320804,11340297,lincRNA,-1,19493,chr5_11320804_11340297
1700003C15Rik,5,11689253,11769308,lincRNA,-1,80055,chr5_11689253_11769308
Gm29066,5,12089537,12097647,lincRNA,1,8110,chr5_12089537_12097647
Sema3d,5,12383385,12588948,protein_coding,1,205563,chr5_12383385_12588948
Sema3a,5,13125414,13602565,protein_coding,1,477151,chr5_13125414_13602565
4930568A13Rik,5,13748111,13808343,lincRNA,-1,60232,chr5_13748111_13808343
Speer3,5,13791619,13796820,protein_coding,1,5201,chr5_13791619_13796820
Sema3e,5,14025276,14256689,protein_coding,1,231413,chr5_14025276_14256689
Gm4128,5,14056438,14074157,antisense,-1,17719,chr5_14056438_14074157
Pclo,5,14514918,14863459,protein_coding,1,348541,chr5_14514918_14863459
Gm26918,5,14520673,14539852,antisense,-1,19179,chr5_14520673_14539852
Gm26954,5,14696985,14723664,antisense,-1,26679,chr5_14696985_14723664
Gm43391,CHR_MG4212_PATCH,15464171,15506860,antisense;lncRNA,1,42689,chrCHR_MG4212_PATCH_15464171_15506860
Gm21847,CHR_MG4212_PATCH,15516489,15684663,antisense;lncRNA,1,168174,chrCHR_MG4212_PATCH_15516489_15684663
Gm30613,CHR_MG4212_PATCH,15538002,15633050,antisense;lncRNA,-1,95048,chrCHR_MG4212_PATCH_15538002_15633050
Speer4cos,5,15680710,15714596,antisense,1,33886,chr5_15680710_15714596
4930519H02Rik,5,15863928,15883829,lincRNA,-1,19901,chr5_15863928_15883829
Gm3510,5,15923755,15933406,lincRNA,-1,9651,chr5_15923755_15933406
Cacna2d1,5,15934691,16374511,protein_coding,1,439820,chr5_15934691_16374511
Gm43000,5,15993957,15997839,antisense,-1,3882,chr5_15993957_15997839
Hgf,5,16553495,16620152,protein_coding,1,66657,chr5_16553495_16620152
Gm28710,5,16791810,16882052,lincRNA;protein_coding,1,90242,chr5_16791810_16882052
Sema3c,5,17574281,17730268,protein_coding,1,155987,chr5_17574281_17730268
Cd36,5,17781690,17888801,protein_coding,-1,107111,chr5_17781690_17888801
Gnat3,5,17962549,18019834,protein_coding,1,57285,chr5_17962549_18019834
Gnai1,5,18265135,18360355,protein_coding,-1,95220,chr5_18265135_18360355
Gm31752,5,18481705,18490194,lincRNA,-1,8489,chr5_18481705_18490194
4921504A21Rik,5,19202368,19226555,antisense,-1,24187,chr5_19202368_19226555
Magi2,5,19227036,20704792,protein_coding,1,1477756,chr5_19227036_20704792
Phtf2,5,20758663,20882124,protein_coding,-1,123461,chr5_20758663_20882124
Tmem60,5,20882191,20886870,protein_coding,1,4679,chr5_20882191_20886870
Rsbn1l,5,20893028,20956398,protein_coding,-1,63370,chr5_20893028_20956398
A630072M18Rik,5,20950989,20956398,antisense,1,5409,chr5_20950989_20956398
Ptpn12,5,20986645,21055911,protein_coding,-1,69266,chr5_20986645_21055911
Gsap,5,21186255,21315132,protein_coding,1,128877,chr5_21186255_21315132
Ccdc146,5,21292961,21424677,protein_coding,-1,131716,chr5_21292961_21424677
Fgl2,5,21372642,21378374,protein_coding,1,5732,chr5_21372642_21378374
Fam185a,5,21424958,21482124,protein_coding,1,57166,chr5_21424958_21482124
Fbxl13,5,21483847,21645634,protein_coding,-1,161787,chr5_21483847_21645634
Lrrc17,5,21543559,21575904,protein_coding,1,32345,chr5_21543559_21575904
Armc10,5,21645813,21662694,protein_coding,1,16881,chr5_21645813_21662694
Napepld,5,21662901,21701396,protein_coding,-1,38495,chr5_21662901_21701396
Pmpcb,5,21737141,21757152,protein_coding,1,20011,chr5_21737141_21757152
Dnajc2,5,21757267,21785251,protein_coding,-1,27984,chr5_21757267_21785251
Psmc2,5,21785283,21803787,protein_coding,1,18504,chr5_21785283_21803787
Slc26a5,5,21810655,21865604,protein_coding,-1,54949,chr5_21810655_21865604
Reln,5,21884454,22344702,protein_coding,-1,460248,chr5_21884454_22344702
Gm10475,5,21910931,21954014,antisense,1,43083,chr5_21910931_21954014
Gm16110,5,22334442,22336118,antisense,1,1676,chr5_22334442_22336118
Gm43657,5,22400886,22404718,lincRNA,-1,3832,chr5_22400886_22404718
Orc5,5,22486485,22550429,protein_coding,-1,63944,chr5_22486485_22550429
6030443J06Rik,5,22550432,22807850,lincRNA,1,257418,chr5_22550432_22807850
A930003O13Rik,5,22738910,22746907,lincRNA,-1,7997,chr5_22738910_22746907
Lhfpl3,5,22746059,23275597,protein_coding,1,529538,chr5_22746059_23275597
Gm42948,5,23200920,23223796,antisense,-1,22876,chr5_23200920_23223796
Gm42951,5,23330370,23347274,lincRNA,-1,16904,chr5_23330370_23347274
5031425E22Rik,5,23382308,23434269,lincRNA,-1,51961,chr5_23382308_23434269
4930580E04Rik,5,23387109,23388601,lincRNA,1,1492,chr5_23387109_23388601
Kmt2e,5,23434441,23504235,protein_coding,1,69794,chr5_23434441_23504235
Srpk2,5,23503264,23684617,protein_coding,-1,181353,chr5_23503264_23684617
Pus7,5,23740648,23783711,protein_coding,-1,43063,chr5_23740648_23783711
Rint1,5,23787711,23820369,protein_coding,1,32658,chr5_23787711_23820369
Tomm7,5,23838944,23844161,protein_coding,-1,5217,chr5_23838944_23844161
2700038G22Rik,5,23850597,23855038,lincRNA,1,4441,chr5_23850597_23855038
Fam126a,5,23915276,24030690,protein_coding,-1,115414,chr5_23915276_24030690
Klhl7,5,24100605,24160792,protein_coding,1,60187,chr5_24100605_24160792
Nupl2,5,24164963,24184013,protein_coding,1,19050,chr5_24164963_24184013
Kcnh2,5,24319589,24351604,protein_coding,-1,32015,chr5_24319589_24351604
Nos3,5,24364810,24384474,protein_coding,1,19664,chr5_24364810_24384474
Gm15587,5,24366192,24383614,antisense,-1,17422,chr5_24366192_24383614
Atg9b,5,24384181,24392143,protein_coding,-1,7962,chr5_24384181_24392143
Abcb8,5,24393663,24410054,protein_coding,1,16391,chr5_24393663_24410054
Asic3,5,24413392,24417835,protein_coding,1,4443,chr5_24413392_24417835
Cdk5,5,24418241,24423530,protein_coding,-1,5289,chr5_24418241_24423530
Slc4a2,5,24423837,24440950,protein_coding,1,17113,chr5_24423837_24440950
Fastk,5,24438440,24445287,protein_coding,-1,6847,chr5_24438440_24445287
Tmub1,5,24445458,24447854,protein_coding,-1,2396,chr5_24445458_24447854
2310074N15Rik,5,24447908,24448489,lincRNA,1,581,chr5_24447908_24448489
Agap3,5,24452177,24502047,protein_coding,1,49870,chr5_24452177_24502047
Gbx1,5,24502757,24527202,protein_coding,-1,24445,chr5_24502757_24527202
Asb10,5,24532697,24540978,protein_coding,-1,8281,chr5_24532697_24540978
Abcf2,5,24565345,24577467,protein_coding,-1,12122,chr5_24565345_24577467
Chpf2,5,24586741,24594556,protein_coding,1,7815,chr5_24586741_24594556
Smarcd3,5,24590818,24624411,protein_coding,-1,33593,chr5_24590818_24624411
Nub1,5,24685532,24710378,protein_coding,1,24846,chr5_24685532_24710378
Gm26648,5,24696902,24704690,antisense,-1,7788,chr5_24696902_24704690
Wdr86,5,24711738,24730727,protein_coding,-1,18989,chr5_24711738_24730727
Crygn,5,24751003,24758008,protein_coding,-1,7005,chr5_24751003_24758008
Rheb,5,24802823,24842624,protein_coding,-1,39801,chr5_24802823_24842624
Prkag2,5,24862744,25100642,protein_coding,-1,237898,chr5_24862744_25100642
Prkag2os2,5,24873544,24875934,antisense,1,2390,chr5_24873544_24875934
Prkag2os1,5,24902569,24906850,antisense,1,4281,chr5_24902569_24906850
1500035N22Rik,5,24985842,24998168,lincRNA,1,12326,chr5_24985842_24998168
Galntl5,5,25181460,25220297,protein_coding,1,38837,chr5_25181460_25220297
Galnt11,5,25221904,25265918,protein_coding,1,44014,chr5_25221904_25265918
E130116L18Rik,5,25222848,25223153,protein_coding,-1,305,chr5_25222848_25223153
Kmt2c,5,25271798,25498783,protein_coding,-1,226985,chr5_25271798_25498783
Cct8l1,5,25516067,25518027,protein_coding,1,1960,chr5_25516067_25518027
1700096K18Rik,5,25530013,25531466,lincRNA,1,1453,chr5_25530013_25531466
Gm10062,5,25659806,25661282,lincRNA,-1,1476,chr5_25659806_25661282
Gm43972,5,25659809,25661275,lincRNA,1,1466,chr5_25659809_25661275
Xrcc2,5,25689812,25705825,protein_coding,-1,16013,chr5_25689812_25705825
Actr3b,5,25759997,25850688,protein_coding,1,90691,chr5_25759997_25850688
Gm21663,5,25935791,25942381,protein_coding,-1,6590,chr5_25935791_25942381
Gm21671,5,25948253,25954417,protein_coding,-1,6164,chr5_25948253_25954417
Gm21680,5,25965961,25972663,protein_coding,-1,6702,chr5_25965961_25972663
Gm21698,5,25982030,25988650,protein_coding,-1,6620,chr5_25982030_25988650
Gm1979,5,25999022,26004798,protein_coding,-1,5776,chr5_25999022_26004798
Gm5862,5,26017278,26022916,protein_coding,-1,5638,chr5_26017278_26022916
Speer4a,5,26032846,26039558,protein_coding,-1,6712,chr5_26032846_26039558
Gm7347,5,26051883,26058581,protein_coding,-1,6698,chr5_26051883_26058581
Gm10471,5,26082574,26089291,protein_coding,-1,6717,chr5_26082574_26089291
5031410I06Rik,5,26098668,26105362,protein_coding,-1,6694,chr5_26098668_26105362
Gm10220,5,26114764,26121421,protein_coding,-1,6657,chr5_26114764_26121421
Gm7361,5,26257691,26264308,protein_coding,1,6617,chr5_26257691_26264308
4930584F24Rik,5,26460070,26493314,lincRNA,-1,33244,chr5_26460070_26493314
Dpp6,5,26817203,27727505,protein_coding,1,910302,chr5_26817203_27727505
Speer4b,5,27495639,27501438,protein_coding,-1,5799,chr5_27495639_27501438
Gm16058,5,27552551,27553875,antisense,-1,1324,chr5_27552551_27553875
Paxip1,5,27740080,27791691,protein_coding,-1,51611,chr5_27740080_27791691
Htr5a,5,27842149,27855088,protein_coding,1,12939,chr5_27842149_27855088
Gm26608,5,28019465,28071105,lincRNA,-1,51640,chr5_28019465_28071105
Insig1,5,28071363,28078662,protein_coding,1,7299,chr5_28071363_28078662
En2,5,28165694,28172166,protein_coding,1,6472,chr5_28165694_28172166
Cnpy1,5,28200819,28245806,protein_coding,-1,44987,chr5_28200819_28245806
Rbm33,5,28317121,28419239,protein_coding,1,102118,chr5_28317121_28419239
Shh,5,28456815,28467256,protein_coding,-1,10441,chr5_28456815_28467256
9530036O11Rik,5,28458274,28933995,antisense,1,475721,chr5_28458274_28933995
Rnf32,5,29195992,29228457,protein_coding,1,32465,chr5_29195992_29228457
Lmbr1,5,29229802,29378390,protein_coding,-1,148588,chr5_29229802_29378390
4632411P08Rik,5,29378699,29390488,lincRNA,1,11789,chr5_29378699_29390488
Nom1,5,29434664,29457843,protein_coding,1,23179,chr5_29434664_29457843
Mnx1,5,29473034,29478470,protein_coding,-1,5436,chr5_29473034_29478470
Ube3c,5,29569242,29676092,protein_coding,1,106850,chr5_29569242_29676092
Gm5129,5,29735334,29735936,antisense,-1,602,chr5_29735334_29735936
Dnajb6,5,29735688,29818134,protein_coding,1,82446,chr5_29735688_29818134
Gm42450,5,29886728,29891964,lincRNA,-1,5236,chr5_29886728_29891964
A230098N10Rik,5,29996141,30008798,lincRNA,-1,12657,chr5_29996141_30008798
Il6,5,30013114,30019981,protein_coding,1,6867,chr5_30013114_30019981
Tyms,5,30058202,30073617,protein_coding,-1,15415,chr5_30058202_30073617
Gm4961,5,30092940,30097686,lincRNA,1,4746,chr5_30092940_30097686
3110082J24Rik,5,30103584,30106086,protein_coding,-1,2502,chr5_30103584_30106086
Garem2,5,30105161,30118378,protein_coding,1,13217,chr5_30105161_30118378
Hadha,5,30118304,30155162,protein_coding,-1,36858,chr5_30118304_30155162
Hadhb,5,30155248,30184593,protein_coding,1,29345,chr5_30155248_30184593
Adgrf3,5,30193431,30205722,protein_coding,-1,12291,chr5_30193431_30205722
Selenoi,5,30232581,30272427,protein_coding,1,39846,chr5_30232581_30272427
Drc1,5,30281388,30366695,protein_coding,1,85307,chr5_30281388_30366695
Otof,5,30367062,30461932,protein_coding,-1,94870,chr5_30367062_30461932
Cib4,5,30485583,30545836,protein_coding,-1,60253,chr5_30485583_30545836
Gm42765,5,30529457,30543830,antisense,1,14373,chr5_30529457_30543830
Kcnk3,5,30588170,30625271,protein_coding,1,37101,chr5_30588170_30625271
Slc35f6,5,30647933,30659729,protein_coding,1,11796,chr5_30647933_30659729
Cenpa,5,30666777,30674830,protein_coding,1,8053,chr5_30666777_30674830
Dpysl5,5,30711564,30799375,protein_coding,1,87811,chr5_30711564_30799375
Mapre3,5,30814641,30866106,protein_coding,1,51465,chr5_30814641_30866106
Gm15461,5,30817977,30822612,antisense,-1,4635,chr5_30817977_30822612
Tmem214,5,30868012,30879180,protein_coding,1,11168,chr5_30868012_30879180
Agbl5,5,30888694,30906965,protein_coding,1,18271,chr5_30888694_30906965
Ost4,5,30905885,30907788,protein_coding,-1,1903,chr5_30905885_30907788
Emilin1,5,30913402,30921277,protein_coding,1,7875,chr5_30913402_30921277
Khk,5,30921431,30931248,protein_coding,1,9817,chr5_30921431_30931248
Cgref1,5,30933143,30945591,protein_coding,-1,12448,chr5_30933143_30945591
Preb,5,30950853,30960361,protein_coding,-1,9508,chr5_30950853_30960361
Tcf23,5,30968662,30977018,protein_coding,1,8356,chr5_30968662_30977018
Slc5a6,5,31036036,31048924,protein_coding,-1,12888,chr5_31036036_31048924
Atraid,5,31048312,31054623,protein_coding,1,6311,chr5_31048312_31054623
Cad,5,31054780,31078479,protein_coding,1,23699,chr5_31054780_31078479
Slc30a3,5,31086106,31108237,protein_coding,-1,22131,chr5_31086106_31108237
Dnajc5g,5,31106285,31112526,protein_coding,1,6241,chr5_31106285_31112526
Trim54,5,31116712,31137630,protein_coding,1,20918,chr5_31116712_31137630
Gm15469,5,31135753,31137344,antisense,-1,1591,chr5_31135753_31137344
Ucn,5,31138063,31138829,protein_coding,-1,766,chr5_31138063_31138829
Mpv17,5,31140654,31154251,protein_coding,-1,13597,chr5_31140654_31154251
Gm29609,5,31144739,31179911,protein_coding,-1,35172,chr5_31144739_31179911
Gtf3c2,5,31156005,31180144,protein_coding,-1,24139,chr5_31156005_31180144
Eif2b4,5,31187558,31193430,protein_coding,-1,5872,chr5_31187558_31193430
Snx17,5,31193227,31199143,protein_coding,1,5916,chr5_31193227_31199143
Zfp513,5,31198981,31202303,protein_coding,-1,3322,chr5_31198981_31202303
Ppm1g,5,31202664,31220687,protein_coding,-1,18023,chr5_31202664_31220687
Gm9970,5,31240466,31241232,antisense,-1,766,chr5_31240466_31241232
Nrbp1,5,31240864,31251566,protein_coding,1,10702,chr5_31240864_31251566
Krtcap3,5,31251691,31253202,protein_coding,1,1511,chr5_31251691_31253202
Ift172,5,31253277,31291116,protein_coding,-1,37839,chr5_31253277_31291116
Fndc4,5,31292242,31296080,protein_coding,-1,3838,chr5_31292242_31296080
Gckr,5,31297443,31327314,protein_coding,1,29871,chr5_31297443_31327314
Zfp512,5,31452431,31481754,protein_coding,1,29323,chr5_31452431_31481754
4930548H24Rik,5,31485740,31488476,protein_coding,1,2736,chr5_31485740_31488476
4930566F21Rik,5,31486629,31495179,antisense,-1,8550,chr5_31486629_31495179
Gpn1,5,31494741,31512904,protein_coding,1,18163,chr5_31494741_31512904
Supt7l,5,31514564,31527807,protein_coding,-1,13243,chr5_31514564_31527807
Slc4a1ap,5,31526995,31556932,protein_coding,1,29937,chr5_31526995_31556932
Gm43660,5,31560812,31569072,lincRNA,-1,8260,chr5_31560812_31569072
AI839979,5,31569595,31571397,lincRNA,-1,1802,chr5_31569595_31571397
Mrpl33,5,31596935,31664384,protein_coding,1,67449,chr5_31596935_31664384
Rbks,5,31624439,31697627,protein_coding,-1,73188,chr5_31624439_31697627
Babam2,5,31697684,32084962,protein_coding,1,387278,chr5_31697684_32084962
Gm17130,5,32005977,32010863,antisense,-1,4886,chr5_32005977_32010863
Fosl2,5,32135801,32157842,protein_coding,1,22041,chr5_32135801_32157842
Plb1,5,32232708,32366520,protein_coding,1,133812,chr5_32232708_32366520
Gm36840,5,32320764,32354883,antisense,-1,34119,chr5_32320764_32354883
Gm7596,5,32390047,32397908,lincRNA,-1,7861,chr5_32390047_32397908
Ppp1cb,5,32458843,32517433,protein_coding,1,58590,chr5_32458843_32517433
Gm15614,5,32507184,32651065,antisense,-1,143881,chr5_32507184_32651065
Yes1,5,32611171,32687057,protein_coding,1,75886,chr5_32611171_32687057
Pisd,5,32736301,32785646,protein_coding,-1,49345,chr5_32736301_32785646
Gm20671,5,32737230,32827109,protein_coding,-1,89879,chr5_32737230_32827109
Prr14l,5,32789820,32854256,protein_coding,-1,64436,chr5_32789820_32854256
Depdc5,5,32863701,32994236,protein_coding,1,130535,chr5_32863701_32994236
Ywhah,5,33018816,33027966,protein_coding,1,9150,chr5_33018816_33027966
Slc5a1,5,33104219,33162870,protein_coding,1,58651,chr5_33104219_33162870
Spon2,5,33198184,33218455,protein_coding,-1,20271,chr5_33198184_33218455
Ctbp1,5,33247723,33274994,protein_coding,-1,27271,chr5_33247723_33274994
Gm20465,5,33293614,33311150,lincRNA,-1,17536,chr5_33293614_33311150
Maea,5,33335509,33373296,protein_coding,1,37787,chr5_33335509_33373296
Uvssa,5,33378549,33419754,protein_coding,1,41205,chr5_33378549_33419754
Fam53a,5,33600347,33629635,protein_coding,-1,29288,chr5_33600347_33629635
Gm9903,5,33629925,33632092,protein_coding,1,2167,chr5_33629925_33632092
Slbp,5,33634952,33652574,protein_coding,-1,17622,chr5_33634952_33652574
Tmem129,5,33653216,33658416,protein_coding,-1,5200,chr5_33653216_33658416
Tacc3,5,33658128,33678995,protein_coding,1,20867,chr5_33658128_33678995
Fgfr3,5,33721674,33737068,protein_coding,1,15394,chr5_33721674_33737068
Letm1,5,33739673,33782817,protein_coding,-1,43144,chr5_33739673_33782817
Nsd2,5,33820725,33897975,protein_coding,1,77250,chr5_33820725_33897975
Nelfa,5,33897916,33936413,protein_coding,-1,38497,chr5_33897916_33936413
Gm42849,5,33947026,33948832,lincRNA,1,1806,chr5_33947026_33948832
Gm42851,5,33947580,33948990,lincRNA,-1,1410,chr5_33947580_33948990
Gm1673,5,33983433,33985013,protein_coding,1,1580,chr5_33983433_33985013
Nat8l,5,33995984,34005916,protein_coding,1,9932,chr5_33995984_34005916
Poln,5,34007179,34169448,protein_coding,-1,162269,chr5_34007179_34169448
4930557J02Rik,5,34118740,34135339,antisense,1,16599,chr5_34118740_34135339
Haus3,5,34153880,34169527,protein_coding,-1,15647,chr5_34153880_34169527
Mxd4,5,34173883,34187720,protein_coding,-1,13837,chr5_34173883_34187720
Gm42846,5,34173887,34174887,antisense,1,1000,chr5_34173887_34174887
Zfyve28,5,34194893,34288449,protein_coding,-1,93556,chr5_34194893_34288449
Gm42848,5,34221162,34225984,antisense,1,4822,chr5_34221162_34225984
Cfap99,5,34288600,34327327,protein_coding,1,38727,chr5_34288600_34327327
Gm43458,5,34309212,34327530,lincRNA,-1,18318,chr5_34309212_34327530
Rnf4,5,34336289,34355629,protein_coding,1,19340,chr5_34336289_34355629
Fam193a,5,34369933,34486456,protein_coding,1,116523,chr5_34369933_34486456
Tnip2,5,34496087,34513991,protein_coding,-1,17904,chr5_34496087_34513991
Sh3bp2,5,34525838,34563641,protein_coding,1,37803,chr5_34525838_34563641
Add1,5,34573664,34632308,protein_coding,1,58644,chr5_34573664_34632308
Mfsd10,5,34633642,34637212,protein_coding,-1,3570,chr5_34633642_34637212
Nop14,5,34638536,34660148,protein_coding,-1,21612,chr5_34638536_34660148
Gm15522,5,34650718,34652477,antisense,1,1759,chr5_34650718_34652477
Grk4,5,34660379,34755305,protein_coding,1,94926,chr5_34660379_34755305
Gm42560,5,34679523,34706831,antisense,-1,27308,chr5_34679523_34706831
Htt,5,34761740,34912534,protein_coding,1,150794,chr5_34761740_34912534
Msantd1,5,34908012,34923839,protein_coding,1,15827,chr5_34908012_34923839
Rgs12,5,34949445,35039644,protein_coding,1,90199,chr5_34949445_35039644
Gm43791,5,35031870,35033445,antisense,-1,1575,chr5_35031870_35033445
Hgfac,5,35041509,35048461,protein_coding,1,6952,chr5_35041509_35048461
Dok7,5,35056766,35087839,protein_coding,1,31073,chr5_35056766_35087839
Lrpap1,5,35091501,35105766,protein_coding,-1,14265,chr5_35091501_35105766
Adra2c,5,35278319,35281763,protein_coding,1,3444,chr5_35278319_35281763
4930478P22Rik,5,35361541,35367677,lincRNA,1,6136,chr5_35361541_35367677
Cpz,5,35502218,35525698,protein_coding,-1,23480,chr5_35502218_35525698
Trmt44,5,35556203,35575070,protein_coding,-1,18867,chr5_35556203_35575070
4931431C16Rik,5,35581227,35588763,antisense,-1,7536,chr5_35581227_35588763
Acox3,5,35583040,35615352,protein_coding,1,32312,chr5_35583040_35615352
Htra3,5,35652023,35679782,protein_coding,-1,27759,chr5_35652023_35679782
Sh3tc1,5,35697180,35739987,protein_coding,-1,42807,chr5_35697180_35739987
Ablim2,5,35757880,35884973,protein_coding,1,127093,chr5_35757880_35884973
Afap1,5,35893319,36003923,protein_coding,1,110604,chr5_35893319_36003923
Sorcs2,5,36017180,36398139,protein_coding,-1,380959,chr5_36017180_36398139
Psapl1,5,36204021,36206568,protein_coding,1,2547,chr5_36204021_36206568
2210406O10Rik,5,36447611,36464853,lincRNA,-1,17242,chr5_36447611_36464853
Grpel1,5,36464998,36474080,protein_coding,1,9082,chr5_36464998_36474080
Tada2b,5,36473670,36484285,protein_coding,-1,10615,chr5_36473670_36484285
Ccdc96,5,36484588,36488172,protein_coding,1,3584,chr5_36484588_36488172
Tbc1d14,5,36490604,36593276,protein_coding,-1,102672,chr5_36490604_36593276
D5Ertd579e,5,36600485,36696024,protein_coding,-1,95539,chr5_36600485_36696024
Bloc1s4,5,36747378,36748650,protein_coding,-1,1272,chr5_36747378_36748650
Gm43701,5,36748618,36750437,antisense,1,1819,chr5_36748618_36750437
Mrfap1,5,36794867,36796772,protein_coding,-1,1905,chr5_36794867_36796772
Man2b2,5,36806921,36830653,protein_coding,-1,23732,chr5_36806921_36830653
Ppp2r2c,5,36868513,36955078,protein_coding,1,86565,chr5_36868513_36955078
Ppp2r2cos,5,36873595,36876879,antisense,-1,3284,chr5_36873595_36876879
Wfs1,5,36966104,36989205,protein_coding,-1,23101,chr5_36966104_36989205
Jakmip1,5,37028335,37150607,protein_coding,1,122272,chr5_37028335_37150607
Gm26647,5,37038164,37041646,antisense,-1,3482,chr5_37038164_37041646
Crmp1,5,37241940,37292133,protein_coding,1,50193,chr5_37241940_37292133
Evc,5,37289098,37336894,protein_coding,-1,47796,chr5_37289098_37336894
Evc2,5,37338499,37425055,protein_coding,1,86556,chr5_37338499_37425055
Stk32b,5,37446825,37717171,protein_coding,-1,270346,chr5_37446825_37717171
Cytl1,5,37735519,37739820,protein_coding,1,4301,chr5_37735519_37739820
Msx1,5,37820485,37824583,protein_coding,-1,4098,chr5_37820485_37824583
Stx18,5,38038742,38137765,protein_coding,1,99023,chr5_38038742_38137765
Nsg1,5,38137192,38159907,protein_coding,-1,22715,chr5_38137192_38159907
Zbtb49,5,38189735,38220457,protein_coding,-1,30722,chr5_38189735_38220457
Lyar,5,38220470,38234306,protein_coding,1,13836,chr5_38220470_38234306
Tmem128,5,38260185,38269634,protein_coding,1,9449,chr5_38260185_38269634
Gm26560,5,38317333,38320897,antisense,-1,3564,chr5_38317333_38320897
Drd5,5,38319367,38322518,protein_coding,1,3151,chr5_38319367_38322518
4930487D11Rik,5,38344435,38349197,lincRNA,1,4762,chr5_38344435_38349197
Slc2a9,5,38349273,38503143,protein_coding,-1,153870,chr5_38349273_38503143
Wdr1,5,38526813,38563221,protein_coding,-1,36408,chr5_38526813_38563221
Zfp518b,5,38668484,38684826,protein_coding,-1,16342,chr5_38668484_38684826
Clnk,5,38706462,38876812,protein_coding,-1,170350,chr5_38706462_38876812
Clnkos,5,38735983,38747897,antisense,1,11914,chr5_38735983_38747897
Gm40293,5,39253950,39307084,lincRNA,-1,53134,chr5_39253950_39307084
Gm40292,5,39307120,39313295,lincRNA,1,6175,chr5_39307120_39313295
Gm42524,5,39458097,39477679,lincRNA,1,19582,chr5_39458097_39477679
4930513D17Rik,5,39461749,39603574,lincRNA,-1,141825,chr5_39461749_39603574
Hs3st1,5,39613935,39755475,protein_coding,-1,141540,chr5_39613935_39755475
Gm35191,5,39975671,39985628,lincRNA,-1,9957,chr5_39975671_39985628
Rab28,5,41624976,41708157,protein_coding,-1,83181,chr5_41624976_41708157
Bod1l,5,41787538,41844315,protein_coding,-1,56777,chr5_41787538_41844315
Gm16223,5,42067960,42216798,protein_coding,1,148838,chr5_42067960_42216798
Gm43700,5,43026548,43038236,lincRNA,-1,11688,chr5_43026548_43038236
Gm42711,5,43039737,43044061,lincRNA,-1,4324,chr5_43039737_43044061
Gm7854,5,43151686,43235355,antisense,-1,83669,chr5_43151686_43235355
Cpeb2,5,43233170,43289724,protein_coding,1,56554,chr5_43233170_43289724
Gm43020,5,43353047,43355259,lincRNA,-1,2212,chr5_43353047_43355259
Gm43699,5,43376447,43379637,lincRNA,1,3190,chr5_43376447_43379637
C1qtnf7,5,43515538,43618803,protein_coding,1,103265,chr5_43515538_43618803
Gm15866,5,43549928,43601731,antisense,-1,51803,chr5_43549928_43601731
Cc2d2a,5,43662346,43740972,protein_coding,1,78626,chr5_43662346_43740972
Fbxl5,5,43744615,43821638,protein_coding,-1,77023,chr5_43744615_43821638
Bst1,5,43818885,43843986,protein_coding,1,25101,chr5_43818885_43843986
Cd38,5,43868553,43912375,protein_coding,1,43822,chr5_43868553_43912375
Gm7879,5,43913144,43913917,protein_coding,1,773,chr5_43913144_43913917
Fgfbp1,5,43978858,43981779,protein_coding,-1,2921,chr5_43978858_43981779
Prom1,5,43993620,44102032,protein_coding,-1,108412,chr5_43993620_44102032
Gm16401,5,44100442,44102515,antisense,1,2073,chr5_44100442_44102515
Tapt1,5,44175154,44226626,protein_coding,-1,51472,chr5_44175154_44226626
Gm42982,5,44219683,44224003,antisense,1,4320,chr5_44219683_44224003
Gm42984,5,44226587,44243548,antisense,1,16961,chr5_44226587_44243548
Gm36017,5,44412793,44427592,lincRNA,-1,14799,chr5_44412793_44427592
Ldb2,5,44472132,44799680,protein_coding,-1,327548,chr5_44472132_44799680
Gm43507,5,44641484,44662153,antisense,1,20669,chr5_44641484_44662153
Gm42750,5,44865149,44877138,lincRNA,1,11989,chr5_44865149_44877138
4930431F12Rik,5,44966200,44978805,lincRNA,1,12605,chr5_44966200_44978805
D5Ertd615e,5,45009171,45424402,lincRNA,-1,415231,chr5_45009171_45424402
Qdpr,5,45434021,45450236,protein_coding,-1,16215,chr5_45434021_45450236
Gm42413,5,45434389,45450138,antisense,1,15749,chr5_45434389_45450138
Clrn2,5,45453751,45464149,protein_coding,1,10398,chr5_45453751_45464149
Lap3,5,45493374,45512691,protein_coding,1,19317,chr5_45493374_45512691
Med28,5,45520229,45529276,protein_coding,1,9047,chr5_45520229_45529276
Fam184b,5,45529705,45639614,protein_coding,-1,109909,chr5_45529705_45639614
9630001P10Rik,5,45638699,45645469,antisense,1,6770,chr5_45638699_45645469
Ncapg,5,45669919,45700546,protein_coding,1,30627,chr5_45669919_45700546
Lcorl,5,45697181,45857615,protein_coding,-1,160434,chr5_45697181_45857615
Slit2,5,47983138,48307733,protein_coding,1,324595,chr5_47983138_48307733
4930518C09Rik,5,48003065,48005707,antisense,-1,2642,chr5_48003065_48005707
5730480H06Rik,5,48327952,48414294,protein_coding,1,86342,chr5_48327952_48414294
Kcnip4,5,48389502,49524907,protein_coding,-1,1135405,chr5_48389502_49524907
Gm20700,5,48590889,48599994,antisense,1,9105,chr5_48590889_48599994
Adgra3,5,49959956,50059006,protein_coding,-1,99050,chr5_49959956_50059006
4930448I18Rik,5,50151333,50156095,lincRNA,1,4762,chr5_50151333_50156095
Gm43016,5,50543642,50689221,lincRNA,1,145579,chr5_50543642_50689221
Ppargc1a,5,51454250,51567726,protein_coding,-1,113476,chr5_51454250_51567726
Gm43177,5,52117312,52118523,lincRNA,1,1211,chr5_52117312_52118523
Dhx15,5,52150203,52190514,protein_coding,-1,40311,chr5_52150203_52190514
C130083M11Rik,5,52199984,52216434,lincRNA,-1,16450,chr5_52199984_52216434
Sod3,5,52363791,52371418,protein_coding,1,7627,chr5_52363791_52371418
Ccdc149,5,52374651,52471521,protein_coding,-1,96870,chr5_52374651_52471521
Gm3519,5,52441159,52443252,antisense,1,2093,chr5_52441159_52443252
Lgi2,5,52533517,52566462,protein_coding,-1,32945,chr5_52533517_52566462
Gm43685,5,52538831,52540079,antisense,1,1248,chr5_52538831_52540079
8030423F21Rik,5,52607550,52619012,lincRNA,-1,11462,chr5_52607550_52619012
Sepsecs,5,52640087,52669708,protein_coding,-1,29621,chr5_52640087_52669708
Pi4k2b,5,52741574,52769340,protein_coding,1,27766,chr5_52741574_52769340
Zcchc4,5,52775409,52824665,protein_coding,1,49256,chr5_52775409_52824665
Anapc4,5,52834012,52867797,protein_coding,1,33785,chr5_52834012_52867797
Gm30301,5,52982037,52995753,lincRNA,1,13716,chr5_52982037_52995753
Slc34a2,5,53038081,53071664,protein_coding,1,33583,chr5_53038081_53071664
Sel1l3,5,53107083,53213927,protein_coding,-1,106844,chr5_53107083_53213927
Smim20,5,53267083,53278540,protein_coding,1,11457,chr5_53267083_53278540
Gm45495,5,53281810,53283509,lincRNA,1,1699,chr5_53281810_53283509
Gm42745,5,53360656,53371774,lincRNA,-1,11118,chr5_53360656_53371774
Rbpj,5,53466152,53657362,protein_coding,1,191210,chr5_53466152_53657362
Gm10441,5,53519260,53522731,antisense,-1,3471,chr5_53519260_53522731
Gm40304,5,53546351,53547322,antisense,-1,971,chr5_53546351_53547322
Cckar,5,53697776,53707705,protein_coding,-1,9929,chr5_53697776_53707705
Tbc1d19,5,53809606,53903965,protein_coding,1,94359,chr5_53809606_53903965
Stim2,5,53998499,54121057,protein_coding,1,122558,chr5_53998499_54121057
Gm10440,5,54349991,54358543,lincRNA,1,8552,chr5_54349991_54358543
Pcdh7,5,57717967,58133230,protein_coding,1,415263,chr5_57717967_58133230
4930459L07Rik,5,58443239,58452999,lincRNA,-1,9760,chr5_58443239_58452999
Gm43042,5,59569702,59574242,lincRNA,-1,4540,chr5_59569702_59574242
4933402J10Rik,5,59963119,59986004,lincRNA,-1,22885,chr5_59963119_59986004
Arap2,5,62602445,62766159,protein_coding,-1,163714,chr5_62602445_62766159
Dthd1,5,62811674,62888308,protein_coding,1,76634,chr5_62811674_62888308
Nwd2,5,63649102,63810546,protein_coding,1,161444,chr5_63649102_63810546
0610040J01Rik,5,63812363,63899625,protein_coding,1,87262,chr5_63812363_63899625
Rell1,5,63908897,63968897,protein_coding,-1,60000,chr5_63908897_63968897
5830416I19Rik,5,64044978,64050228,lincRNA,1,5250,chr5_64044978_64050228
Pgm1,4,99898374,99987294,protein_coding,1,88920,chr4_99898374_99987294
Tbc1d1,5,64156305,64351486,protein_coding,1,195181,chr5_64156305_64351486
Gm43838,5,64360514,64363631,lincRNA,1,3117,chr5_64360514_64363631
Gm43837,5,64383454,64386205,lincRNA,1,2751,chr5_64383454_64386205
Gm31363,5,64433955,64473588,lincRNA,1,39633,chr5_64433955_64473588
1700027F09Rik,5,64454813,64467943,lincRNA,-1,13130,chr5_64454813_64467943
C030018K13Rik,5,64477008,64483967,lincRNA,1,6959,chr5_64477008_64483967
Gm3716,5,64593857,64610700,lincRNA,-1,16843,chr5_64593857_64610700
Gm42564,5,64635361,64637388,lincRNA,-1,2027,chr5_64635361_64637388
Gm26761,5,64695461,64698521,lincRNA,-1,3060,chr5_64695461_64698521
Klf3,5,64803388,64832901,protein_coding,1,29513,chr5_64803388_64832901
Tlr1,5,64924679,64933563,protein_coding,-1,8884,chr5_64924679_64933563
Fam114a1,5,64970071,65041886,protein_coding,1,71815,chr5_64970071_65041886
Tmem156,5,65054346,65092132,protein_coding,-1,37786,chr5_65054346_65092132
Klhl5,5,65107539,65168188,protein_coding,1,60649,chr5_65107539_65168188
Wdr19,5,65199696,65260415,protein_coding,1,60719,chr5_65199696_65260415
Rfc1,5,65261850,65335670,protein_coding,-1,73820,chr5_65261850_65335670
Klb,5,65348314,65384007,protein_coding,1,35693,chr5_65348314_65384007
Rpl9,5,65388364,65391444,protein_coding,-1,3080,chr5_65388364_65391444
Lias,5,65391497,65410693,protein_coding,1,19196,chr5_65391497_65410693
Ugdh,5,65413221,65435949,protein_coding,-1,22728,chr5_65413221_65435949
Gm43552,5,65427427,65492833,protein_coding,-1,65406,chr5_65427427_65492833
Smim14,5,65446844,65537184,protein_coding,-1,90340,chr5_65446844_65537184
Ube2k,5,65537233,65598988,protein_coding,1,61755,chr5_65537233_65598988
Gm42726,5,65587716,65591440,antisense,-1,3724,chr5_65587716_65591440
Pds5a,5,65605721,65698273,protein_coding,-1,92552,chr5_65605721_65698273
N4bp2,5,65763521,65830108,protein_coding,1,66587,chr5_65763521_65830108
Rhoh,5,65861213,65896700,protein_coding,1,35487,chr5_65861213_65896700
Chrna9,5,65934921,65977326,protein_coding,1,42405,chr5_65934921_65977326
9130230L23Rik,5,65979358,66004285,protein_coding,-1,24927,chr5_65979358_66004285
Rbm47,5,66016549,66173118,protein_coding,-1,156569,chr5_66016549_66173118
Gm26725,5,66151212,66174945,antisense,1,23733,chr5_66151212_66174945
1700126H18Rik,5,66166607,66191336,antisense,-1,24729,chr5_66166607_66191336
Nsun7,5,66259897,66298026,protein_coding,1,38129,chr5_66259897_66298026
Apbb2,5,66298703,66618784,protein_coding,-1,320081,chr5_66298703_66618784
Uchl1os,5,66626495,66676498,antisense,-1,50003,chr5_66626495_66676498
Uchl1,5,66676091,66687234,protein_coding,1,11143,chr5_66676091_66687234
Limch1,5,66745827,67057158,protein_coding,1,311331,chr5_66745827_67057158
Gm15949,5,66985091,66985641,antisense,-1,550,chr5_66985091_66985641
Gm15948,5,66988816,66991207,antisense,-1,2391,chr5_66988816_66991207
Phox2b,5,67094399,67099301,protein_coding,-1,4902,chr5_67094399_67099301
Gm42670,5,67259971,67261262,antisense,-1,1291,chr5_67259971_67261262
Tmem33,5,67260565,67291461,protein_coding,1,30896,chr5_67260565_67291461
Slc30a9,5,67306955,67358443,protein_coding,1,51488,chr5_67306955_67358443
Gm43698,5,67360387,67366599,lincRNA,1,6212,chr5_67360387_67366599
Bend4,5,67392147,67428310,protein_coding,-1,36163,chr5_67392147_67428310
Gm26756,5,67427680,67437990,antisense,1,10310,chr5_67427680_67437990
Shisa3,5,67607882,67623552,protein_coding,1,15670,chr5_67607882_67623552
Atp8a1,5,67618140,67847434,protein_coding,-1,229294,chr5_67618140_67847434
Gm15478,5,67642401,67646776,antisense,1,4375,chr5_67642401_67646776
Gm15477,5,67847065,67909013,antisense,1,61948,chr5_67847065_67909013
Gm21905,5,67927261,67946421,protein_coding,-1,19160,chr5_67927261_67946421
Gm5108,5,67941669,67977070,protein_coding,1,35401,chr5_67941669_67977070
Grxcr1,5,68031835,68166398,protein_coding,1,134563,chr5_68031835_68166398
Kctd8,5,69109285,69341679,protein_coding,-1,232394,chr5_69109285_69341679
Yipf7,5,69516671,69542648,protein_coding,-1,25977,chr5_69516671_69542648
Guf1,5,69556923,69575973,protein_coding,1,19050,chr5_69556923_69575973
Gnpda2,5,69573108,69592340,protein_coding,-1,19232,chr5_69573108_69592340
Gabrg1,5,70751047,70842617,protein_coding,-1,91570,chr5_70751047_70842617
Gabra2,5,70957597,71095849,protein_coding,-1,138252,chr5_70957597_71095849
Cox7b2,5,71442824,71548205,protein_coding,-1,105381,chr5_71442824_71548205
Gabra4,5,71569749,71658308,protein_coding,-1,88559,chr5_71569749_71658308
Gabrb1,5,71658113,72149037,protein_coding,1,490924,chr5_71658113_72149037
Gm38562,5,71680268,71699824,antisense,-1,19556,chr5_71680268_71699824
Commd8,5,72156575,72168189,protein_coding,-1,11614,chr5_72156575_72168189
Corin,5,72300025,72504473,protein_coding,-1,204448,chr5_72300025_72504473
Gm20647,5,72316354,72368048,antisense,1,51694,chr5_72316354_72368048
Nfxl1,5,72513301,72559684,protein_coding,-1,46383,chr5_72513301_72559684
Zar1,5,72576806,72581254,protein_coding,-1,4448,chr5_72576806_72581254
Cnga1,5,72603696,72644275,protein_coding,-1,40579,chr5_72603696_72644275
Nipal1,5,72647795,72671078,protein_coding,1,23283,chr5_72647795_72671078
Txk,5,72695978,72752777,protein_coding,-1,56799,chr5_72695978_72752777
Tec,5,72755716,72868483,protein_coding,-1,112767,chr5_72755716_72868483
Slain2,5,72914304,72978829,protein_coding,1,64525,chr5_72914304_72978829
Gm10135,5,72965808,72974702,protein_coding,-1,8894,chr5_72965808_72974702
Slc10a4,5,73006883,73012955,protein_coding,1,6072,chr5_73006883_73012955
Fryl,5,73019987,73256619,protein_coding,-1,236632,chr5_73019987_73256619
1700071G01Rik,5,73157014,73157884,antisense,1,870,chr5_73157014_73157884
Gm34411,5,73263429,73268986,lincRNA,1,5557,chr5_73263429_73268986
1700025M24Rik,5,73268581,73284187,lincRNA,-1,15606,chr5_73268581_73284187
Ociad1,5,73292784,73314069,protein_coding,1,21285,chr5_73292784_73314069
Ociad2,5,73322199,73341028,protein_coding,-1,18829,chr5_73322199_73341028
Cwh43,5,73406075,73453435,protein_coding,1,47360,chr5_73406075_73453435
Dcun1d4,5,73481000,73560794,protein_coding,1,79794,chr5_73481000_73560794
Lrrc66,5,73606642,73632526,protein_coding,-1,25884,chr5_73606642_73632526
Sgcb,5,73632749,73647790,protein_coding,-1,15041,chr5_73632749_73647790
Spata18,5,73651379,73679512,protein_coding,1,28133,chr5_73651379_73679512
1700019F05Rik,5,73912896,73920421,lincRNA,1,7525,chr5_73912896_73920421
C78283,5,73946381,73948376,lincRNA,1,1995,chr5_73946381_73948376
Usp46,5,73998453,74068431,protein_coding,-1,69978,chr5_73998453_74068431
Usp46os1,5,74014215,74029680,antisense,1,15465,chr5_74014215_74029680
Rasl11b,5,74195286,74199481,protein_coding,1,4195,chr5_74195286_74199481
Scfd2,5,74204816,74531759,protein_coding,-1,326943,chr5_74204816_74531759
Fip1l1,5,74535449,74598800,protein_coding,1,63351,chr5_74535449_74598800
Lnx1,5,74592447,74702912,protein_coding,-1,110465,chr5_74592447_74702912
Gm15984,5,74702598,74728605,antisense,1,26007,chr5_74702598_74728605
Gm15985,5,74731516,74734451,lincRNA,-1,2935,chr5_74731516_74734451
Gm6116,5,74949190,74966368,lincRNA,1,17178,chr5_74949190_74966368
Chic2,5,74997988,75044774,protein_coding,-1,46786,chr5_74997988_75044774
Gsx2,5,75075601,75077893,protein_coding,1,2292,chr5_75075601_75077893
Gm19583,5,75110321,75147107,lincRNA,1,36786,chr5_75110321_75147107
Pdgfra,5,75152292,75198215,protein_coding,1,45923,chr5_75152292_75198215
Gm42800,5,75387775,75399372,lincRNA,-1,11597,chr5_75387775_75399372
Kit,5,75574916,75656722,protein_coding,1,81806,chr5_75574916_75656722
Gm43101,5,75727605,75735967,lincRNA,1,8362,chr5_75727605_75735967
Gm19590,5,75833035,75835645,lincRNA,-1,2610,chr5_75833035_75835645
Gm28865,5,75849238,75852958,lincRNA,-1,3720,chr5_75849238_75852958
Kdr,5,75932827,75978458,protein_coding,-1,45631,chr5_75932827_75978458
Gm32780,5,76043098,76055899,lincRNA,1,12801,chr5_76043098_76055899
Srd5a3,5,76140271,76155504,protein_coding,1,15233,chr5_76140271_76155504
Tmem165,5,76183880,76209245,protein_coding,1,25365,chr5_76183880_76209245
Clock,5,76209868,76304792,protein_coding,-1,94924,chr5_76209868_76304792
Gm7467,5,76304876,76305527,antisense,1,651,chr5_76304876_76305527
Pdcl2,5,76312115,76331156,protein_coding,-1,19041,chr5_76312115_76331156
Nmu,5,76333495,76363788,protein_coding,-1,30293,chr5_76333495_76363788
Gm7271,5,76484040,76516649,protein_coding,1,32609,chr5_76484040_76516649
Exoc1,5,76529311,76570294,protein_coding,1,40983,chr5_76529311_76570294
Cep135,5,76588698,76646466,protein_coding,1,57768,chr5_76588698_76646466
C530008M17Rik,5,76656512,76873554,protein_coding,1,217042,chr5_76656512_76873554
Aasdh,5,76873659,76905514,protein_coding,-1,31855,chr5_76873659_76905514
Ppat,5,76913249,76951578,protein_coding,-1,38329,chr5_76913249_76951578
2310040G07Rik,5,76928372,76947758,transcribed_unprocessed_pseudogene,1,19386,chr5_76928372_76947758
Paics,5,76951307,76967509,protein_coding,1,16202,chr5_76951307_76967509
Srp72,5,76974683,76999937,protein_coding,1,25254,chr5_76974683_76999937
Arl9,5,77004055,77010606,protein_coding,1,6551,chr5_77004055_77010606
1700112J05Rik,5,77006449,77018863,lincRNA,-1,12414,chr5_77006449_77018863
Thegl,5,77016023,77061529,protein_coding,1,45506,chr5_77016023_77061529
Hopx,5,77086988,77115121,protein_coding,-1,28133,chr5_77086988_77115121
Hopxos,5,77094532,77102303,antisense,1,7771,chr5_77094532_77102303
Gm15831,5,77116810,77122348,lincRNA,-1,5538,chr5_77116810_77122348
Spink2,5,77205107,77211471,protein_coding,-1,6364,chr5_77205107_77211471
Rest,5,77265491,77286432,protein_coding,1,20941,chr5_77265491_77286432
Noa1,5,77294182,77310084,protein_coding,-1,15902,chr5_77294182_77310084
Polr2b,5,77310147,77349324,protein_coding,1,39177,chr5_77310147_77349324
Igfbp7,5,77349240,77408041,protein_coding,-1,58801,chr5_77349240_77408041
Gm34648,5,77386599,77393683,antisense,1,7084,chr5_77386599_77393683
Gm34728,5,77434034,77473219,lincRNA,1,39185,chr5_77434034_77473219
Gm42761,5,77485727,77494361,lincRNA,1,8634,chr5_77485727_77494361
Adgrl3,5,81020138,81825133,protein_coding,1,804995,chr5_81020138_81825133
Gm16054,5,81791909,81798426,antisense,-1,6517,chr5_81791909_81798426
Tecrl,5,83278145,83355195,protein_coding,-1,77050,chr5_83278145_83355195
Epha5,5,84054761,84417382,protein_coding,-1,362621,chr5_84054761_84417382
Gm43532,5,84428805,84432620,lincRNA,1,3815,chr5_84428805_84432620
Cenpc1,5,86012024,86065583,protein_coding,-1,53559,chr5_86012024_86065583
Stap1,5,86071746,86106125,protein_coding,1,34379,chr5_86071746_86106125
Uba6,5,86109287,86172803,protein_coding,-1,63516,chr5_86109287_86172803
Gnrhr,5,86180754,86197901,protein_coding,-1,17147,chr5_86180754_86197901
Tmprss11c,5,86231481,86289308,protein_coding,-1,57827,chr5_86231481_86289308
Tmprss11d,5,86302217,86373420,protein_coding,-1,71203,chr5_86302217_86373420
Tmprss11a,5,86410410,86468990,protein_coding,-1,58580,chr5_86410410_86468990
Tmprss11g,5,86485876,86518600,protein_coding,-1,32724,chr5_86485876_86518600
Tmprss11f,5,86521898,86632424,protein_coding,-1,110526,chr5_86521898_86632424
Tmprss11b,5,86657631,86676362,protein_coding,-1,18731,chr5_86657631_86676362
Gm43056,5,86683850,86686640,lincRNA,-1,2790,chr5_86683850_86686640
Tmprss11e,5,86705186,86745815,protein_coding,-1,40629,chr5_86705186_86745815
Gm43055,5,86728906,86817106,lincRNA,1,88200,chr5_86728906_86817106
Gm43057,5,86767141,86783033,lincRNA,-1,15892,chr5_86767141_86783033
Ythdc1,5,86804221,86836659,protein_coding,1,32438,chr5_86804221_86836659
Ugt2b34,5,86889767,86906937,protein_coding,-1,17170,chr5_86889767_86906937
Ugt2b1,5,86916638,86926530,protein_coding,-1,9892,chr5_86916638_86926530
Ugt2b35,5,87000860,87013275,protein_coding,1,12415,chr5_87000860_87013275
Ugt2b36,5,87065927,87092555,protein_coding,-1,26628,chr5_87065927_87092555
Ugt2b5,5,87124960,87140318,protein_coding,-1,15358,chr5_87124960_87140318
Ugt2b37,5,87240493,87254804,protein_coding,-1,14311,chr5_87240493_87254804
Ugt2a3,5,87324972,87337195,protein_coding,-1,12223,chr5_87324972_87337195
Ugt2b38,5,87409942,87424203,protein_coding,-1,14261,chr5_87409942_87424203
Ugt2a1,5,87459490,87490871,protein_coding,-1,31381,chr5_87459490_87490871
Sult1b1,5,87513339,87538195,protein_coding,-1,24856,chr5_87513339_87538195
Sult1e1,5,87575969,87591594,protein_coding,-1,15625,chr5_87575969_87591594
Csn1s1,5,87666208,87682578,protein_coding,1,16370,chr5_87666208_87682578
Csn1s2a,5,87774567,87788797,protein_coding,1,14230,chr5_87774567_87788797
Prr27,5,87825686,87846387,protein_coding,1,20701,chr5_87825686_87846387
Odam,5,87885029,87894174,protein_coding,1,9145,chr5_87885029_87894174
1700066N21Rik,5,87908579,87979351,antisense,-1,70772,chr5_87908579_87979351
Csn3,5,87925579,87932665,protein_coding,1,7086,chr5_87925579_87932665
Gm28434,5,87969517,88008277,protein_coding,1,38760,chr5_87969517_88008277
Smr2,5,88086556,88109053,protein_coding,1,22497,chr5_88086556_88109053
Gm7714,5,88268919,88282835,protein_coding,1,13916,chr5_88268919_88282835
Amtn,5,88376108,88385916,protein_coding,1,9808,chr5_88376108_88385916
Ambn,5,88455991,88468531,protein_coding,1,12540,chr5_88455991_88468531
Enam,5,88487975,88506049,protein_coding,1,18074,chr5_88487975_88506049
Jchain,5,88519809,88527891,protein_coding,-1,8082,chr5_88519809_88527891
Utp3,5,88554462,88556090,protein_coding,1,1628,chr5_88554462_88556090
Rufy3,5,88565040,88651392,protein_coding,1,86352,chr5_88565040_88651392
Grsf1,5,88659448,88676171,protein_coding,-1,16723,chr5_88659448_88676171
Mob1b,5,88720855,88764220,protein_coding,1,43365,chr5_88720855_88764220
Dck,5,88764996,88783281,protein_coding,1,18285,chr5_88764996_88783281
Gm42912,5,88793896,88813470,lincRNA,1,19574,chr5_88793896_88813470
Slc4a4,5,88886486,89239653,protein_coding,1,353167,chr5_88886486_89239653
Gc,5,89417522,89457898,protein_coding,-1,40376,chr5_89417522_89457898
Npffr2,5,89527429,89583740,protein_coding,1,56311,chr5_89527429_89583740
Adamts3,5,89677087,89883334,protein_coding,-1,206247,chr5_89677087_89883334
Cox18,5,90214724,90224001,protein_coding,-1,9277,chr5_90214724_90224001
Ankrd17,5,90227166,90366577,protein_coding,-1,139411,chr5_90227166_90366577
Gm9958,5,90366620,90368488,bidirectional_promoter_lncRNA,1,1868,chr5_90366620_90368488
Alb,5,90460897,90476602,protein_coding,1,15705,chr5_90460897_90476602
Afp,5,90490737,90508907,protein_coding,1,18170,chr5_90490737_90508907
Gm43449,5,90499088,90515931,antisense,-1,16843,chr5_90499088_90515931
Afm,5,90518932,90553543,protein_coding,1,34611,chr5_90518932_90553543
Rassf6,5,90603076,90640657,protein_coding,-1,37581,chr5_90603076_90640657
Cxcl5,5,90759360,90761624,protein_coding,1,2264,chr5_90759360_90761624
Pf4,5,90772435,90773383,protein_coding,1,948,chr5_90772435_90773383
Cxcl15,5,90794534,90803067,protein_coding,1,8533,chr5_90794534_90803067
Mthfd2l,5,90931117,91021368,protein_coding,1,90251,chr5_90931117_91021368
Epgn,5,91027464,91035215,protein_coding,1,7751,chr5_91027464_91035215
Gm19610,5,91051871,91074773,antisense,-1,22902,chr5_91051871_91074773
Ereg,5,91074622,91093646,protein_coding,1,19024,chr5_91074622_91093646
Areg,5,91139599,91148432,protein_coding,1,8833,chr5_91139599_91148432
Gm19619,5,91257571,91283421,lincRNA,-1,25850,chr5_91257571_91283421
Btc,5,91357261,91402994,protein_coding,-1,45733,chr5_91357261_91402994
Parm1,5,91517615,91626894,protein_coding,1,109279,chr5_91517615_91626894
Gm28271,5,91763325,91767914,lincRNA,-1,4589,chr5_91763325_91767914
Gm43688,5,91911400,91913403,lincRNA,-1,2003,chr5_91911400_91913403
Rchy1,5,91948904,91963068,protein_coding,-1,14164,chr5_91948904_91963068
Odaph,5,91987475,91995320,protein_coding,1,7845,chr5_91987475_91995320
Cdkl2,5,92006074,92043883,protein_coding,-1,37809,chr5_92006074_92043883
G3bp2,5,92052146,92083719,protein_coding,-1,31573,chr5_92052146_92083719
Uso1,5,92137938,92202798,protein_coding,1,64860,chr5_92137938_92202798
U90926,5,92209893,92215408,processed_transcript,-1,5515,chr5_92209893_92215408
Ppef2,5,92226679,92256278,protein_coding,-1,29599,chr5_92226679_92256278
Naaa,5,92257659,92278170,protein_coding,-1,20511,chr5_92257659_92278170
Sdad1,5,92284010,92310479,protein_coding,-1,26469,chr5_92284010_92310479
Gm43599,5,92290052,92302760,antisense,1,12708,chr5_92290052_92302760
Art3,5,92331827,92414628,protein_coding,1,82801,chr5_92331827_92414628
Nup54,5,92415540,92435219,protein_coding,-1,19679,chr5_92415540_92435219
Scarb2,5,92441314,92506833,protein_coding,-1,65519,chr5_92441314_92506833
Fam47e,5,92555069,92591279,protein_coding,1,36210,chr5_92555069_92591279
Stbd1,5,92603041,92606579,protein_coding,1,3538,chr5_92603041_92606579
Ccdc158,5,92607954,92675271,protein_coding,-1,67317,chr5_92607954_92675271
Shroom3,5,92683435,92965318,protein_coding,1,281883,chr5_92683435_92965318
Sowahb,5,93041123,93045022,protein_coding,-1,3899,chr5_93041123_93045022
Ccni,5,93181933,93206495,protein_coding,-1,24562,chr5_93181933_93206495
2010109A12Rik,5,93206518,93213475,protein_coding,1,6957,chr5_93206518_93213475
Ccng2,5,93267257,93276231,protein_coding,1,8974,chr5_93267257_93276231
Gm16427,5,93481829,93540200,protein_coding,-1,58371,chr5_93481829_93540200
C87414,5,93634993,93671551,protein_coding,-1,36558,chr5_93634993_93671551
Gm16429,5,93924777,93929052,protein_coding,-1,4275,chr5_93924777_93929052
BC061212,5,94066151,94070545,protein_coding,-1,4394,chr5_94066151_94070545
AA792892,5,94339749,94385079,protein_coding,1,45330,chr5_94339749_94385079
Gm3139,5,94526287,94546423,protein_coding,1,20136,chr5_94526287_94546423
Gm6205,5,94648382,94686353,protein_coding,1,37971,chr5_94648382_94686353
Gm3183,5,94865436,94885388,protein_coding,1,19952,chr5_94865436_94885388
Gm6367,5,94988626,95026536,protein_coding,1,37910,chr5_94988626_95026536
Gm3259,5,95305911,95343917,protein_coding,1,38006,chr5_95305911_95343917
D5Ertd577e,5,95456806,95485587,protein_coding,1,28781,chr5_95456806_95485587
E330014E10Rik,5,95775990,95804708,protein_coding,1,28718,chr5_95775990_95804708
Cxcl13,5,95956951,95961068,protein_coding,1,4117,chr5_95956951_95961068
Cnot6l,5,96070333,96164171,protein_coding,-1,93838,chr5_96070333_96164171
Mrpl1,5,96209493,96266727,protein_coding,1,57234,chr5_96209493_96266727
Fras1,5,96373955,96784728,protein_coding,1,410773,chr5_96373955_96784728
Gm33050,5,96456389,96457743,antisense,-1,1354,chr5_96456389_96457743
Gm42604,5,96735547,96739364,antisense,-1,3817,chr5_96735547_96739364
Anxa3,5,96793339,96845966,protein_coding,1,52627,chr5_96793339_96845966
1700016F12Rik,5,96849505,96852938,lincRNA,1,3433,chr5_96849505_96852938
Gm42601,5,96879342,96891172,lincRNA,1,11830,chr5_96879342_96891172
Gm33370,5,96910341,96922175,lincRNA,-1,11834,chr5_96910341_96922175
Gm8013,5,96921272,96934867,lincRNA,1,13595,chr5_96921272_96934867
Gm9484,5,96996206,96997364,lincRNA,-1,1158,chr5_96996206_96997364
Bmp2k,5,96997689,97091867,protein_coding,1,94178,chr5_96997689_97091867
Paqr3,5,97082329,97111596,protein_coding,-1,29267,chr5_97082329_97111596
Gm33609,5,97143026,97149848,lincRNA,1,6822,chr5_97143026_97149848
Gm2861,5,97195586,97207964,lincRNA,1,12378,chr5_97195586_97207964
Gm33969,5,97325904,97348439,lincRNA,1,22535,chr5_97325904_97348439
Naa11,5,97382198,97392379,protein_coding,-1,10181,chr5_97382198_97392379
4930467D21Rik,5,97392417,97642179,lincRNA,1,249762,chr5_97392417_97642179
Gk2,5,97455142,97457021,protein_coding,-1,1879,chr5_97455142_97457021
Antxr2,5,97882783,98031043,protein_coding,-1,148260,chr5_97882783_98031043
Prdm8,5,98167198,98188991,protein_coding,1,21793,chr5_98167198_98188991
A730035I17Rik,5,98183121,98185984,antisense,-1,2863,chr5_98183121_98185984
Fgf5,5,98254184,98277030,protein_coding,1,22846,chr5_98254184_98277030
1700010H22Rik,5,98553629,98567004,lincRNA,-1,13375,chr5_98553629_98567004
Bmp3,5,98854415,98884396,protein_coding,1,29981,chr5_98854415_98884396
Prkg2,5,98929773,99037351,protein_coding,-1,107578,chr5_98929773_99037351
Gm43251,5,99039063,99171421,lincRNA,-1,132358,chr5_99039063_99171421
Rasgef1b,5,99217426,99729065,protein_coding,-1,511639,chr5_99217426_99729065
Gm35394,5,99274095,99279284,lincRNA,1,5189,chr5_99274095_99279284
Gm35172,5,99508389,99511037,lincRNA,1,2648,chr5_99508389_99511037
4930405H06Rik,5,99625836,99627062,antisense,1,1226,chr5_99625836_99627062
Gm16226,5,99682410,99715774,antisense,1,33364,chr5_99682410_99715774
Gm38413,5,99730854,99753973,lincRNA,-1,23119,chr5_99730854_99753973
Hnrnpd,5,99955935,99978938,protein_coding,-1,23003,chr5_99955935_99978938
Gm17092,5,99977686,99980171,antisense,1,2485,chr5_99977686_99980171
Hnrnpdl,5,100033577,100039664,protein_coding,-1,6087,chr5_100033577_100039664
Enoph1,5,100039985,100068760,protein_coding,1,28775,chr5_100039985_100068760
Tmem150c,5,100077872,100159808,protein_coding,-1,81936,chr5_100077872_100159808
Tmem150cos,5,100077962,100095273,antisense,1,17311,chr5_100077962_100095273
Gm9932,5,100196611,100200724,lincRNA,1,4113,chr5_100196611_100200724
2310034O05Rik,5,100210692,100218049,lincRNA,1,7357,chr5_100210692_100218049
Sec31a,5,100361649,100416234,protein_coding,-1,54585,chr5_100361649_100416234
5430416N02Rik,5,100420842,100429535,lincRNA,-1,8693,chr5_100420842_100429535
Lin54,5,100441918,100500639,protein_coding,-1,58721,chr5_100441918_100500639
Cops4,5,100518309,100547803,protein_coding,1,29494,chr5_100518309_100547803
Plac8,5,100553725,100572245,protein_coding,-1,18520,chr5_100553725_100572245
Coq2,5,100654723,100675140,protein_coding,-1,20417,chr5_100654723_100675140
Gm15777,5,100670859,100678105,antisense,1,7246,chr5_100670859_100678105
Hpse,5,100679484,100719716,protein_coding,-1,40232,chr5_100679484_100719716
Helq,5,100762145,100798598,protein_coding,-1,36453,chr5_100762145_100798598
Mrps18c,5,100798627,100804471,protein_coding,1,5844,chr5_100798627_100804471
Abraxas1,5,100805192,100820965,protein_coding,-1,15773,chr5_100805192_100820965
4930458D05Rik,5,100840797,100847167,antisense,-1,6370,chr5_100840797_100847167
Gpat3,5,100845713,100899102,protein_coding,1,53389,chr5_100845713_100899102
Gm36793,5,100910001,100913707,lincRNA,-1,3706,chr5_100910001_100913707
Gm42133,5,101698133,101704063,lincRNA,-1,5930,chr5_101698133_101704063
9430085M18Rik,5,101703586,101705850,lincRNA,1,2264,chr5_101703586_101705850
Cds1,5,101765130,101823858,protein_coding,1,58728,chr5_101765130_101823858
Wdfy3,5,101832956,102069921,protein_coding,-1,236965,chr5_101832956_102069921
Gm20548,5,101837416,101846410,antisense,1,8994,chr5_101837416_101846410
Gm29707,5,102070218,102071782,lincRNA,1,1564,chr5_102070218_102071782
1700013M08Rik,5,102474290,102483289,antisense,-1,8999,chr5_102474290_102483289
Arhgap24,5,102481391,102897937,protein_coding,1,416546,chr5_102481391_102897937
Mapk10,5,102907948,103211334,protein_coding,-1,303386,chr5_102907948_103211334
4930429D17Rik,5,103230375,103299029,lincRNA,-1,68654,chr5_103230375_103299029
5430427N15Rik,5,103354306,103356698,lincRNA,-1,2392,chr5_103354306_103356698
Ptpn13,5,103425192,103598303,protein_coding,1,173111,chr5_103425192_103598303
Gm42620,5,103513445,103533021,antisense,-1,19576,chr5_103513445_103533021
Slc10a6,5,103605711,103629403,protein_coding,-1,23692,chr5_103605711_103629403
1700016H13Rik,5,103648039,103656010,protein_coding,-1,7971,chr5_103648039_103656010
Aff1,5,103692374,103855322,protein_coding,1,162948,chr5_103692374_103855322
Klhl8,5,103861973,103911259,protein_coding,-1,49286,chr5_103861973_103911259
Hsd17b13,5,103955440,103977410,protein_coding,-1,21970,chr5_103955440_103977410
Hsd17b11,5,103989762,104021919,protein_coding,-1,32157,chr5_103989762_104021919
Nudt9,5,104046306,104065379,protein_coding,1,19073,chr5_104046306_104065379
Gm17660,5,104070064,104077608,protein_coding,-1,7544,chr5_104070064_104077608
Sparcl1,5,104079111,104113733,protein_coding,-1,34622,chr5_104079111_104113733
Gm26703,5,104109217,104119687,antisense,1,10470,chr5_104109217_104119687
Dspp,5,104170712,104180127,protein_coding,1,9415,chr5_104170712_104180127
Dmp1,5,104202613,104214102,protein_coding,1,11489,chr5_104202613_104214102
Ibsp,5,104299171,104311469,protein_coding,1,12298,chr5_104299171_104311469
Mepe,5,104325329,104338611,protein_coding,1,13282,chr5_104325329_104338611
Spp1,5,104435118,104441050,protein_coding,1,5932,chr5_104435118_104441050
Pkd2,5,104459450,104505819,protein_coding,1,46369,chr5_104459450_104505819
Zfp951,5,104813169,104860070,protein_coding,-1,46901,chr5_104813169_104860070
Abcg3,5,104935057,104982718,protein_coding,-1,47661,chr5_104935057_104982718
Gbp8,5,105014150,105139540,protein_coding,-1,125390,chr5_105014150_105139540
Gm43302,5,105214907,105293695,protein_coding,-1,78788,chr5_105214907_105293695
Gm26519,5,105401245,105406970,lincRNA,1,5725,chr5_105401245_105406970
Gm32051,5,105409367,105415670,lincRNA,1,6303,chr5_105409367_105415670
Lrrc8b,5,105415775,105490074,protein_coding,1,74299,chr5_105415775_105490074
Lrrc8c,5,105519388,105613018,protein_coding,1,93630,chr5_105519388_105613018
Lrrc8d,5,105699969,105832436,protein_coding,1,132467,chr5_105699969_105832436
Lrrc8dos,5,105814773,105818988,antisense,-1,4215,chr5_105814773_105818988
Zfp326,5,105876565,105915818,protein_coding,1,39253,chr5_105876565_105915818
Gm42916,5,106369012,106370818,lincRNA,1,1806,chr5_106369012_106370818
Barhl2,5,106452523,106458166,protein_coding,-1,5643,chr5_106452523_106458166
Gm26872,5,106465800,106471007,lincRNA,-1,5207,chr5_106465800_106471007
Gm28050,5,106500894,106574718,lincRNA,-1,73824,chr5_106500894_106574718
Gm29464,5,106574875,106575387,lincRNA,1,512,chr5_106574875_106575387
Zfp644,5,106616739,106697287,protein_coding,-1,80548,chr5_106616739_106697287
Hfm1,5,106840192,106926321,protein_coding,-1,86129,chr5_106840192_106926321
Cdc7,5,106964322,106984432,protein_coding,1,20110,chr5_106964322_106984432
Gm33474,5,107048836,107056042,lincRNA,1,7206,chr5_107048836_107056042
Tgfbr3,5,107106570,107289629,protein_coding,-1,183059,chr5_107106570_107289629
Brdt,5,107331159,107387058,protein_coding,1,55899,chr5_107331159_107387058
Gm42902,5,107392731,107403480,antisense,-1,10749,chr5_107392731_107403480
Ephx4,5,107402736,107430035,protein_coding,1,27299,chr5_107402736_107430035
Gm17202,5,107404823,107431910,antisense,-1,27087,chr5_107404823_107431910
Lpcat2b,5,107431549,107435039,protein_coding,1,3490,chr5_107431549_107435039
Gm42669,5,107507621,107580596,protein_coding,1,72975,chr5_107507621_107580596
Glmn,5,107548967,107597888,protein_coding,-1,48921,chr5_107548967_107597888
Rpap2,5,107597373,107661838,protein_coding,1,64465,chr5_107597373_107661838
A930041C12Rik,5,107630250,107633850,antisense,-1,3600,chr5_107630250_107633850
Gm26692,5,107659461,107688010,lincRNA,-1,28549,chr5_107659461_107688010
4930428O21Rik,5,107698212,107703480,lincRNA,-1,5268,chr5_107698212_107703480
Gfi1,5,107716657,107726036,protein_coding,-1,9379,chr5_107716657_107726036
Evi5,5,107744795,107875107,protein_coding,-1,130312,chr5_107744795_107875107
Ube2d2b,5,107830099,107831776,protein_coding,1,1677,chr5_107830099_107831776
Rpl5,5,107900502,107909005,protein_coding,1,8503,chr5_107900502_107909005
Mtf2,5,108065674,108109004,protein_coding,1,43330,chr5_108065674_108109004
Tmed5,5,108106366,108132620,protein_coding,-1,26254,chr5_108106366_108132620
Ccdc18,5,108132875,108233628,protein_coding,1,100753,chr5_108132875_108233628
Dr1,5,108268897,108280526,protein_coding,1,11629,chr5_108268897_108280526
Pigg,5,108312609,108349355,protein_coding,1,36746,chr5_108312609_108349355
9330198I05Rik,5,108360187,108363885,lincRNA,1,3698,chr5_108360187_108363885
Gm42518,5,108364037,108364974,lincRNA,-1,937,chr5_108364037_108364974
Gm42517,5,108366073,108367922,protein_coding,-1,1849,chr5_108366073_108367922
Gm10419,5,108367769,108378239,lincRNA,1,10470,chr5_108367769_108378239
Pde6b,5,108388391,108432397,protein_coding,1,44006,chr5_108388391_108432397
Atp5k,5,108433244,108434448,protein_coding,-1,1204,chr5_108433244_108434448
Mfsd7a,5,108441054,108449100,protein_coding,-1,8046,chr5_108441054_108449100
Pcgf3,5,108461232,108506976,protein_coding,1,45744,chr5_108461232_108506976
Cplx1,5,108518554,108550024,protein_coding,-1,31470,chr5_108518554_108550024
Gak,5,108569411,108629755,protein_coding,-1,60344,chr5_108569411_108629755
Tmem175,5,108629770,108648782,protein_coding,1,19012,chr5_108629770_108648782
Dgkq,5,108646693,108669672,protein_coding,-1,22979,chr5_108646693_108669672
Idua,5,108660331,108684557,protein_coding,1,24226,chr5_108660331_108684557
Slc26a1,5,108669878,108675569,protein_coding,-1,5691,chr5_108669878_108675569
Fgfrl1,5,108692382,108706924,protein_coding,1,14542,chr5_108692382_108706924
Rnf212,5,108729290,108774982,protein_coding,-1,45692,chr5_108729290_108774982
1700047L14Rik,5,108763842,108768914,antisense,1,5072,chr5_108763842_108768914
Tmed11,5,108777235,108795363,protein_coding,-1,18128,chr5_108777235_108795363
Vmn2r8,5,108791843,108808850,protein_coding,-1,17007,chr5_108791843_108808850
Gm20629,5,108849781,108949255,antisense,1,99474,chr5_108849781_108949255
Vmn2r10,5,108990063,109006527,protein_coding,-1,16464,chr5_108990063_109006527
Vmn2r11,5,109043360,109059569,protein_coding,-1,16209,chr5_109043360_109059569
Vmn2r12,5,109083824,109097950,protein_coding,-1,14126,chr5_109083824_109097950
Vmn2r13,5,109152940,109192199,protein_coding,-1,39259,chr5_109152940_109192199
Vmn2r15,5,109285670,109297644,protein_coding,-1,11974,chr5_109285670_109297644
Vmn2r16,5,109330162,109370247,protein_coding,1,40085,chr5_109330162_109370247
Vmn2r17,5,109419688,109458459,protein_coding,1,38771,chr5_109419688_109458459
Crlf2,5,109554709,109558993,protein_coding,-1,4284,chr5_109554709_109558993
5430403G16Rik,5,109674545,109691041,protein_coding,-1,16496,chr5_109674545_109691041
4930522L14Rik,5,109735990,109751886,protein_coding,-1,15896,chr5_109735990_109751886
A430073D23Rik,5,109769407,109796298,lincRNA,-1,26891,chr5_109769407_109796298
Gm26779,5,109886231,109891137,lincRNA,1,4906,chr5_109886231_109891137
Gm15446,5,109923400,109943936,protein_coding,1,20536,chr5_109923400_109943936
1010001B22Rik,5,109995511,109996398,lincRNA,-1,887,chr5_109995511_109996398
Zfp932,5,109996521,110010411,protein_coding,1,13890,chr5_109996521_110010411
Gm17655,5,110046139,110072513,protein_coding,-1,26374,chr5_110046139_110072513
Gm35315,5,110076136,110094420,protein_coding,-1,18284,chr5_110076136_110094420
Plcxd1,5,110099969,110105953,protein_coding,1,5984,chr5_110099969_110105953
Gtpbp6,5,110103975,110108197,protein_coding,-1,4222,chr5_110103975_110108197
Zfp605,5,110110092,110129794,protein_coding,1,19702,chr5_110110092_110129794
Chfr,5,110135842,110171972,protein_coding,1,36130,chr5_110135842_110171972
Gm43136,5,110153487,110154122,antisense,-1,635,chr5_110153487_110154122
Golga3,5,110176701,110226470,protein_coding,1,49769,chr5_110176701_110226470
Gm43137,5,110230608,110231201,antisense,-1,593,chr5_110230608_110231201
Ankle2,5,110231004,110256651,protein_coding,1,25647,chr5_110231004_110256651
Pgam5,5,110259130,110269913,protein_coding,-1,10783,chr5_110259130_110269913
Gm15788,5,110262161,110277267,antisense,1,15106,chr5_110262161_110277267
Pxmp2,5,110274282,110286186,protein_coding,-1,11904,chr5_110274282_110286186
Pole,5,110286306,110337474,protein_coding,1,51168,chr5_110286306_110337474
P2rx2,5,110339812,110343212,protein_coding,-1,3400,chr5_110339812_110343212
Lrcol1,5,110344730,110356094,protein_coding,1,11364,chr5_110344730_110356094
Fbrsl1,5,110361754,110448602,protein_coding,-1,86848,chr5_110361754_110448602
Gm42596,5,110447989,110449946,antisense,1,1957,chr5_110447989_110449946
A630023P12Rik,5,110514923,110525980,lincRNA,1,11057,chr5_110514923_110525980
Galnt9,5,110544355,110621380,protein_coding,1,77025,chr5_110544355_110621380
Noc4l,5,110648418,110653417,protein_coding,-1,4999,chr5_110648418_110653417
Ddx51,5,110653451,110660496,protein_coding,1,7045,chr5_110653451_110660496
Gm42595,5,110661392,110662998,lincRNA,1,1606,chr5_110661392_110662998
Ep400,5,110664373,110770717,protein_coding,-1,106344,chr5_110664373_110770717
Gm15559,5,110770949,110779260,antisense,1,8311,chr5_110770949_110779260
Pus1,5,110773667,110780659,protein_coding,-1,6992,chr5_110773667_110780659
Ulk1,5,110784488,110810097,protein_coding,-1,25609,chr5_110784488_110810097
Hscb,5,110829070,110839777,protein_coding,-1,10707,chr5_110829070_110839777
Chek2,5,110839979,110874145,protein_coding,1,34166,chr5_110839979_110874145
Ttc28,5,110879803,111289780,protein_coding,1,409977,chr5_110879803_111289780
Pitpnb,5,111330763,111388359,protein_coding,1,57596,chr5_111330763_111388359
Gm43118,5,111387515,111388289,antisense,-1,774,chr5_111387515_111388289
Mn1,5,111417362,111457033,protein_coding,1,39671,chr5_111417362_111457033
C130026L21Rik,5,111581422,111604932,lincRNA,1,23510,chr5_111581422_111604932
E130006D01Rik,5,111734284,111761725,lincRNA,-1,27441,chr5_111734284_111761725
Gm16019,5,111742849,111748176,lincRNA,1,5327,chr5_111742849_111748176
Gm36535,5,111791555,111805689,lincRNA,1,14134,chr5_111791555_111805689
Gm42488,5,111939804,111944235,lincRNA,-1,4431,chr5_111939804_111944235
1700016B01Rik,5,112156237,112165244,lincRNA,1,9007,chr5_112156237_112165244
1700028D13Rik,5,112206763,112210004,lincRNA,1,3241,chr5_112206763_112210004
Miat,5,112213228,112229395,lincRNA,-1,16167,chr5_112213228_112229395
Gm26953,5,112215461,112233720,lincRNA,1,18259,chr5_112215461_112233720
Cryba4,5,112246493,112252518,protein_coding,-1,6025,chr5_112246493_112252518
Crybb1,5,112255815,112269585,protein_coding,1,13770,chr5_112255815_112269585
Tpst2,5,112276691,112315361,protein_coding,1,38670,chr5_112276691_112315361
Tfip11,5,112326358,112338073,protein_coding,1,11715,chr5_112326358_112338073
Srrd,5,112337392,112343040,protein_coding,-1,5648,chr5_112337392_112343040
Hps4,5,112343083,112378414,protein_coding,1,35331,chr5_112343083_112378414
Gm6583,5,112353801,112356033,protein_coding,-1,2232,chr5_112353801_112356033
Gm20636,5,112374369,112377639,antisense,-1,3270,chr5_112374369_112377639
Asphd2,5,112384354,112394866,protein_coding,-1,10512,chr5_112384354_112394866
Sez6l,5,112419151,112577185,protein_coding,-1,158034,chr5_112419151_112577185
Gm6588,5,112449426,112451738,protein_coding,1,2312,chr5_112449426_112451738
Gm27004,5,112582645,112583371,lincRNA,1,726,chr5_112582645_112583371
1700034G24Rik,5,112582936,112589996,lincRNA,-1,7060,chr5_112582936_112589996
Gm42864,5,112649367,112652112,lincRNA,1,2745,chr5_112649367_112652112
Gm42865,5,112675375,112680587,lincRNA,1,5212,chr5_112675375_112680587
Myo18b,5,112688876,112896362,protein_coding,-1,207486,chr5_112688876_112896362
1700095B10Rik,5,112793292,112801701,antisense,1,8409,chr5_112793292_112801701
Grk3,5,112910482,113015791,protein_coding,-1,105309,chr5_112910482_113015791
Crybb2,5,113058258,113070117,protein_coding,-1,11859,chr5_113058258_113070117
Crybb3,5,113075839,113081584,protein_coding,-1,5745,chr5_113075839_113081584
2900026A02Rik,5,113086323,113221236,protein_coding,-1,134913,chr5_113086323_113221236
Gm42161,5,113145328,113154368,lincRNA,1,9040,chr5_113145328_113154368
Tmem211,5,113226909,113239263,protein_coding,1,12354,chr5_113226909_113239263
Sgsm1,5,113243220,113310786,protein_coding,-1,67566,chr5_113243220_113310786
Aym1,5,113357294,113357821,protein_coding,1,527,chr5_113357294_113357821
Wscd2,5,113490333,113589725,protein_coding,1,99392,chr5_113490333_113589725
Cmklr1,5,113612354,113650426,protein_coding,-1,38072,chr5_113612354_113650426
1700069L16Rik,5,113692422,113724772,protein_coding,-1,32350,chr5_113692422_113724772
Ficd,5,113735803,113740600,protein_coding,1,4797,chr5_113735803_113740600
Sart3,5,113742446,113772510,protein_coding,-1,30064,chr5_113742446_113772510
Iscu,5,113772748,113778288,protein_coding,1,5540,chr5_113772748_113778288
Tmem119,5,113793729,113800516,protein_coding,-1,6787,chr5_113793729_113800516
Selplg,5,113818536,113832644,protein_coding,-1,14108,chr5_113818536_113832644
Coro1c,5,113842436,113908758,protein_coding,-1,66322,chr5_113842436_113908758
Gm17122,5,113842601,113843116,antisense,1,515,chr5_113842601_113843116
Gm42797,5,113928555,113930134,lincRNA,-1,1579,chr5_113928555_113930134
Ssh1,5,113937094,113993894,protein_coding,-1,56800,chr5_113937094_113993894
Dao,5,114003703,114025682,protein_coding,1,21979,chr5_114003703_114025682
Svop,5,114026910,114091570,protein_coding,-1,64660,chr5_114026910_114091570
Usp30,5,114065461,114124720,protein_coding,1,59259,chr5_114065461_114124720
Alkbh2,5,114123926,114128218,protein_coding,-1,4292,chr5_114123926_114128218
Ung,5,114130386,114139323,protein_coding,1,8937,chr5_114130386_114139323
Acacb,5,114146535,114250761,protein_coding,1,104226,chr5_114146535_114250761
Foxn4,5,114254164,114273807,protein_coding,-1,19643,chr5_114254164_114273807
Myo1h,5,114289166,114365357,protein_coding,1,76191,chr5_114289166_114365357
Kctd10,5,114363567,114380508,protein_coding,-1,16941,chr5_114363567_114380508
Ube3b,5,114380607,114421169,protein_coding,1,40562,chr5_114380607_114421169
Mmab,5,114431034,114444060,protein_coding,-1,13026,chr5_114431034_114444060
Mvk,5,114444269,114460591,protein_coding,1,16322,chr5_114444269_114460591
Fam222a,5,114568016,114613220,protein_coding,1,45204,chr5_114568016_114613220
Trpv4,5,114622152,114658421,protein_coding,-1,36269,chr5_114622152_114658421
Gltp,5,114669398,114690984,protein_coding,-1,21586,chr5_114669398_114690984
Tchp,5,114707760,114722327,protein_coding,1,14567,chr5_114707760_114722327
Gm42789,5,114715554,114716120,antisense,-1,566,chr5_114715554_114716120
Git2,5,114727407,114775517,protein_coding,-1,48110,chr5_114727407_114775517
Ankrd13a,5,114774677,114806200,protein_coding,1,31523,chr5_114774677_114806200
1500011B03Rik,5,114808196,114823468,protein_coding,-1,15272,chr5_114808196_114823468
4930519G04Rik,5,114853664,114883880,protein_coding,1,30216,chr5_114853664_114883880
Gm9936,5,114855025,114859383,antisense,-1,4358,chr5_114855025_114859383
Oasl2,5,114896936,114912234,protein_coding,1,15298,chr5_114896936_114912234
Gm13822,5,114917318,114923277,antisense,-1,5959,chr5_114917318_114923277
Oasl1,5,114923240,114937915,protein_coding,1,14675,chr5_114923240_114937915
2210016L21Rik,5,114942158,114949783,protein_coding,1,7625,chr5_114942158_114949783
Hnf1a,5,114948980,114971094,protein_coding,-1,22114,chr5_114948980_114971094
Hnf1aos1,5,114968784,114998042,antisense,1,29258,chr5_114968784_114998042
Sppl3,5,115011137,115098790,protein_coding,1,87653,chr5_115011137_115098790
Gm10401,5,115097689,115098295,protein_coding,-1,606,chr5_115097689_115098295
Acads,5,115110299,115119346,protein_coding,-1,9047,chr5_115110299_115119346
Unc119b,5,115122550,115134975,protein_coding,-1,12425,chr5_115122550_115134975
Mlec,5,115142981,115158179,protein_coding,-1,15198,chr5_115142981_115158179
Cabp1,5,115168689,115194381,protein_coding,-1,25692,chr5_115168689_115194381
Pop5,5,115235836,115245351,protein_coding,1,9515,chr5_115235836_115245351
Rnf10,5,115241412,115272898,protein_coding,-1,31486,chr5_115241412_115272898
Coq5,5,115279666,115296972,protein_coding,1,17306,chr5_115279666_115296972
Dynll1,5,115297110,115300999,protein_coding,-1,3889,chr5_115297110_115300999
Gm13830,5,115301120,115319208,lincRNA,1,18088,chr5_115301120_115319208
Srsf9,5,115327177,115333080,protein_coding,1,5903,chr5_115327177_115333080
Gatc,5,115333239,115341178,protein_coding,-1,7939,chr5_115333239_115341178
Triap1,5,115341225,115343569,protein_coding,1,2344,chr5_115341225_115343569
Cox6a1,5,115345642,115348981,protein_coding,-1,3339,chr5_115345642_115348981
Gm42903,5,115349130,115353155,lincRNA,1,4025,chr5_115349130_115353155
4930401G09Rik,5,115358700,115360123,lincRNA,-1,1423,chr5_115358700_115360123
Gm13832,5,115359078,115422863,lincRNA,1,63785,chr5_115359078_115422863
Msi1,5,115429599,115455698,protein_coding,1,26099,chr5_115429599_115455698
4930430O22Rik,5,115436066,115436644,antisense,-1,578,chr5_115436066_115436644
Pla2g1b,5,115466262,115474722,protein_coding,1,8460,chr5_115466262_115474722
Sirt4,5,115478010,115484725,protein_coding,-1,6715,chr5_115478010_115484725
Pxn,5,115506676,115555987,protein_coding,1,49311,chr5_115506676_115555987
Rplp0,5,115559467,115563727,protein_coding,1,4260,chr5_115559467_115563727
1110006O24Rik,5,115631049,115631816,lincRNA,-1,767,chr5_115631049_115631816
Rab35,5,115631908,115647736,protein_coding,1,15828,chr5_115631908_115647736
Bicdl1,5,115648175,115731621,protein_coding,-1,83446,chr5_115648175_115731621
Cit,5,115845278,116008947,protein_coding,1,163669,chr5_115845278_116008947
Gm14508,5,116009316,116016105,antisense,1,6789,chr5_116009316_116016105
Prkab1,5,116013586,116024508,protein_coding,-1,10922,chr5_116013586_116024508
Gm13842,5,116026411,116029230,lincRNA,-1,2819,chr5_116026411_116029230
Tmem233,5,116038755,116083246,protein_coding,-1,44491,chr5_116038755_116083246
C330018A13Rik,5,116123614,116129110,antisense,1,5496,chr5_116123614_116129110
Ccdc60,5,116124641,116288985,protein_coding,-1,164344,chr5_116124641_116288985
Gm14507,5,116243706,116254953,antisense,1,11247,chr5_116243706_116254953
Gm13837,5,116257661,116258644,antisense,1,983,chr5_116257661_116258644
Gm13839,5,116301300,116303514,lincRNA,1,2214,chr5_116301300_116303514
Gm13838,5,116305682,116309360,lincRNA,-1,3678,chr5_116305682_116309360
B230112J18Rik,5,116312360,116318281,lincRNA,1,5921,chr5_116312360_116318281
Hspb8,5,116408491,116422864,protein_coding,-1,14373,chr5_116408491_116422864
Srrm4os,5,116438720,116465487,antisense,1,26767,chr5_116438720_116465487
Srrm4,5,116439275,116591817,protein_coding,-1,152542,chr5_116439275_116591817
Gm43122,5,116642736,116830554,lincRNA,-1,187818,chr5_116642736_116830554
Suds3,5,117091680,117116113,protein_coding,-1,24433,chr5_117091680_117116113
9530046B11Rik,5,117115218,117118723,antisense,1,3505,chr5_117115218_117118723
Taok3,5,117120129,117275219,protein_coding,1,155090,chr5_117120129_117275219
Pebp1,5,117282654,117287625,protein_coding,-1,4971,chr5_117282654_117287625
BC051077,5,117312518,117315645,lincRNA,-1,3127,chr5_117312518_117315645
Gm10399,5,117318497,117319244,antisense,-1,747,chr5_117318497_117319244
Vsig10,5,117319083,117355005,protein_coding,1,35922,chr5_117319083_117355005
Wsb2,5,117357304,117378601,protein_coding,1,21297,chr5_117357304_117378601
Rfc5,5,117378103,117389047,protein_coding,-1,10944,chr5_117378103_117389047
Gm15728,5,117389139,117393498,lincRNA,1,4359,chr5_117389139_117393498
Ksr2,5,117414000,117775003,protein_coding,1,361003,chr5_117414000_117775003
Nos1,5,117781032,117958840,protein_coding,1,177808,chr5_117781032_117958840
Gm26995,5,117935725,117939518,antisense,-1,3793,chr5_117935725_117939518
Fbxo21,5,117976730,118010201,protein_coding,1,33471,chr5_117976730_118010201
Tesc,5,118027743,118061878,protein_coding,1,34135,chr5_118027743_118061878
Fbxw8,5,118064965,118155464,protein_coding,-1,90499,chr5_118064965_118155464
Gm9754,5,118065360,118069710,antisense,1,4350,chr5_118065360_118069710
Hrk,5,118164648,118189478,protein_coding,1,24830,chr5_118164648_118189478
Rnft2,5,118190736,118245116,protein_coding,-1,54380,chr5_118190736_118245116
2410131K14Rik,5,118245227,118266093,protein_coding,1,20866,chr5_118245227_118266093
Gm28563,5,118396806,118397330,lincRNA,-1,524,chr5_118396806_118397330
Med13l,5,118560679,118765438,protein_coding,1,204759,chr5_118560679_118765438
Gm43342,5,118928123,118935962,lincRNA,1,7839,chr5_118928123_118935962
4930413E15Rik,5,118952339,118961261,lincRNA,1,8922,chr5_118952339_118961261
1700081H04Rik,5,119108234,119114543,lincRNA,1,6309,chr5_119108234_119114543
Gm31314,5,119518795,119527954,lincRNA,-1,9159,chr5_119518795_119527954
Tbx3os1,5,119570130,119671365,antisense,-1,101235,chr5_119570130_119671365
Gm16063,5,119625942,119634464,lincRNA,1,8522,chr5_119625942_119634464
Gm16064,5,119646134,119659262,lincRNA,1,13128,chr5_119646134_119659262
Tbx3,5,119670669,119684724,protein_coding,1,14055,chr5_119670669_119684724
Tbx5,5,119832668,119885219,protein_coding,1,52551,chr5_119832668_119885219
Rbm19,5,120116465,120198981,protein_coding,1,82516,chr5_120116465_120198981
Gm10390,5,120121096,120139263,antisense,-1,18167,chr5_120121096_120139263
Gm27199,5,120419659,120431767,antisense,-1,12108,chr5_120419659_120431767
Lhx5,5,120431699,120441223,protein_coding,1,9524,chr5_120431699_120441223
Sdsl,5,120458186,120472810,protein_coding,-1,14624,chr5_120458186_120472810
Sds,5,120476526,120483932,protein_coding,1,7406,chr5_120476526_120483932
Gm15690,5,120479842,120480903,antisense,-1,1061,chr5_120479842_120480903
Plbd2,5,120483282,120503625,protein_coding,-1,20343,chr5_120483282_120503625
Slc8b1,5,120511168,120534024,protein_coding,1,22856,chr5_120511168_120534024
Tpcn1,5,120534153,120588673,protein_coding,-1,54520,chr5_120534153_120588673
Iqcd,5,120589016,120607118,protein_coding,1,18102,chr5_120589016_120607118
Rita1,5,120594305,120612589,protein_coding,-1,18284,chr5_120594305_120612589
Ddx54,5,120612739,120628592,protein_coding,1,15853,chr5_120612739_120628592
Gm43579,5,120626315,120627621,antisense,-1,1306,chr5_120626315_120627621
Cfap73,5,120628335,120634235,protein_coding,-1,5900,chr5_120628335_120634235
Rasal1,5,120648812,120679597,protein_coding,1,30785,chr5_120648812_120679597
Dtx1,5,120680202,120711927,protein_coding,-1,31725,chr5_120680202_120711927
Oas2,5,120730333,120749853,protein_coding,-1,19520,chr5_120730333_120749853
Oas3,5,120753098,120777661,protein_coding,-1,24563,chr5_120753098_120777661
Gm43069,5,120777796,120805623,antisense,1,27827,chr5_120777796_120805623
Oas1c,5,120800194,120812514,protein_coding,-1,12320,chr5_120800194_120812514
Oas1f,5,120847367,120857986,protein_coding,1,10619,chr5_120847367_120857986
Oas1h,5,120861421,120873506,protein_coding,1,12085,chr5_120861421_120873506
Oas1g,5,120876142,120887613,protein_coding,-1,11471,chr5_120876142_120887613
Oas1a,5,120896256,120907521,protein_coding,-1,11265,chr5_120896256_120907521
Oas1d,5,120914536,120921652,protein_coding,1,7116,chr5_120914536_120921652
Rph3a,5,120940499,121010092,protein_coding,-1,69593,chr5_120940499_121010092
Ptpn11,5,121130533,121191397,protein_coding,-1,60864,chr5_121130533_121191397
Rpl6,5,121204481,121209241,protein_coding,1,4760,chr5_121204481_121209241
Hectd4,5,121220219,121368577,protein_coding,1,148358,chr5_121220219_121368577
Trafd1,5,121371725,121385632,protein_coding,-1,13907,chr5_121371725_121385632
Gm42917,5,121384010,121393465,antisense,1,9455,chr5_121384010_121393465
Naa25,5,121397936,121444378,protein_coding,1,46442,chr5_121397936_121444378
Erp29,5,121428590,121452506,protein_coding,-1,23916,chr5_121428590_121452506
Tmem116,5,121451893,121524183,protein_coding,1,72290,chr5_121451893_121524183
Adam1b,5,121500098,121503435,protein_coding,-1,3337,chr5_121500098_121503435
Adam1a,5,121518576,121545482,protein_coding,-1,26906,chr5_121518576_121545482
Mapkapk5,5,121525038,121545905,protein_coding,-1,20867,chr5_121525038_121545905
Aldh2,5,121566027,121593824,protein_coding,-1,27797,chr5_121566027_121593824
Acad12,5,121596775,121618938,protein_coding,-1,22163,chr5_121596775_121618938
Acad10,5,121621026,121660514,protein_coding,-1,39488,chr5_121621026_121660514
Brap,5,121660563,121687256,protein_coding,1,26693,chr5_121660563_121687256
Atxn2,5,121711337,121816493,protein_coding,1,105156,chr5_121711337_121816493
Gm16552,5,121717666,121727403,antisense,-1,9737,chr5_121717666_121727403
Sh2b3,5,121815488,121837646,protein_coding,-1,22158,chr5_121815488_121837646
Cux2,5,121856366,122050102,protein_coding,-1,193736,chr5_121856366_122050102
Gm3970,5,122025330,122029697,antisense,1,4367,chr5_122025330_122029697
Gm15637,5,122048382,122055654,antisense,1,7272,chr5_122048382_122055654
Myl2,5,122100951,122113472,protein_coding,1,12521,chr5_122100951_122113472
Ccdc63,5,122108040,122140823,protein_coding,-1,32783,chr5_122108040_122140823
Ppp1cc,5,122158278,122175273,protein_coding,1,16995,chr5_122158278_122175273
Hvcn1,5,122206804,122242297,protein_coding,1,35493,chr5_122206804_122242297
Tctn1,5,122237848,122264460,protein_coding,-1,26612,chr5_122237848_122264460
Pptc7,5,122284365,122324281,protein_coding,1,39916,chr5_122284365_122324281
Rad9b,5,122323223,122354233,protein_coding,-1,31010,chr5_122323223_122354233
Vps29,5,122354369,122364984,protein_coding,1,10615,chr5_122354369_122364984
Fam216a,5,122364580,122372364,protein_coding,-1,7784,chr5_122364580_122372364
Gpn3,5,122371876,122382902,protein_coding,1,11026,chr5_122371876_122382902
Arpc3,5,122391878,122414184,protein_coding,1,22306,chr5_122391878_122414184
Anapc7,5,122421693,122444912,protein_coding,1,23219,chr5_122421693_122444912
Atp2a2,5,122453513,122502225,protein_coding,-1,48712,chr5_122453513_122502225
Ift81,5,122550204,122614518,protein_coding,-1,64314,chr5_122550204_122614518
Gm43301,5,122581469,122584853,antisense,1,3384,chr5_122581469_122584853
P2rx7,5,122643911,122691432,protein_coding,1,47521,chr5_122643911_122691432
P2rx4,5,122707544,122729738,protein_coding,1,22194,chr5_122707544_122729738
Camkk2,5,122731170,122779409,protein_coding,-1,48239,chr5_122731170_122779409
Anapc5,5,122787459,122821339,protein_coding,-1,33880,chr5_122787459_122821339
Rnf34,5,122850048,122871291,protein_coding,1,21243,chr5_122850048_122871291
Kdm2b,5,122870665,122989823,protein_coding,-1,119158,chr5_122870665_122989823
A930024E05Rik,5,122989354,122998345,antisense,1,8991,chr5_122989354_122998345
Gm2479,5,123007299,123015080,antisense,-1,7781,chr5_123007299_123015080
Orai1,5,123015074,123030456,protein_coding,1,15382,chr5_123015074_123030456
Morn3,5,123035769,123047016,protein_coding,-1,11247,chr5_123035769_123047016
Tmem120b,5,123068415,123117749,protein_coding,1,49334,chr5_123068415_123117749
Gm38102,5,123133939,123137695,lincRNA,1,3756,chr5_123133939_123137695
4932422M17Rik,5,123138931,123141569,lincRNA,1,2638,chr5_123138931_123141569
Setd1b,5,123142193,123168629,protein_coding,1,26436,chr5_123142193_123168629
Psmd9,5,123169413,123250131,protein_coding,1,80718,chr5_123169413_123250131
Wdr66,5,123252102,123327484,protein_coding,1,75382,chr5_123252102_123327484
Gm15857,5,123293638,123310324,antisense,-1,16686,chr5_123293638_123310324
Gm15860,5,123332726,123344437,antisense,-1,11711,chr5_123332726_123344437
Bcl7a,5,123343834,123374992,protein_coding,1,31158,chr5_123343834_123374992
Gm15747,5,123393649,123397957,antisense,-1,4308,chr5_123393649_123397957
Mlxip,5,123394798,123457932,protein_coding,1,63134,chr5_123394798_123457932
Il31,5,123480157,123489489,protein_coding,-1,9332,chr5_123480157_123489489
Lrrc43,5,123489305,123508205,protein_coding,1,18900,chr5_123489305_123508205
Diablo,5,123509765,123524176,protein_coding,-1,14411,chr5_123509765_123524176
B3gnt4,5,123510460,123511882,protein_coding,1,1422,chr5_123510460_123511882
Gm49027,5,123512082,123525488,protein_coding,-1,13406,chr5_123512082_123525488
Vps33a,5,123528659,123573038,protein_coding,-1,44379,chr5_123528659_123573038
Clip1,5,123577795,123684618,protein_coding,-1,106823,chr5_123577795_123684618
Zcchc8,5,123698294,123721100,protein_coding,-1,22806,chr5_123698294_123721100
Rsrc2,5,123728426,123749414,protein_coding,-1,20988,chr5_123728426_123749414
Kntc1,5,123749716,123821593,protein_coding,1,71877,chr5_123749716_123821593
Denr,5,123907175,123928835,protein_coding,1,21660,chr5_123907175_123928835
Gm43518,5,123927418,123938388,protein_coding,1,10970,chr5_123927418_123938388
Ccdc62,5,123930679,123969895,protein_coding,1,39216,chr5_123930679_123969895
Hip1r,5,123973628,124005558,protein_coding,1,31930,chr5_123973628_124005558
Vps37b,5,124004641,124032270,protein_coding,-1,27629,chr5_124004641_124032270
Gm34086,5,124032361,124076299,lincRNA,1,43938,chr5_124032361_124076299
Gm43661,5,124035201,124052352,lincRNA,-1,17151,chr5_124035201_124052352
Abcb9,5,124061530,124095798,protein_coding,-1,34268,chr5_124061530_124095798
Gm16001,5,124111109,124112264,lincRNA,-1,1155,chr5_124111109_124112264
Ogfod2,5,124112297,124115483,protein_coding,1,3186,chr5_124112297_124115483
Arl6ip4,5,124116089,124118196,protein_coding,1,2107,chr5_124116089_124118196
Pitpnm2,5,124118690,124249760,protein_coding,-1,131070,chr5_124118690_124249760
Pitpnm2os2,5,124194907,124200346,antisense,1,5439,chr5_124194907_124200346
Pitpnm2os1,5,124229725,124237137,antisense,1,7412,chr5_124229725_124237137
Gm42425,5,124237724,124238435,antisense,1,711,chr5_124237724_124238435
Mphosph9,5,124250959,124327972,protein_coding,-1,77013,chr5_124250959_124327972
2810006K23Rik,5,124328089,124341844,protein_coding,1,13755,chr5_124328089_124341844
Cdk2ap1,5,124345417,124363082,protein_coding,-1,17665,chr5_124345417_124363082
Sbno1,5,124368702,124426001,protein_coding,-1,57299,chr5_124368702_124426001
Kmt5a,5,124439930,124462308,protein_coding,1,22378,chr5_124439930_124462308
Rilpl2,5,124463265,124478366,protein_coding,-1,15101,chr5_124463265_124478366
Snrnp35,5,124483134,124491124,protein_coding,1,7990,chr5_124483134_124491124
Rilpl1,5,124493080,124531391,protein_coding,-1,38311,chr5_124493080_124531391
Tmed2,5,124540695,124550506,protein_coding,1,9811,chr5_124540695_124550506
Ddx55,5,124552864,124569660,protein_coding,1,16796,chr5_124552864_124569660
Eif2b1,5,124570213,124579131,protein_coding,-1,8918,chr5_124570213_124579131
Gtf2h3,5,124579140,124597680,protein_coding,1,18540,chr5_124579140_124597680
Atp6v0a2,5,124628576,124724455,protein_coding,1,95879,chr5_124628576_124724455
4930404A12Rik,5,124721997,124725079,antisense,-1,3082,chr5_124721997_124725079
Dnah10,5,124725085,124834308,protein_coding,1,109223,chr5_124725085_124834308
Ccdc92,5,124834418,124862424,protein_coding,-1,28006,chr5_124834418_124862424
Zfp664,5,124862691,124902693,protein_coding,1,40002,chr5_124862691_124902693
Rflna,5,125003221,125012547,protein_coding,1,9326,chr5_125003221_125012547
Ncor2,5,125017153,125179219,protein_coding,-1,162066,chr5_125017153_125179219
Gm42838,5,125057841,125058370,antisense,1,529,chr5_125057841_125058370
Gm42839,5,125086841,125090359,antisense,1,3518,chr5_125086841_125090359
Gm32585,5,125238314,125272815,lincRNA,-1,34501,chr5_125238314_125272815
Scarb1,5,125277087,125341094,protein_coding,-1,64007,chr5_125277087_125341094
Gm40323,5,125361175,125370760,lincRNA,1,9585,chr5_125361175_125370760
Ubc,5,125385965,125390202,protein_coding,-1,4237,chr5_125385965_125390202
Gm10382,5,125389322,125390555,antisense,1,1233,chr5_125389322_125390555
Dhx37,5,125413858,125434121,protein_coding,-1,20263,chr5_125413858_125434121
Bri3bp,5,125441568,125460370,protein_coding,1,18802,chr5_125441568_125460370
Aacs,5,125475814,125517410,protein_coding,1,41596,chr5_125475814_125517410
Tmem132b,5,125531774,125792583,protein_coding,1,260809,chr5_125531774_125792583
1700048F04Rik,5,125928770,125952630,lincRNA,1,23860,chr5_125928770_125952630
Gm42952,5,125963530,125988428,lincRNA,1,24898,chr5_125963530_125988428
1700081B01Rik,5,126706914,126736252,lincRNA,1,29338,chr5_126706914_126736252
Gm33347,5,126724326,126727284,lincRNA,-1,2958,chr5_126724326_126727284
Gm42953,5,126797255,126815482,lincRNA,-1,18227,chr5_126797255_126815482
Gm40331,5,126852757,126885316,lincRNA,1,32559,chr5_126852757_126885316
4933438B17Rik,5,127027377,127088529,lincRNA,1,61152,chr5_127027377_127088529
4930572K03Rik,5,127170560,127184356,lincRNA,1,13796,chr5_127170560_127184356
Tmem132c,5,127241808,127565793,protein_coding,1,323985,chr5_127241808_127565793
Tmem132cos,5,127256858,127281634,antisense,-1,24776,chr5_127256858_127281634
Gm42980,5,127578750,127580109,lincRNA,1,1359,chr5_127578750_127580109
Slc15a4,5,127595664,127632897,protein_coding,-1,37233,chr5_127595664_127632897
Glt1d1,5,127632262,127709374,protein_coding,1,77112,chr5_127632262_127709374
Tmem132d,5,127781630,128433077,protein_coding,-1,651447,chr5_127781630_128433077
Gm42817,5,128336777,128342778,antisense,1,6001,chr5_128336777_128342778
Gm42495,5,128444416,128447731,lincRNA,1,3315,chr5_128444416_128447731
Gm42500,5,128448904,128449782,lincRNA,1,878,chr5_128448904_128449782
Fzd10,5,128600844,128604093,protein_coding,1,3249,chr5_128600844_128604093
Piwil1,5,128702524,128755474,protein_coding,1,52950,chr5_128702524_128755474
Rimbp2,5,128757791,128953486,protein_coding,-1,195695,chr5_128757791_128953486
Gm42875,5,128769524,128777837,antisense,1,8313,chr5_128769524_128777837
Stx2,5,128984557,129008574,protein_coding,-1,24017,chr5_128984557_129008574
Ran,5,129020069,129024323,protein_coding,1,4254,chr5_129020069_129024323
Adgrd1,5,129096750,129204599,protein_coding,1,107849,chr5_129096750_129204599
Gm43001,5,129363562,129364721,lincRNA,1,1159,chr5_129363562_129364721
Sfswap,5,129501221,129571384,protein_coding,1,70163,chr5_129501221_129571384
Mmp17,5,129584169,129611099,protein_coding,1,26930,chr5_129584169_129611099
Zfp11,5,129654593,129670099,protein_coding,-1,15506,chr5_129654593_129670099
Mrps17,5,129715497,129722556,protein_coding,1,7059,chr5_129715497_129722556
Nipsnap2,5,129725063,129758327,protein_coding,1,33264,chr5_129725063_129758327
Psph,5,129765558,129787449,protein_coding,-1,21891,chr5_129765558_129787449
Sumf2,5,129846986,129864050,protein_coding,1,17064,chr5_129846986_129864050
Phkg1,5,129863421,129898549,protein_coding,-1,35128,chr5_129863421_129898549
Zbed5,5,129895723,129903623,protein_coding,1,7900,chr5_129895723_129903623
Nupr1l,5,129908540,129913789,protein_coding,1,5249,chr5_129908540_129913789
Vkorc1l1,5,129941970,129986692,protein_coding,1,44722,chr5_129941970_129986692
Gusb,5,129989011,130003049,protein_coding,-1,14038,chr5_129989011_130003049
Asl,5,130011258,130029247,protein_coding,-1,17989,chr5_130011258_130029247
Crcp,5,130029290,130060789,protein_coding,1,31499,chr5_130029290_130060789
Tpst1,5,130073326,130135729,protein_coding,1,62403,chr5_130073326_130135729
Kctd7,5,130144861,130155806,protein_coding,1,10945,chr5_130144861_130155806
Rabgef1,5,130171798,130214342,protein_coding,1,42544,chr5_130171798_130214342
Tmem248,5,130217081,130243765,protein_coding,1,26684,chr5_130217081_130243765
Gm6598,5,130220451,130223065,antisense,-1,2614,chr5_130220451_130223065
Sbds,5,130245731,130255530,protein_coding,-1,9799,chr5_130245731_130255530
Tyw1,5,130255619,130341563,protein_coding,1,85944,chr5_130255619_130341563
Caln1,5,130369455,130847412,protein_coding,1,477957,chr5_130369455_130847412
A330070K13Rik,5,130378778,130384631,protein_coding,-1,5853,chr5_130378778_130384631
Galnt17,5,130872082,131308497,protein_coding,-1,436415,chr5_130872082_131308497
Gm29681,5,131391600,131414718,lincRNA;lncRNA,-1,23118,chr5_131391600_131414718
Auts2,5,131437333,132543344,protein_coding,-1,1106011,chr5_131437333_132543344
2810432F15Rik,CHR_MG171_PATCH,131615438,131625088,antisense;lncRNA,1,9650,chrCHR_MG171_PATCH_131615438_131625088
4930563F08Rik,CHR_MG171_PATCH,131880269,131883769,antisense;lncRNA,1,3500,chrCHR_MG171_PATCH_131880269_131883769
Gm42439,CHR_MG171_PATCH,131954992,131965008,antisense;lncRNA,1,10016,chrCHR_MG171_PATCH_131954992_131965008
Gm42626,5,132546056,132550634,lincRNA;lncRNA,1,4578,chr5_132546056_132550634
Gm36667,5,133534590,133598406,lincRNA,-1,63816,chr5_133534590_133598406
Gm15627,5,134098412,134099208,lincRNA,-1,796,chr5_134098412_134099208
Rcc1l,5,134148054,134176774,protein_coding,-1,28720,chr5_134148054_134176774
Gtf2ird2,5,134184019,134224355,protein_coding,1,40336,chr5_134184019_134224355
Ncf1,5,134220053,134229625,protein_coding,-1,9572,chr5_134220053_134229625
Gtf2i,5,134237834,134314760,protein_coding,-1,76926,chr5_134237834_134314760
Gtf2ird1,5,134357656,134456716,protein_coding,-1,99060,chr5_134357656_134456716
Gm42882,5,134455990,134458030,antisense,1,2040,chr5_134455990_134458030
Clip2,5,134489383,134552434,protein_coding,-1,63051,chr5_134489383_134552434
Gm42884,5,134552057,134558495,antisense,1,6438,chr5_134552057_134558495
Rfc2,5,134581366,134601805,protein_coding,1,20439,chr5_134581366_134601805
Lat2,5,134600022,134615025,protein_coding,-1,15003,chr5_134600022_134615025
Eif4h,5,134619721,134639490,protein_coding,-1,19769,chr5_134619721_134639490
Limk1,5,134656039,134688598,protein_coding,-1,32559,chr5_134656039_134688598
Gm10369,5,134676490,134680145,antisense,1,3655,chr5_134676490_134680145
Eln,5,134702593,134747323,protein_coding,-1,44730,chr5_134702593_134747323
Gm30003,5,134747042,134822967,antisense,1,75925,chr5_134747042_134822967
Tmem270,5,134901593,134906733,protein_coding,-1,5140,chr5_134901593_134906733
Mettl27,5,134932368,134942637,protein_coding,1,10269,chr5_134932368_134942637
Cldn3,5,134986214,134987472,protein_coding,1,1258,chr5_134986214_134987472
Wbscr25,5,134987433,135001350,antisense,-1,13917,chr5_134987433_135001350
Abhd11,5,135009152,135012175,protein_coding,1,3023,chr5_135009152_135012175
Stx1a,5,135023482,135051100,protein_coding,1,27618,chr5_135023482_135051100
Bud23,5,135052957,135064959,protein_coding,-1,12002,chr5_135052957_135064959
Dnajc30,5,135064202,135065862,protein_coding,1,1660,chr5_135064202_135065862
Vps37d,5,135072900,135078266,protein_coding,-1,5366,chr5_135072900_135078266
Mlxipl,5,135089890,135138382,protein_coding,1,48492,chr5_135089890_135138382
Tbl2,5,135149657,135165760,protein_coding,1,16103,chr5_135149657_135165760
Bcl7b,5,135168283,135181855,protein_coding,1,13572,chr5_135168283_135181855
Baz1b,5,135187264,135246129,protein_coding,1,58865,chr5_135187264_135246129
Fzd9,5,135248938,135251230,protein_coding,-1,2292,chr5_135248938_135251230
Fkbp6,5,135291704,135350044,protein_coding,-1,58340,chr5_135291704_135350044
Trim50,5,135353295,135368005,protein_coding,1,14710,chr5_135353295_135368005
Nsun5,5,135369953,135376805,protein_coding,1,6852,chr5_135369953_135376805
Pom121,5,135376141,135394546,protein_coding,-1,18405,chr5_135376141_135394546
Hip1,5,135406531,135545120,protein_coding,-1,138589,chr5_135406531_135545120
Ccl26,5,135560448,135563569,protein_coding,-1,3121,chr5_135560448_135563569
Ccl24,5,135569937,135573049,protein_coding,-1,3112,chr5_135569937_135573049
Rhbdd2,5,135632618,135646448,protein_coding,1,13830,chr5_135632618_135646448
Gm43091,5,135653810,135672987,lincRNA,-1,19177,chr5_135653810_135672987
Por,5,135670033,135735326,protein_coding,1,65293,chr5_135670033_135735326
Tmem120a,5,135735485,135744448,protein_coding,-1,8963,chr5_135735485_135744448
Styxl1,5,135747220,135778385,protein_coding,-1,31165,chr5_135747220_135778385
Mdh2,5,135778480,135790398,protein_coding,1,11918,chr5_135778480_135790398
Srrm3,5,135806890,135874772,protein_coding,1,67882,chr5_135806890_135874772
Srrm3os,5,135843057,135844946,antisense,-1,1889,chr5_135843057_135844946
Hspb1,5,135887919,135889563,protein_coding,1,1644,chr5_135887919_135889563
Ywhag,5,135908409,135934616,protein_coding,-1,26207,chr5_135908409_135934616
Ssc4d,5,135960211,135974531,protein_coding,-1,14320,chr5_135960211_135974531
Zp3,5,135980099,135988624,protein_coding,1,8525,chr5_135980099_135988624
Dtx2,5,135994800,136032872,protein_coding,1,38072,chr5_135994800_136032872
Upk3b,5,136038496,136046487,protein_coding,1,7991,chr5_136038496_136046487
Upk3bl,5,136054492,136064326,protein_coding,1,9834,chr5_136054492_136064326
Rasa4,5,136083916,136111860,protein_coding,1,27944,chr5_136083916_136111860
Gm15701,5,136102604,136104436,antisense,-1,1832,chr5_136102604_136104436
Polr2j,5,136116631,136122947,protein_coding,1,6316,chr5_136116631_136122947
Gm43604,5,136120966,136121670,antisense,-1,704,chr5_136120966_136121670
Lrwd1,5,136122772,136136074,protein_coding,-1,13302,chr5_136122772_136136074
Alkbh4,5,136136146,136141615,protein_coding,1,5469,chr5_136136146_136141615
Orai2,5,136147459,136170713,protein_coding,-1,23254,chr5_136147459_136170713
Prkrip1,5,136178127,136198963,protein_coding,-1,20836,chr5_136178127_136198963
Sh2b2,5,136218147,136246556,protein_coding,-1,28409,chr5_136218147_136246556
Cux1,5,136248135,136567490,protein_coding,-1,319355,chr5_136248135_136567490
Gm16599,5,136274996,136417894,antisense,1,142898,chr5_136274996_136417894
Myl10,5,136693146,136701094,protein_coding,1,7948,chr5_136693146_136701094
Col26a1,5,136741759,136883209,protein_coding,-1,141450,chr5_136741759_136883209
Ift22,5,136908150,136915404,protein_coding,1,7254,chr5_136908150_136915404
4933404O12Rik,5,136919146,136937112,lincRNA,1,17966,chr5_136919146_136937112
Fis1,5,136953275,136966234,protein_coding,1,12959,chr5_136953275_136966234
Cldn15,5,136966616,136975858,protein_coding,1,9242,chr5_136966616_136975858
Znhit1,5,136982164,136988021,protein_coding,-1,5857,chr5_136982164_136988021
Plod3,5,136987019,136996648,protein_coding,1,9629,chr5_136987019_136996648
Vgf,5,137026392,137033351,protein_coding,1,6959,chr5_137026392_137033351
Ap1s1,5,137034993,137046135,protein_coding,-1,11142,chr5_137034993_137046135
Serpine1,5,137061504,137072268,protein_coding,-1,10764,chr5_137061504_137072268
Trim56,5,137105644,137116209,protein_coding,-1,10565,chr5_137105644_137116209
Muc3,5,137134922,137149322,protein_coding,-1,14400,chr5_137134922_137149322
Gm3054,5,137154029,137166070,lincRNA,-1,12041,chr5_137154029_137166070
Gm40348,5,137166450,137172662,lincRNA,1,6212,chr5_137166450_137172662
Muc3a,5,137208813,137212389,protein_coding,-1,3576,chr5_137208813_137212389
Gm42456,5,137274093,137288662,lincRNA,-1,14569,chr5_137274093_137288662
Ache,5,137287519,137294466,protein_coding,1,6947,chr5_137287519_137294466
Ufsp1,5,137294629,137295665,protein_coding,1,1036,chr5_137294629_137295665
Srrt,5,137295704,137307674,protein_coding,-1,11970,chr5_137295704_137307674
Trip6,5,137309654,137314404,protein_coding,-1,4750,chr5_137309654_137314404
Slc12a9,5,137314558,137333597,protein_coding,-1,19039,chr5_137314558_137333597
Ephb4,5,137350109,137378669,protein_coding,1,28560,chr5_137350109_137378669
Zan,5,137378637,137477064,protein_coding,-1,98427,chr5_137378637_137477064
Epo,5,137483020,137533242,protein_coding,-1,50222,chr5_137483020_137533242
9130604C24Rik,5,137502673,137503628,lincRNA,1,955,chr5_137502673_137503628
Gm8066,5,137510253,137517501,lincRNA,1,7248,chr5_137510253_137517501
Gigyf1,5,137518548,137527935,protein_coding,1,9387,chr5_137518548_137527935
Gnb2,5,137528127,137533510,protein_coding,-1,5383,chr5_137528127_137533510
Gm17112,5,137532423,137540718,antisense,1,8295,chr5_137532423_137540718
Actl6b,5,137553517,137569582,protein_coding,1,16065,chr5_137553517_137569582
Tfr2,5,137569840,137587481,protein_coding,1,17641,chr5_137569840_137587481
Mospd3,5,137596645,137601058,protein_coding,-1,4413,chr5_137596645_137601058
Pcolce,5,137605103,137613784,protein_coding,-1,8681,chr5_137605103_137613784
Fbxo24,5,137612503,137629002,protein_coding,-1,16499,chr5_137612503_137629002
Gm36266,5,137612852,137615247,antisense,1,2395,chr5_137612852_137615247
Lrch4,5,137629121,137641099,protein_coding,1,11978,chr5_137629121_137641099
Gm20605,5,137629175,137642899,protein_coding,1,13724,chr5_137629175_137642899
Sap25,5,137641334,137642902,protein_coding,1,1568,chr5_137641334_137642902
Irs3,5,137643031,137645714,protein_coding,-1,2683,chr5_137643031_137645714
Agfg2,5,137650463,137684726,protein_coding,-1,34263,chr5_137650463_137684726
Gm15498,5,137685154,137690751,lincRNA,-1,5597,chr5_137685154_137690751
Nyap1,5,137729899,137741607,protein_coding,-1,11708,chr5_137729899_137741607
Tsc22d4,5,137745730,137768450,protein_coding,1,22720,chr5_137745730_137768450
Ppp1r35,5,137778849,137780110,protein_coding,1,1261,chr5_137778849_137780110
Mepce,5,137781906,137787655,protein_coding,-1,5749,chr5_137781906_137787655
Zcwpw1,5,137787798,137822621,protein_coding,1,34823,chr5_137787798_137822621
Pilra,5,137821952,137836281,protein_coding,-1,14329,chr5_137821952_137836281
Gm36551,5,137857045,137860318,antisense,1,3273,chr5_137857045_137860318
Cyp3a13,5,137892932,137921619,protein_coding,-1,28687,chr5_137892932_137921619
Gjc3,5,137953461,137963098,protein_coding,-1,9637,chr5_137953461_137963098
Azgp1,5,137981520,137990233,protein_coding,1,8713,chr5_137981520_137990233
Smok3b,5,138021429,138050636,protein_coding,1,29207,chr5_138021429_138050636
Smok3c,5,138053194,138066537,protein_coding,1,13343,chr5_138053194_138066537
Zkscan1,5,138085084,138107822,protein_coding,1,22738,chr5_138085084_138107822
Zscan21,5,138116903,138134265,protein_coding,1,17362,chr5_138116903_138134265
Zfp113,5,138139702,138155744,protein_coding,-1,16042,chr5_138139702_138155744
Cops6,5,138161071,138164646,protein_coding,1,3575,chr5_138161071_138164646
Mcm7,5,138164583,138172422,protein_coding,-1,7839,chr5_138164583_138172422
Ap4m1,5,138172002,138180429,protein_coding,1,8427,chr5_138172002_138180429
Taf6,5,138178617,138187451,protein_coding,-1,8834,chr5_138178617_138187451
Cnpy4,5,138187485,138193918,protein_coding,1,6433,chr5_138187485_138193918
Mblac1,5,138194314,138195621,protein_coding,1,1307,chr5_138194314_138195621
Gm454,5,138202134,138207310,transcribed_unprocessed_pseudogene,-1,5176,chr5_138202134_138207310
Nxpe5,5,138225898,138253363,protein_coding,1,27465,chr5_138225898_138253363
Lamtor4,5,138255482,138259398,protein_coding,1,3916,chr5_138255482_138259398
6330418K02Rik,5,138264043,138266661,antisense,1,2618,chr5_138264043_138266661
Gal3st4,5,138264921,138272840,protein_coding,-1,7919,chr5_138264921_138272840
Gm43720,5,138264952,138279958,protein_coding,-1,15006,chr5_138264952_138279958
Stag3,5,138280240,138312393,protein_coding,1,32153,chr5_138280240_138312393
Gm10874,5,138363719,138388287,lincRNA,1,24568,chr5_138363719_138388287
Zfp157,5,138441468,138460694,protein_coding,1,19226,chr5_138441468_138460694
1700123K08Rik,5,138561840,138564712,protein_coding,-1,2872,chr5_138561840_138564712
Zfp68,5,138603652,138619761,protein_coding,-1,16109,chr5_138603652_138619761
A430033K04Rik,5,138622859,138652414,protein_coding,1,29555,chr5_138622859_138652414
Fam20c,5,138754514,138810077,protein_coding,1,55563,chr5_138754514_138810077
Pdgfa,5,138976014,138997370,protein_coding,-1,21356,chr5_138976014_138997370
6330403L08Rik,5,138995056,139000577,antisense,1,5521,chr5_138995056_139000577
Prkar1b,5,139017306,139150001,protein_coding,-1,132695,chr5_139017306_139150001
Dnaaf5,5,139150223,139186510,protein_coding,1,36287,chr5_139150223_139186510
Sun1,5,139200637,139249840,protein_coding,1,49203,chr5_139200637_139249840
4930520M14Rik,5,139215469,139216356,antisense,-1,887,chr5_139215469_139216356
Get4,5,139252324,139270051,protein_coding,1,17727,chr5_139252324_139270051
Adap1,5,139271876,139325622,protein_coding,-1,53746,chr5_139271876_139325622
Cox19,5,139336189,139351418,protein_coding,-1,15229,chr5_139336189_139351418
Cyp2w1,5,139352617,139357033,protein_coding,1,4416,chr5_139352617_139357033
3110082I17Rik,5,139359739,139460527,protein_coding,-1,100788,chr5_139359739_139460527
Gpr146,5,139377697,139396415,protein_coding,1,18718,chr5_139377697_139396415
C130050O18Rik,5,139405280,139415623,protein_coding,1,10343,chr5_139405280_139415623
Gper1,5,139423151,139427800,protein_coding,1,4649,chr5_139423151_139427800
Zfand2a,5,139471211,139484549,protein_coding,-1,13338,chr5_139471211_139484549
4930500L23Rik,5,139523749,139541339,lincRNA,1,17590,chr5_139523749_139541339
Uncx,5,139543494,139548179,protein_coding,1,4685,chr5_139543494_139548179
Micall2,5,139706696,139736336,protein_coding,-1,29640,chr5_139706696_139736336
Ints1,5,139751282,139775674,protein_coding,-1,24392,chr5_139751282_139775674
Mafk,5,139791513,139802653,protein_coding,1,11140,chr5_139791513_139802653
Tmem184a,5,139802485,139819917,protein_coding,-1,17432,chr5_139802485_139819917
Gm26938,5,139807978,139826407,protein_coding,-1,18429,chr5_139807978_139826407
Psmg3,5,139823592,139826885,protein_coding,-1,3293,chr5_139823592_139826885
Gm42423,5,139895809,139902734,lincRNA,1,6925,chr5_139895809_139902734
Elfn1,5,139907943,139974722,protein_coding,1,66779,chr5_139907943_139974722
Mad1l1,5,140008689,140321552,protein_coding,-1,312863,chr5_140008689_140321552
Gm16122,5,140074105,140085512,antisense,1,11407,chr5_140074105_140085512
Gm16121,5,140101199,140107591,antisense,1,6392,chr5_140101199_140107591
Gm16120,5,140207385,140210751,antisense,1,3366,chr5_140207385_140210751
Nudt1,5,140321656,140338137,protein_coding,1,16481,chr5_140321656_140338137
Mrm2,5,140327674,140331898,protein_coding,-1,4224,chr5_140327674_140331898
Snx8,5,140340299,140389262,protein_coding,-1,48963,chr5_140340299_140389262
Eif3b,5,140419328,140443360,protein_coding,1,24032,chr5_140419328_140443360
Gm4869,5,140445645,140495071,protein_coding,1,49426,chr5_140445645_140495071
Chst12,5,140505550,140525724,protein_coding,1,20174,chr5_140505550_140525724
Lfng,5,140607320,140615545,protein_coding,1,8225,chr5_140607320_140615545
Ttyh3,5,140620578,140649031,protein_coding,-1,28453,chr5_140620578_140649031
Iqce,5,140661827,140702378,protein_coding,-1,40551,chr5_140661827_140702378
Brat1,5,140705011,140719379,protein_coding,1,14368,chr5_140705011_140719379
Amz1,5,140724127,140761439,protein_coding,1,37312,chr5_140724127_140761439
Gna12,5,140758408,140830431,protein_coding,-1,72023,chr5_140758408_140830431
Card11,5,140872990,141000582,protein_coding,-1,127592,chr5_140872990_141000582
Sdk1,5,141241490,142215586,protein_coding,1,974096,chr5_141241490_142215586
Gm16035,5,141373179,141380926,antisense,-1,7747,chr5_141373179_141380926
Gm16036,5,141595985,141616002,antisense,-1,20017,chr5_141595985_141616002
Foxk1,5,142401497,142462011,protein_coding,1,60514,chr5_142401497_142462011
Ap5z1,5,142463944,142478710,protein_coding,1,14766,chr5_142463944_142478710
Radil,5,142484839,142551098,protein_coding,-1,66259,chr5_142484839_142551098
Mmd2,5,142562358,142608800,protein_coding,-1,46442,chr5_142562358_142608800
Wipi2,5,142627698,142670588,protein_coding,1,42890,chr5_142627698_142670588
Slc29a4,5,142692512,142722490,protein_coding,1,29978,chr5_142692512_142722490
Tnrc18,5,142724661,142817662,protein_coding,-1,93001,chr5_142724661_142817662
Fbxl18,5,142866946,142895421,protein_coding,-1,28475,chr5_142866946_142895421
Actb,5,142903115,142906754,protein_coding,-1,3639,chr5_142903115_142906754
Fscn1,5,142960343,142973185,protein_coding,1,12842,chr5_142960343_142973185
Rnf216,5,142990893,143112994,protein_coding,-1,122101,chr5_142990893_143112994
Olfr718-ps1,5,143134014,143147581,protein_coding,-1,13567,chr5_143134014_143147581
Rbak,5,143172186,143180775,protein_coding,-1,8589,chr5_143172186_143180775
Spdye4b,5,143181017,143205075,protein_coding,1,24058,chr5_143181017_143205075
Spdye4a,5,143216316,143226890,protein_coding,-1,10574,chr5_143216316_143226890
4930448H16Rik,5,143227718,143234748,lincRNA,1,7030,chr5_143227718_143234748
Zfp12,5,143235163,143248834,protein_coding,1,13671,chr5_143235163_143248834
Zfp316,5,143249697,143270022,protein_coding,-1,20325,chr5_143249697_143270022
BC030343,5,143270075,143272513,lincRNA,1,2438,chr5_143270075_143272513
Zfp853,5,143287038,143293623,protein_coding,-1,6585,chr5_143287038_143293623
E130309D02Rik,5,143301195,143315360,protein_coding,-1,14165,chr5_143301195_143315360
Zdhhc4,5,143316489,143329256,protein_coding,-1,12767,chr5_143316489_143329256
0610040B10Rik,5,143329247,143332704,antisense,1,3457,chr5_143329247_143332704
Grid2ip,5,143357338,143392152,protein_coding,1,34814,chr5_143357338_143392152
Gm20635,5,143390730,143403748,antisense,-1,13018,chr5_143390730_143403748
Kdelr2,5,143403838,143421901,protein_coding,1,18063,chr5_143403838_143421901
Daglb,5,143464584,143505942,protein_coding,1,41358,chr5_143464584_143505942
Rac1,5,143503634,143528036,protein_coding,-1,24402,chr5_143503634_143528036
Fam220a,5,143548706,143564531,protein_coding,1,15825,chr5_143548706_143564531
Cyth3,5,143622447,143710250,protein_coding,1,87803,chr5_143622447_143710250
Usp42,5,143710325,143732280,protein_coding,-1,21955,chr5_143710325_143732280
D130017N08Rik,5,143758354,143768575,lincRNA,1,10221,chr5_143758354_143768575
Eif2ak1,5,143817788,143904251,protein_coding,1,86463,chr5_143817788_143904251
Ankrd61,5,143890741,143897685,protein_coding,-1,6944,chr5_143890741_143897685
Aimp2,5,143902704,143909847,protein_coding,-1,7143,chr5_143902704_143909847
Pms2,5,143909964,143933968,protein_coding,1,24004,chr5_143909964_143933968
Gm17135,5,143922577,143980991,antisense,-1,58414,chr5_143922577_143980991
Rsph10b,5,143933035,143985719,protein_coding,1,52684,chr5_143933035_143985719
Ccz1,5,143987909,144014877,protein_coding,-1,26968,chr5_143987909_144014877
Ocm,5,144019804,144026670,protein_coding,-1,6866,chr5_144019804_144026670
Lmtk2,5,144100436,144188204,protein_coding,1,87768,chr5_144100436_144188204
Bhlha15,5,144190286,144194441,protein_coding,1,4155,chr5_144190286_144194441
Tecpr1,5,144194442,144223615,protein_coding,-1,29173,chr5_144194442_144223615
2900089D17Rik,5,144241690,144256186,antisense,-1,14496,chr5_144241690_144256186
Bri3,5,144244437,144446757,protein_coding,1,202320,chr5_144244437_144446757
Baiap2l1,5,144264526,144358112,protein_coding,-1,93586,chr5_144264526_144358112
Nptx2,5,144545902,144557478,protein_coding,1,11576,chr5_144545902_144557478
Tmem130,5,144735915,144761818,protein_coding,-1,25903,chr5_144735915_144761818
Trrap,5,144767732,144859778,protein_coding,1,92046,chr5_144767732_144859778
Smurf1,5,144876495,144965847,protein_coding,-1,89352,chr5_144876495_144965847
Kpna7,5,144983519,145084030,protein_coding,-1,100511,chr5_144983519_145084030
Arpc1a,5,145083830,145108761,protein_coding,1,24931,chr5_145083830_145108761
Arpc1b,5,145114215,145130705,protein_coding,1,16490,chr5_145114215_145130705
Pdap1,5,145128769,145140238,protein_coding,-1,11469,chr5_145128769_145140238
Bud31,5,145140362,145148078,protein_coding,1,7716,chr5_145140362_145148078
Ptcd1,5,145147514,145167108,protein_coding,-1,19594,chr5_145147514_145167108
Cpsf4,5,145167213,145182041,protein_coding,1,14828,chr5_145167213_145182041
Atp5j2,5,145183698,145192062,protein_coding,-1,8364,chr5_145183698_145192062
Zkscan14,5,145194946,145201868,protein_coding,-1,6922,chr5_145194946_145201868
Zkscan5,5,145204562,145221750,protein_coding,1,17188,chr5_145204562_145221750
Zfp655,5,145231715,145247302,protein_coding,1,15587,chr5_145231715_145247302
Zscan25,5,145280500,145291278,protein_coding,1,10778,chr5_145280500_145291278
Cyp3a57,5,145345279,145390926,protein_coding,1,45647,chr5_145345279_145390926
Cyp3a16,5,145436309,145469723,protein_coding,-1,33414,chr5_145436309_145469723
Cyp3a41b,5,145558664,145584730,protein_coding,-1,26066,chr5_145558664_145584730
Cyp3a41a,5,145694049,145720136,protein_coding,-1,26087,chr5_145694049_145720136
Cyp3a44,5,145773983,145805874,protein_coding,-1,31891,chr5_145773983_145805874
Cyp3a11,5,145854426,145879964,protein_coding,-1,25538,chr5_145854426_145879964
Cyp3a25,5,145977194,146009618,protein_coding,-1,32424,chr5_145977194_146009618
Cyp3a59,5,146079257,146113287,protein_coding,1,34030,chr5_146079257_146113287
1700001J03Rik,5,146182441,146185304,protein_coding,-1,2863,chr5_146182441_146185304
B230303O12Rik,5,146188620,146194809,lincRNA,-1,6189,chr5_146188620_146194809
Gm43625,5,146203251,146204789,lincRNA,-1,1538,chr5_146203251_146204789
Rnf6,5,146209192,146221555,protein_coding,-1,12363,chr5_146209192_146221555
Cdk8,5,146231230,146302874,protein_coding,1,71644,chr5_146231230_146302874
Wasf3,5,146384985,146473615,protein_coding,1,88630,chr5_146384985_146473615
Gm6408,5,146481965,146484704,protein_coding,1,2739,chr5_146481965_146484704
Gpr12,5,146582398,146585239,protein_coding,-1,2841,chr5_146582398_146585239
Gm34333,5,146586645,146600102,lincRNA,-1,13457,chr5_146586645_146600102
Usp12,5,146734809,146795006,protein_coding,-1,60197,chr5_146734809_146795006
1700041I07Rik,5,146795918,146806433,lincRNA,1,10515,chr5_146795918_146806433
Rpl21,5,146832890,146837032,protein_coding,1,4142,chr5_146832890_146837032
Rasl11a,5,146845071,146847726,protein_coding,1,2655,chr5_146845071_146847726
Gtf3a,5,146948657,146955614,protein_coding,1,6957,chr5_146948657_146955614
Mtif3,5,146951573,146963800,protein_coding,-1,12227,chr5_146951573_146963800
Lnx2,5,147016655,147076586,protein_coding,-1,59931,chr5_147016655_147076586
Polr1d,5,147077050,147111597,protein_coding,1,34547,chr5_147077050_147111597
Plut,5,147228596,147271521,antisense,-1,42925,chr5_147228596_147271521
Urad,5,147314984,147322440,protein_coding,-1,7456,chr5_147314984_147322440
Flt3,5,147330741,147400489,protein_coding,-1,69748,chr5_147330741_147400489
Gm26597,5,147399554,147401917,antisense,1,2363,chr5_147399554_147401917
D5Ertd605e,5,147418601,147423044,lincRNA,1,4443,chr5_147418601_147423044
Pan3,5,147430161,147548502,protein_coding,1,118341,chr5_147430161_147548502
Flt1,5,147561604,147726011,protein_coding,-1,164407,chr5_147561604_147726011
Gm43156,5,147745516,147749176,lincRNA,1,3660,chr5_147745516_147749176
Pomp,5,147860461,147876456,protein_coding,1,15995,chr5_147860461_147876456
Slc46a3,5,147878437,147894815,protein_coding,-1,16378,chr5_147878437_147894815
Gm15721,5,147949882,147957166,lincRNA,-1,7284,chr5_147949882_147957166
Mtus2,5,147957320,148316065,protein_coding,1,358745,chr5_147957320_148316065
Slc7a1,5,148327410,148399904,protein_coding,-1,72494,chr5_148327410_148399904
Ubl3,5,148504635,148552789,protein_coding,-1,48154,chr5_148504635_148552789
Gm36186,5,148711466,148718397,lincRNA,1,6931,chr5_148711466_148718397
4930505K14Rik,5,148777963,148783080,lincRNA,1,5117,chr5_148777963_148783080
Gm15407,5,148820767,148837798,lincRNA,1,17031,chr5_148820767_148837798
Katnal1,5,148871584,148929320,protein_coding,-1,57736,chr5_148871584_148929320
Gm42791,5,148893775,148995147,protein_coding,-1,101372,chr5_148893775_148995147
Gm15406,5,148948897,148996566,lincRNA,-1,47669,chr5_148948897_148996566
8430423G03Rik,5,148950250,148951658,lincRNA,1,1408,chr5_148950250_148951658
Gm15409,5,148959278,148961712,lincRNA,1,2434,chr5_148959278_148961712
Gm15408,5,149006962,149012776,lincRNA,1,5814,chr5_149006962_149012776
Hmgb1,5,149046702,149184489,protein_coding,-1,137787,chr5_149046702_149184489
Gm42787,5,149128584,149129957,lincRNA,1,1373,chr5_149128584_149129957
Gm42788,5,149144263,149153540,lincRNA,1,9277,chr5_149144263_149153540
Gm43332,5,149183183,149184226,lincRNA,1,1043,chr5_149183183_149184226
Uspl1,5,149184350,149215434,protein_coding,1,31084,chr5_149184350_149215434
2310047D07Rik,5,149231332,149237984,lincRNA,1,6652,chr5_149231332_149237984
Gm29264,5,149234816,149247682,lincRNA,-1,12866,chr5_149234816_149247682
Alox5ap,5,149264767,149288153,protein_coding,1,23386,chr5_149264767_149288153
Gm19719,5,149282752,149287868,antisense,-1,5116,chr5_149282752_149287868
BC028471,5,149367636,149393596,lincRNA,1,25960,chr5_149367636_149393596
Medag,5,149411749,149431723,protein_coding,1,19974,chr5_149411749_149431723
Gm43151,5,149423363,149425099,antisense,-1,1736,chr5_149423363_149425099
Gm43150,5,149425653,149428962,antisense,-1,3309,chr5_149425653_149428962
Tex26,5,149439660,149470979,protein_coding,1,31319,chr5_149439660_149470979
Gm15997,5,149489056,149538030,antisense,-1,48974,chr5_149489056_149538030
Wdr95,5,149528679,149611894,protein_coding,1,83215,chr5_149528679_149611894
Hsph1,5,149614287,149636376,protein_coding,-1,22089,chr5_149614287_149636376
Gm20005,5,149641610,149647790,lincRNA,1,6180,chr5_149641610_149647790
B3glct,5,149678230,149762599,protein_coding,1,84369,chr5_149678230_149762599
Rxfp2,5,150018675,150082184,protein_coding,1,63509,chr5_150018675_150082184
Gm42557,5,150067258,150082795,antisense,-1,15537,chr5_150067258_150082795
Fry,5,150118645,150497753,protein_coding,1,379108,chr5_150118645_150497753
Gm42556,5,150283995,150299441,antisense,-1,15446,chr5_150283995_150299441
Gm5,5,150499747,150502304,lincRNA,-1,2557,chr5_150499747_150502304
Zar1l,5,150507055,150518164,protein_coding,-1,11109,chr5_150507055_150518164
Brca2,5,150522630,150570329,protein_coding,1,47699,chr5_150522630_150570329
Gm42529,5,150560209,150566426,antisense,-1,6217,chr5_150560209_150566426
Gm43690,5,150570833,150571098,lincRNA,-1,265,chr5_150570833_150571098
N4bp2l1,5,150571644,150597188,protein_coding,-1,25544,chr5_150571644_150597188
Gm43598,5,150597062,150599540,lincRNA,-1,2478,chr5_150597062_150599540
Gm43597,5,150599932,150607003,lincRNA,-1,7071,chr5_150599932_150607003
N4bp2l2,5,150608007,150666183,protein_coding,-1,58176,chr5_150608007_150666183
Pds5b,5,150673739,150810690,protein_coding,1,136951,chr5_150673739_150810690
Gm36447,5,150822859,150866601,lincRNA,1,43742,chr5_150822859_150866601
Gm43298,5,150863963,150882642,lincRNA,-1,18679,chr5_150863963_150882642
Kl,5,150952607,150993817,protein_coding,1,41210,chr5_150952607_150993817
Stard13,5,151037510,151233836,protein_coding,-1,196326,chr5_151037510_151233836
Gm42906,5,151063546,151428163,protein_coding,-1,364617,chr5_151063546_151428163
5430435K18Rik,5,151252305,151259264,lincRNA,1,6959,chr5_151252305_151259264
Vmn2r18,5,151561190,151606021,protein_coding,-1,44831,chr5_151561190_151606021
Rfc3,5,151642756,151651242,protein_coding,-1,8486,chr5_151642756_151651242
Gm43129,5,151685811,151693926,lincRNA,1,8115,chr5_151685811_151693926
Gm8579,6,3288519,3317019,lincRNA,1,28500,chr6_3288519_3317019
Samd9l,6,3372257,3399572,protein_coding,-1,27315,chr6_3372257_3399572
Hepacam2,6,3457096,3498298,protein_coding,-1,41202,chr6_3457096_3498298
Vps50,6,3498382,3603531,protein_coding,1,105149,chr6_3498382_3603531
Calcr,6,3685680,3764714,protein_coding,-1,79034,chr6_3685680_3764714
Tfpi2,6,3962595,3988919,protein_coding,-1,26324,chr6_3962595_3988919
Gng11,6,4003904,4008445,protein_coding,1,4541,chr6_4003904_4008445
4930528H21Rik,6,4031841,4047585,lincRNA,-1,15744,chr6_4031841_4047585
Bet1,6,4076899,4086972,protein_coding,-1,10073,chr6_4076899_4086972
Col1a2,6,4504814,4541544,protein_coding,1,36730,chr6_4504814_4541544
Casd1,6,4600839,4643355,protein_coding,1,42516,chr6_4600839_4643355
Sgce,6,4674350,4747207,protein_coding,-1,72857,chr6_4674350_4747207
Peg10,6,4747306,4760517,protein_coding,1,13211,chr6_4747306_4760517
Gm20714,6,4807055,4816329,lincRNA,-1,9274,chr6_4807055_4816329
Ppp1r9a,6,4902917,5165661,protein_coding,1,262744,chr6_4902917_5165661
Pon1,6,5168090,5193946,protein_coding,-1,25856,chr6_5168090_5193946
Pon3,6,5220852,5256286,protein_coding,-1,35434,chr6_5220852_5256286
Pon2,6,5264147,5298455,protein_coding,-1,34308,chr6_5264147_5298455
Asb4,6,5383386,5433022,protein_coding,1,49636,chr6_5383386_5433022
Pdk4,6,5483351,5496309,protein_coding,-1,12958,chr6_5483351_5496309
Dync1i1,6,5725639,6028039,protein_coding,1,302400,chr6_5725639_6028039
1700019G24Rik,6,5963909,5977393,antisense,-1,13484,chr6_5963909_5977393
Slc25a13,6,6041218,6217173,protein_coding,-1,175955,chr6_6041218_6217173
Gm20619,6,6248659,6378675,lincRNA,1,130016,chr6_6248659_6378675
Gm20617,6,6456189,6484487,lincRNA,-1,28298,chr6_6456189_6484487
Gm20685,6,6483022,6508616,lincRNA,1,25594,chr6_6483022_6508616
Sem1,6,6557294,6578663,protein_coding,-1,21369,chr6_6557294_6578663
Gm20618,6,6603219,6691521,lincRNA,-1,88302,chr6_6603219_6691521
Dlx6os1,6,6820189,6871633,antisense;misc_RNA,-1,51444,chr6_6820189_6871633
Dlx6,6,6863334,6868568,protein_coding,1,5234,chr6_6863334_6868568
Dlx5,6,6877805,6882085,protein_coding,-1,4280,chr6_6877805_6882085
Gm26774,6,6952170,6955900,lincRNA,-1,3730,chr6_6952170_6955900
Sdhaf3,6,6956004,7042979,protein_coding,1,86975,chr6_6956004_7042979
Gm19272,6,7301908,7309747,lincRNA,1,7839,chr6_7301908_7309747
Tac1,6,7554879,7565834,protein_coding,1,10955,chr6_7554879_7565834
Asns,6,7675169,7693254,protein_coding,-1,18085,chr6_7675169_7693254
1700012J15Rik,6,7766394,7777681,lincRNA,1,11287,chr6_7766394_7777681
C1galt1,6,7844842,7875687,protein_coding,1,30845,chr6_7844842_7875687
Col28a1,6,7997808,8192617,protein_coding,-1,194809,chr6_7997808_8192617
Mios,6,8209222,8236274,protein_coding,1,27052,chr6_8209222_8236274
Rpa3,6,8255936,8259173,protein_coding,-1,3237,chr6_8255936_8259173
Umad1,6,8259288,8459470,protein_coding,1,200182,chr6_8259288_8459470
Gm45062,6,8259450,8597480,protein_coding,1,338030,chr6_8259450_8597480
Gm16055,6,8354056,8364136,antisense,-1,10080,chr6_8354056_8364136
Gm16043,6,8420009,8443455,antisense,-1,23446,chr6_8420009_8443455
Glcci1,6,8509600,8597548,protein_coding,1,87948,chr6_8509600_8597548
Ica1,6,8630527,8778488,protein_coding,-1,147961,chr6_8630527_8778488
Nxph1,6,8948431,9249032,protein_coding,1,300601,chr6_8948431_9249032
Gm35822,6,10895490,10970126,lincRNA,1,74636,chr6_10895490_10970126
AA545190,6,10971560,10979638,lincRNA,-1,8078,chr6_10971560_10979638
Ndufa4,6,11900292,11907497,protein_coding,-1,7205,chr6_11900292_11907497
Phf14,6,11907809,12081205,protein_coding,1,173396,chr6_11907809_12081205
Thsd7a,6,12311610,12749410,protein_coding,-1,437800,chr6_12311610_12749410
Gm44129,6,12608996,12658956,lincRNA,1,49960,chr6_12608996_12658956
Tmem106b,6,13069759,13089269,protein_coding,1,19510,chr6_13069759_13089269
Vwde,6,13156299,13224965,protein_coding,-1,68666,chr6_13156299_13224965
1700016P04Rik,6,13413337,13415996,lincRNA,1,2659,chr6_13413337_13415996
Tmem168,6,13580687,13608100,protein_coding,-1,27413,chr6_13580687_13608100
Bmt2,6,13625673,13677966,protein_coding,-1,52293,chr6_13625673_13677966
Gpr85,6,13834458,13839942,protein_coding,-1,5484,chr6_13834458_13839942
2610001J05Rik,6,13867735,13871518,protein_coding,-1,3783,chr6_13867735_13871518
1110019D14Rik,6,13871526,14044385,lincRNA,1,172859,chr6_13871526_14044385
Ppp1r3a,6,14713977,14755274,protein_coding,-1,41297,chr6_14713977_14755274
Foxp2,6,14901349,15441977,protein_coding,1,540628,chr6_14901349_15441977
Mdfic,6,15720661,15802169,protein_coding,1,81508,chr6_15720661_15802169
Gm36503,6,16550387,16579873,lincRNA,1,29486,chr6_16550387_16579873
Tfec,6,16833373,16898441,protein_coding,-1,65068,chr6_16833373_16898441
Gm15473,6,17058806,17064996,lincRNA,-1,6190,chr6_17058806_17064996
Gm4876,6,17065010,17171833,antisense,-1,106823,chr6_17065010_17171833
Tes,6,17065149,17105828,protein_coding,1,40679,chr6_17065149_17105828
D830026I12Rik,6,17197751,17210152,lincRNA,1,12401,chr6_17197751_17210152
Gm15581,6,17206823,17385604,antisense,-1,178781,chr6_17206823_17385604
Cav2,6,17281185,17289115,protein_coding,1,7930,chr6_17281185_17289115
Cav1,6,17306335,17341452,protein_coding,1,35117,chr6_17306335_17341452
Met,6,17463800,17573980,protein_coding,1,110180,chr6_17463800_17573980
Capza2,6,17636234,17666972,protein_coding,1,30738,chr6_17636234_17666972
St7,6,17692933,17943025,protein_coding,1,250092,chr6_17692933_17943025
Gm26738,6,17834585,17835185,antisense,-1,600,chr6_17834585_17835185
Wnt2,6,17988940,18030585,protein_coding,-1,41645,chr6_17988940_18030585
Asz1,6,18050964,18109061,protein_coding,-1,58097,chr6_18050964_18109061
Cftr,6,18170687,18322768,protein_coding,1,152081,chr6_18170687_18322768
Gm15592,6,18270136,18289048,antisense,-1,18912,chr6_18270136_18289048
Cttnbp2,6,18366478,18514843,protein_coding,-1,148365,chr6_18366478_18514843
Gm15594,6,18424684,18427885,antisense,1,3201,chr6_18424684_18427885
Gm20186,6,18845910,18848207,lincRNA,-1,2297,chr6_18845910_18848207
Lsm8,6,18848579,18855751,protein_coding,1,7172,chr6_18848579_18855751
Ankrd7,6,18866318,18879586,protein_coding,1,13268,chr6_18866318_18879586
4930524B17Rik,6,19247899,19278843,lincRNA,-1,30944,chr6_19247899_19278843
Kcnd2,6,21215503,21729805,protein_coding,1,514302,chr6_21215503_21729805
Tspan12,6,21771395,21852515,protein_coding,-1,81120,chr6_21771395_21852515
Gm30270,6,21852418,21853483,antisense,1,1065,chr6_21852418_21853483
Gm3289,6,21852981,21858178,lincRNA,-1,5197,chr6_21852981_21858178
Ing3,6,21949571,21976038,protein_coding,1,26467,chr6_21949571_21976038
Cped1,6,21985916,22256404,protein_coding,1,270488,chr6_21985916_22256404
Wnt16,6,22288227,22298522,protein_coding,1,10295,chr6_22288227_22298522
Fam3c,6,22306520,22356243,protein_coding,-1,49723,chr6_22306520_22356243
Ptprz1,6,22875502,23052916,protein_coding,1,177414,chr6_22875502_23052916
Aass,6,23072173,23132986,protein_coding,-1,60813,chr6_23072173_23132986
Cadps2,6,23262773,23839421,protein_coding,-1,576648,chr6_23262773_23839421
Slc13a1,6,24088283,24168092,protein_coding,-1,79809,chr6_24088283_24168092
Iqub,6,24444865,24515067,protein_coding,-1,70202,chr6_24444865_24515067
Ndufa5,6,24518666,24528013,protein_coding,-1,9347,chr6_24518666_24528013
Asb15,6,24528144,24573164,protein_coding,1,45020,chr6_24528144_24573164
Lmod2,6,24597762,24605414,protein_coding,1,7652,chr6_24597762_24605414
Wasl,6,24613805,24665009,protein_coding,-1,51204,chr6_24613805_24665009
Hyal6,6,24733245,24745452,protein_coding,1,12207,chr6_24733245_24745452
Hyal4,6,24748329,24767662,protein_coding,1,19333,chr6_24748329_24767662
Hyal5,6,24857997,24891958,protein_coding,1,33961,chr6_24857997_24891958
Tmem229a,6,24951141,24956297,protein_coding,-1,5156,chr6_24951141_24956297
Gpr37,6,25665878,25690729,protein_coding,-1,24851,chr6_25665878_25690729
Pot1a,6,25743737,25809246,protein_coding,-1,65509,chr6_25743737_25809246
Gm20756,6,25931426,25977227,lincRNA,1,45801,chr6_25931426_25977227
Grm8,6,27275119,28135178,protein_coding,-1,860059,chr6_27275119_28135178
6530409C15Rik,6,28215555,28260862,antisense,1,45307,chr6_28215555_28260862
Zfp800,6,28239927,28398005,protein_coding,-1,158078,chr6_28239927_28398005
Gcc1,6,28416091,28428390,protein_coding,-1,12299,chr6_28416091_28428390
Arf5,6,28423560,28426602,protein_coding,1,3042,chr6_28423560_28426602
Fscn3,6,28427789,28438622,protein_coding,1,10833,chr6_28427789_28438622
Pax4,6,28442334,28449353,protein_coding,-1,7019,chr6_28442334_28449353
Snd1,6,28475139,28935162,protein_coding,1,460023,chr6_28475139_28935162
Lrrc4,6,28661831,28831747,protein_coding,-1,169916,chr6_28661831_28831747
Gm3294,6,28981634,29028922,lincRNA,1,47288,chr6_28981634_29028922
Lep,6,29060220,29073877,protein_coding,1,13657,chr6_29060220_29073877
Rbm28,6,29123576,29165006,protein_coding,-1,41430,chr6_29123576_29165006
Prrt4,6,29169232,29179584,protein_coding,-1,10352,chr6_29169232_29179584
Impdh1,6,29200434,29216364,protein_coding,-1,15930,chr6_29200434_29216364
Hilpda,6,29272488,29275446,protein_coding,1,2958,chr6_29272488_29275446
Fam71f2,6,29279593,29290680,protein_coding,1,11087,chr6_29279593_29290680
Fam71f1,6,29319140,29336019,protein_coding,1,16879,chr6_29319140_29336019
Calu,6,29348069,29377110,protein_coding,1,29041,chr6_29348069_29377110
Opn1sw,6,29376671,29388468,protein_coding,-1,11797,chr6_29376671_29388468
Ccdc136,6,29396309,29426994,protein_coding,1,30685,chr6_29396309_29426994
Flnc,6,29433256,29461883,protein_coding,1,28627,chr6_29433256_29461883
Atp6v1f,6,29467718,29470512,protein_coding,1,2794,chr6_29467718_29470512
Kcp,6,29473162,29507952,protein_coding,-1,34790,chr6_29473162_29507952
Irf5,6,29526625,29541871,protein_coding,1,15246,chr6_29526625_29541871
Tnpo3,6,29540827,29609887,protein_coding,-1,69060,chr6_29540827_29609887
Tspan33,6,29694222,29718559,protein_coding,1,24337,chr6_29694222_29718559
Smo,6,29735503,29761365,protein_coding,1,25862,chr6_29735503_29761365
Ahcyl2,6,29768011,29912310,protein_coding,1,144299,chr6_29768011_29912310
Strip2,6,29917012,29959681,protein_coding,1,42669,chr6_29917012_29959681
Smkr-ps,6,29985235,29993778,transcribed_unitary_pseudogene,1,8543,chr6_29985235_29993778
Nrf1,6,30047988,30153458,protein_coding,1,105470,chr6_30047988_30153458
Ube2h,6,30211289,30304539,protein_coding,-1,93250,chr6_30211289_30304539
1700095J07Rik,6,30304605,30331779,lincRNA,1,27174,chr6_30304605_30331779
Zc3hc1,6,30366380,30391028,protein_coding,-1,24648,chr6_30366380_30391028
Klhdc10,6,30401868,30455179,protein_coding,1,53311,chr6_30401868_30455179
1700012C14Rik,6,30460128,30463313,lincRNA,1,3185,chr6_30460128_30463313
Tmem209,6,30479053,30509783,protein_coding,-1,30730,chr6_30479053_30509783
Ssmem1,6,30509849,30520254,protein_coding,1,10405,chr6_30509849_30520254
Cpa2,6,30541582,30564476,protein_coding,1,22894,chr6_30541582_30564476
Cpa4,6,30568369,30592418,protein_coding,1,24049,chr6_30568369_30592418
Cpa5,6,30611010,30631745,protein_coding,1,20735,chr6_30611010_30631745
Cep41,6,30653457,30693749,protein_coding,-1,40292,chr6_30653457_30693749
Gm13782,6,30673944,30682266,antisense,1,8322,chr6_30673944_30682266
Mest,6,30723547,30748465,protein_coding,1,24918,chr6_30723547_30748465
Gm44296,6,30735029,30735924,antisense,-1,895,chr6_30735029_30735924
Copg2,6,30747554,30896794,protein_coding,-1,149240,chr6_30747554_30896794
4930412F09Rik,6,30896899,30943470,lincRNA,1,46571,chr6_30896899_30943470
Tsga13,6,30896981,30915573,protein_coding,-1,18592,chr6_30896981_30915573
Klf14,6,30956023,30959078,protein_coding,-1,3055,chr6_30956023_30959078
Gm27019,6,31063092,31063495,lincRNA,-1,403,chr6_31063092_31063495
Lncpint,6,31082565,31220488,lincRNA,-1,137923,chr6_31082565_31220488
Gm13833,6,31102846,31104646,lincRNA,1,1800,chr6_31102846_31104646
Gm14532,6,31356743,31372369,lincRNA,1,15626,chr6_31356743_31372369
Mkln1os,6,31366885,31398773,lincRNA,-1,31888,chr6_31366885_31398773
Gm13844,6,31372895,31383877,lincRNA,1,10982,chr6_31372895_31383877
Mkln1,6,31398735,31516811,protein_coding,1,118076,chr6_31398735_31516811
Podxl,6,31519488,31563981,protein_coding,-1,44493,chr6_31519488_31563981
Gm6117,6,31574967,31576723,lincRNA,1,1756,chr6_31574967_31576723
Gm43154,6,31605190,31798053,lincRNA,1,192863,chr6_31605190_31798053
Gm13848,6,31658173,31666131,lincRNA,-1,7958,chr6_31658173_31666131
Gm43293,6,31702245,31706990,lincRNA,-1,4745,chr6_31702245_31706990
Gm13849,6,31786675,31922270,lincRNA,1,135595,chr6_31786675_31922270
1700012A03Rik,6,32050246,32058921,protein_coding,1,8675,chr6_32050246_32058921
Plxna4,6,32144268,32588192,protein_coding,-1,443924,chr6_32144268_32588192
Plxna4os3,6,32303829,32316614,antisense,1,12785,chr6_32303829_32316614
Plxna4os2,6,32451170,32454750,antisense,1,3580,chr6_32451170_32454750
Plxna4os1,6,32511073,32515576,antisense,1,4503,chr6_32511073_32515576
BC049739,6,32751629,32752288,lincRNA,-1,659,chr6_32751629_32752288
Chchd3,6,32790976,33060260,protein_coding,-1,269284,chr6_32790976_33060260
Gm14540,6,33038468,33043222,antisense,1,4754,chr6_33038468_33043222
Exoc4,6,33249085,33973979,protein_coding,1,724894,chr6_33249085_33973979
Gm13853,6,33984989,33992411,lincRNA,-1,7422,chr6_33984989_33992411
Lrguk,6,34029448,34134034,protein_coding,1,104586,chr6_34029448_34134034
Gm13856,6,34151929,34174235,antisense,1,22306,chr6_34151929_34174235
Slc35b4,6,34153380,34177111,protein_coding,-1,23731,chr6_34153380_34177111
Gm14546,6,34290265,34324249,antisense,1,33984,chr6_34290265_34324249
Akr1b3,6,34302434,34317478,protein_coding,-1,15044,chr6_34302434_34317478
Akr1b8,6,34354119,34368463,protein_coding,1,14344,chr6_34354119_34368463
Akr1b10,6,34384218,34396950,protein_coding,1,12732,chr6_34384218_34396950
Bpgm,6,34476207,34505613,protein_coding,1,29406,chr6_34476207_34505613
Gm13860,6,34533553,34541387,lincRNA,1,7834,chr6_34533553_34541387
Cald1,6,34598500,34775473,protein_coding,1,176973,chr6_34598500_34775473
Gm13861,6,34651354,34653894,lincRNA,-1,2540,chr6_34651354_34653894
Gm14547,6,34727221,34735389,antisense,-1,8168,chr6_34727221_34735389
Agbl3,6,34780432,34859459,protein_coding,1,79027,chr6_34780432_34859459
Tmem140,6,34863146,34874946,protein_coding,1,11800,chr6_34863146_34874946
Wdr91,6,34880426,34910876,protein_coding,-1,30450,chr6_34880426_34910876
Slc23a4,6,34945278,34988404,protein_coding,-1,43126,chr6_34945278_34988404
Cnot4,6,35022065,35133724,protein_coding,-1,111659,chr6_35022065_35133724
Nup205,6,35177421,35247596,protein_coding,1,70175,chr6_35177421_35247596
1810058I24Rik,6,35252654,35263496,protein_coding,1,10842,chr6_35252654_35263496
Slc13a4,6,35267957,35308131,protein_coding,-1,40174,chr6_35267957_35308131
Fam180a,6,35312668,35326141,protein_coding,-1,13473,chr6_35312668_35326141
1700065J11Rik,6,35330846,35336825,lincRNA,1,5979,chr6_35330846_35336825
Mtpn,6,35508906,35539888,protein_coding,-1,30982,chr6_35508906_35539888
9330158H04Rik,6,36209620,36390191,lincRNA,-1,180571,chr6_36209620_36390191
Chrm2,6,36388084,36528414,protein_coding,1,140330,chr6_36388084_36528414
Ptn,6,36714929,36810220,protein_coding,-1,95291,chr6_36714929_36810220
Dgki,6,36846022,37300184,protein_coding,-1,454162,chr6_36846022_37300184
1700111E14Rik,6,36937048,36985784,antisense,1,48736,chr6_36937048_36985784
Creb3l2,6,37327255,37442146,protein_coding,-1,114891,chr6_37327255_37442146
Akr1d1,6,37530173,37568815,protein_coding,1,38642,chr6_37530173_37568815
Trim24,6,37870811,37966296,protein_coding,1,95485,chr6_37870811_37966296
Svopl,6,37983739,38046996,protein_coding,-1,63257,chr6_37983739_38046996
Atp6v0a4,6,38048483,38124586,protein_coding,-1,76103,chr6_38048483_38124586
Tmem213,6,38109255,38115809,protein_coding,1,6554,chr6_38109255_38115809
D630045J12Rik,6,38123174,38254009,protein_coding,-1,130835,chr6_38123174_38254009
Zc3hav1l,6,38287396,38299259,protein_coding,-1,11863,chr6_38287396_38299259
Zc3hav1,6,38305286,38354603,protein_coding,-1,49317,chr6_38305286_38354603
Ttc26,6,38381469,38427647,protein_coding,1,46178,chr6_38381469_38427647
Ubn2,6,38433950,38524825,protein_coding,1,90875,chr6_38433950_38524825
Fmc1,6,38533502,38539449,protein_coding,1,5947,chr6_38533502_38539449
Luc7l2,6,38551334,38609470,protein_coding,1,58136,chr6_38551334_38609470
Klrg2,6,38625693,38637242,protein_coding,-1,11549,chr6_38625693_38637242
Clec2l,6,38663067,38680865,protein_coding,1,17798,chr6_38663067_38680865
Hipk2,6,38694390,38876165,protein_coding,-1,181775,chr6_38694390_38876165
Tbxas1,6,38875404,39084585,protein_coding,1,209181,chr6_38875404_39084585
Gm42962,6,38917098,38984325,antisense,-1,67227,chr6_38917098_38984325
1700025N23Rik,6,39063878,39067598,antisense,-1,3720,chr6_39063878_39067598
Parp12,6,39086410,39118349,protein_coding,-1,31939,chr6_39086410_39118349
4930599N23Rik,6,39118473,39148312,antisense,1,29839,chr6_39118473_39148312
Kdm7a,6,39136623,39206789,protein_coding,-1,70166,chr6_39136623_39206789
Gm43479,6,39240114,39242541,lincRNA,1,2427,chr6_39240114_39242541
Slc37a3,6,39334773,39377675,protein_coding,-1,42902,chr6_39334773_39377675
Rab19,6,39381175,39390380,protein_coding,1,9205,chr6_39381175_39390380
Mkrn1,6,39397804,39420462,protein_coding,-1,22658,chr6_39397804_39420462
Gm10244,6,39419887,39421294,antisense,1,1407,chr6_39419887_39421294
Dennd2a,6,39462378,39557867,protein_coding,-1,95489,chr6_39462378_39557867
Adck2,6,39573873,39588769,protein_coding,1,14896,chr6_39573873_39588769
Gm16272,6,39584092,39592784,antisense,-1,8692,chr6_39584092_39592784
Gm42420,6,39585753,39596595,protein_coding,1,10842,chr6_39585753_39596595
Ndufb2,6,39592574,39603382,protein_coding,1,10808,chr6_39592574_39603382
Braf,6,39603237,39725463,protein_coding,-1,122226,chr6_39603237_39725463
Mrps33,6,39801804,39810988,protein_coding,-1,9184,chr6_39801804_39810988
Gm26833,6,39871532,39871971,antisense,-1,439,chr6_39871532_39871971
Tmem178b,6,39871461,40255150,protein_coding,1,383689,chr6_39871461_40255150
Gm26807,6,40203298,40209259,antisense,-1,5961,chr6_40203298_40209259
Agk,6,40325172,40396762,protein_coding,1,71590,chr6_40325172_40396762
Wee2,6,40439088,40466813,protein_coding,1,27725,chr6_40439088_40466813
Ssbp1,6,40471352,40484700,protein_coding,1,13348,chr6_40471352_40484700
Tas2r137,6,40491233,40492305,protein_coding,1,1072,chr6_40491233_40492305
Tas2r108,6,40493529,40494541,protein_coding,1,1012,chr6_40493529_40494541
Olfr461,6,40542171,40555050,protein_coding,-1,12879,chr6_40542171_40555050
Olfr460,6,40569487,40574343,protein_coding,1,4856,chr6_40569487_40574343
Clec5a,6,40574894,40585821,protein_coding,-1,10927,chr6_40574894_40585821
Mgam,6,40628831,40769123,protein_coding,1,140292,chr6_40628831_40769123
1700074P13Rik,6,40920437,40940557,protein_coding,-1,20120,chr6_40920437_40940557
Gm4744,6,40948463,40954353,unprocessed_pseudogene,-1,5890,chr6_40948463_40954353
1810009J06Rik,6,40964754,40968435,protein_coding,1,3681,chr6_40964754_40968435
Gm2663,6,40995830,40999479,protein_coding,-1,3649,chr6_40995830_40999479
2210010C04Rik,6,41030268,41035509,protein_coding,-1,5241,chr6_41030268_41035509
5830405F06Rik,6,41055883,41063102,lincRNA,1,7219,chr6_41055883_41063102
Trbv12-2,6,41118851,41119364,TR_V_gene,1,513,chr6_41118851_41119364
Try5,6,41311233,41316841,protein_coding,-1,5608,chr6_41311233_41316841
Try10,6,41354105,41357914,protein_coding,1,3809,chr6_41354105_41357914
Prss3,6,41373814,41377678,protein_coding,-1,3864,chr6_41373814_41377678
Gm5771,6,41392356,41397230,protein_coding,1,4874,chr6_41392356_41397230
Gm10334,6,41442216,41446145,protein_coding,-1,3929,chr6_41442216_41446145
Prss1,6,41458932,41463786,protein_coding,1,4854,chr6_41458932_41463786
Prss2,6,41521787,41525079,protein_coding,1,3292,chr6_41521787_41525079
Trbc1,6,41538218,41539881,TR_C_gene,1,1663,chr6_41538218_41539881
Trbc2,6,41546730,41548352,TR_C_gene,1,1622,chr6_41546730_41548352
Ephb6,6,41605482,41620509,protein_coding,1,15027,chr6_41605482_41620509
Trpv6,6,41620624,41636405,protein_coding,-1,15781,chr6_41620624_41636405
Trpv5,6,41652173,41680769,protein_coding,-1,28596,chr6_41652173_41680769
Kel,6,41686330,41704339,protein_coding,-1,18009,chr6_41686330_41704339
Olfr459,6,41768770,41775177,protein_coding,-1,6407,chr6_41768770_41775177
Sval2,6,41852989,41864413,protein_coding,1,11424,chr6_41852989_41864413
Sva,6,42038394,42042851,protein_coding,1,4457,chr6_42038394_42042851
Gstk1,6,42245935,42250447,protein_coding,1,4512,chr6_42245935_42250447
Tmem139,6,42261959,42264555,protein_coding,1,2596,chr6_42261959_42264555
Casp2,6,42264985,42282508,protein_coding,1,17523,chr6_42264985_42282508
Clcn1,6,42286685,42315756,protein_coding,1,29071,chr6_42286685_42315756
Fam131b,6,42315312,42324643,protein_coding,-1,9331,chr6_42315312_42324643
Gm44284,6,42328713,42350862,antisense,-1,22149,chr6_42328713_42350862
Zyx,6,42349630,42360213,protein_coding,1,10583,chr6_42349630_42360213
Epha1,6,42358487,42373268,protein_coding,-1,14781,chr6_42358487_42373268
2010310C07Rik,6,42370671,42381215,antisense,1,10544,chr6_42370671_42381215
Tas2r143,6,42400238,42401119,protein_coding,1,881,chr6_42400238_42401119
Olfr458,6,42459979,42465196,protein_coding,-1,5217,chr6_42459979_42465196
Olfr457,6,42468015,42476335,protein_coding,-1,8320,chr6_42468015_42476335
Olfr455,6,42535664,42547587,protein_coding,-1,11923,chr6_42535664_42547587
Tcaf3,6,42584866,42597692,protein_coding,-1,12826,chr6_42584866_42597692
Tcaf2,6,42623016,42645254,protein_coding,-1,22238,chr6_42623016_42645254
Tcaf1,6,42668002,42710088,protein_coding,-1,42086,chr6_42668002_42710088
Olfr452,6,42785093,42791619,protein_coding,1,6526,chr6_42785093_42791619
Olfr450,6,42811939,42819081,protein_coding,1,7142,chr6_42811939_42819081
Olfr448,6,42890441,42899085,protein_coding,1,8644,chr6_42890441_42899085
Olfr444,6,42949067,42956764,protein_coding,1,7697,chr6_42949067_42956764
Olfr441,6,43106369,43117803,protein_coding,1,11434,chr6_43106369_43117803
Olfr437,6,43163282,43169861,protein_coding,1,6579,chr6_43163282_43169861
Olfr13,6,43172140,43177460,protein_coding,1,5320,chr6_43172140_43177460
Olfr435,6,43197146,43203629,protein_coding,1,6483,chr6_43197146_43203629
Olfr434,6,43213021,43218113,protein_coding,1,5092,chr6_43213021_43218113
Olfr47,6,43231529,43236959,protein_coding,1,5430,chr6_43231529_43236959
Arhgef5,6,43265582,43289320,protein_coding,1,23738,chr6_43265582_43289320
Nobox,6,43303674,43309554,protein_coding,-1,5880,chr6_43303674_43309554
Tpk1,6,43345001,43666278,protein_coding,-1,321277,chr6_43345001_43666278
9430018G01Rik,6,43467979,43474318,antisense,1,6339,chr6_43467979_43474318
Gm35216,6,44080488,44083355,lincRNA,-1,2867,chr6_44080488_44083355
Cntnap2,6,45059357,47304213,protein_coding,1,2244856,chr6_45059357_47304213
Cul1,6,47453398,47526139,protein_coding,1,72741,chr6_47453398_47526139
Ezh2,6,47530139,47595341,protein_coding,-1,65202,chr6_47530139_47595341
Pdia4,6,47796141,47813430,protein_coding,-1,17289,chr6_47796141_47813430
Zfp786,6,47819266,47830867,protein_coding,-1,11601,chr6_47819266_47830867
Zfp398,6,47835661,47873537,protein_coding,1,37876,chr6_47835661_47873537
Zfp282,6,47877204,47908485,protein_coding,1,31281,chr6_47877204_47908485
Zfp212,6,47920476,47932639,protein_coding,1,12163,chr6_47920476_47932639
Zfp956,6,47953390,47965300,protein_coding,1,11910,chr6_47953390_47965300
Zfp777,6,48024188,48048911,protein_coding,-1,24723,chr6_48024188_48048911
Zfp746,6,48062395,48086593,protein_coding,-1,24198,chr6_48062395_48086593
Gm16630,6,48130906,48159280,lincRNA,-1,28374,chr6_48130906_48159280
Gm44696,6,48374136,48395408,lincRNA,-1,21272,chr6_48374136_48395408
Krba1,6,48395586,48419781,protein_coding,1,24195,chr6_48395586_48419781
Zfp467,6,48427697,48445825,protein_coding,-1,18128,chr6_48427697_48445825
Sspo,6,48448229,48501250,protein_coding,1,53021,chr6_48448229_48501250
1700026J14Rik,6,48536582,48537474,lincRNA,-1,892,chr6_48536582_48537474
Atp6v0e2,6,48537615,48541801,protein_coding,1,4186,chr6_48537615_48541801
Lrrc61,6,48554796,48570722,protein_coding,1,15926,chr6_48554796_48570722
Rarres2,6,48569696,48572789,protein_coding,-1,3093,chr6_48569696_48572789
Gm45021,6,48589610,48613250,protein_coding,1,23640,chr6_48589610_48613250
Zfp775,6,48602063,48623227,protein_coding,1,21164,chr6_48602063_48623227
Gm38804,6,48613973,48622357,antisense,-1,8384,chr6_48613973_48622357
AI854703,6,48626764,48633689,protein_coding,1,6925,chr6_48626764_48633689
Gimap8,6,48647234,48660875,protein_coding,1,13641,chr6_48647234_48660875
Gimap9,6,48676129,48679114,protein_coding,1,2985,chr6_48676129_48679114
Gimap4,6,48684549,48692060,protein_coding,1,7511,chr6_48684549_48692060
Gimap6,6,48701582,48708225,protein_coding,-1,6643,chr6_48701582_48708225
Gm28053,6,48718607,48752644,protein_coding,1,34037,chr6_48718607_48752644
Gimap5,6,48746197,48754210,protein_coding,1,8013,chr6_48746197_48754210
Gimap3,6,48764464,48770851,protein_coding,-1,6387,chr6_48764464_48770851
Tmem176b,6,48833818,48841496,protein_coding,-1,7678,chr6_48833818_48841496
Tmem176a,6,48840919,48847071,protein_coding,1,6152,chr6_48840919_48847071
Gm7932,6,48860329,48866083,lincRNA,1,5754,chr6_48860329_48866083
Aoc1,6,48872896,48909188,protein_coding,1,36292,chr6_48872896_48909188
4930563H07Rik,6,48986616,48999616,antisense,-1,13000,chr6_48986616_48999616
Svs1,6,48986861,48991722,protein_coding,1,4861,chr6_48986861_48991722
Gpnmb,6,49036546,49070929,protein_coding,1,34383,chr6_49036546_49070929
Malsu1,6,49073795,49086751,protein_coding,1,12956,chr6_49073795_49086751
Igf2bp3,6,49085223,49214957,protein_coding,-1,129734,chr6_49085223_49214957
Tra2a,6,49243924,49264033,protein_coding,-1,20109,chr6_49243924_49264033
Ccdc126,6,49319274,49341582,protein_coding,1,22308,chr6_49319274_49341582
Fam221a,6,49367739,49390539,protein_coding,1,22800,chr6_49367739_49390539
Stk31,6,49395604,49469501,protein_coding,1,73897,chr6_49395604_49469501
Npy,6,49822710,49829507,protein_coding,1,6797,chr6_49822710_49829507
Gm3455,6,50051186,50107628,lincRNA,1,56442,chr6_50051186_50107628
Mpp6,6,50110241,50198939,protein_coding,1,88698,chr6_50110241_50198939
Gsdme,6,50188888,50263862,protein_coding,-1,74974,chr6_50188888_50263862
Osbpl3,6,50293330,50456201,protein_coding,-1,162871,chr6_50293330_50456201
Cycs,6,50562563,50566538,protein_coding,-1,3975,chr6_50562563_50566538
5430402O13Rik,6,50566643,50594865,antisense,1,28222,chr6_50566643_50594865
4921507P07Rik,6,50573302,50596632,protein_coding,-1,23330,chr6_50573302_50596632
Npvf,6,50650672,50654439,protein_coding,-1,3767,chr6_50650672_50654439
C530044C16Rik,6,50776115,50815033,lincRNA,1,38918,chr6_50776115_50815033
Gm44109,6,50799072,50803031,lincRNA,-1,3959,chr6_50799072_50803031
G930045G22Rik,6,50849023,50878077,lincRNA,-1,29054,chr6_50849023_50878077
Gm6559,6,51379710,51392791,lincRNA,1,13081,chr6_51379710_51392791
Nfe2l3,6,51432670,51458768,protein_coding,1,26098,chr6_51432670_51458768
Hnrnpa2b1,6,51460932,51469894,protein_coding,-1,8962,chr6_51460932_51469894
Cbx3,6,51470360,51483704,protein_coding,1,13344,chr6_51470360_51483704
Snx10,6,51523901,51590679,protein_coding,1,66778,chr6_51523901_51590679
Gm38811,6,51694309,51711081,lincRNA,-1,16772,chr6_51694309_51711081
Skap2,6,51857422,52012549,protein_coding,-1,155127,chr6_51857422_52012549
Gm44077,6,52012601,52026986,lincRNA,1,14385,chr6_52012601_52026986
Halr1,6,52102949,52113684,lincRNA,1,10735,chr6_52102949_52113684
Hoxaas3,6,52175217,52215076,antisense,1,39859,chr6_52175217_52215076
Hoxa7,6,52214491,52221854,protein_coding,-1,7363,chr6_52214491_52221854
Gm44028,6,52509889,52514036,lincRNA,1,4147,chr6_52509889_52514036
Hibadh,6,52546228,52640389,protein_coding,-1,94161,chr6_52546228_52640389
Tax1bp1,6,52713729,52766780,protein_coding,1,53051,chr6_52713729_52766780
Jazf1,6,52768797,53068631,protein_coding,-1,299834,chr6_52768797_53068631
Creb5,6,53287270,53700376,protein_coding,1,413106,chr6_53287270_53700376
Tril,6,53815468,53820830,protein_coding,-1,5362,chr6_53815468_53820830
Gm16499,6,53818743,53868183,antisense;lincRNA,1,49440,chr6_53818743_53868183
Cpvl,6,53873279,53978671,protein_coding,-1,105392,chr6_53873279_53978671
Chn2,6,54039554,54301810,protein_coding,1,262256,chr6_54039554_54301810
9530036M11Rik,6,54146887,54150937,antisense,-1,4050,chr6_54146887_54150937
Prr15,6,54325835,54330201,protein_coding,1,4366,chr6_54325835_54330201
Wipf3,6,54429603,54503768,protein_coding,1,74165,chr6_54429603_54503768
Gm44026,6,54463685,54473170,antisense,-1,9485,chr6_54463685_54473170
Scrn1,6,54501173,54566489,protein_coding,-1,65316,chr6_54501173_54566489
Fkbp14,6,54577604,54597308,protein_coding,-1,19704,chr6_54577604_54597308
Plekha8,6,54595111,54645839,protein_coding,1,50728,chr6_54595111_54645839
Gm28402,6,54680930,54681917,antisense,-1,987,chr6_54680930_54681917
Mturn,6,54681624,54703851,protein_coding,1,22227,chr6_54681624_54703851
Znrf2,6,54816916,54893500,protein_coding,1,76584,chr6_54816916_54893500
Nod1,6,54923949,54972612,protein_coding,-1,48663,chr6_54923949_54972612
Ggct,6,54982580,54992950,protein_coding,-1,10370,chr6_54982580_54992950
Gars,6,55038007,55079500,protein_coding,1,41493,chr6_55038007_55079500
Crhr2,6,55090049,55133016,protein_coding,-1,42967,chr6_55090049_55133016
Gm34358,6,55154459,55167210,lincRNA,1,12751,chr6_55154459_55167210
Mindy4,6,55203383,55320222,protein_coding,1,116839,chr6_55203383_55320222
Gm44073,6,55296262,55307886,antisense,-1,11624,chr6_55296262_55307886
Aqp1,6,55336432,55348555,protein_coding,1,12123,chr6_55336432_55348555
Ghrhr,6,55376295,55388530,protein_coding,1,12235,chr6_55376295_55388530
6430584L05Rik,6,55396887,55412285,lincRNA,1,15398,chr6_55396887_55412285
Adcyap1r1,6,55451978,55501451,protein_coding,1,49473,chr6_55451978_55501451
Neurod6,6,55677822,55681263,protein_coding,-1,3441,chr6_55677822_55681263
Gm3279,6,55684571,55694574,lincRNA,1,10003,chr6_55684571_55694574
Ppp1r17,6,56017497,56032689,protein_coding,1,15192,chr6_56017497_56032689
Pde1c,6,56069804,56652487,protein_coding,-1,582683,chr6_56069804_56652487
Lsm5,6,56701063,56704710,protein_coding,-1,3647,chr6_56701063_56704710
Avl9,6,56714899,56761912,protein_coding,1,47013,chr6_56714899_56761912
Kbtbd2,6,56777524,56797813,protein_coding,-1,20289,chr6_56777524_56797813
Fkbp9,6,56832059,56879358,protein_coding,1,47299,chr6_56832059_56879358
Nt5c3,6,56882400,56923932,protein_coding,-1,41532,chr6_56882400_56923932
Vmn1r4,6,56924015,56958100,protein_coding,1,34085,chr6_56924015_56958100
Vmn1r5,6,56970273,56988390,protein_coding,1,18117,chr6_56970273_56988390
Vmn1r6,6,56997243,57009825,protein_coding,1,12582,chr6_56997243_57009825
Vmn1r8,6,57032284,57037391,protein_coding,1,5107,chr6_57032284_57037391
Vmn1r12,6,57156919,57165329,protein_coding,1,8410,chr6_57156919_57165329
Vmn1r13,6,57203290,57214799,protein_coding,1,11509,chr6_57203290_57214799
Vmn1r15,6,57257952,57259972,protein_coding,1,2020,chr6_57257952_57259972
Vmn1r16,6,57318052,57329494,protein_coding,-1,11442,chr6_57318052_57329494
Vmn1r18,6,57376660,57395783,protein_coding,-1,19123,chr6_57376660_57395783
4930533I22Rik,6,57476697,57497671,antisense,1,20974,chr6_57476697_57497671
Ppm1k,6,57506502,57535468,protein_coding,-1,28966,chr6_57506502_57535468
Herc6,6,57581000,57664632,protein_coding,1,83632,chr6_57581000_57664632
Pyurf,6,57686576,57692078,protein_coding,-1,5502,chr6_57686576_57692078
Lancl2,6,57702540,57739439,protein_coding,1,36899,chr6_57702540_57739439
Vopp1,6,57727807,57825159,protein_coding,-1,97352,chr6_57727807_57825159
Vmn1r21,6,57842830,57850343,protein_coding,-1,7513,chr6_57842830_57850343
Vmn1r22,6,57898126,57908028,protein_coding,-1,9902,chr6_57898126_57908028
Vmn1r23,6,57925842,57926838,protein_coding,-1,996,chr6_57925842_57926838
Vmn1r24,6,57954707,57961503,protein_coding,-1,6796,chr6_57954707_57961503
Vmn1r25,6,57978299,57980810,protein_coding,-1,2511,chr6_57978299_57980810
Vmn1r26,6,58004934,58015159,protein_coding,-1,10225,chr6_58004934_58015159
Gm43994,6,58192321,58194765,lincRNA,1,2444,chr6_58192321_58194765
Vmn1r27,6,58213091,58218821,protein_coding,-1,5730,chr6_58213091_58218821
Vmn1r28,6,58262037,58275639,protein_coding,1,13602,chr6_58262037_58275639
Vmn1r29,6,58301549,58311685,protein_coding,1,10136,chr6_58301549_58311685
Vmn1r30,6,58434159,58443385,protein_coding,-1,9226,chr6_58434159_58443385
Gm35077,6,58457868,58521810,lincRNA,-1,63942,chr6_58457868_58521810
Abcg2,6,58584523,58695676,protein_coding,1,111153,chr6_58584523_58695676
Herc3,6,58831465,58920398,protein_coding,1,88933,chr6_58831465_58920398
Nap1l5,6,58905233,58907076,protein_coding,-1,1843,chr6_58905233_58907076
Fam13a,6,58932090,59024549,protein_coding,-1,92459,chr6_58932090_59024549
Gm45060,6,58964874,58972234,antisense,1,7360,chr6_58964874_58972234
BB365896,6,58965655,59002083,antisense,1,36428,chr6_58965655_59002083
Tigd2,6,59208870,59212033,protein_coding,1,3163,chr6_59208870_59212033
Gprin3,6,59347226,59426294,protein_coding,-1,79068,chr6_59347226_59426294
Gm5570,6,60031967,60150045,lincRNA,1,118078,chr6_60031967_60150045
Gm35386,6,60586778,60591189,lincRNA,1,4411,chr6_60586778_60591189
Snca,6,60731575,60829855,protein_coding,-1,98280,chr6_60731575_60829855
Mmrn1,6,60924976,60989378,protein_coding,1,64402,chr6_60924976_60989378
Ccser1,6,61180324,62382865,protein_coding,1,1202541,chr6_61180324_62382865
Grid2,6,63255876,64704323,protein_coding,1,1448447,chr6_63255876_64704323
Gm44071,6,63324672,63328441,antisense,-1,3769,chr6_63324672_63328441
Gm44072,6,64040429,64041557,antisense,-1,1128,chr6_64040429_64041557
Atoh1,6,64729125,64731245,protein_coding,1,2120,chr6_64729125_64731245
Smarcad1,6,65042583,65116061,protein_coding,1,73478,chr6_65042583_65116061
Hpgds,6,65117293,65144908,protein_coding,-1,27615,chr6_65117293_65144908
Tnip3,6,65525313,65634040,protein_coding,1,108727,chr6_65525313_65634040
Ndnf,6,65671590,65712326,protein_coding,1,40736,chr6_65671590_65712326
Gm16838,6,65768544,65779249,antisense,-1,10705,chr6_65768544_65779249
Prdm5,6,65778988,65937010,protein_coding,1,158022,chr6_65778988_65937010
2610300M13Rik,6,66451949,66465738,lincRNA,-1,13789,chr6_66451949_66465738
Mad2l1,6,66535390,66547220,protein_coding,1,11830,chr6_66535390_66547220
Vmn1r32,6,66552180,66560096,protein_coding,-1,7916,chr6_66552180_66560096
Vmn1r33,6,66610543,66618282,protein_coding,-1,7739,chr6_66610543_66618282
Vmn1r34,6,66635936,66643879,protein_coding,-1,7943,chr6_66635936_66643879
Vmn1r35,6,66678070,66685906,protein_coding,-1,7836,chr6_66678070_66685906
Vmn1r36,6,66715257,66719168,protein_coding,-1,3911,chr6_66715257_66719168
Vmn1r37,6,66729382,66733039,protein_coding,1,3657,chr6_66729382_66733039
Vmn1r38,6,66774003,66782627,protein_coding,-1,8624,chr6_66774003_66782627
Vmn1r39,6,66803297,66810609,protein_coding,-1,7312,chr6_66803297_66810609
Gng12,6,66896397,67021350,protein_coding,1,124953,chr6_66896397_67021350
Gm36816,6,66990031,67009260,antisense,-1,19229,chr6_66990031_67009260
Gadd45a,6,67035096,67037457,protein_coding,-1,2361,chr6_67035096_67037457
Gm38825,6,67179799,67239710,antisense,-1,59911,chr6_67179799_67239710
Serbp1,6,67238176,67297736,protein_coding,1,59560,chr6_67238176_67297736
Il12rb2,6,67291318,67376188,protein_coding,-1,84870,chr6_67291318_67376188
Il23r,6,67422932,67491855,protein_coding,-1,68923,chr6_67422932_67491855
Gm42889,6,67532489,67556204,lincRNA,1,23715,chr6_67532489_67556204
Tacstd2,6,67534062,67535796,protein_coding,-1,1734,chr6_67534062_67535796
Igkv1-35,6,70010949,70011673,IG_V_gene,-1,724,chr6_70010949_70011673
Igkv8-34,6,70044112,70044678,IG_V_gene,-1,566,chr6_70044112_70044678
Igkv7-33,6,70058632,70059199,IG_V_gene,-1,567,chr6_70058632_70059199
Igkv8-28,6,70143593,70144166,IG_V_gene,-1,573,chr6_70143593_70144166
Igkv8-21,6,70314895,70315472,IG_V_gene,-1,577,chr6_70314895_70315472
Igkv6-20,6,70335841,70336507,IG_V_gene,-1,666,chr6_70335841_70336507
Igkv8-19,6,70340876,70341453,IG_V_gene,-1,577,chr6_70340876_70341453
Gm30211,6,70719074,70740554,lincRNA,1,21480,chr6_70719074_70740554
Rpia,6,70765720,70792232,protein_coding,-1,26512,chr6_70765720_70792232
Eif2ak3,6,70844515,70905245,protein_coding,1,60730,chr6_70844515_70905245
Thnsl2,6,71128166,71144439,protein_coding,-1,16273,chr6_71128166_71144439
Gm44427,6,71164799,71166119,lincRNA,1,1320,chr6_71164799_71166119
Smyd1,6,71213940,71322233,protein_coding,-1,108293,chr6_71213940_71322233
Krcc1,6,71271677,71285319,protein_coding,1,13642,chr6_71271677_71285319
Gm1070,6,71293765,71302880,transcribed_unprocessed_pseudogene,1,9115,chr6_71293765_71302880
Cd8b1,6,71322788,71337494,protein_coding,1,14706,chr6_71322788_71337494
Gm44174,6,71353035,71373284,lincRNA,1,20249,chr6_71353035_71373284
Gm44175,6,71354351,71360829,lincRNA,-1,6478,chr6_71354351_71360829
Cd8a,6,71373427,71379173,protein_coding,1,5746,chr6_71373427_71379173
Rmnd5a,6,71388634,71440637,protein_coding,-1,52003,chr6_71388634_71440637
Gm44172,6,71451992,71458998,lincRNA,1,7006,chr6_71451992_71458998
Rnf103,6,71493894,71510881,protein_coding,1,16987,chr6_71493894_71510881
1700040L08Rik,6,71543192,71544114,antisense,-1,922,chr6_71543192_71544114
Chmp3,6,71543797,71582609,protein_coding,1,38812,chr6_71543797_71582609
Kdm3a,6,71588972,71632990,protein_coding,-1,44018,chr6_71588972_71632990
Reep1,6,71707561,71810710,protein_coding,1,103149,chr6_71707561_71810710
Mrpl35,6,71812997,71826969,protein_coding,-1,13972,chr6_71812997_71826969
Immt,6,71831331,71877388,protein_coding,1,46057,chr6_71831331_71877388
Ptcd3,6,71880638,71908750,protein_coding,-1,28112,chr6_71880638_71908750
Polr1a,6,71909053,71984935,protein_coding,1,75882,chr6_71909053_71984935
9130221F21Rik,6,72013896,72042528,lincRNA,-1,28632,chr6_72013896_72042528
St3gal5,6,72097592,72154571,protein_coding,1,56979,chr6_72097592_72154571
4933431G14Rik,6,72120213,72123197,antisense,-1,2984,chr6_72120213_72123197
Gm38832,6,72162849,72167707,lincRNA,1,4858,chr6_72162849_72167707
Atoh8,6,72206177,72235577,protein_coding,-1,29400,chr6_72206177_72235577
Sftpb,6,72304610,72314372,protein_coding,1,9762,chr6_72304610_72314372
Usp39,6,72318677,72345184,protein_coding,-1,26507,chr6_72318677_72345184
Gm45051,CHR_MG184_PATCH,72347028,72348458,antisense;lncRNA,-1,1430,chrCHR_MG184_PATCH_72347028_72348458
0610030E20Rik,6,72347316,72353148,protein_coding,1,5832,chr6_72347316_72353148
Tmem150a,6,72355446,72359762,protein_coding,1,4316,chr6_72355446_72359762
Rnf181,6,72359713,72366956,protein_coding,-1,7243,chr6_72359713_72366956
Vamp5,6,72368793,72380468,protein_coding,-1,11675,chr6_72368793_72380468
Vamp8,6,72385222,72390703,protein_coding,-1,5481,chr6_72385222_72390703
Ggcx,6,72414307,72430712,protein_coding,1,16405,chr6_72414307_72430712
Mat2a,6,72432798,72439558,protein_coding,-1,6760,chr6_72432798_72439558
Sh2d6,6,72513641,72521707,protein_coding,-1,8066,chr6_72513641_72521707
Capg,6,72544391,72562983,protein_coding,1,18592,chr6_72544391_72562983
Elmod3,6,72565922,72598413,protein_coding,-1,32491,chr6_72565922_72598413
Retsat,6,72598475,72608425,protein_coding,1,9950,chr6_72598475_72608425
Tgoln1,6,72608432,72617000,protein_coding,-1,8568,chr6_72608432_72617000
Tcf7l1,6,72626378,72789254,protein_coding,-1,162876,chr6_72626378_72789254
Gm15401,6,72629288,72637717,antisense,1,8429,chr6_72629288_72637717
Gm15402,6,72699214,72705090,antisense,1,5876,chr6_72699214_72705090
Kcmf1,6,72841114,72899979,protein_coding,-1,58865,chr6_72841114_72899979
Gm26640,6,72953236,72957247,lincRNA,1,4011,chr6_72953236_72957247
Tmsb10,6,72957347,72958748,protein_coding,-1,1401,chr6_72957347_72958748
Gm20560,6,73012043,73020360,antisense,1,8317,chr6_73012043_73020360
Dnah6,6,73017606,73221651,protein_coding,-1,204045,chr6_73017606_73221651
Suclg1,6,73248382,73276911,protein_coding,1,28529,chr6_73248382_73276911
1700065L07Rik,6,73436986,73471021,lincRNA,-1,34035,chr6_73436986_73471021
Gm31747,6,73586109,73608673,lincRNA,-1,22564,chr6_73586109_73608673
Gm44113,6,75968046,75974983,lincRNA,-1,6937,chr6_75968046_75974983
Gm9008,6,76495432,76497784,protein_coding,-1,2352,chr6_76495432_76497784
Gm44166,6,76496082,76497524,antisense,1,1442,chr6_76496082_76497524
Ctnna2,6,76881637,77979699,protein_coding,-1,1098062,chr6_76881637_77979699
Lrrtm1,6,77242689,77257791,protein_coding,1,15102,chr6_77242689_77257791
Reg2,6,78395623,78408106,protein_coding,1,12483,chr6_78395623_78408106
Gm20362,6,79032044,79035869,lincRNA,1,3825,chr6_79032044_79035869
Gm44271,6,79688845,79710914,lincRNA,1,22069,chr6_79688845_79710914
Gm20594,6,79817916,79818364,protein_coding,1,448,chr6_79817916_79818364
Gm4409,6,79926414,80023156,antisense,-1,96742,chr6_79926414_80023156
Lrrtm4,6,80018877,80810143,protein_coding,1,791266,chr6_80018877_80810143
Gm38839,6,81675946,81715232,lincRNA,-1,39286,chr6_81675946_81715232
1700009C05Rik,6,81900464,81910800,lincRNA,-1,10336,chr6_81900464_81910800
Gcfc2,6,81923669,81959915,protein_coding,1,36246,chr6_81923669_81959915
Mrpl19,6,81957851,81965958,protein_coding,-1,8107,chr6_81957851_81965958
Gm20383,6,81984321,81992413,lincRNA,1,8092,chr6_81984321_81992413
Eva1a,6,82041043,82093099,protein_coding,1,52056,chr6_82041043_82093099
Tacr1,6,82402334,82560104,protein_coding,1,157770,chr6_82402334_82560104
Pole4,6,82618992,82705365,protein_coding,-1,86373,chr6_82618992_82705365
Gm44145,6,82680132,82694822,antisense,1,14690,chr6_82680132_82694822
Hk2,6,82725025,82774454,protein_coding,-1,49429,chr6_82725025_82774454
Gm38843,6,82803769,82805083,lincRNA,-1,1314,chr6_82803769_82805083
Gm32591,6,82823214,82841371,lincRNA,1,18157,chr6_82823214_82841371
Gm45145,6,82896867,82905214,lincRNA,-1,8347,chr6_82896867_82905214
Sema4f,6,82911885,82939769,protein_coding,-1,27884,chr6_82911885_82939769
M1ap,6,82946902,83030309,protein_coding,1,83407,chr6_82946902_83030309
Dok1,6,83030934,83033471,protein_coding,-1,2537,chr6_83030934_83033471
Loxl3,6,83034173,83052562,protein_coding,1,18389,chr6_83034173_83052562
Htra2,6,83051266,83055273,protein_coding,-1,4007,chr6_83051266_83055273
Aup1,6,83054521,83057808,protein_coding,1,3287,chr6_83054521_83057808
Dqx1,6,83057844,83067318,protein_coding,1,9474,chr6_83057844_83067318
Pcgf1,6,83077869,83080855,protein_coding,1,2986,chr6_83077869_83080855
Lbx2,6,83086367,83088243,protein_coding,1,1876,chr6_83086367_83088243
Gm42688,6,83101617,83109939,protein_coding,1,8322,chr6_83101617_83109939
Ccdc142os,6,83106608,83109054,antisense,-1,2446,chr6_83106608_83109054
Mogs,6,83115496,83118898,protein_coding,1,3402,chr6_83115496_83118898
Wbp1,6,83119044,83121559,protein_coding,-1,2515,chr6_83119044_83121559
Ino80b,6,83121765,83125431,protein_coding,-1,3666,chr6_83121765_83125431
Gm44287,6,83122520,83124397,antisense,1,1877,chr6_83122520_83124397
Rtkn,6,83135463,83152579,protein_coding,1,17116,chr6_83135463_83152579
Wdr54,6,83149361,83156397,protein_coding,-1,7036,chr6_83149361_83156397
1700003E16Rik,6,83156404,83162945,protein_coding,1,6541,chr6_83156404_83162945
Dctn1,6,83165920,83200117,protein_coding,1,34197,chr6_83165920_83200117
Gm15624,6,83166152,83172755,antisense,-1,6603,chr6_83166152_83172755
Slc4a5,6,83219828,83304945,protein_coding,1,85117,chr6_83219828_83304945
Mthfd2,6,83305691,83325908,protein_coding,-1,20217,chr6_83305691_83325908
Mob1a,6,83326016,83343776,protein_coding,1,17760,chr6_83326016_83343776
Bola3,6,83349147,83360136,protein_coding,1,10989,chr6_83349147_83360136
Tet3,6,83362373,83459084,protein_coding,-1,96711,chr6_83362373_83459084
Dguok,6,83480217,83506969,protein_coding,-1,26752,chr6_83480217_83506969
Actg2,6,83512905,83536265,protein_coding,-1,23360,chr6_83512905_83536265
Stambp,6,83543211,83572729,protein_coding,-1,29518,chr6_83543211_83572729
Gm21284,6,83568039,83588123,antisense,1,20084,chr6_83568039_83588123
Clec4f,6,83644542,83656187,protein_coding,-1,11645,chr6_83644542_83656187
Cd207,6,83671215,83677857,protein_coding,-1,6642,chr6_83671215_83677857
Vax2os,6,83692806,83712201,antisense,-1,19395,chr6_83692806_83712201
Vax2,6,83711264,83738313,protein_coding,1,27049,chr6_83711264_83738313
Atp6v1b1,6,83742990,83758855,protein_coding,1,15865,chr6_83742990_83758855
1700124L16Rik,6,83761756,83762865,antisense,-1,1109,chr6_83761756_83762865
Ankrd53,6,83762644,83768326,protein_coding,1,5682,chr6_83762644_83768326
Tex261,6,83768885,83775813,protein_coding,-1,6928,chr6_83768885_83775813
Nagk,6,83794982,83804018,protein_coding,1,9036,chr6_83794982_83804018
Paip2b,6,83805401,83831741,protein_coding,-1,26340,chr6_83805401_83831741
Zfp638,6,83867109,83989550,protein_coding,1,122441,chr6_83867109_83989550
Dysf,6,84008590,84211060,protein_coding,1,202470,chr6_84008590_84211060
Gm15475,6,84093772,84107007,antisense,-1,13235,chr6_84093772_84107007
Gm44127,6,84225252,84286603,lincRNA,1,61351,chr6_84225252_84286603
Gm10445,6,84412942,84423838,lincRNA,-1,10896,chr6_84412942_84423838
Cyp26b1,6,84571414,84593908,protein_coding,-1,22494,chr6_84571414_84593908
Exoc6b,6,84618487,85069513,protein_coding,-1,451026,chr6_84618487_85069513
Gm44012,6,84921123,84924996,antisense,1,3873,chr6_84921123_84924996
Gm5878,6,85111416,85126125,lincRNA,-1,14709,chr6_85111416_85126125
Spr,6,85130176,85137766,protein_coding,-1,7590,chr6_85130176_85137766
Emx1,6,85187438,85204462,protein_coding,1,17024,chr6_85187438_85204462
Sfxn5,6,85213049,85333422,protein_coding,-1,120373,chr6_85213049_85333422
Rab11fip5,6,85334962,85374634,protein_coding,-1,39672,chr6_85334962_85374634
Noto,6,85423886,85428877,protein_coding,1,4991,chr6_85423886_85428877
Smyd5,6,85431989,85446435,protein_coding,1,14446,chr6_85431989_85446435
Pradc1,6,85446810,85451970,protein_coding,-1,5160,chr6_85446810_85451970
Cct7,6,85451514,85468475,protein_coding,1,16961,chr6_85451514_85468475
Fbxo41,6,85469574,85502994,protein_coding,-1,33420,chr6_85469574_85502994
Egr4,6,85511121,85513589,protein_coding,-1,2468,chr6_85511121_85513589
Alms1,6,85587531,85702753,protein_coding,1,115222,chr6_85587531_85702753
Nat8f7,6,85706727,85713205,protein_coding,-1,6478,chr6_85706727_85713205
Nat8f3,6,85732513,85765754,protein_coding,-1,33241,chr6_85732513_85765754
Nat8f6,6,85808024,85820954,protein_coding,-1,12930,chr6_85808024_85820954
Nat8,6,85830388,85832082,protein_coding,-1,1694,chr6_85830388_85832082
Nat8f2,6,85865422,85869158,protein_coding,-1,3736,chr6_85865422_85869158
Nat8f4,6,85899051,85904884,protein_coding,-1,5833,chr6_85899051_85904884
Nat8f1,6,85910154,85915687,protein_coding,-1,5533,chr6_85910154_85915687
Tprkb,6,85911865,85930284,protein_coding,1,18419,chr6_85911865_85930284
Dusp11,6,85942268,85961667,protein_coding,-1,19399,chr6_85942268_85961667
Gm19265,6,85961623,86001926,antisense,1,40303,chr6_85961623_86001926
4930553P18Rik,6,86004380,86009355,lincRNA,1,4975,chr6_86004380_86009355
Figla,6,86016171,86020996,protein_coding,1,4825,chr6_86016171_86020996
Add2,6,86028681,86124409,protein_coding,1,95728,chr6_86028681_86124409
Gm44089,6,86084366,86087080,antisense,-1,2714,chr6_86084366_86087080
Tgfa,6,86195223,86275719,protein_coding,1,80496,chr6_86195223_86275719
Fam136a,6,86365646,86370058,protein_coding,1,4412,chr6_86365646_86370058
Snrpg,6,86371304,86379328,protein_coding,1,8024,chr6_86371304_86379328
Gm44941,6,86372538,86375285,antisense,-1,2747,chr6_86372538_86375285
Pcyox1,6,86386006,86397154,protein_coding,-1,11148,chr6_86386006_86397154
Tia1,6,86404219,86433405,protein_coding,1,29186,chr6_86404219_86433405
Gm44790,6,86426658,86445630,protein_coding,1,18972,chr6_86426658_86445630
C87436,6,86438374,86473500,protein_coding,1,35126,chr6_86438374_86473500
A430078I02Rik,6,86470277,86480830,antisense,-1,10553,chr6_86470277_86480830
2310040G24Rik,6,86483376,86488227,lincRNA,-1,4851,chr6_86483376_86488227
Gm43936,6,86493216,86493909,lincRNA,-1,693,chr6_86493216_86493909
Gm44386,6,86513891,86516273,lincRNA,-1,2382,chr6_86513891_86516273
Pcbp1,6,86524492,86526321,protein_coding,-1,1829,chr6_86524492_86526321
1600020E01Rik,6,86526247,86582466,antisense,1,56219,chr6_86526247_86582466
Asprv1,6,86628164,86629710,protein_coding,1,1546,chr6_86628164_86629710
Mxd1,6,86647042,86669161,protein_coding,-1,22119,chr6_86647042_86669161
Snrnp27,6,86675151,86684522,protein_coding,-1,9371,chr6_86675151_86684522
Gm44214,6,86687823,86688428,lincRNA,-1,605,chr6_86687823_86688428
Gmcl1,6,86691768,86733383,protein_coding,-1,41615,chr6_86691768_86733383
Gm44036,6,86733489,86737065,lincRNA,1,3576,chr6_86733489_86737065
Anxa4,6,86736840,86793584,protein_coding,-1,56744,chr6_86736840_86793584
Aak1,6,86849517,87003223,protein_coding,1,153706,chr6_86849517_87003223
Nfu1,6,87009236,87028461,protein_coding,1,19225,chr6_87009236_87028461
Gfpt1,6,87042846,87092197,protein_coding,1,49351,chr6_87042846_87092197
D6Ertd527e,6,87104746,87112997,protein_coding,1,8251,chr6_87104746_87112997
Antxr1,6,87133853,87335821,protein_coding,-1,201968,chr6_87133853_87335821
Gm44418,6,87277745,87279750,antisense,1,2005,chr6_87277745_87279750
Gkn1,6,87345650,87350942,protein_coding,-1,5292,chr6_87345650_87350942
Gkn3,6,87383256,87388935,protein_coding,-1,5679,chr6_87383256_87388935
Arhgap25,6,87458545,87533259,protein_coding,-1,74714,chr6_87458545_87533259
Aplf,6,87628424,87672193,protein_coding,-1,43769,chr6_87628424_87672193
Gm44097,6,87657754,87663823,antisense,1,6069,chr6_87657754_87663823
1810020O05Rik,6,87675590,87722801,protein_coding,-1,47211,chr6_87675590_87722801
Gm44210,6,87729964,87731148,antisense,-1,1184,chr6_87729964_87731148
Efcc1,6,87730869,87755908,protein_coding,1,25039,chr6_87730869_87755908
Gm43904,6,87776143,87777480,lincRNA,1,1337,chr6_87776143_87777480
Gp9,6,87778072,87779768,protein_coding,1,1696,chr6_87778072_87779768
Rab43,6,87788853,87812164,protein_coding,-1,23311,chr6_87788853_87812164
Gm45140,6,87788861,87835795,protein_coding,-1,46934,chr6_87788861_87835795
Isy1,6,87814269,87838798,protein_coding,-1,24529,chr6_87814269_87838798
Cnbp,6,87842615,87851106,protein_coding,-1,8491,chr6_87842615_87851106
Copg1,6,87887814,87913595,protein_coding,1,25781,chr6_87887814_87913595
Gm26636,6,87908843,87914459,antisense,-1,5616,chr6_87908843_87914459
Hmces,6,87913935,87936629,protein_coding,1,22694,chr6_87913935_87936629
Gm5577,6,87980883,88005471,antisense,1,24588,chr6_87980883_88005471
Rab7,6,87999106,88045270,protein_coding,-1,46164,chr6_87999106_88045270
Rpn1,6,88084482,88105304,protein_coding,1,20822,chr6_88084482_88105304
Gm38708,6,88188397,88190681,lincRNA,-1,2284,chr6_88188397_88190681
Gata2,6,88193891,88207032,protein_coding,1,13141,chr6_88193891_88207032
Dnajb8,6,88222268,88254415,protein_coding,1,32147,chr6_88222268_88254415
Eefsec,6,88257334,88446539,protein_coding,-1,189205,chr6_88257334_88446539
Gm44264,6,88445687,88446513,antisense,1,826,chr6_88445687_88446513
Ruvbl1,6,88465409,88497572,protein_coding,1,32163,chr6_88465409_88497572
Sec61a1,6,88503579,88518905,protein_coding,-1,15326,chr6_88503579_88518905
Gm44170,6,88503605,88504277,antisense,1,672,chr6_88503605_88504277
Kbtbd12,6,88545114,88637950,protein_coding,-1,92836,chr6_88545114_88637950
Gm26588,6,88716422,88725860,antisense,-1,9438,chr6_88716422_88725860
Mgll,6,88724412,88828360,protein_coding,1,103948,chr6_88724412_88828360
Abtb1,6,88835914,88841984,protein_coding,-1,6070,chr6_88835914_88841984
Podxl2,6,88842558,88875044,protein_coding,-1,32486,chr6_88842558_88875044
Gm15612,6,88842854,88847274,antisense,1,4420,chr6_88842854_88847274
Mcm2,6,88883474,88898780,protein_coding,-1,15306,chr6_88883474_88898780
Tpra1,6,88902251,88912238,protein_coding,1,9987,chr6_88902251_88912238
4933427D06Rik,6,88950683,89110031,lincRNA,1,159348,chr6_88950683_89110031
Gm1965,6,89140994,89147388,lincRNA,1,6394,chr6_89140994_89147388
4930512J16Rik,6,89269511,89285725,lincRNA,-1,16214,chr6_89269511_89285725
Gm26811,6,89304630,89327621,antisense,1,22991,chr6_89304630_89327621
Plxna1,6,89316314,89362620,protein_coding,-1,46306,chr6_89316314_89362620
Chchd6,6,89383146,89595652,protein_coding,-1,212506,chr6_89383146_89595652
Txnrd3,6,89643988,89675529,protein_coding,1,31541,chr6_89643988_89675529
Vmn1r40,6,89707540,89716657,protein_coding,1,9117,chr6_89707540_89716657
Vmn1r41,6,89740766,89747645,protein_coding,1,6879,chr6_89740766_89747645
Vmn1r42,6,89842573,89876413,protein_coding,-1,33840,chr6_89842573_89876413
Vmn1r44,6,89883660,89894888,protein_coding,1,11228,chr6_89883660_89894888
Vmn1r46,6,89969313,89986721,protein_coding,1,17408,chr6_89969313_89986721
Vmn1r47,6,90016147,90027477,protein_coding,1,11330,chr6_90016147_90027477
Vmn1r49,6,90071893,90078506,protein_coding,-1,6613,chr6_90071893_90078506
Vmn1r51,6,90122596,90132264,protein_coding,1,9668,chr6_90122596_90132264
Vmn1r52,6,90174808,90181248,protein_coding,1,6440,chr6_90174808_90181248
Vmn1r53,6,90223317,90224438,protein_coding,-1,1121,chr6_90223317_90224438
Vmn1r54,6,90246300,90271213,protein_coding,1,24913,chr6_90246300_90271213
Chst13,6,90308349,90325185,protein_coding,-1,16836,chr6_90308349_90325185
Uroc1,6,90333284,90364551,protein_coding,1,31267,chr6_90333284_90364551
Zxdc,6,90369492,90403490,protein_coding,1,33998,chr6_90369492_90403490
Cfap100,6,90403479,90428797,protein_coding,-1,25318,chr6_90403479_90428797
Gm44117,6,90459711,90461468,lincRNA,-1,1757,chr6_90459711_90461468
Klf15,6,90462576,90475238,protein_coding,1,12662,chr6_90462576_90475238
Gm44421,6,90478466,90479686,lincRNA,1,1220,chr6_90478466_90479686
Gm45901,6,90486393,90519480,lincRNA,1,33087,chr6_90486393_90519480
Aldh1l1,6,90486427,90600203,protein_coding,1,113776,chr6_90486427_90600203
Gm15756,6,90596697,90599948,antisense,-1,3251,chr6_90596697_90599948
Slc41a3,6,90604725,90646412,protein_coding,1,41687,chr6_90604725_90646412
Iqsec1,6,90656088,90988685,protein_coding,-1,332597,chr6_90656088_90988685
Gm44123,6,90689731,90690829,antisense,1,1098,chr6_90689731_90690829
Nup210,6,91013068,91116829,protein_coding,-1,103761,chr6_91013068_91116829
Hdac11,6,91156665,91174692,protein_coding,1,18027,chr6_91156665_91174692
Gm14573,6,91158713,91159256,antisense,-1,543,chr6_91158713_91159256
Fbln2,6,91212455,91272540,protein_coding,1,60085,chr6_91212455_91272540
Wnt7a,6,91363981,91411363,protein_coding,-1,47382,chr6_91363981_91411363
4930471M09Rik,6,91428308,91440912,transcribed_processed_pseudogene,-1,12604,chr6_91428308_91440912
1810044D09Rik,6,91440987,91441755,lincRNA,1,768,chr6_91440987_91441755
Chchd4,6,91462172,91473546,protein_coding,-1,11374,chr6_91462172_91473546
Tmem43,6,91473703,91488463,protein_coding,1,14760,chr6_91473703_91488463
Xpc,6,91489305,91515888,protein_coding,-1,26583,chr6_91489305_91515888
Lsm3,6,91515928,91522625,protein_coding,1,6697,chr6_91515928_91522625
Gm45218,6,91599232,91605514,lincRNA,1,6282,chr6_91599232_91605514
Slc6a6,6,91684053,91759066,protein_coding,1,75013,chr6_91684053_91759066
Grip2,6,91761509,91827250,protein_coding,-1,65741,chr6_91761509_91827250
Ccdc174,6,91878053,91899843,protein_coding,1,21790,chr6_91878053_91899843
4930590J08Rik,6,91902809,91950725,protein_coding,1,47916,chr6_91902809_91950725
Fgd5,6,91978878,92076004,protein_coding,1,97126,chr6_91978878_92076004
Nr2c2,6,92091390,92174294,protein_coding,1,82904,chr6_92091390_92174294
Mrps25,6,92169525,92184033,protein_coding,-1,14508,chr6_92169525_92184033
Rbsn,6,92186712,92214925,protein_coding,-1,28213,chr6_92186712_92214925
Trh,6,92242061,92244650,protein_coding,-1,2589,chr6_92242061_92244650
Prickle2,6,92370908,92706155,protein_coding,-1,335247,chr6_92370908_92706155
Adamts9,6,92772699,92943492,protein_coding,-1,170793,chr6_92772699_92943492
A730049H05Rik,6,92816478,92847174,protein_coding,1,30696,chr6_92816478_92847174
Gm15737,6,92869357,92884411,protein_coding,1,15054,chr6_92869357_92884411
9530026P05Rik,6,92940329,93272979,antisense,1,332650,chr6_92940329_93272979
Magi1,6,93675455,94283917,protein_coding,-1,608462,chr6_93675455_94283917
Slc25a26,6,94500331,94604672,protein_coding,1,104341,chr6_94500331_94604672
Lrig1,6,94604529,94700158,protein_coding,-1,95629,chr6_94604529_94700158
Kbtbd8os,6,95114017,95117631,antisense,-1,3614,chr6_95114017_95117631
Kbtbd8,6,95117240,95129790,protein_coding,1,12550,chr6_95117240_95129790
Suclg2,6,95473009,95718800,protein_coding,-1,245791,chr6_95473009_95718800
1700123L14Rik,6,96164497,96166243,protein_coding,-1,1746,chr6_96164497_96166243
Eogt,6,97110024,97149182,protein_coding,-1,39158,chr6_97110024_97149182
Tmf1,6,97152997,97179122,protein_coding,-1,26125,chr6_97152997_97179122
Uba3,6,97183670,97205647,protein_coding,-1,21977,chr6_97183670_97205647
Arl6ip5,6,97210689,97233315,protein_coding,1,22626,chr6_97210689_97233315
Lmod3,6,97238534,97252759,protein_coding,-1,14225,chr6_97238534_97252759
Frmd4b,6,97286867,97617541,protein_coding,-1,330674,chr6_97286867_97617541
Mitf,6,97807052,98021349,protein_coding,1,214297,chr6_97807052_98021349
Gm32592,6,98121796,98248611,antisense,1,126815,chr6_98121796_98248611
Gm765,6,98235708,98342754,protein_coding,-1,107046,chr6_98235708_98342754
Gm44196,6,98507726,98697674,lincRNA,-1,189948,chr6_98507726_98697674
Foxp1,6,98925338,99522721,protein_coding,-1,597383,chr6_98925338_99522721
Gm20696,6,99257484,99666797,protein_coding,-1,409313,chr6_99257484_99666797
Gpr27,6,99692679,99695066,protein_coding,1,2387,chr6_99692679_99695066
Prok2,6,99711299,99726392,protein_coding,-1,15093,chr6_99711299_99726392
Gm26748,6,99725771,99732553,antisense,1,6782,chr6_99725771_99732553
Gm44442,6,99928248,99950931,lincRNA,-1,22683,chr6_99928248_99950931
Gm33201,6,99967516,99991215,lincRNA,-1,23699,chr6_99967516_99991215
Rybp,6,100228565,100287485,protein_coding,-1,58920,chr6_100228565_100287485
1700049E22Rik,6,100527400,100533426,lincRNA,1,6026,chr6_100527400_100533426
Shq1,6,100568256,100671157,protein_coding,-1,102901,chr6_100568256_100671157
Gxylt2,6,100704734,100810913,protein_coding,1,106179,chr6_100704734_100810913
Ppp4r2,6,100833622,100869934,protein_coding,1,36312,chr6_100833622_100869934
Gm43950,6,101028022,101081205,lincRNA,1,53183,chr6_101028022_101081205
Gm43948,6,101059171,101198013,antisense,1,138842,chr6_101059171_101198013
Pdzrn3,6,101149609,101377897,protein_coding,-1,228288,chr6_101149609_101377897
Gm26911,6,101198569,101220141,antisense,1,21572,chr6_101198569_101220141
Gm44169,6,101519655,101537292,lincRNA,1,17637,chr6_101519655_101537292
Gm9871,6,101774249,101801982,lincRNA,1,27733,chr6_101774249_101801982
Cntn3,6,102162655,102573101,protein_coding,-1,410446,chr6_102162655_102573101
4930587E11Rik,6,102266100,102336674,antisense,1,70574,chr6_102266100_102336674
Chl1,6,103510586,103750211,protein_coding,1,239625,chr6_103510586_103750211
Cntn6,6,104492790,104863406,protein_coding,1,370616,chr6_104492790_104863406
Gm19757,6,105481266,105492668,lincRNA,-1,11402,chr6_105481266_105492668
Gm15631,6,105673064,105677581,lincRNA,-1,4517,chr6_105673064_105677581
Cntn4,6,105677660,106699310,protein_coding,1,1021650,chr6_105677660_106699310
Il5ra,6,106710357,106749037,protein_coding,-1,38680,chr6_106710357_106749037
Trnt1,6,106769120,106782474,protein_coding,1,13354,chr6_106769120_106782474
Crbn,6,106780201,106800077,protein_coding,-1,19876,chr6_106780201_106800077
Gm34933,6,107181206,107276738,lincRNA,-1,95532,chr6_107181206_107276738
Lrrn1,6,107529768,107570214,protein_coding,1,40446,chr6_107529768_107570214
4933431M02Rik,6,107627774,107632549,lincRNA,1,4775,chr6_107627774_107632549
Setmar,6,108065045,108077122,protein_coding,1,12077,chr6_108065045_108077122
Sumf1,6,108107028,108185582,protein_coding,-1,78554,chr6_108107028_108185582
Itpr1,6,108213096,108551109,protein_coding,1,338013,chr6_108213096_108551109
Gm44040,6,108519029,108525687,antisense,-1,6658,chr6_108519029_108525687
0610040F04Rik,6,108577039,108660934,antisense,-1,83895,chr6_108577039_108660934
Bhlhe40,6,108660629,108666925,protein_coding,1,6296,chr6_108660629_108666925
Arl8b,6,108783099,108825278,protein_coding,1,42179,chr6_108783099_108825278
Edem1,6,108828641,108859356,protein_coding,1,30715,chr6_108828641_108859356
Gm20387,6,110639753,110645916,antisense,-1,6163,chr6_110639753_110645916
Grm7,6,110645581,111567230,protein_coding,1,921649,chr6_110645581_111567230
Lmcd1,6,112273758,112330425,protein_coding,1,56667,chr6_112273758_112330425
5031434C07Rik,6,112285593,112288837,antisense,-1,3244,chr6_112285593_112288837
Ssu2,6,112359324,112388023,protein_coding,-1,28699,chr6_112359324_112388023
Cav3,6,112459505,112472872,protein_coding,1,13367,chr6_112459505_112472872
Oxtr,6,112473683,112489943,protein_coding,-1,16260,chr6_112473683_112489943
Rad18,6,112619850,112696686,protein_coding,-1,76836,chr6_112619850_112696686
Srgap3,6,112717971,112947266,protein_coding,-1,229295,chr6_112717971_112947266
Gm44081,6,112947037,112949330,lincRNA,1,2293,chr6_112947037_112949330
Thumpd3,6,113046225,113068273,protein_coding,1,22048,chr6_113046225_113068273
Gt(ROSA)26Sor,6,113067428,113077333,antisense,-1,9905,chr6_113067428_113077333
Setd5,6,113077365,113153435,protein_coding,1,76070,chr6_113077365_113153435
Lhfpl4,6,113168090,113195384,protein_coding,-1,27294,chr6_113168090_113195384
Mtmr14,6,113237843,113281392,protein_coding,1,43549,chr6_113237843_113281392
Gm16161,6,113275837,113276930,antisense,-1,1093,chr6_113275837_113276930
Cpne9,6,113282307,113305627,protein_coding,1,23320,chr6_113282307_113305627
Brpf1,6,113307137,113324860,protein_coding,1,17723,chr6_113307137_113324860
Gm15492,6,113308666,113326747,antisense,-1,18081,chr6_113308666_113326747
Ogg1,6,113326972,113335068,protein_coding,1,8096,chr6_113326972_113335068
Camk1,6,113334124,113343984,protein_coding,-1,9860,chr6_113334124_113343984
Tada3,6,113366025,113377883,protein_coding,-1,11858,chr6_113366025_113377883
Arpc4,6,113378115,113390448,protein_coding,1,12333,chr6_113378115_113390448
Ttll3,6,113389260,113414587,protein_coding,1,25327,chr6_113389260_113414587
Rpusd3,6,113415319,113419340,protein_coding,-1,4021,chr6_113415319_113419340
Cidec,6,113424634,113435760,protein_coding,-1,11126,chr6_113424634_113435760
Jagn1,6,113442569,113448229,protein_coding,1,5660,chr6_113442569_113448229
Il17re,6,113458484,113470758,protein_coding,1,12274,chr6_113458484_113470758
Il17rc,6,113471427,113483140,protein_coding,1,11713,chr6_113471427_113483140
Creld1,6,113483297,113493343,protein_coding,1,10046,chr6_113483297_113493343
Prrt3,6,113493639,113501931,protein_coding,-1,8292,chr6_113493639_113501931
Emc3,6,113514874,113531652,protein_coding,-1,16778,chr6_113514874_113531652
Fancd2,6,113531682,113597017,protein_coding,1,65335,chr6_113531682_113597017
Fancd2os,6,113596761,113600715,protein_coding,-1,3954,chr6_113596761_113600715
Brk1,6,113604772,113616951,protein_coding,1,12179,chr6_113604772_113616951
Gm44199,6,113610318,113612445,antisense,-1,2127,chr6_113610318_113612445
Vhl,6,113623959,113631633,protein_coding,1,7674,chr6_113623959_113631633
1700015O11Rik,6,113631649,113633144,lincRNA,-1,1495,chr6_113631649_113633144
Irak2,6,113638467,113695026,protein_coding,1,56559,chr6_113638467_113695026
Gm43964,6,113640562,113641521,antisense,-1,959,chr6_113640562_113641521
Tatdn2,6,113697050,113711069,protein_coding,1,14019,chr6_113697050_113711069
Gm26982,6,113714971,113716121,antisense,1,1150,chr6_113714971_113716121
Ghrl,6,113716119,113719880,protein_coding,-1,3761,chr6_113716119_113719880
Gm44053,6,113725223,113726151,lincRNA,1,928,chr6_113725223_113726151
Sec13,6,113728062,113740743,protein_coding,-1,12681,chr6_113728062_113740743
Atp2b2,6,113743831,114042613,protein_coding,-1,298782,chr6_113743831_114042613
Gm15082,6,113937739,113940206,antisense,1,2467,chr6_113937739_113940206
Gm15083,6,114004789,114052265,antisense,1,47476,chr6_114004789_114052265
Slc6a11,6,114131241,114249952,protein_coding,1,118711,chr6_114131241_114249952
Slc6a1,6,114282635,114317532,protein_coding,1,34897,chr6_114282635_114317532
Hrh1,6,114397936,114483296,protein_coding,1,85360,chr6_114397936_114483296
Atg7,6,114643097,114860614,protein_coding,1,217517,chr6_114643097_114860614
Vgll4,6,114860628,114969994,protein_coding,-1,109366,chr6_114860628_114969994
Tamm41,6,115004381,115037876,protein_coding,-1,33495,chr6_115004381_115037876
Syn2,6,115134902,115282006,protein_coding,1,147104,chr6_115134902_115282006
Timp4,6,115241892,115252205,protein_coding,-1,10313,chr6_115241892_115252205
Pparg,6,115360951,115490399,protein_coding,1,129448,chr6_115360951_115490399
Gm44079,6,115451815,115464990,antisense,-1,13175,chr6_115451815_115464990
Gm36355,6,115529131,115536900,lincRNA,-1,7769,chr6_115529131_115536900
Tsen2,6,115544664,115578628,protein_coding,1,33964,chr6_115544664_115578628
Mkrn2os,6,115583544,115592576,protein_coding,-1,9032,chr6_115583544_115592576
Mkrn2,6,115601902,115622624,protein_coding,1,20722,chr6_115601902_115622624
Raf1,6,115618067,115676635,protein_coding,-1,58568,chr6_115618067_115676635
Tmem40,6,115729131,115762410,protein_coding,-1,33279,chr6_115729131_115762410
Cand2,6,115774538,115805557,protein_coding,1,31019,chr6_115774538_115805557
Rpl32,6,115805505,115808747,protein_coding,-1,3242,chr6_115805505_115808747
Efcab12,6,115810729,115838412,protein_coding,-1,27683,chr6_115810729_115838412
Gm44206,6,115824499,115842525,antisense,1,18026,chr6_115824499_115842525
Mbd4,6,115840697,115853371,protein_coding,-1,12674,chr6_115840697_115853371
Ift122,6,115853470,115926699,protein_coding,1,73229,chr6_115853470_115926699
Rho,6,115931748,115940036,protein_coding,1,8288,chr6_115931748_115940036
Plxnd1,6,115954811,115995005,protein_coding,-1,40194,chr6_115954811_115995005
Tmcc1,6,116018611,116193486,protein_coding,-1,174875,chr6_116018611_116193486
Gm20404,6,116107650,116127493,antisense,1,19843,chr6_116107650_116127493
Washc2,6,116208038,116262686,protein_coding,1,54648,chr6_116208038_116262686
Zfand4,6,116264222,116330302,protein_coding,1,66080,chr6_116264222_116330302
Alox5,6,116410077,116461178,protein_coding,-1,51101,chr6_116410077_116461178
Olfr211,6,116489091,116498221,protein_coding,1,9130,chr6_116489091_116498221
Olfr212,6,116506516,116517965,protein_coding,1,11449,chr6_116506516_116517965
Olfr214,6,116554235,116560611,protein_coding,1,6376,chr6_116554235_116560611
Zfp422,6,116624016,116628999,protein_coding,-1,4983,chr6_116624016_116628999
Rassf4,6,116633008,116673952,protein_coding,-1,40944,chr6_116633008_116673952
Tmem72,6,116679063,116716913,protein_coding,-1,37850,chr6_116679063_116716913
D030044L04Rik,6,117160773,117162808,lincRNA,1,2035,chr6_117160773_117162808
Cxcl12,6,117168535,117181367,protein_coding,1,12832,chr6_117168535_117181367
Gm4640,6,117420577,117423617,lincRNA,-1,3040,chr6_117420577_117423617
6820426E19Rik,6,117495235,117500077,lincRNA,1,4842,chr6_117495235_117500077
Gm9946,6,117559697,117572329,lincRNA,1,12632,chr6_117559697_117572329
Gm45083,6,117578715,117612570,lincRNA,-1,33855,chr6_117578715_117612570
1700030F04Rik,6,117646693,117751769,lincRNA,-1,105076,chr6_117646693_117751769
Gm7292,6,117716342,117718868,lincRNA,1,2526,chr6_117716342_117718868
Zfp637,6,117841180,117845956,protein_coding,1,4776,chr6_117841180_117845956
Zfp239,6,117862100,117873291,protein_coding,1,11191,chr6_117862100_117873291
Hnrnpf,6,117900324,117925622,protein_coding,1,25298,chr6_117900324_117925622
Fxyd4,6,117933559,117937692,protein_coding,-1,4133,chr6_117933559_117937692
Rasgef1a,6,118011438,118091546,protein_coding,1,80108,chr6_118011438_118091546
Csgalnact2,6,118107452,118139140,protein_coding,-1,31688,chr6_118107452_118139140
Ret,6,118151745,118197718,protein_coding,-1,45973,chr6_118151745_118197718
Bms1,6,118383381,118419474,protein_coding,-1,36093,chr6_118383381_118419474
Zfp248,6,118427319,118455528,protein_coding,-1,28209,chr6_118427319_118455528
Zfp9,6,118461950,118479320,protein_coding,-1,17370,chr6_118461950_118479320
Ankrd26,6,118501308,118562226,protein_coding,-1,60918,chr6_118501308_118562226
Cacna1c,6,118587240,119196890,protein_coding,-1,609650,chr6_118587240_119196890
Dcp1b,6,119175253,119221616,protein_coding,1,46363,chr6_119175253_119221616
Cacna2d4,6,119236526,119352407,protein_coding,1,115881,chr6_119236526_119352407
Lrtm2,6,119315133,119330766,protein_coding,-1,15633,chr6_119315133_119330766
Adipor2,6,119353150,119417704,protein_coding,-1,64554,chr6_119353150_119417704
Wnt5b,6,119432531,119544347,protein_coding,-1,111816,chr6_119432531_119544347
Fbxl14,6,119479668,119482630,protein_coding,1,2962,chr6_119479668_119482630
Erc1,6,119570796,119848167,protein_coding,-1,277371,chr6_119570796_119848167
Gm44317,6,119570941,119578057,antisense,1,7116,chr6_119570941_119578057
4930540M05Rik,6,119896159,119902653,lincRNA,-1,6494,chr6_119896159_119902653
Rad52,6,119902698,119922828,protein_coding,1,20130,chr6_119902698_119922828
Wnk1,6,119923969,120038672,protein_coding,-1,114703,chr6_119923969_120038672
Ninj2,6,120093350,120200339,protein_coding,1,106989,chr6_120093350_120200339
B4galnt3,6,120203073,120294559,protein_coding,-1,91486,chr6_120203073_120294559
Ccdc77,6,120324323,120364374,protein_coding,-1,40051,chr6_120324323_120364374
Kdm5a,6,120364124,120444574,protein_coding,1,80450,chr6_120364124_120444574
Il17ra,6,120463247,120487559,protein_coding,1,24312,chr6_120463247_120487559
Tmem121b,6,120488939,120493807,protein_coding,-1,4868,chr6_120488939_120493807
Hdhd5,6,120509494,120531319,protein_coding,-1,21825,chr6_120509494_120531319
Gm20692,6,120512449,120513232,antisense,1,783,chr6_120512449_120513232
1700072O05Rik,6,120554796,120562879,lincRNA,1,8083,chr6_120554796_120562879
Cecr2,6,120666369,120771190,protein_coding,1,104821,chr6_120666369_120771190
Slc25a18,6,120773578,120794336,protein_coding,1,20758,chr6_120773578_120794336
Atp6v1e1,6,120794305,120822793,protein_coding,-1,28488,chr6_120794305_120822793
Bcl2l13,6,120836212,120892842,protein_coding,1,56630,chr6_120836212_120892842
Bid,6,120891930,120916853,protein_coding,-1,24923,chr6_120891930_120916853
Mical3,6,120931707,121130999,protein_coding,-1,199292,chr6_120931707_121130999
Gm43916,6,120951901,120952867,antisense,1,966,chr6_120951901_120952867
Gm43915,6,120958844,120997498,antisense,1,38654,chr6_120958844_120997498
Pex26,6,121183667,121198837,protein_coding,1,15170,chr6_121183667_121198837
Tuba8,6,121210696,121226854,protein_coding,1,16158,chr6_121210696_121226854
Gm15856,6,121223692,121226153,antisense,-1,2461,chr6_121223692_121226153
Usp18,6,121245906,121270917,protein_coding,1,25011,chr6_121245906_121270917
Gm44148,6,121255203,121272685,lincRNA,-1,17482,chr6_121255203_121272685
Slc6a13,6,121300227,121337733,protein_coding,1,37506,chr6_121300227_121337733
Slc6a12,6,121343076,121365775,protein_coding,1,22699,chr6_121343076_121365775
Iqsec3,6,121372933,121473678,protein_coding,-1,100745,chr6_121372933_121473678
A2m,6,121635376,121679227,protein_coding,1,43851,chr6_121635376_121679227
Gm7298,6,121732932,121789084,protein_coding,1,56152,chr6_121732932_121789084
Mug1,6,121838541,121889057,protein_coding,1,50516,chr6_121838541_121889057
Mug2,6,122006761,122085965,protein_coding,1,79204,chr6_122006761_122085965
Klrg1,6,122270596,122282882,protein_coding,-1,12286,chr6_122270596_122282882
M6pr,6,122308720,122317680,protein_coding,1,8960,chr6_122308720_122317680
Phc1,6,122317731,122340561,protein_coding,-1,22830,chr6_122317731_122340561
Rimklb,6,122447296,122498761,protein_coding,-1,51465,chr6_122447296_122498761
Mfap5,6,122505845,122529290,protein_coding,1,23445,chr6_122505845_122529290
Aicda,6,122553801,122564180,protein_coding,1,10379,chr6_122553801_122564180
Apobec1,6,122577792,122602444,protein_coding,-1,24652,chr6_122577792_122602444
Gdf3,6,122605403,122610087,protein_coding,-1,4684,chr6_122605403_122610087
Dppa3,6,122626410,122630272,protein_coding,1,3862,chr6_122626410_122630272
Nanog,6,122707489,122714633,protein_coding,1,7144,chr6_122707489_122714633
Slc2a3,6,122727809,122801640,protein_coding,-1,73831,chr6_122727809_122801640
Gm26826,6,122813619,122820614,antisense,-1,6995,chr6_122813619_122820614
Foxj2,6,122819914,122845366,protein_coding,1,25452,chr6_122819914_122845366
C3ar1,6,122847138,122856161,protein_coding,-1,9023,chr6_122847138_122856161
Necap1,6,122874474,122888941,protein_coding,1,14467,chr6_122874474_122888941
Clec4a1,6,122921848,122934619,protein_coding,1,12771,chr6_122921848_122934619
Clec4a3,6,122952515,122969875,protein_coding,1,17360,chr6_122952515_122969875
Clec4a4,6,122990367,123024105,protein_coding,1,33738,chr6_122990367_123024105
Clec4b1,6,123049962,123071555,protein_coding,1,21593,chr6_123049962_123071555
Clec4a2,6,123106428,123143999,protein_coding,1,37571,chr6_123106428_123143999
Clec4b2,6,123172893,123204671,protein_coding,1,31778,chr6_123172893_123204671
Clec4n,6,123229843,123247021,protein_coding,1,17178,chr6_123229843_123247021
Clec4d,6,123262111,123275265,protein_coding,1,13154,chr6_123262111_123275265
Vmn2r19,6,123308333,123336537,protein_coding,1,28204,chr6_123308333_123336537
Vmn2r20,6,123373513,123418116,protein_coding,-1,44603,chr6_123373513_123418116
Vmn2r21,6,123492508,123533406,protein_coding,-1,40898,chr6_123492508_123533406
Vmn2r22,6,123609758,123650725,protein_coding,-1,40967,chr6_123609758_123650725
Vmn2r23,6,123702670,123747657,protein_coding,1,44987,chr6_123702670_123747657
Vmn2r24,6,123778879,123824912,protein_coding,1,46033,chr6_123778879_123824912
Vmn2r25,6,123821646,123853463,protein_coding,-1,31817,chr6_123821646_123853463
Vmn2r26,6,124024568,124065806,protein_coding,1,41238,chr6_124024568_124065806
Vmn2r27,6,124189756,124231856,protein_coding,-1,42100,chr6_124189756_124231856
Gm43971,6,124279485,124282592,lincRNA,1,3107,chr6_124279485_124282592
Cd163,6,124304656,124330527,protein_coding,1,25871,chr6_124304656_124330527
1700013D24Rik,6,124347598,124357069,lincRNA,-1,9471,chr6_124347598_124357069
1700027F06Rik,6,124363301,124364519,lincRNA,-1,1218,chr6_124363301_124364519
Gm44006,6,124372162,124374805,lincRNA,1,2643,chr6_124372162_124374805
Pex5,6,124396816,124415067,protein_coding,-1,18251,chr6_124396816_124415067
Clstn3,6,124430581,124464794,protein_coding,-1,34213,chr6_124430581_124464794
Gm44096,6,124492163,124494368,antisense,-1,2205,chr6_124492163_124494368
C1rl,6,124493113,124510643,protein_coding,1,17530,chr6_124493113_124510643
C1ra,6,124512405,124523443,protein_coding,1,11038,chr6_124512405_124523443
C1s1,6,124530345,124542359,protein_coding,-1,12014,chr6_124530345_124542359
Gm16567,6,124530911,124542310,antisense,1,11399,chr6_124530911_124542310
C1rb,6,124570294,124581171,protein_coding,1,10877,chr6_124570294_124581171
C1s2,6,124624625,124636085,protein_coding,-1,11460,chr6_124624625_124636085
Lpcat3,6,124663027,124704418,protein_coding,1,41391,chr6_124663027_124704418
Emg1,6,124704085,124712178,protein_coding,-1,8093,chr6_124704085_124712178
Phb2,6,124712336,124716950,protein_coding,1,4614,chr6_124712336_124716950
Gm15884,6,124715573,124718831,antisense,-1,3258,chr6_124715573_124718831
Ptpn6,6,124720707,124738714,protein_coding,-1,18007,chr6_124720707_124738714
Gm20531,6,124732168,124738040,antisense,1,5872,chr6_124732168_124738040
Grcc10,6,124739183,124741374,protein_coding,-1,2191,chr6_124739183_124741374
Gm45234,6,124739189,124756021,protein_coding,-1,16832,chr6_124739189_124756021
Atn1,6,124742544,124756524,protein_coding,-1,13980,chr6_124742544_124756524
Eno2,6,124760053,124769673,protein_coding,-1,9620,chr6_124760053_124769673
Lrrc23,6,124769863,124779727,protein_coding,-1,9864,chr6_124769863_124779727
Spsb2,6,124808661,124810619,protein_coding,1,1958,chr6_124808661_124810619
Tpi1,6,124810586,124814296,protein_coding,-1,3710,chr6_124810586_124814296
Usp5,6,124815019,124829484,protein_coding,-1,14465,chr6_124815019_124829484
Cdca3,6,124829547,124833701,protein_coding,1,4154,chr6_124829547_124833701
Gnb3,6,124834240,124840275,protein_coding,-1,6035,chr6_124834240_124840275
P3h3,6,124841089,124857752,protein_coding,-1,16663,chr6_124841089_124857752
Gpr162,6,124858444,124863983,protein_coding,-1,5539,chr6_124858444_124863983
Cd4,6,124864692,124888221,protein_coding,-1,23529,chr6_124864692_124888221
Lag3,6,124904361,124911705,protein_coding,-1,7344,chr6_124904361_124911705
Ptms,6,124913681,124920103,protein_coding,-1,6422,chr6_124913681_124920103
A230083G16Rik,6,124916863,124925844,antisense,1,8981,chr6_124916863_124925844
Mlf2,6,124931386,124937238,protein_coding,1,5852,chr6_124931386_124937238
Cops7a,6,124958413,124965538,protein_coding,-1,7125,chr6_124958413_124965538
Pianp,6,124996694,125003096,protein_coding,1,6402,chr6_124996694_125003096
Zfp384,6,125009145,125037870,protein_coding,1,28725,chr6_125009145_125037870
4930557K07Rik,6,125010173,125049851,antisense,-1,39678,chr6_125010173_125049851
Ing4,6,125039760,125049265,protein_coding,1,9505,chr6_125039760_125049265
Acrbp,6,125049689,125063267,protein_coding,1,13578,chr6_125049689_125063267
Lpar5,6,125067920,125082472,protein_coding,1,14552,chr6_125067920_125082472
Chd4,6,125095981,125130591,protein_coding,1,34610,chr6_125095981_125130591
Nop2,6,125131909,125144753,protein_coding,1,12844,chr6_125131909_125144753
Iffo1,6,125145241,125161782,protein_coding,1,16541,chr6_125145241_125161782
Gapdh,6,125161715,125166467,protein_coding,-1,4752,chr6_125161715_125166467
Ncapd2,6,125168007,125191701,protein_coding,-1,23694,chr6_125168007_125191701
Mrpl51,6,125191801,125196269,protein_coding,1,4468,chr6_125191801_125196269
Vamp1,6,125215551,125245964,protein_coding,1,30413,chr6_125215551_125245964
Tapbpl,6,125223933,125231860,protein_coding,-1,7927,chr6_125223933_125231860
Cd27,6,125232622,125237010,protein_coding,-1,4388,chr6_125232622_125237010
Tuba3a,6,125278274,125286042,protein_coding,-1,7768,chr6_125278274_125286042
Ltbr,6,125306571,125313885,protein_coding,-1,7314,chr6_125306571_125313885
Scnn1a,6,125320659,125344943,protein_coding,1,24284,chr6_125320659_125344943
Tnfrsf1a,6,125349362,125362484,protein_coding,1,13122,chr6_125349362_125362484
Plekhg6,6,125362660,125380793,protein_coding,-1,18133,chr6_125362660_125380793
Cd9,6,125460266,125494791,protein_coding,-1,34525,chr6_125460266_125494791
Gm28809,6,125481363,125484678,antisense,1,3315,chr6_125481363_125484678
Vwf,6,125546774,125686679,protein_coding,1,139905,chr6_125546774_125686679
Ano2,6,125690419,126040126,protein_coding,1,349707,chr6_125690419_126040126
Ntf3,6,126101412,126166910,protein_coding,-1,65498,chr6_126101412_126166910
Gm10415,6,126286649,126328686,lincRNA,-1,42037,chr6_126286649_126328686
Gm29009,6,126331750,126334588,lincRNA,1,2838,chr6_126331750_126334588
Kcna5,6,126532551,126535412,protein_coding,-1,2861,chr6_126532551_126535412
Gm45869,6,126549869,126556169,lincRNA,-1,6300,chr6_126549869_126556169
Kcna1,6,126640397,126646384,protein_coding,-1,5987,chr6_126640397_126646384
Kcna6,6,126708329,126740674,protein_coding,-1,32345,chr6_126708329_126740674
Gm26673,6,126718684,126741601,antisense,1,22917,chr6_126718684_126741601
Ndufa9,6,126821721,126849136,protein_coding,-1,27415,chr6_126821721_126849136
1700018A23Rik,6,126822377,126825177,antisense,1,2800,chr6_126822377_126825177
Akap3,6,126853098,126874308,protein_coding,1,21210,chr6_126853098_126874308
Dyrk4,6,126876020,126921839,protein_coding,-1,45819,chr6_126876020_126921839
Rad51ap1,6,126923050,126939587,protein_coding,-1,16537,chr6_126923050_126939587
D6Wsu163e,6,126939962,126975967,protein_coding,1,36005,chr6_126939962_126975967
Fgf23,6,127072902,127081408,protein_coding,1,8506,chr6_127072902_127081408
Tigar,6,127085116,127109557,protein_coding,-1,24441,chr6_127085116_127109557
Platr31,6,127100297,127110467,antisense,1,10170,chr6_127100297_127110467
Gm43126,6,127122966,127126155,antisense,1,3189,chr6_127122966_127126155
Ccnd2,6,127125162,127152193,protein_coding,-1,27031,chr6_127125162_127152193
9330179D12Rik,6,127149389,127212411,antisense,1,63022,chr6_127149389_127212411
Gm43635,6,127251638,127254644,lincRNA,-1,3006,chr6_127251638_127254644
Gm38404,6,127296186,127307967,lincRNA,-1,11781,chr6_127296186_127307967
Parp11,6,127446840,127494261,protein_coding,1,47421,chr6_127446840_127494261
Cracr2a,6,127561338,127674248,protein_coding,1,112910,chr6_127561338_127674248
Prmt8,6,127689011,127769472,protein_coding,-1,80461,chr6_127689011_127769472
Gm42738,6,127767542,127768905,antisense,1,1363,chr6_127767542_127768905
Gm38901,6,127873563,127877246,lincRNA,-1,3683,chr6_127873563_127877246
Tspan11,6,127887589,127953977,protein_coding,1,66388,chr6_127887589_127953977
Gm15870,6,127934689,127944839,antisense,-1,10150,chr6_127934689_127944839
Tspan9,6,127961396,128143594,protein_coding,-1,182198,chr6_127961396_128143594
9330102E08Rik,6,128169704,128183803,translated_unprocessed_pseudogene,-1,14099,chr6_128169704_128183803
Gm10010,6,128187818,128200623,lincRNA,-1,12805,chr6_128187818_128200623
Tead4,6,128224288,128300823,protein_coding,-1,76535,chr6_128224288_128300823
Tulp3,6,128321161,128355851,protein_coding,-1,34690,chr6_128321161_128355851
Gm26770,6,128356004,128358837,antisense,1,2833,chr6_128356004_128358837
Rhno1,6,128357000,128362911,protein_coding,-1,5911,chr6_128357000_128362911
Foxm1,6,128362967,128376146,protein_coding,1,13179,chr6_128362967_128376146
Gm44596,6,128375503,128407475,protein_coding,1,31972,chr6_128375503_128407475
Gm15862,6,128381584,128399740,antisense,-1,18156,chr6_128381584_128399740
Nrip2,6,128399296,128416427,protein_coding,1,17131,chr6_128399296_128416427
Itfg2,6,128409444,128424931,protein_coding,-1,15487,chr6_128409444_128424931
Fkbp4,6,128429735,128438677,protein_coding,-1,8942,chr6_128429735_128438677
Gm10069,6,128438757,128503281,antisense,1,64524,chr6_128438757_128503281
Pzp,6,128483567,128526720,protein_coding,-1,43153,chr6_128483567_128526720
A2ml1,6,128539821,128581608,protein_coding,-1,41787,chr6_128539821_128581608
Klrb1a,6,128609227,128623533,protein_coding,-1,14306,chr6_128609227_128623533
Clec2h,6,128662385,128677374,protein_coding,1,14989,chr6_128662385_128677374
Klrb1,6,128705836,128723059,protein_coding,-1,17223,chr6_128705836_128723059
Gm44511,6,128780285,128826315,protein_coding,-1,46030,chr6_128780285_128826315
Gm44066,6,128842558,128843171,lincRNA,-1,613,chr6_128842558_128843171
Gm44067,6,128843786,128846959,lincRNA,-1,3173,chr6_128843786_128846959
BC035044,6,128849090,128891126,protein_coding,-1,42036,chr6_128849090_128891126
Clec2g,6,128934381,128984707,protein_coding,1,50326,chr6_128934381_128984707
Gm15987,6,128951204,128975029,antisense,-1,23825,chr6_128951204_128975029
Clec2e,6,129091998,129100913,protein_coding,-1,8915,chr6_129091998_129100913
Clec2d,6,129180615,129186534,protein_coding,1,5919,chr6_129180615_129186534
2310001H17Rik,6,129208412,129238725,lincRNA,-1,30313,chr6_129208412_129238725
Clec12a,6,129342691,129365303,protein_coding,1,22612,chr6_129342691_129365303
Clec1b,6,129397297,129409335,protein_coding,1,12038,chr6_129397297_129409335
Clec9a,6,129408862,129424763,protein_coding,1,15901,chr6_129408862_129424763
Clec1a,6,129424772,129452000,protein_coding,-1,27228,chr6_129424772_129452000
Olr1,6,129485244,129507165,protein_coding,-1,21921,chr6_129485244_129507165
Gabarapl1,6,129533160,129542346,protein_coding,1,9186,chr6_129533160_129542346
Klre1,6,129577905,129585827,protein_coding,1,7922,chr6_129577905_129585827
Klrd1,6,129591782,129598775,protein_coding,1,6993,chr6_129591782_129598775
Klrk1,6,129610323,129623864,protein_coding,-1,13541,chr6_129610323_129623864
Klrc1,6,129666015,129678973,protein_coding,-1,12958,chr6_129666015_129678973
Klri1,6,129697218,129717132,protein_coding,-1,19914,chr6_129697218_129717132
Klri2,6,129729041,129740484,protein_coding,-1,11443,chr6_129729041_129740484
Klra17,6,129831154,129876672,protein_coding,-1,45518,chr6_129831154_129876672
Gm17631,6,129862649,129864393,protein_coding,1,1744,chr6_129862649_129864393
Klra5,6,129898996,129917650,protein_coding,-1,18654,chr6_129898996_129917650
Klra6,6,130013033,130026954,protein_coding,-1,13921,chr6_130013033_130026954
Klra4,6,130043731,130067271,protein_coding,-1,23540,chr6_130043731_130067271
Klra8,6,130115226,130129898,protein_coding,-1,14672,chr6_130115226_130129898
Klra10,6,130269194,130281928,protein_coding,-1,12734,chr6_130269194_130281928
Klra3,6,130323289,130337574,protein_coding,-1,14285,chr6_130323289_130337574
Klra1,6,130363917,130386874,protein_coding,-1,22957,chr6_130363917_130386874
Klra2,6,131219223,131247362,protein_coding,-1,28139,chr6_131219223_131247362
Magohb,6,131284388,131293244,protein_coding,-1,8856,chr6_131284388_131293244
Styk1,6,131299142,131353597,protein_coding,-1,54455,chr6_131299142_131353597
Ybx3,6,131364855,131388476,protein_coding,-1,23621,chr6_131364855_131388476
5430401F13Rik,6,131486400,131553763,protein_coding,1,67363,chr6_131486400_131553763
Prp2,6,132595913,132601236,protein_coding,1,5323,chr6_132595913_132601236
A630073D07Rik,6,132625111,132651526,protein_coding,-1,26415,chr6_132625111_132651526
Smim10l1,6,133104909,133110899,protein_coding,1,5990,chr6_133104909_133110899
Etv6,6,134035700,134270158,protein_coding,1,234458,chr6_134035700_134270158
Gm17088,6,134168879,134172007,antisense,-1,3128,chr6_134168879_134172007
Gm17089,6,134233158,134243711,antisense,-1,10553,chr6_134233158_134243711
4933406J09Rik,6,134308951,134403415,antisense,-1,94464,chr6_134308951_134403415
Bcl2l14,6,134396318,134438736,protein_coding,1,42418,chr6_134396318_134438736
Gm44448,6,134404077,134424353,lincRNA,-1,20276,chr6_134404077_134424353
Lrp6,6,134446476,134566965,protein_coding,-1,120489,chr6_134446476_134566965
Gm38910,6,134605234,134607681,lincRNA,-1,2447,chr6_134605234_134607681
Mansc1,6,134609207,134632488,protein_coding,-1,23281,chr6_134609207_134632488
Borcs5,6,134639510,134711187,protein_coding,1,71677,chr6_134639510_134711187
Dusp16,6,134715468,134792625,protein_coding,-1,77157,chr6_134715468_134792625
Gm36328,6,134754246,134755192,antisense,1,946,chr6_134754246_134755192
Crebl2,6,134830154,134858931,protein_coding,1,28777,chr6_134830154_134858931
Gpr19,6,134869093,134898578,protein_coding,-1,29485,chr6_134869093_134898578
2810454H06Rik,6,134897961,134901108,antisense,1,3147,chr6_134897961_134901108
Cdkn1b,6,134920401,134925513,protein_coding,1,5112,chr6_134920401_134925513
Gm44238,6,134928992,134930112,lincRNA,-1,1120,chr6_134928992_134930112
Lockd,6,134929092,134956798,lincRNA,1,27706,chr6_134929092_134956798
Apold1,6,134981718,134986836,protein_coding,1,5118,chr6_134981718_134986836
Ddx47,6,135011612,135023776,protein_coding,1,12164,chr6_135011612_135023776
Gprc5a,6,135065651,135084709,protein_coding,1,19058,chr6_135065651_135084709
Gprc5d,6,135105991,135118283,protein_coding,-1,12292,chr6_135105991_135118283
Hebp1,6,135137522,135198022,protein_coding,-1,60500,chr6_135137522_135198022
Gm19434,6,135188480,135194960,antisense,1,6480,chr6_135188480_135194960
Fam234b,6,135197977,135244955,protein_coding,1,46978,chr6_135197977_135244955
Gsg1,6,135237326,135254351,protein_coding,-1,17025,chr6_135237326_135254351
Gm36640,6,135289359,135341684,antisense,1,52325,chr6_135289359_135341684
Pbp2,6,135309127,135310405,protein_coding,-1,1278,chr6_135309127_135310405
Gm44275,6,135312155,135319561,lincRNA,-1,7406,chr6_135312155_135319561
Emp1,6,135362545,135383173,protein_coding,1,20628,chr6_135362545_135383173
4930425L21Rik,6,135658913,135684527,lincRNA,1,25614,chr6_135658913_135684527
Grin2b,6,135713233,136173511,protein_coding,-1,460278,chr6_135713233_136173511
Gm14329,6,135732870,135744311,lincRNA,1,11441,chr6_135732870_135744311
Gm14330,6,135875505,135884792,antisense,1,9287,chr6_135875505_135884792
Gm26653,6,136173061,136175664,antisense,1,2603,chr6_136173061_136175664
E330021D16Rik,6,136400317,136415569,protein_coding,-1,15252,chr6_136400317_136415569
Atf7ip,6,136506167,136610862,protein_coding,1,104695,chr6_136506167_136610862
Plbd1,6,136612070,136661928,protein_coding,-1,49858,chr6_136612070_136661928
Gucy2c,6,136697284,136781765,protein_coding,-1,84481,chr6_136697284_136781765
Wbp11,6,136813654,136828233,protein_coding,-1,14579,chr6_136813654_136828233
BC049715,6,136827626,136840662,protein_coding,1,13036,chr6_136827626_136840662
Smco3,6,136829927,136835452,protein_coding,-1,5525,chr6_136829927_136835452
Art4,6,136848451,136857733,protein_coding,-1,9282,chr6_136848451_136857733
Mgp,6,136872435,136875823,protein_coding,-1,3388,chr6_136872435_136875823
Erp27,6,136907311,136922180,protein_coding,-1,14869,chr6_136907311_136922180
Arhgdib,6,136923655,136941899,protein_coding,-1,18244,chr6_136923655_136941899
Pde6h,6,136923832,136968865,protein_coding,1,45033,chr6_136923832_136968865
Rerg,6,137054825,137170497,protein_coding,-1,115672,chr6_137054825_137170497
Ptpro,6,137252319,137463233,protein_coding,1,210914,chr6_137252319_137463233
Eps8,6,137477245,137654876,protein_coding,-1,177631,chr6_137477245_137654876
Strap,6,137735078,137751932,protein_coding,1,16854,chr6_137735078_137751932
Dera,6,137754546,137857340,protein_coding,1,102794,chr6_137754546_137857340
Slc15a5,6,137983586,138079916,protein_coding,-1,96330,chr6_137983586_138079916
Mgst1,6,138140316,138156755,protein_coding,1,16439,chr6_138140316_138156755
Lmo3,6,138362918,138581968,protein_coding,-1,219050,chr6_138362918_138581968
A830011K09Rik,6,138423105,138429592,antisense,1,6487,chr6_138423105_138429592
Gm30332,6,138443973,138461615,antisense,1,17642,chr6_138443973_138461615
B230110G15Rik,6,138580624,138599314,antisense,1,18690,chr6_138580624_138599314
Igbp1b,6,138657089,138658544,protein_coding,-1,1455,chr6_138657089_138658544
Rergl,6,139492973,139501976,protein_coding,-1,9003,chr6_139492973_139501976
4930404I20Rik,6,139555559,139557611,lincRNA,-1,2052,chr6_139555559_139557611
Pik3c2g,6,139587221,139969284,protein_coding,1,382063,chr6_139587221_139969284
Plcz1,6,139989673,140041457,protein_coding,-1,51784,chr6_139989673_140041457
Plekha5,6,140424054,140597110,protein_coding,1,173056,chr6_140424054_140597110
Aebp2,6,140622663,140678472,protein_coding,1,55809,chr6_140622663_140678472
Gm11077,6,140729284,140756053,protein_coding,1,26769,chr6_140729284_140756053
Gm30524,6,140955609,141044134,lincRNA,1,88525,chr6_140955609_141044134
Gm28523,6,141246920,141250009,antisense,-1,3089,chr6_141246920_141250009
Pde3a,6,141249269,141507448,protein_coding,1,258179,chr6_141249269_141507448
Slco1c1,6,141524368,141570177,protein_coding,1,45809,chr6_141524368_141570177
Slco1b2,6,141629518,141686646,protein_coding,1,57128,chr6_141629518_141686646
Gm5724,6,141708118,141773810,protein_coding,-1,65692,chr6_141708118_141773810
Slco1a4,6,141805440,141856199,protein_coding,-1,50759,chr6_141805440_141856199
Slco1a1,6,141907282,141946962,protein_coding,-1,39680,chr6_141907282_141946962
Gm6614,6,141971845,142011414,protein_coding,-1,39569,chr6_141971845_142011414
Slco1a6,6,142085761,142208521,protein_coding,-1,122760,chr6_142085761_142208521
Gm20400,6,142161493,142173796,antisense,1,12303,chr6_142161493_142173796
Slco1a5,6,142234227,142322981,protein_coding,-1,88754,chr6_142234227_142322981
Pyroxd1,6,142345654,142363257,protein_coding,1,17603,chr6_142345654_142363257
Recql,6,142350342,142387087,protein_coding,-1,36745,chr6_142350342_142387087
Golt1b,6,142387221,142403858,protein_coding,1,16637,chr6_142387221_142403858
Spx,6,142413441,142419730,protein_coding,1,6289,chr6_142413441_142419730
Gys2,6,142422613,142473109,protein_coding,-1,50496,chr6_142422613_142473109
Ldhb,6,142490249,142507957,protein_coding,-1,17708,chr6_142490249_142507957
Kcnj8,6,142564837,142571614,protein_coding,-1,6777,chr6_142564837_142571614
Abcc9,6,142587862,142702315,protein_coding,-1,114453,chr6_142587862_142702315
5330439B14Rik,6,142614595,142626462,antisense,1,11867,chr6_142614595_142626462
Cmas,6,142756686,142775714,protein_coding,1,19028,chr6_142756686_142775714
Sult6b2,6,142785204,142804502,protein_coding,-1,19298,chr6_142785204_142804502
St8sia1,6,142821545,142964452,protein_coding,-1,142907,chr6_142821545_142964452
A930014E10Rik,6,142971752,142973818,lincRNA,1,2066,chr6_142971752_142973818
C2cd5,6,143010920,143100141,protein_coding,-1,89221,chr6_143010920_143100141
Gm31108,6,143109214,143153931,lincRNA,-1,44717,chr6_143109214_143153931
Etnk1,6,143167221,143232307,protein_coding,1,65086,chr6_143167221_143232307
1700126G02Rik,6,143201397,143221448,antisense,-1,20051,chr6_143201397_143221448
D6Ertd474e,6,143245888,143297272,lincRNA,1,51384,chr6_143245888_143297272
1700060C16Rik,6,143593353,143651288,lincRNA,-1,57935,chr6_143593353_143651288
Sox5,6,143828425,144781977,protein_coding,-1,953552,chr6_143828425_144781977
Sox5os1,6,144021908,144023778,antisense,1,1870,chr6_144021908_144023778
Sox5os2,6,144481225,144501416,antisense,1,20191,chr6_144481225_144501416
Sox5os3,6,144672868,144693834,antisense,1,20966,chr6_144672868_144693834
Sox5os4,6,144720911,144759883,antisense,1,38972,chr6_144720911_144759883
Bcat1,6,144993835,145076184,protein_coding,-1,82349,chr6_144993835_145076184
Gm26666,6,145047559,145050430,antisense,1,2871,chr6_145047559_145050430
Gm15687,6,145056389,145059892,antisense,1,3503,chr6_145056389_145059892
Lrmp,6,145115653,145174934,protein_coding,1,59281,chr6_145115653_145174934
Casc1,6,145174834,145211005,protein_coding,-1,36171,chr6_145174834_145211005
Gm15543,6,145182275,145187630,antisense,1,5355,chr6_145182275_145187630
Etfrf1,6,145211134,145216939,protein_coding,1,5805,chr6_145211134_145216939
Kras,6,145216699,145250239,protein_coding,-1,33540,chr6_145216699_145250239
Gm15706,6,145250529,145251849,lincRNA,1,1320,chr6_145250529_145251849
2010013B24Rik,6,145303152,145308951,lincRNA,1,5799,chr6_145303152_145308951
Lmntd1,6,145365134,145614319,protein_coding,-1,249185,chr6_145365134_145614319
Gm15499,6,145441756,145444028,antisense,1,2272,chr6_145441756_145444028
Gm15704,6,145738693,145746273,lincRNA,-1,7580,chr6_145738693_145746273
Rassf8,6,145746748,145821079,protein_coding,1,74331,chr6_145746748_145821079
Bhlhe41,6,145858243,145865558,protein_coding,-1,7315,chr6_145858243_145865558
Sspn,6,145931641,145965223,protein_coding,1,33582,chr6_145931641_145965223
Sspnos,6,145951656,145957534,antisense,-1,5878,chr6_145951656_145957534
Itpr2,6,146108299,146502223,protein_coding,-1,393924,chr6_146108299_146502223
Ints13,6,146549632,146577835,protein_coding,-1,28203,chr6_146549632_146577835
Fgfr1op2,6,146577203,146599198,protein_coding,1,21995,chr6_146577203_146599198
Tm7sf3,6,146602352,146642824,protein_coding,-1,40472,chr6_146602352_146642824
Med21,6,146642547,146650732,protein_coding,1,8185,chr6_146642547_146650732
4930479D17Rik,6,146657218,146665403,lincRNA,1,8185,chr6_146657218_146665403
Stk38l,6,146724995,146778812,protein_coding,1,53817,chr6_146724995_146778812
Arntl2,6,146796055,146833529,protein_coding,1,37474,chr6_146796055_146833529
Smco2,6,146850104,146871406,protein_coding,1,21302,chr6_146850104_146871406
Ppfibp1,6,146888487,147032025,protein_coding,1,143538,chr6_146888487_147032025
1700034J05Rik,6,146950329,146954422,protein_coding,-1,4093,chr6_146950329_146954422
Gm44085,6,146992367,146994024,antisense,-1,1657,chr6_146992367_146994024
Rep15,6,147032584,147034245,protein_coding,1,1661,chr6_147032584_147034245
Mrps35,6,147042764,147073991,protein_coding,1,31227,chr6_147042764_147073991
Mansc4,6,147075060,147087032,protein_coding,-1,11972,chr6_147075060_147087032
Klhl42,6,147091379,147112778,protein_coding,1,21399,chr6_147091379_147112778
E330012B07Rik,6,147180244,147208285,lincRNA,1,28041,chr6_147180244_147208285
Gm15767,6,147242527,147243801,lincRNA,-1,1274,chr6_147242527_147243801
Pthlh,6,147252101,147264183,protein_coding,-1,12082,chr6_147252101_147264183
Gm6288,6,147438362,147476046,antisense,-1,37684,chr6_147438362_147476046
Ccdc91,6,147475828,147632612,protein_coding,1,156784,chr6_147475828_147632612
1700049E15Rik,6,147690241,147702374,lincRNA,1,12133,chr6_147690241_147702374
Gm15762,6,147709982,147719451,lincRNA,-1,9469,chr6_147709982_147719451
Far2os2,6,148006580,148047339,antisense,-1,40759,chr6_148006580_148047339
Far2,6,148047259,148182758,protein_coding,1,135499,chr6_148047259_148182758
Far2os1,6,148060855,148067873,antisense,-1,7018,chr6_148060855_148067873
Ergic2,6,148179079,148212374,protein_coding,-1,33295,chr6_148179079_148212374
Gm17216,6,148213367,148214573,lincRNA,-1,1206,chr6_148213367_148214573
Tmtc1,6,148232430,148444389,protein_coding,-1,211959,chr6_148232430_148444389
Gm44020,6,148358795,148362113,antisense,1,3318,chr6_148358795_148362113
Gm6313,6,148606786,148614309,lincRNA,-1,7523,chr6_148606786_148614309
4930528G23Rik,6,148659978,148678000,lincRNA,-1,18022,chr6_148659978_148678000
Gm44115,6,148701998,148712269,lincRNA,1,10271,chr6_148701998_148712269
Ipo8,6,148770683,148831467,protein_coding,-1,60784,chr6_148770683_148831467
Caprin2,6,148842492,148896237,protein_coding,-1,53745,chr6_148842492_148896237
Gm43913,6,148915215,148920535,lincRNA,-1,5320,chr6_148915215_148920535
3010003L21Rik,6,148944867,148947129,antisense,1,2262,chr6_148944867_148947129
Dennd5b,6,148988071,149101680,protein_coding,-1,113609,chr6_148988071_149101680
Gm10203,6,149130170,149130710,protein_coding,1,540,chr6_149130170_149130710
Etfbkmt,6,149139849,149151171,protein_coding,1,11322,chr6_149139849_149151171
Amn1,6,149157147,149188712,protein_coding,-1,31565,chr6_149157147_149188712
1700003I16Rik,6,149199095,149215185,lincRNA,-1,16090,chr6_149199095_149215185
Bicd1,6,149408886,149563329,protein_coding,1,154443,chr6_149408886_149563329
Gm21814,6,149566090,149583656,lincRNA,1,17566,chr6_149566090_149583656
Speer9-ps1,7,3128146,3144992,lincRNA;lncRNA,1,16846,chr7_3128146_3144992
AU018091,7,3154498,3169203,protein_coding,-1,14705,chr7_3154498_3169203
Nlrp12,7,3217458,3249740,protein_coding,-1,32282,chr7_3217458_3249740
Myadm,7,3289080,3300442,protein_coding,1,11362,chr7_3289080_3300442
Prkcg,7,3289179,3331099,protein_coding,1,41920,chr7_3289179_3331099
Cacng7,7,3331471,3368221,protein_coding,1,36750,chr7_3331471_3368221
Gm44257,7,3376637,3390080,lincRNA;lncRNA,-1,13443,chr7_3376637_3390080
Cacng8,7,3389199,3415648,protein_coding,1,26449,chr7_3389199_3415648
Gm44151,CHR_MG4151_PATCH,3390112,3400926,antisense;lncRNA,-1,10814,chrCHR_MG4151_PATCH_3390112_3400926
3300002P13Rik,7,3420181,3423445,lincRNA;lncRNA,-1,3264,chr7_3420181_3423445
Cacng6,7,3422711,3435667,protein_coding,1,12956,chr7_3422711_3435667
Gm35037,7,3449873,3475020,lincRNA;lncRNA,1,25147,chr7_3449873_3475020
Tarm1,7,3486500,3502624,protein_coding,-1,16124,chr7_3486500_3502624
Gm44920,7,3591646,3604150,lincRNA,-1,12504,chr7_3591646_3604150
Oscar,7,3609813,3616157,protein_coding,-1,6344,chr7_3609813_3616157
Ndufa3,7,3617373,3620327,protein_coding,1,2954,chr7_3617373_3620327
Tfpt,7,3620324,3629929,protein_coding,-1,9605,chr7_3620324_3629929
Prpf31,7,3629985,3642486,protein_coding,1,12501,chr7_3629985_3642486
Cnot3,7,3645268,3661109,protein_coding,1,15841,chr7_3645268_3661109
Leng1,7,3660098,3665840,protein_coding,-1,5742,chr7_3660098_3665840
Tmc4,7,3665790,3677553,protein_coding,-1,11763,chr7_3665790_3677553
Gm15929,7,3666252,3670278,antisense,1,4026,chr7_3666252_3670278
Mboat7,7,3677789,3693523,protein_coding,-1,15734,chr7_3677789_3693523
Tsen34,7,3692863,3701024,protein_coding,1,8161,chr7_3692863_3701024
Rps9,7,3703993,3706897,protein_coding,1,2904,chr7_3703993_3706897
Pirb,7,3711409,3720391,protein_coding,-1,8982,chr7_3711409_3720391
Gm15448,7,3816781,3825687,protein_coding,-1,8906,chr7_3816781_3825687
Pira2,7,3836812,3845051,protein_coding,-1,8239,chr7_3836812_3845051
Gm14548,7,3884242,3898120,protein_coding,-1,13878,chr7_3884242_3898120
Lilra6,7,3908280,3915503,protein_coding,-1,7223,chr7_3908280_3915503
Gm44581,7,3928853,3932849,lincRNA,-1,3996,chr7_3928853_3932849
Lair1,7,4003402,4063204,protein_coding,-1,59802,chr7_4003402_4063204
9430041J12Rik,7,4074125,4120728,antisense,-1,46603,chr7_4074125_4120728
Ttyh1,7,4119408,4136708,protein_coding,1,17300,chr7_4119408_4136708
D030047H15Rik,7,4126340,4136926,antisense,-1,10586,chr7_4126340_4136926
Leng8,7,4137039,4148177,protein_coding,1,11138,chr7_4137039_4148177
Leng9,7,4147915,4150374,protein_coding,-1,2459,chr7_4147915_4150374
Cdc42ep5,7,4151260,4164860,protein_coding,-1,13600,chr7_4151260_4164860
Lilra5,7,4237754,4243463,protein_coding,1,5709,chr7_4237754_4243463
Ncr1,7,4337724,4345164,protein_coding,1,7440,chr7_4337724_4345164
Gp6,7,4363965,4397744,protein_coding,-1,33779,chr7_4363965_4397744
Rdh13,7,4424770,4445649,protein_coding,-1,20879,chr7_4424770_4445649
Gm15494,7,4445697,4471285,antisense,-1,25588,chr7_4445697_4471285
Eps8l1,7,4460674,4480487,protein_coding,1,19813,chr7_4460674_4480487
Ppp1r12c,7,4481520,4501680,protein_coding,-1,20160,chr7_4481520_4501680
Tnnt1,7,4504570,4516382,protein_coding,-1,11812,chr7_4504570_4516382
Tnni3,7,4518305,4524229,protein_coding,-1,5924,chr7_4518305_4524229
Dnaaf3,7,4522933,4532453,protein_coding,-1,9520,chr7_4522933_4532453
Gm15873,7,4526536,4530575,antisense,1,4039,chr7_4526536_4530575
Syt5,7,4539765,4547541,protein_coding,-1,7776,chr7_4539765_4547541
Ptprh,7,4548612,4604041,protein_coding,-1,55429,chr7_4548612_4604041
Gm44877,7,4626978,4630544,antisense,1,3566,chr7_4626978_4630544
Tmem86b,7,4628040,4631422,protein_coding,-1,3382,chr7_4628040_4631422
Ppp6r1,7,4631495,4659019,protein_coding,-1,27524,chr7_4631495_4659019
Hspbp1,7,4660521,4685068,protein_coding,-1,24547,chr7_4660521_4685068
Brsk1,7,4690604,4715997,protein_coding,1,25393,chr7_4690604_4715997
Tmem150b,7,4706832,4725249,protein_coding,-1,18417,chr7_4706832_4725249
Kmt5c,7,4740115,4747514,protein_coding,1,7399,chr7_4740115_4747514
Cox6b2,7,4751792,4753094,protein_coding,-1,1302,chr7_4751792_4753094
Fam71e2,7,4753226,4771302,protein_coding,-1,18076,chr7_4753226_4771302
Il11,7,4772373,4782859,protein_coding,-1,10486,chr7_4772373_4782859
Tmem190,7,4782937,4784341,protein_coding,1,1404,chr7_4782937_4784341
Tmem238,7,4784557,4789656,protein_coding,-1,5099,chr7_4784557_4789656
Rpl28,7,4792874,4795066,protein_coding,1,2192,chr7_4792874_4795066
Ube2s,7,4794546,4812590,protein_coding,-1,18044,chr7_4794546_4812590
Shisa7,7,4825552,4844696,protein_coding,-1,19144,chr7_4825552_4844696
Isoc2b,7,4844959,4870258,protein_coding,-1,25299,chr7_4844959_4870258
Isoc2a,7,4877153,4896973,protein_coding,1,19820,chr7_4877153_4896973
Gm36210,7,4898450,4906516,protein_coding,-1,8066,chr7_4898450_4906516
Gm44983,7,4908886,4912357,lincRNA,-1,3471,chr7_4908886_4912357
Zfp628,7,4915217,4922002,protein_coding,1,6785,chr7_4915217_4922002
Nat14,7,4922028,4925006,protein_coding,1,2978,chr7_4922028_4925006
Ssc5d,7,4925785,4944826,protein_coding,1,19041,chr7_4925785_4944826
Sbk2,7,4940512,4964406,protein_coding,-1,23894,chr7_4940512_4964406
Sbk3,7,4965260,4971168,protein_coding,-1,5908,chr7_4965260_4971168
Zfp579,7,4983483,4996158,protein_coding,-1,12675,chr7_4983483_4996158
Fiz1,7,5007059,5014697,protein_coding,-1,7638,chr7_5007059_5014697
Zfp524,7,5014415,5018488,protein_coding,1,4073,chr7_5014415_5018488
Gm44973,7,5015496,5033097,protein_coding,1,17601,chr7_5015496_5033097
Ccdc106,7,5020553,5060785,protein_coding,1,40232,chr7_5020553_5060785
Zfp784,7,5034439,5038446,protein_coding,-1,4007,chr7_5034439_5038446
Gm15510,7,5046949,5057116,antisense,-1,10167,chr7_5046949_5057116
U2af2,7,5062143,5079938,protein_coding,1,17795,chr7_5062143_5079938
Epn1,7,5080235,5098178,protein_coding,1,17943,chr7_5080235_5098178
Rfpl4,7,5109787,5116950,protein_coding,-1,7163,chr7_5109787_5116950
Rasl2-9,7,5124938,5125950,protein_coding,-1,1012,chr7_5124938_5125950
Vmn1r57,7,5218493,5221736,protein_coding,1,3243,chr7_5218493_5221736
Nlrp2,7,5298547,5351035,protein_coding,-1,52488,chr7_5298547_5351035
Gm5065,7,5350537,5360682,protein_coding,1,10145,chr7_5350537_5360682
Vmn1r58,7,5401681,5413396,protein_coding,-1,11715,chr7_5401681_5413396
Vmn2r28,7,5477255,5493956,protein_coding,-1,16701,chr7_5477255_5493956
Vmn1r65,7,6007750,6011010,protein_coding,-1,3260,chr7_6007750_6011010
Nlrp4c,7,6045161,6105150,protein_coding,1,59989,chr7_6045161_6105150
Zfp787,7,6131491,6155997,protein_coding,-1,24506,chr7_6131491_6155997
Zfp444,7,6172226,6193811,protein_coding,1,21585,chr7_6172226_6193811
Galp,7,6197090,6216137,protein_coding,1,19047,chr7_6197090_6216137
Zscan5b,7,6222278,6239423,protein_coding,1,17145,chr7_6222278_6239423
Epp13,7,6252710,6282066,protein_coding,1,29356,chr7_6252710_6282066
Gm45069,7,6282839,6283610,lincRNA,-1,771,chr7_6282839_6283610
Zfp667,7,6286579,6307883,protein_coding,1,21304,chr7_6286579_6307883
Zfp583,7,6315660,6331285,protein_coding,-1,15625,chr7_6315660_6331285
Gm38944,7,6342995,6344005,lincRNA,-1,1010,chr7_6342995_6344005
Gm3854,7,6343759,6355956,protein_coding,1,12197,chr7_6343759_6355956
Zfp78,7,6363280,6382605,protein_coding,1,19325,chr7_6363280_6382605
Zfp28,7,6383295,6396915,protein_coding,1,13620,chr7_6383295_6396915
Smim17,7,6398715,6432093,protein_coding,1,33378,chr7_6398715_6432093
Gm20715,7,6410277,6441691,protein_coding,1,31414,chr7_6410277_6441691
Olfr1344,7,6438688,6442161,protein_coding,1,3473,chr7_6438688_6442161
Olfr1336,7,6456168,6466817,protein_coding,1,10649,chr7_6456168_6466817
Olfr1346,7,6467101,6478112,protein_coding,1,11011,chr7_6467101_6478112
Olfr5,7,6478322,6486941,protein_coding,-1,8619,chr7_6478322_6486941
Olfr1347,7,6486944,6499755,protein_coding,-1,12811,chr7_6486944_6499755
Olfr1348,7,6499793,6508748,protein_coding,-1,8955,chr7_6499793_6508748
Olfr1349,7,6513269,6522950,protein_coding,-1,9681,chr7_6513269_6522950
Zim1,7,6671269,6696450,protein_coding,-1,25181,chr7_6671269_6696450
Peg3,7,6703892,6730431,protein_coding,-1,26539,chr7_6703892_6730431
Usp29,7,6730578,6967219,protein_coding,1,236641,chr7_6730578_6967219
Zim3,7,6955685,6977420,antisense,-1,21735,chr7_6955685_6977420
Aurkc,7,6995300,7003091,protein_coding,1,7791,chr7_6995300_7003091
Zfp954,7,7114690,7121488,protein_coding,-1,6798,chr7_7114690_7121488
Zfp773,7,7127073,7136755,protein_coding,-1,9682,chr7_7127073_7136755
Zfp418,7,7171330,7183562,protein_coding,1,12232,chr7_7171330_7183562
Zfp772,7,7202117,7209998,protein_coding,-1,7881,chr7_7202117_7209998
Gm45844,7,7213017,7278289,protein_coding,-1,65272,chr7_7213017_7278289
Clcn4,7,7282309,7300851,protein_coding,-1,18542,chr7_7282309_7300851
Gm45631,7,7295766,7297137,antisense,1,1371,chr7_7295766_7297137
Vmn2r30,7,7310437,7337609,protein_coding,-1,27172,chr7_7310437_7337609
Gm45783,7,7334149,7374573,protein_coding,-1,40424,chr7_7334149_7374573
Vmn2r32,7,7462096,7480018,protein_coding,-1,17922,chr7_7462096_7480018
Vmn2r33,7,7550967,7566786,protein_coding,-1,15819,chr7_7550967_7566786
Vmn2r34,7,7670804,7689513,protein_coding,-1,18709,chr7_7670804_7689513
Vmn2r35,7,7786151,7819867,protein_coding,-1,33716,chr7_7786151_7819867
Vmn2r36,7,7875954,7902495,protein_coding,-1,26541,chr7_7875954_7902495
Vmn2r41,7,8136950,8161654,protein_coding,-1,24704,chr7_8136950_8161654
Vmn2r42,7,8182372,8200320,protein_coding,-1,17948,chr7_8182372_8200320
Vmn2r45,7,8469563,8489075,protein_coding,-1,19512,chr7_8469563_8489075
Vmn2r40,7,8906772,8931435,protein_coding,-1,24663,chr7_8906772_8931435
Vmn2r38,7,9073775,9097881,protein_coding,-1,24106,chr7_9073775_9097881
Vmn2r37,7,9205546,9223653,protein_coding,-1,18107,chr7_9205546_9223653
Vmn2r46,7,9747811,9770571,protein_coding,-1,22760,chr7_9747811_9770571
Vmn2r47,7,9816782,9841325,protein_coding,-1,24543,chr7_9816782_9841325
Gm45351,7,9868880,9876966,unprocessed_pseudogene,-1,8086,chr7_9868880_9876966
Vmn2r48,7,9927624,9953585,protein_coding,-1,25961,chr7_9927624_9953585
Vmn2r49,7,9976245,9992257,protein_coding,-1,16012,chr7_9976245_9992257
Vmn2r51,7,10087198,10105741,protein_coding,-1,18543,chr7_10087198_10105741
Vmn1r66,7,10272991,10278006,protein_coding,-1,5015,chr7_10272991_10278006
Vmn1r67,7,10443331,10449202,protein_coding,1,5871,chr7_10443331_10449202
Zik1,7,10487229,10495394,protein_coding,-1,8165,chr7_10487229_10495394
Vmn1r69,7,10578930,10613659,protein_coding,-1,34729,chr7_10578930_10613659
Nlrp4b,7,10687789,10730168,protein_coding,1,42379,chr7_10687789_10730168
Vmn1r71,7,10744543,10754364,protein_coding,-1,9821,chr7_10744543_10754364
Zscan4d,7,11161374,11166159,protein_coding,-1,4785,chr7_11161374_11166159
Vmn1r72,7,11664479,11680147,protein_coding,-1,15668,chr7_11664479_11680147
Vmn1r73,7,11730266,11762081,protein_coding,1,31815,chr7_11730266_11762081
Vmn1r74,7,11833980,11853276,protein_coding,1,19296,chr7_11833980_11853276
Vmn1r76,7,11923523,11938213,protein_coding,-1,14690,chr7_11923523_11938213
Vmn1r78,7,12150257,12159959,protein_coding,1,9702,chr7_12150257_12159959
Vmn1r81,7,12247241,12268269,protein_coding,-1,21028,chr7_12247241_12268269
Vmn1r83,7,12319707,12329481,protein_coding,-1,9774,chr7_12319707_12329481
Vmn1r84,7,12360313,12369273,protein_coding,-1,8960,chr7_12360313_12369273
Zfp551,7,12415153,12422751,protein_coding,-1,7598,chr7_12415153_12422751
Zfp606,7,12478293,12496235,protein_coding,1,17942,chr7_12478293_12496235
2900092C05Rik,7,12512517,12556323,protein_coding,1,43806,chr7_12512517_12556323
Vmn2r53,7,12562851,12608788,protein_coding,-1,45937,chr7_12562851_12608788
Vmn2r54,7,12613839,12640319,protein_coding,-1,26480,chr7_12613839_12640319
Vmn2r55,7,12651706,12685003,protein_coding,-1,33297,chr7_12651706_12685003
Vmn2r56,7,12688721,12735004,protein_coding,-1,46283,chr7_12688721_12735004
Zscan18,7,12768090,12803635,protein_coding,-1,35545,chr7_12768090_12803635
Zfp329,7,12804977,12818858,protein_coding,-1,13881,chr7_12804977_12818858
Gm45593,7,12825918,12828121,lincRNA,1,2203,chr7_12825918_12828121
Zfp110,7,12834761,12850577,protein_coding,1,15816,chr7_12834761_12850577
Gm31152,7,12860884,12868583,lincRNA,-1,7699,chr7_12860884_12868583
Zfp128,7,12881177,12893422,protein_coding,1,12245,chr7_12881177_12893422
Zscan22,7,12897815,12909083,protein_coding,1,11268,chr7_12897815_12909083
Rps5,7,12922290,12926686,protein_coding,1,4396,chr7_12922290_12926686
Rnf225,7,12927416,12931072,protein_coding,1,3656,chr7_12927416_12931072
1810019N24Rik,7,12948592,12961768,lincRNA,-1,13176,chr7_12948592_12961768
Gm29638,7,12959299,12961887,lincRNA,1,2588,chr7_12959299_12961887
Zfp324,7,12965838,12974236,protein_coding,1,8398,chr7_12965838_12974236
Zfp446,7,12977848,12985714,protein_coding,1,7866,chr7_12977848_12985714
Slc27a5,7,12988346,12998192,protein_coding,-1,9846,chr7_12988346_12998192
Trim28,7,12999114,13031035,protein_coding,1,31921,chr7_12999114_13031035
Zbtb45,7,13003898,13010034,protein_coding,-1,6136,chr7_13003898_13010034
Chmp2a,7,13032010,13034807,protein_coding,-1,2797,chr7_13032010_13034807
Ube2m,7,13035120,13038275,protein_coding,-1,3155,chr7_13035120_13038275
Mzf1,7,13042303,13054764,protein_coding,-1,12461,chr7_13042303_13054764
Gm45436,7,13093172,13098674,lincRNA,1,5502,chr7_13093172_13098674
Vmn1r86,7,13097531,13119917,protein_coding,-1,22386,chr7_13097531_13119917
Vmn1r87,7,13130904,13140157,protein_coding,-1,9253,chr7_13130904_13140157
Gm38947,7,13192117,13197215,lincRNA,-1,5098,chr7_13192117_13197215
Vmn1r89,7,13213020,13220657,protein_coding,1,7637,chr7_13213020_13220657
Zswim9,7,13258967,13278721,protein_coding,-1,19754,chr7_13258967_13278721
Lig1,7,13277283,13311433,protein_coding,1,34150,chr7_13277283_13311433
Pla2g4c,7,13324655,13360672,protein_coding,1,36017,chr7_13324655_13360672
Cabp5,7,13398132,13408887,protein_coding,1,10755,chr7_13398132_13408887
Bsph1,7,13450841,13473449,protein_coding,1,22608,chr7_13450841_13473449
Bsph2,7,13554864,13571067,protein_coding,-1,16203,chr7_13554864_13571067
Sult2a5,7,13623967,13670807,protein_coding,1,46840,chr7_13623967_13670807
Sult2a2,7,13733505,13779636,protein_coding,1,46131,chr7_13733505_13779636
Sult2a1,7,13796246,13837409,protein_coding,-1,41163,chr7_13796246_13837409
Sult2a4,7,13909676,13989607,protein_coding,-1,79931,chr7_13909676_13989607
Sult2a3,7,14067446,14123044,protein_coding,-1,55598,chr7_14067446_14123044
Sult2a6,7,14222403,14254870,protein_coding,-1,32467,chr7_14222403_14254870
Sult2a8,7,14410686,14446769,protein_coding,-1,36083,chr7_14410686_14446769
Sult2a7,7,14465051,14494230,protein_coding,-1,29179,chr7_14465051_14494230
Vmn1r90,7,14555474,14563506,protein_coding,-1,8032,chr7_14555474_14563506
Obox7,7,14659496,14665996,protein_coding,1,6500,chr7_14659496_14665996
Obox1,7,15388948,15556866,protein_coding,1,167918,chr7_15388948_15556866
Obox3,7,15479825,15639902,protein_coding,-1,160077,chr7_15479825_15639902
Obox5,7,15750131,15759800,protein_coding,1,9669,chr7_15750131_15759800
Obox6,7,15833241,15839678,protein_coding,-1,6437,chr7_15833241_15839678
Crx,7,15865947,15879968,protein_coding,-1,14021,chr7_15865947_15879968
Crxos,7,15882617,15904020,protein_coding,1,21403,chr7_15882617_15904020
Selenow,7,15917208,15922402,protein_coding,-1,5194,chr7_15917208_15922402
Nop53,7,15936183,15946074,protein_coding,-1,9891,chr7_15936183_15946074
Ehd2,7,15946958,15967567,protein_coding,-1,20609,chr7_15946958_15967567
Bicra,7,15970672,16047921,protein_coding,-1,77249,chr7_15970672_16047921
Gm38948,7,15971883,15984654,lincRNA,1,12771,chr7_15971883_15984654
Zfp541,7,16061814,16096334,protein_coding,1,34520,chr7_16061814_16096334
Napa,7,16098458,16117975,protein_coding,1,19517,chr7_16098458_16117975
Kptn,7,16119895,16127516,protein_coding,1,7621,chr7_16119895_16127516
Slc8a2,7,16129826,16161063,protein_coding,1,31237,chr7_16129826_16161063
Meis3,7,16175090,16186504,protein_coding,1,11414,chr7_16175090_16186504
Dhx34,7,16197147,16222037,protein_coding,-1,24890,chr7_16197147_16222037
C5ar2,7,16234585,16244154,protein_coding,-1,9569,chr7_16234585_16244154
C5ar1,7,16246743,16259540,protein_coding,-1,12797,chr7_16246743_16259540
Inafm1,7,16272013,16273617,protein_coding,-1,1604,chr7_16272013_16273617
Ccdc9,7,16274042,16286795,protein_coding,-1,12753,chr7_16274042_16286795
Bbc3,7,16308393,16318205,protein_coding,1,9812,chr7_16308393_16318205
Sae1,7,16320234,16387806,protein_coding,-1,67572,chr7_16320234_16387806
Zc3h4,7,16400910,16437696,protein_coding,1,36786,chr7_16400910_16437696
Gm45509,7,16406755,16407983,lincRNA,-1,1228,chr7_16406755_16407983
Gm45510,7,16413908,16416621,antisense,-1,2713,chr7_16413908_16416621
Tmem160,7,16452779,16455494,protein_coding,1,2715,chr7_16452779_16455494
Npas1,7,16455721,16477728,protein_coding,-1,22007,chr7_16455721_16477728
Arhgap35,7,16493719,16614993,protein_coding,-1,121274,chr7_16493719_16614993
Gm29443,7,16613824,16632643,antisense,1,18819,chr7_16613824_16632643
Gm29442,7,16618627,16619832,lincRNA,-1,1205,chr7_16618627_16619832
Ceacam15,7,16671331,16675705,protein_coding,-1,4374,chr7_16671331_16675705
Ceacam9,7,16721929,16726132,protein_coding,1,4203,chr7_16721929_16726132
Ap2s1,7,16738410,16749294,protein_coding,1,10884,chr7_16738410_16749294
Slc1a5,7,16781340,16798274,protein_coding,1,16934,chr7_16781340_16798274
Fkrp,7,16809246,16816732,protein_coding,-1,7486,chr7_16809246_16816732
Strn4,7,16815889,16840931,protein_coding,1,25042,chr7_16815889_16840931
Prkd2,7,16842902,16870464,protein_coding,1,27562,chr7_16842902_16870464
9330104G04Rik,7,16871347,16874886,lincRNA,-1,3539,chr7_16871347_16874886
Dact3,7,16875317,16887462,protein_coding,1,12145,chr7_16875317_16887462
Gng8,7,16891786,16895436,protein_coding,1,3650,chr7_16891786_16895436
Ptgir,7,16906490,16910905,protein_coding,1,4415,chr7_16906490_16910905
Calm3,7,16915379,16924114,protein_coding,-1,8735,chr7_16915379_16924114
Pnmal2,7,16944682,16948828,protein_coding,1,4146,chr7_16944682_16948828
Pnmal1,7,16959679,16964607,protein_coding,1,4928,chr7_16959679_16964607
Gm42372,7,16983086,16988152,protein_coding,1,5066,chr7_16983086_16988152
Ccdc8,7,16992708,16997516,protein_coding,1,4808,chr7_16992708_16997516
Ppp5c,7,17004640,17027924,protein_coding,-1,23284,chr7_17004640_17027924
Hif3a,7,17031507,17062427,protein_coding,-1,30920,chr7_17031507_17062427
Psg16,7,17074040,17133450,protein_coding,1,59410,chr7_17074040_17133450
Ceacam3,7,17150282,17164253,protein_coding,1,13971,chr7_17150282_17164253
Psg29,7,17203477,17215760,protein_coding,1,12283,chr7_17203477_17215760
Gm32772,7,17287678,17371627,lincRNA,-1,83949,chr7_17287678_17371627
Gm32846,7,17392760,17424099,lincRNA,-1,31339,chr7_17392760_17424099
Ceacam5,7,17713238,17761132,protein_coding,1,47894,chr7_17713238_17761132
Ceacam14,7,17812633,17815663,protein_coding,1,3030,chr7_17812633_17815663
Ceacam13,7,18009889,18019221,protein_coding,1,9332,chr7_18009889_18019221
Gm44613,7,18074016,18186952,antisense,-1,112936,chr7_18074016_18186952
Igfl3,7,18176494,18181862,protein_coding,1,5368,chr7_18176494_18181862
Mill1,7,18245347,18266092,protein_coding,1,20745,chr7_18245347_18266092
Psg25,7,18519702,18532269,protein_coding,-1,12567,chr7_18519702_18532269
Psg27,7,18556514,18567305,protein_coding,-1,10791,chr7_18556514_18567305
Psg23,7,18606343,18616501,protein_coding,-1,10158,chr7_18606343_18616501
Psg21,7,18646736,18656725,protein_coding,-1,9989,chr7_18646736_18656725
Psg20,7,18674107,18686185,protein_coding,-1,12078,chr7_18674107_18686185
Psg19,7,18789567,18798520,protein_coding,-1,8953,chr7_18789567_18798520
Psg17,7,18813937,18821607,protein_coding,-1,7670,chr7_18813937_18821607
Mill2,7,18839966,18865402,protein_coding,1,25436,chr7_18839966_18865402
Pglyrp1,7,18871331,18890459,protein_coding,1,19128,chr7_18871331_18890459
Ccdc61,7,18890883,18910415,protein_coding,-1,19532,chr7_18890883_18910415
Nova2,7,18925888,18965319,protein_coding,1,39431,chr7_18925888_18965319
Nanos2,7,18987400,18988962,protein_coding,1,1562,chr7_18987400_18988962
Gm45058,7,18987559,18988324,antisense,-1,765,chr7_18987559_18988324
Mypop,7,18991245,19001766,protein_coding,1,10521,chr7_18991245_19001766
Mypopos,7,18993234,19001222,antisense,-1,7988,chr7_18993234_19001222
Irf2bp1,7,19004044,19006777,protein_coding,1,2733,chr7_19004044_19006777
Foxa3,7,19013284,19023538,protein_coding,-1,10254,chr7_19013284_19023538
Sympk,7,19024377,19054618,protein_coding,1,30241,chr7_19024377_19054618
Rsph6a,7,19054690,19074447,protein_coding,1,19757,chr7_19054690_19074447
Dmwd,7,19076227,19082776,protein_coding,1,6549,chr7_19076227_19082776
Dmpk,7,19083849,19093821,protein_coding,1,9972,chr7_19083849_19093821
Six5,7,19094594,19098549,protein_coding,1,3955,chr7_19094594_19098549
Gm4969,7,19099046,19118368,protein_coding,-1,19322,chr7_19099046_19118368
Fbxo46,7,19119859,19140172,protein_coding,1,20313,chr7_19119859_19140172
Qpctl,7,19139702,19149291,protein_coding,-1,9589,chr7_19139702_19149291
Snrpd2,7,19149722,19153542,protein_coding,1,3820,chr7_19149722_19153542
Gipr,7,19156061,19166127,protein_coding,-1,10066,chr7_19156061_19166127
Eml2,7,19176421,19206482,protein_coding,1,30061,chr7_19176421_19206482
Gpr4,7,19212538,19224174,protein_coding,1,11636,chr7_19212538_19224174
Opa3,7,19228334,19256543,protein_coding,1,28209,chr7_19228334_19256543
Vasp,7,19256929,19271817,protein_coding,-1,14888,chr7_19256929_19271817
1700058P15Rik,7,19258492,19259739,antisense,1,1247,chr7_19258492_19259739
Ppm1n,7,19276805,19280064,protein_coding,-1,3259,chr7_19276805_19280064
Rtn2,7,19282624,19296160,protein_coding,1,13536,chr7_19282624_19296160
Gm26802,7,19298260,19300770,lincRNA,-1,2510,chr7_19298260_19300770
Fosb,7,19302696,19310051,protein_coding,-1,7355,chr7_19302696_19310051
D830036C21Rik,7,19320117,19342515,lincRNA,-1,22398,chr7_19320117_19342515
Gm44698,7,19333129,19337655,lincRNA,1,4526,chr7_19333129_19337655
Ercc1,7,19344778,19356524,protein_coding,1,11746,chr7_19344778_19356524
Cd3eap,7,19356014,19359483,protein_coding,-1,3469,chr7_19356014_19359483
Ppp1r13l,7,19359749,19378533,protein_coding,1,18784,chr7_19359749_19378533
Ercc2,7,19382010,19395694,protein_coding,1,13684,chr7_19382010_19395694
Gm26852,7,19382220,19392718,antisense,-1,10498,chr7_19382220_19392718
Klc3,7,19394437,19404104,protein_coding,-1,9667,chr7_19394437_19404104
Ckm,7,19404776,19422841,protein_coding,1,18065,chr7_19404776_19422841
A930016O22Rik,7,19417466,19421417,antisense,-1,3951,chr7_19417466_19421417
Mark4,7,19424775,19458821,protein_coding,-1,34046,chr7_19424775_19458821
Exoc3l2,7,19463331,19496762,protein_coding,1,33431,chr7_19463331_19496762
Bloc1s3,7,19504486,19508367,protein_coding,-1,3881,chr7_19504486_19508367
Trappc6a,7,19508395,19516145,protein_coding,1,7750,chr7_19508395_19516145
Nkpd1,7,19517838,19525056,protein_coding,1,7218,chr7_19517838_19525056
Ppp1r37,7,19530800,19563076,protein_coding,-1,32276,chr7_19530800_19563076
Gemin7,7,19564946,19577595,protein_coding,-1,12649,chr7_19564946_19577595
Zfp296,7,19577287,19580656,protein_coding,1,3369,chr7_19577287_19580656
Clasrp,7,19581035,19604486,protein_coding,-1,23451,chr7_19581035_19604486
Relb,7,19606217,19629438,protein_coding,-1,23221,chr7_19606217_19629438
Clptm1,7,19631571,19665033,protein_coding,-1,33462,chr7_19631571_19665033
Apoc1,7,19689481,19692660,protein_coding,-1,3179,chr7_19689481_19692660
Apoe,7,19696109,19699188,protein_coding,-1,3079,chr7_19696109_19699188
Tomm40,7,19701313,19715438,protein_coding,-1,14125,chr7_19701313_19715438
Gm20512,7,19715016,19721731,antisense,1,6715,chr7_19715016_19721731
Nectin2,7,19716644,19750483,protein_coding,-1,33839,chr7_19716644_19750483
Bcam,7,19756131,19771016,protein_coding,-1,14885,chr7_19756131_19771016
Gm26600,7,19770611,19775403,antisense,1,4792,chr7_19770611_19775403
Cblc,7,19778881,19796809,protein_coding,-1,17928,chr7_19778881_19796809
Bcl3,7,19808462,19822770,protein_coding,-1,14308,chr7_19808462_19822770
Gm16175,7,19809609,19811872,antisense,1,2263,chr7_19809609_19811872
Gm16174,7,19816553,19818625,antisense,1,2072,chr7_19816553_19818625
Gm19345,7,19852003,19858350,protein_coding,1,6347,chr7_19852003_19858350
Ceacam16,7,19852097,19861299,protein_coding,-1,9202,chr7_19852097_19861299
Gm44659,7,19868121,19871438,lincRNA,-1,3317,chr7_19868121_19871438
Ceacam19,7,19875742,19887965,protein_coding,-1,12223,chr7_19875742_19887965
Pvr,7,19903578,19921160,protein_coding,-1,17582,chr7_19903578_19921160
Gm16251,7,19920729,19927607,antisense,1,6878,chr7_19920729_19927607
Igsf23,7,19937305,19950756,protein_coding,-1,13451,chr7_19937305_19950756
Ceacam20,7,19965412,19991104,protein_coding,1,25692,chr7_19965412_19991104
Nlrp9b,7,19991465,20073306,protein_coding,1,81841,chr7_19991465_20073306
Gm5891,7,21908665,21921291,protein_coding,-1,12626,chr7_21908665_21921291
Vmn1r139,7,22069057,22097907,protein_coding,1,28850,chr7_22069057_22097907
Gm10662,7,23131854,23144480,protein_coding,-1,12626,chr7_23131854_23144480
Nlrp4e,7,23301192,23362277,protein_coding,1,61085,chr7_23301192_23362277
Nlrp5,7,23385889,23441922,protein_coding,1,56033,chr7_23385889_23441922
Vmn1r175,7,23807182,23810643,protein_coding,-1,3461,chr7_23807182_23810643
Vmn1r178,7,23892009,23895622,protein_coding,1,3613,chr7_23892009_23895622
Vmn1r180,7,23950632,23955691,protein_coding,1,5059,chr7_23950632_23955691
Vmn1r181,7,23974615,23988139,protein_coding,1,13524,chr7_23974615_23988139
Gm36694,7,24054232,24073164,antisense,-1,18932,chr7_24054232_24073164
Zfp180,7,24081924,24107713,protein_coding,1,25789,chr7_24081924_24107713
Zfp112,7,24112314,24127952,protein_coding,1,15638,chr7_24112314_24127952
Gm44793,7,24112454,24116600,antisense,-1,4146,chr7_24112454_24116600
Zfp235,7,24134169,24143241,protein_coding,1,9072,chr7_24134169_24143241
Zfp114,7,24175060,24183188,protein_coding,1,8128,chr7_24175060_24183188
Zfp111,7,24193947,24211443,protein_coding,-1,17496,chr7_24193947_24211443
Zfp109,7,24227572,24237560,protein_coding,-1,9988,chr7_24227572_24237560
Zfp108,7,24254794,24262445,protein_coding,1,7651,chr7_24254794_24262445
Zfp93,7,24270420,24277794,protein_coding,1,7374,chr7_24270420_24277794
Zfp61,7,24291039,24301232,protein_coding,-1,10193,chr7_24291039_24301232
Zfp94,7,24301704,24316666,protein_coding,-1,14962,chr7_24301704_24316666
Tescl,7,24333082,24333936,protein_coding,-1,854,chr7_24333082_24333936
Lypd5,7,24349196,24355109,protein_coding,1,5913,chr7_24349196_24355109
Kcnn4,7,24370263,24386690,protein_coding,1,16427,chr7_24370263_24386690
Smg9,7,24399619,24422778,protein_coding,1,23159,chr7_24399619_24422778
Irgc1,7,24431922,24452297,protein_coding,-1,20375,chr7_24431922_24452297
Gm36159,7,24448354,24451327,lincRNA,1,2973,chr7_24448354_24451327
Plaur,7,24462484,24475968,protein_coding,1,13484,chr7_24462484_24475968
Cadm4,7,24482023,24504539,protein_coding,1,22516,chr7_24482023_24504539
Zfp428,7,24507006,24515682,protein_coding,1,8676,chr7_24507006_24515682
Irgq,7,24530689,24538600,protein_coding,1,7911,chr7_24530689_24538600
Pinlyp,7,24541658,24546118,protein_coding,-1,4460,chr7_24541658_24546118
Xrcc1,7,24546289,24573440,protein_coding,1,27151,chr7_24546289_24573440
Zfp575,7,24583838,24587641,protein_coding,-1,3803,chr7_24583838_24587641
Ethe1,7,24587543,24608925,protein_coding,1,21382,chr7_24587543_24608925
Phldb3,7,24610763,24629297,protein_coding,1,18534,chr7_24610763_24629297
Gm26550,7,24631145,24637916,antisense,-1,6771,chr7_24631145_24637916
Lypd3,7,24636550,24641118,protein_coding,1,4568,chr7_24636550_24641118
Tex101,7,24668007,24676675,protein_coding,-1,8668,chr7_24668007_24676675
Cd177,7,24743983,24760311,protein_coding,-1,16328,chr7_24743983_24760311
Ceacam10,7,24777206,24784657,protein_coding,1,7451,chr7_24777206_24784657
Gm9844,7,24862213,24862697,protein_coding,1,484,chr7_24862213_24862697
Lypd4,7,24864620,24869941,protein_coding,-1,5321,chr7_24864620_24869941
Dmrtc2,7,24870057,24877651,protein_coding,1,7594,chr7_24870057_24877651
Rps19,7,24884371,24889806,protein_coding,1,5435,chr7_24884371_24889806
Cd79a,7,24897381,24902197,protein_coding,1,4816,chr7_24897381_24902197
Arhgef1,7,24902912,24926594,protein_coding,1,23682,chr7_24902912_24926594
Rabac1,7,24969752,24972754,protein_coding,-1,3002,chr7_24969752_24972754
Atp1a3,7,24978167,25005958,protein_coding,-1,27791,chr7_24978167_25005958
Grik5,7,25009849,25072346,protein_coding,-1,62497,chr7_25009849_25072346
Zfp574,7,25072567,25083492,protein_coding,1,10925,chr7_25072567_25083492
Pou2f2,7,25087344,25179726,protein_coding,-1,92382,chr7_25087344_25179726
D930028M14Rik,7,25152457,25156627,lincRNA,1,4170,chr7_25152457_25156627
Dedd2,7,25199915,25220615,protein_coding,-1,20700,chr7_25199915_25220615
Zfp526,7,25221425,25227507,protein_coding,1,6082,chr7_25221425_25227507
Gsk3a,7,25228258,25237851,protein_coding,-1,9593,chr7_25228258_25237851
9130221H12Rik,7,25228687,25230263,antisense,1,1576,chr7_25228687_25230263
Erf,7,25242561,25250761,protein_coding,-1,8200,chr7_25242561_25250761
Cic,7,25267704,25294159,protein_coding,1,26455,chr7_25267704_25294159
Pafah1b3,7,25295049,25297986,protein_coding,-1,2937,chr7_25295049_25297986
Prr19,7,25301411,25304132,protein_coding,1,2721,chr7_25301411_25304132
Tmem145,7,25306106,25316195,protein_coding,1,10089,chr7_25306106_25316195
Megf8,7,25317164,25365917,protein_coding,1,48753,chr7_25317164_25365917
Cnfn,7,25367620,25369724,protein_coding,-1,2104,chr7_25367620_25369724
4732471J01Rik,7,25376819,25566417,antisense,1,189598,chr7_25376819_25566417
Lipe,7,25379527,25398710,protein_coding,-1,19183,chr7_25379527_25398710
Cxcl17,7,25400053,25412886,protein_coding,-1,12833,chr7_25400053_25412886
Ceacam1,7,25461707,25477603,protein_coding,-1,15896,chr7_25461707_25477603
Ceacam2,7,25516042,25539857,protein_coding,-1,23815,chr7_25516042_25539857
Gm38569,7,25584224,25594776,lincRNA,1,10552,chr7_25584224_25594776
Erich4,7,25614620,25615892,protein_coding,-1,1272,chr7_25614620_25615892
Dmac2,7,25619414,25625551,protein_coding,1,6137,chr7_25619414_25625551
B3gnt8,7,25626654,25635100,protein_coding,1,8446,chr7_25626654_25635100
Bckdha,7,25629946,25658981,protein_coding,-1,29035,chr7_25629946_25658981
Exosc5,7,25659164,25671368,protein_coding,1,12204,chr7_25659164_25671368
Tmem91,7,25669139,25675166,protein_coding,-1,6027,chr7_25669139_25675166
B9d2,7,25680780,25686558,protein_coding,1,5778,chr7_25680780_25686558
Tgfb1,7,25687002,25705077,protein_coding,1,18075,chr7_25687002_25705077
Ccdc97,7,25711106,25719088,protein_coding,-1,7982,chr7_25711106_25719088
Hnrnpul1,7,25721165,25754757,protein_coding,-1,33592,chr7_25721165_25754757
Axl,7,25757273,25788705,protein_coding,-1,31432,chr7_25757273_25788705
Cyp2s1,7,25802475,25816913,protein_coding,-1,14438,chr7_25802475_25816913
Gm26707,7,25816654,25820654,lincRNA,1,4000,chr7_25816654_25820654
Gm30146,7,25860140,25869883,lincRNA,1,9743,chr7_25860140_25869883
Cyp2b10,7,25897620,25926624,protein_coding,1,29004,chr7_25897620_25926624
BC026762,7,26009889,26012391,lincRNA,1,2502,chr7_26009889_26012391
Cyp2b13,7,26061497,26096197,protein_coding,1,34700,chr7_26061497_26096197
Cyp2b9,7,26173411,26210661,protein_coding,1,37250,chr7_26173411_26210661
Vmn1r184,7,26260334,26270619,protein_coding,1,10285,chr7_26260334_26270619
Gm42375,7,26304421,26307286,antisense,-1,2865,chr7_26304421_26307286
Nlrp9c,7,26322473,26403700,protein_coding,-1,81227,chr7_26322473_26403700
Nlrp4a,7,26435113,26476142,protein_coding,1,41029,chr7_26435113_26476142
Nlrp9a,7,26535023,26575615,protein_coding,1,40592,chr7_26535023_26575615
Cyp2b23,7,26665227,26686437,protein_coding,-1,21210,chr7_26665227_26686437
Cyp2b19,7,26757142,26772630,protein_coding,1,15488,chr7_26757142_26772630
Cyp2g1,7,26808892,26821205,protein_coding,1,12313,chr7_26808892_26821205
Cyp2a5,7,26835305,26843548,protein_coding,1,8243,chr7_26835305_26843548
Cyp2a22,7,26931631,26939384,protein_coding,-1,7753,chr7_26931631_26939384
Cyp2a12,7,27029081,27037375,protein_coding,1,8294,chr7_27029081_27037375
Cyp2f2,7,27119909,27133660,protein_coding,1,13751,chr7_27119909_27133660
Gm15883,7,27124481,27130674,antisense,-1,6193,chr7_27124481_27130674
Cyp2t4,7,27153714,27158668,protein_coding,1,4954,chr7_27153714_27158668
Egln2,7,27158658,27166802,protein_coding,-1,8144,chr7_27158658_27166802
Rab4b,7,27168424,27178896,protein_coding,-1,10472,chr7_27168424_27178896
Gm21983,7,27168430,27181086,protein_coding,-1,12656,chr7_27168430_27181086
Mia,7,27179742,27181157,protein_coding,-1,1415,chr7_27179742_27181157
Snrpa,7,27187005,27196271,protein_coding,-1,9266,chr7_27187005_27196271
BC024978,7,27195781,27210186,protein_coding,1,14405,chr7_27195781_27210186
Itpkc,7,27207172,27228661,protein_coding,-1,21489,chr7_27207172_27228661
Coq8b,7,27233023,27257950,protein_coding,1,24927,chr7_27233023_27257950
Gm15567,7,27249263,27257932,antisense,-1,8669,chr7_27249263_27257932
Numbl,7,27258433,27282144,protein_coding,1,23711,chr7_27258433_27282144
Ltbp4,7,27305136,27337692,protein_coding,-1,32556,chr7_27305136_27337692
Shkbp1,7,27342133,27356019,protein_coding,-1,13886,chr7_27342133_27356019
Gm20479,7,27352649,27357419,protein_coding,-1,4770,chr7_27352649_27357419
Sptbn4,7,27356383,27447686,protein_coding,-1,91303,chr7_27356383_27447686
Blvrb,7,27447978,27466144,protein_coding,1,18166,chr7_27447978_27466144
Sertad3,7,27473768,27477364,protein_coding,1,3596,chr7_27473768_27477364
Sertad1,7,27486910,27490316,protein_coding,1,3406,chr7_27486910_27490316
Prx,7,27497388,27520214,protein_coding,1,22826,chr7_27497388_27520214
Gm15541,7,27502718,27508122,antisense,-1,5404,chr7_27502718_27508122
Hipk4,7,27523267,27531175,protein_coding,1,7908,chr7_27523267_27531175
Pld3,7,27532000,27553218,protein_coding,-1,21218,chr7_27532000_27553218
2310022A10Rik,7,27553233,27582099,protein_coding,1,28866,chr7_27553233_27582099
Akt2,7,27591552,27640826,protein_coding,1,49274,chr7_27591552_27640826
Ttc9b,7,27653915,27657346,protein_coding,1,3431,chr7_27653915_27657346
Map3k10,7,27656375,27674598,protein_coding,-1,18223,chr7_27656375_27674598
Zfp607b,7,27689340,27706484,protein_coding,1,17144,chr7_27689340_27706484
Zfp60,7,27731389,27753702,protein_coding,1,22313,chr7_27731389_27753702
Zfp626,7,27807196,27822916,protein_coding,1,15720,chr7_27807196_27822916
Zfp59,7,27838607,27856438,protein_coding,1,17831,chr7_27838607_27856438
Zfp607a,7,27857527,27880825,protein_coding,1,23298,chr7_27857527_27880825
Zfp974,7,27907392,27929460,protein_coding,-1,22068,chr7_27907392_27929460
Gm26891,7,27927724,27931003,antisense,1,3279,chr7_27927724_27931003
Zfp780b,7,27959135,27979171,protein_coding,-1,20036,chr7_27959135_27979171
Zfp850,7,27984854,28014115,protein_coding,-1,29261,chr7_27984854_28014115
Psmc4,7,28041707,28050101,protein_coding,-1,8394,chr7_28041707_28050101
Fcgbp,7,28071236,28120862,protein_coding,1,49626,chr7_28071236_28120862
9530053A07Rik,7,28129466,28164811,protein_coding,1,35345,chr7_28129466_28164811
Fbl,7,28169710,28179269,protein_coding,1,9559,chr7_28169710_28179269
Dyrk1b,7,28179469,28187294,protein_coding,1,7825,chr7_28179469_28187294
Eid2,7,28267881,28269272,protein_coding,1,1391,chr7_28267881_28269272
Eid2b,7,28277739,28279489,protein_coding,1,1750,chr7_28277739_28279489
Selenov,7,28284652,28291186,protein_coding,-1,6534,chr7_28284652_28291186
Dll3,7,28293553,28302238,protein_coding,-1,8685,chr7_28293553_28302238
Timm50,7,28305516,28312072,protein_coding,-1,6556,chr7_28305516_28312072
Supt5,7,28314891,28338746,protein_coding,-1,23855,chr7_28314891_28338746
Gm44709,7,28314898,28318873,antisense,1,3975,chr7_28314898_28318873
Rps16,7,28350652,28353155,protein_coding,1,2503,chr7_28350652_28353155
Plekhg2,7,28359604,28372599,protein_coding,-1,12995,chr7_28359604_28372599
Zfp36,7,28376784,28380253,protein_coding,-1,3469,chr7_28376784_28380253
Gm44710,7,28378980,28392514,antisense,1,13534,chr7_28378980_28392514
Med29,7,28386146,28392708,protein_coding,-1,6562,chr7_28386146_28392708
Paf1,7,28392951,28399388,protein_coding,1,6437,chr7_28392951_28399388
Samd4b,7,28399522,28598144,protein_coding,-1,198622,chr7_28399522_28598144
Gmfg,7,28437447,28448233,protein_coding,1,10786,chr7_28437447_28448233
Lrfn1,7,28451980,28468242,protein_coding,1,16262,chr7_28451980_28468242
Pak4,7,28558819,28598185,protein_coding,-1,39366,chr7_28558819_28598185
Acp7,7,28607276,28631332,protein_coding,-1,24056,chr7_28607276_28631332
Gm44618,7,28629248,28681936,lincRNA,1,52688,chr7_28629248_28681936
Fbxo27,7,28692849,28699338,protein_coding,1,6489,chr7_28692849_28699338
Fbxo17,7,28716804,28738144,protein_coding,1,21340,chr7_28716804_28738144
Mrps12,7,28739641,28741820,protein_coding,-1,2179,chr7_28739641_28741820
Sars2,7,28741992,28753871,protein_coding,1,11879,chr7_28741992_28753871
Ccer2,7,28756174,28758968,protein_coding,1,2794,chr7_28756174_28758968
Nfkbib,7,28758251,28767512,protein_coding,-1,9261,chr7_28758251_28767512
Sirt2,7,28766735,28788661,protein_coding,1,21926,chr7_28766735_28788661
Rinl,7,28788969,28798963,protein_coding,1,9994,chr7_28788969_28798963
Hnrnpl,7,28808541,28822266,protein_coding,1,13725,chr7_28808541_28822266
Gm44702,7,28809304,28810497,antisense,-1,1193,chr7_28809304_28810497
Ech1,7,28825217,28832247,protein_coding,1,7030,chr7_28825217_28832247
Lgals4,7,28833854,28841708,protein_coding,1,7854,chr7_28833854_28841708
Gm10648,7,28859587,28876331,antisense,-1,16744,chr7_28859587_28876331
Lgals7,7,28863853,28866284,protein_coding,1,2431,chr7_28863853_28866284
Capn12,7,28881422,28893563,protein_coding,1,12141,chr7_28881422_28893563
Gm44700,7,28887127,28888483,antisense,-1,1356,chr7_28887127_28888483
Actn4,7,28893248,28962340,protein_coding,-1,69092,chr7_28893248_28962340
Eif3k,7,28971372,28981864,protein_coding,-1,10492,chr7_28971372_28981864
Map4k1,7,28982050,29003279,protein_coding,1,21229,chr7_28982050_29003279
Ryr1,7,29003344,29125179,protein_coding,-1,121835,chr7_29003344_29125179
Gm38979,7,29029023,29030250,antisense,1,1227,chr7_29029023_29030250
Gm26604,7,29071603,29081142,antisense,1,9539,chr7_29071603_29081142
Rasgrp4,7,29134851,29153961,protein_coding,1,19110,chr7_29134851_29153961
Gm16282,7,29138440,29140312,antisense,-1,1872,chr7_29138440_29140312
Fam98c,7,29152510,29156234,protein_coding,-1,3724,chr7_29152510_29156234
1110035H17Rik,7,29155680,29156920,antisense,1,1240,chr7_29155680_29156920
Spred3,7,29158829,29170411,protein_coding,-1,11582,chr7_29158829_29170411
Ggn,7,29170210,29173976,protein_coding,1,3766,chr7_29170210_29173976
Psmd8,7,29174188,29180701,protein_coding,-1,6513,chr7_29174188_29180701
Catsperg1,7,29181321,29214035,protein_coding,-1,32714,chr7_29181321_29214035
Kcnk6,7,29221926,29232515,protein_coding,-1,10589,chr7_29221926_29232515
Yif1b,7,29238329,29247597,protein_coding,1,9268,chr7_29238329_29247597
2200002D01Rik,7,29246561,29248466,protein_coding,-1,1905,chr7_29246561_29248466
Spint2,7,29256323,29281912,protein_coding,-1,25589,chr7_29256323_29281912
Ppp1r14a,7,29289308,29293801,protein_coding,1,4493,chr7_29289308_29293801
Dpf1,7,29303951,29318243,protein_coding,1,14292,chr7_29303951_29318243
Gm44632,7,29316770,29319402,antisense,-1,2632,chr7_29316770_29319402
Sipa1l3,7,29320372,29518641,protein_coding,-1,198269,chr7_29320372_29518641
A330087D11Rik,7,29568903,29573928,lincRNA,-1,5025,chr7_29568903_29573928
Catsperg2,7,29697219,29727032,protein_coding,-1,29813,chr7_29697219_29727032
Zfp84,7,29768552,29779821,protein_coding,1,11269,chr7_29768552_29779821
Zfp30,7,29783998,29794702,protein_coding,1,10704,chr7_29783998_29794702
Zfp790,7,29816114,29831005,protein_coding,1,14891,chr7_29816114_29831005
Zfp940,7,29833620,29853669,protein_coding,-1,20049,chr7_29833620_29853669
Gm26554,7,29853085,29858990,antisense,1,5905,chr7_29853085_29858990
Zfp420,7,29859979,29877292,protein_coding,1,17313,chr7_29859979_29877292
Zfp27,7,29893333,29906572,protein_coding,-1,13239,chr7_29893333_29906572
Zfp383,7,29908223,29916813,protein_coding,1,8590,chr7_29908223_29916813
Zfp74,7,29930815,29954089,protein_coding,-1,23274,chr7_29930815_29954089
Zfp568,7,29983955,30028282,protein_coding,1,44327,chr7_29983955_30028282
Zfp14,7,30036359,30051380,protein_coding,-1,15021,chr7_30036359_30051380
Zfp82,7,30054489,30072900,protein_coding,-1,18411,chr7_30054489_30072900
Gm26920,7,30056034,30090410,protein_coding,-1,34376,chr7_30056034_30090410
Zfp566,7,30077337,30090527,protein_coding,-1,13190,chr7_30077337_30090527
Zfp260,7,30094777,30107622,protein_coding,1,12845,chr7_30094777_30107622
Zfp382,7,30121942,30134950,protein_coding,1,13008,chr7_30121942_30134950
Zfp146,7,30161269,30169750,protein_coding,-1,8481,chr7_30161269_30169750
Gm5113,7,30169875,30182324,transcribed_unprocessed_pseudogene,1,12449,chr7_30169875_30182324
Cox7a1,7,30184144,30186078,protein_coding,1,1934,chr7_30184144_30186078
Capns1,7,30186936,30198811,protein_coding,-1,11875,chr7_30186936_30198811
Gm26810,7,30193954,30200889,antisense,1,6935,chr7_30193954_30200889
Tbcb,7,30224131,30232272,protein_coding,-1,8141,chr7_30224131_30232272
Polr2i,7,30231948,30233390,protein_coding,1,1442,chr7_30231948_30233390
Ovol3,7,30233439,30235725,protein_coding,-1,2286,chr7_30233439_30235725
Wdr62,7,30240138,30280419,protein_coding,-1,40281,chr7_30240138_30280419
Thap8,7,30280094,30290237,protein_coding,1,10143,chr7_30280094_30290237
Clip3,7,30291728,30308367,protein_coding,1,16639,chr7_30291728_30308367
Alkbh6,7,30308717,30314304,protein_coding,1,5587,chr7_30308717_30314304
Syne4,7,30314807,30319046,protein_coding,1,4239,chr7_30314807_30319046
Sdhaf1,7,30321406,30323895,protein_coding,-1,2489,chr7_30321406_30323895
E130208F15Rik,7,30321740,30323472,protein_coding,1,1732,chr7_30321740_30323472
4930479H17Rik,7,30347645,30353321,lincRNA,-1,5676,chr7_30347645_30353321
Lrfn3,7,30355489,30362772,protein_coding,-1,7283,chr7_30355489_30362772
Tyrobp,7,30413760,30417585,protein_coding,1,3825,chr7_30413760_30417585
Hcst,7,30417712,30419854,protein_coding,-1,2142,chr7_30417712_30419854
Nfkbid,7,30421732,30428746,protein_coding,1,7014,chr7_30421732_30428746
Aplp1,7,30434982,30445535,protein_coding,-1,10553,chr7_30434982_30445535
Kirrel2,7,30447534,30457690,protein_coding,-1,10156,chr7_30447534_30457690
Nphs1,7,30458315,30487223,protein_coding,1,28908,chr7_30458315_30487223
Nphs1os,7,30462164,30465591,antisense,-1,3427,chr7_30462164_30465591
Prodh2,7,30493622,30513402,protein_coding,1,19780,chr7_30493622_30513402
Arhgap33os,7,30515122,30522193,protein_coding,1,7071,chr7_30515122_30522193
Arhgap33,7,30522226,30535060,protein_coding,-1,12834,chr7_30522226_30535060
Proser3,7,30539134,30552299,protein_coding,-1,13165,chr7_30539134_30552299
Hspb6,7,30552178,30555443,protein_coding,1,3265,chr7_30552178_30555443
Lin37,7,30555441,30559838,protein_coding,-1,4397,chr7_30555441_30559838
Psenen,7,30561863,30563627,protein_coding,-1,1764,chr7_30561863_30563627
U2af1l4,7,30563301,30565365,protein_coding,1,2064,chr7_30563301_30565365
Gm49396,7,30563344,30567960,protein_coding,1,4616,chr7_30563344_30567960
Igflr1,7,30565427,30567962,protein_coding,1,2535,chr7_30565427_30567962
Kmt2b,7,30568858,30588726,protein_coding,-1,19868,chr7_30568858_30588726
Zbtb32,7,30589681,30598909,protein_coding,-1,9228,chr7_30589681_30598909
Upk1a,7,30603092,30612847,protein_coding,-1,9755,chr7_30603092_30612847
Cox6b1,7,30616861,30626151,protein_coding,-1,9290,chr7_30616861_30626151
Rbm42,7,30640999,30650317,protein_coding,-1,9318,chr7_30640999_30650317
Haus5,7,30653711,30664994,protein_coding,-1,11283,chr7_30653711_30664994
Pmis2,7,30670722,30671605,protein_coding,-1,883,chr7_30670722_30671605
2200002J24Rik,7,30698926,30700536,protein_coding,1,1610,chr7_30698926_30700536
Atp4a,7,30712209,30725534,protein_coding,1,13325,chr7_30712209_30725534
Tmem147,7,30727701,30729540,protein_coding,-1,1839,chr7_30727701_30729540
Tmem147os,7,30729579,30756126,antisense;processed_transcript,1,26547,chr7_30729579_30756126
Gapdhs,7,30729775,30743681,protein_coding,-1,13906,chr7_30729775_30743681
Gm26935,7,30737653,30748437,antisense,1,10784,chr7_30737653_30748437
Sbsn,7,30751471,30756134,protein_coding,1,4663,chr7_30751471_30756134
Dmkn,7,30763756,30781063,protein_coding,1,17307,chr7_30763756_30781063
Ffar2,7,30818348,30823775,protein_coding,-1,5427,chr7_30818348_30823775
Ffar1,7,30857390,30861564,protein_coding,-1,4174,chr7_30857390_30861564
Cd22,7,30865402,30880342,protein_coding,-1,14940,chr7_30865402_30880342
D7Ertd128e,7,30885031,30886446,lincRNA,1,1415,chr7_30885031_30886446
Mag,7,30899176,30914873,protein_coding,-1,15697,chr7_30899176_30914873
Gm44662,7,30916983,30946824,lincRNA,1,29841,chr7_30916983_30946824
Hamp2,7,30922372,30924681,protein_coding,-1,2309,chr7_30922372_30924681
Hamp,7,30942368,30944032,protein_coding,-1,1664,chr7_30942368_30944032
Usf2,7,30945248,30956803,protein_coding,-1,11555,chr7_30945248_30956803
Gm17077,7,30955825,30958004,antisense,1,2179,chr7_30955825_30958004
Gm4673,7,30956909,30961619,antisense,1,4710,chr7_30956909_30961619
Lsr,7,30957770,30973464,protein_coding,-1,15694,chr7_30957770_30973464
Fam187b,7,30973790,30989726,protein_coding,1,15936,chr7_30973790_30989726
Fxyd5,7,31032722,31042481,protein_coding,-1,9759,chr7_31032722_31042481
Fxyd7,7,31042513,31051467,protein_coding,-1,8954,chr7_31042513_31051467
Fxyd1,7,31051678,31057199,protein_coding,-1,5521,chr7_31051678_31057199
Lgi4,7,31059342,31070935,protein_coding,1,11593,chr7_31059342_31070935
Fxyd3,7,31068172,31076704,protein_coding,-1,8532,chr7_31068172_31076704
Hpn,7,31098725,31115290,protein_coding,-1,16565,chr7_31098725_31115290
Scn1b,7,31116524,31127003,protein_coding,-1,10479,chr7_31116524_31127003
Gramd1a,7,31130127,31155896,protein_coding,-1,25769,chr7_31130127_31155896
G630030J09Rik,7,31149528,31152707,antisense,1,3179,chr7_31149528_31152707
Gm10640,7,31155668,31170641,antisense,1,14973,chr7_31155668_31170641
Scgb2b2,7,31290508,31304977,protein_coding,1,14469,chr7_31290508_31304977
Wtip,7,34109543,34133268,protein_coding,-1,23725,chr7_34109543_34133268
Uba2,7,34140688,34169599,protein_coding,-1,28911,chr7_34140688_34169599
Pdcd2l,7,34184499,34196661,protein_coding,-1,12162,chr7_34184499_34196661
Gpi1,7,34201330,34230336,protein_coding,-1,29006,chr7_34201330_34230336
Gm12762,7,34230420,34234102,lincRNA,-1,3682,chr7_34230420_34234102
Gm12758,7,34234377,34240207,antisense,1,5830,chr7_34234377_34240207
4931406P16Rik,7,34236707,34313551,protein_coding,-1,76844,chr7_34236707_34313551
Lsm14a,7,34344646,34393315,protein_coding,-1,48669,chr7_34344646_34393315
Gm12764,7,34388665,34394779,antisense,1,6114,chr7_34388665_34394779
Gm12766,7,34438137,34520885,lincRNA,1,82748,chr7_34438137_34520885
Gm12784,7,34544472,34581691,lincRNA,1,37219,chr7_34544472_34581691
Gm44837,7,34636996,34637712,lincRNA,-1,716,chr7_34636996_34637712
Kctd15,7,34639014,34656732,protein_coding,-1,17718,chr7_34639014_34656732
Gm12781,7,34653184,34660416,antisense,1,7232,chr7_34653184_34660416
Gm12756,7,34665413,34673999,lincRNA,-1,8586,chr7_34665413_34673999
Chst8,7,34674468,34812711,protein_coding,-1,138243,chr7_34674468_34812711
Pepd,7,34912379,35044708,protein_coding,1,132329,chr7_34912379_35044708
Cebpg,7,35046422,35056573,protein_coding,-1,10151,chr7_35046422_35056573
Gm45095,7,35056027,35056379,antisense,1,352,chr7_35056027_35056379
Gm45096,7,35057264,35066733,lincRNA,-1,9469,chr7_35057264_35066733
Gm35611,7,35086836,35090842,lincRNA,1,4006,chr7_35086836_35090842
Gm45091,7,35118044,35119605,antisense,-1,1561,chr7_35118044_35119605
Cebpa,7,35119293,35121928,protein_coding,1,2635,chr7_35119293_35121928
Slc7a10,7,35186385,35201114,protein_coding,1,14729,chr7_35186385_35201114
Lrp3,7,35200027,35215498,protein_coding,-1,15471,chr7_35200027_35215498
Gpatch1,7,35276536,35318440,protein_coding,-1,41904,chr7_35276536_35318440
Rhpn2,7,35334170,35392289,protein_coding,1,58119,chr7_35334170_35392289
Faap24,7,35392152,35396836,protein_coding,-1,4684,chr7_35392152_35396836
Cep89,7,35397035,35438689,protein_coding,1,41654,chr7_35397035_35438689
Slc7a9,7,35448796,35466036,protein_coding,1,17240,chr7_35448796_35466036
Tdrd12,7,35469098,35537745,protein_coding,-1,68647,chr7_35469098_35537745
Nudt19,7,35547185,35556304,protein_coding,-1,9119,chr7_35547185_35556304
B230322F03Rik,7,35555367,35556935,antisense,1,1568,chr7_35555367_35556935
Rgs9bp,7,35578993,35585582,protein_coding,-1,6589,chr7_35578993_35585582
Ankrd27,7,35586244,35639226,protein_coding,1,52982,chr7_35586244_35639226
Pdcd5,7,35641982,35647521,protein_coding,-1,5539,chr7_35641982_35647521
Dpy19l3,7,35685165,35754454,protein_coding,-1,69289,chr7_35685165_35754454
Zfp507,7,35772343,35803003,protein_coding,-1,30660,chr7_35772343_35803003
E130304I02Rik,7,35802592,35838074,antisense,1,35482,chr7_35802592_35838074
Gm28514,7,35838260,35839570,lincRNA,1,1310,chr7_35838260_35839570
Gm38991,7,36097378,36100518,lincRNA,1,3140,chr7_36097378_36100518
Gm29129,7,36568743,36573095,lincRNA,1,4352,chr7_36568743_36573095
Tshz3,7,36698118,36773553,protein_coding,1,75435,chr7_36698118_36773553
Gm28075,7,37140541,37141711,lincRNA,1,1170,chr7_37140541_37141711
Gm28077,7,37299265,37305225,lincRNA,1,5960,chr7_37299265_37305225
Zfp536,7,37318024,37773641,protein_coding,-1,455617,chr7_37318024_37773641
4930505M18Rik,7,37669799,37672347,antisense,1,2548,chr7_37669799_37672347
Uri1,7,37959992,38023551,protein_coding,-1,63559,chr7_37959992_38023551
Gm30684,7,38050147,38061700,lincRNA,-1,11553,chr7_38050147_38061700
Gm30771,7,38059316,38076101,lincRNA,1,16785,chr7_38059316_38076101
Ccne1,7,38097984,38107534,protein_coding,-1,9550,chr7_38097984_38107534
D530033B14Rik,7,38182563,38196457,antisense,-1,13894,chr7_38182563_38196457
1600014C10Rik,7,38183217,38197568,protein_coding,1,14351,chr7_38183217_38197568
Plekhf1,7,38216972,38228016,protein_coding,-1,11044,chr7_38216972_38228016
Pop4,7,38261996,38271423,protein_coding,-1,9427,chr7_38261996_38271423
Gm44767,7,38271412,38333530,antisense,1,62118,chr7_38271412_38333530
Gm29087,7,38500432,38537077,antisense,1,36645,chr7_38500432_38537077
Gm5591,7,38518139,38528193,protein_coding,-1,10054,chr7_38518139_38528193
Gm5114,7,39407294,39413160,protein_coding,-1,5866,chr7_39407294_39413160
Zfp619,7,39517766,39540420,protein_coding,1,22654,chr7_39517766_39540420
Gm37494,7,39544402,39580589,lincRNA,1,36187,chr7_39544402_39580589
4930435C17Rik,7,39789235,39910970,lincRNA,-1,121735,chr7_39789235_39910970
Gm44992,7,39869131,39978319,lincRNA,-1,109188,chr7_39869131_39978319
4933404I11Rik,7,40262705,40269753,lincRNA,1,7048,chr7_40262705_40269753
Gm28807,7,40373302,40469240,lincRNA,-1,95938,chr7_40373302_40469240
4933402C06Rik,7,40674737,40691273,lincRNA,1,16536,chr7_40674737_40691273
A230077H06Rik,7,40818476,40900937,antisense,-1,82461,chr7_40818476_40900937
Gm28307,7,40876543,40885785,lincRNA,1,9242,chr7_40876543_40885785
Vstm2b,7,40898328,40930594,protein_coding,1,32266,chr7_40898328_40930594
Gm38997,7,41012039,41032619,lincRNA,-1,20580,chr7_41012039_41032619
Gm4884,7,41032719,41045302,protein_coding,1,12583,chr7_41032719_41045302
1700110I07Rik,7,41060617,41089843,lincRNA,-1,29226,chr7_41060617_41089843
Gm44748,7,41128646,41284220,lincRNA,-1,155574,chr7_41128646_41284220
Gm5592,7,41153841,41290183,protein_coding,1,136342,chr7_41153841_41290183
AI987944,7,41372923,41393379,protein_coding,-1,20456,chr7_41372923_41393379
Gm17102,7,41393698,41397447,lincRNA,1,3749,chr7_41393698_41397447
Gm20449,7,41399378,41499417,protein_coding,-1,100039,chr7_41399378_41499417
AW146154,7,41478874,41499890,protein_coding,-1,21016,chr7_41478874_41499890
Gm6871,7,41545674,41573662,protein_coding,-1,27988,chr7_41545674_41573662
2610021A01Rik,7,41599230,41628533,protein_coding,1,29303,chr7_41599230_41628533
Zfp788,7,41633203,41651530,protein_coding,1,18327,chr7_41633203_41651530
Vmn2r58,7,41835814,41872712,protein_coding,-1,36898,chr7_41835814_41872712
Vmn2r59,7,42011284,42059023,protein_coding,-1,47739,chr7_42011284_42059023
Vmn2r60,7,42107770,42196208,protein_coding,1,88438,chr7_42107770_42196208
Vmn2r61,7,42260053,42300755,protein_coding,1,40702,chr7_42260053_42300755
Zfp141,7,42473386,42505740,protein_coding,-1,32354,chr7_42473386_42505740
Zfp977,7,42579783,42592547,protein_coding,-1,12764,chr7_42579783_42592547
Zfp976,7,42609526,42642588,protein_coding,-1,33062,chr7_42609526_42642588
Zfp975,7,42660105,42692742,protein_coding,-1,32637,chr7_42660105_42692742
Gm17067,7,42705469,42727017,protein_coding,-1,21548,chr7_42705469_42727017
Vmn2r62,7,42764055,42793525,protein_coding,-1,29470,chr7_42764055_42793525
Gm2381,7,42816829,42867234,protein_coding,-1,50405,chr7_42816829_42867234
Vmn2r63,7,42896711,42933822,protein_coding,-1,37111,chr7_42896711_42933822
Gm17768,7,43078051,43096419,lincRNA,1,18368,chr7_43078051_43096419
Zfp936,7,43114229,43192109,protein_coding,1,77880,chr7_43114229_43192109
Zfp715,7,43296197,43313294,protein_coding,-1,17097,chr7_43296197_43313294
Siglecf,7,43351341,43359531,protein_coding,1,8190,chr7_43351341_43359531
Siglecg,7,43408204,43418358,protein_coding,1,10154,chr7_43408204_43418358
Lim2,7,43427670,43435996,protein_coding,1,8326,chr7_43427670_43435996
Cldnd2,7,43440782,43443334,protein_coding,1,2552,chr7_43440782_43443334
Etfb,7,43444083,43457800,protein_coding,1,13717,chr7_43444083_43457800
Vsig10l,7,43463151,43472019,protein_coding,1,8868,chr7_43463151_43472019
Iglon5,7,43472904,43490075,protein_coding,-1,17171,chr7_43472904_43490075
4931406B18Rik,7,43492044,43505940,protein_coding,-1,13896,chr7_43492044_43505940
Cd33,7,43524216,43544428,protein_coding,-1,20212,chr7_43524216_43544428
Zfp658,7,43562256,43575461,protein_coding,1,13205,chr7_43562256_43575461
Zfp719,7,43579610,43593235,protein_coding,1,13625,chr7_43579610_43593235
Zfp819,7,43607169,43618285,protein_coding,1,11116,chr7_43607169_43618285
Ceacam18,7,43634707,43649295,protein_coding,1,14588,chr7_43634707_43649295
Siglece,7,43651070,43660161,protein_coding,-1,9091,chr7_43651070_43660161
Gm36546,7,43670841,43671314,lincRNA,-1,473,chr7_43670841_43671314
Ctu1,7,43672016,43678298,protein_coding,1,6282,chr7_43672016_43678298
Klk14,7,43690418,43695536,protein_coding,1,5118,chr7_43690418_43695536
Klk13,7,43712567,43727534,protein_coding,1,14967,chr7_43712567_43727534
Klk12,7,43768897,43773585,protein_coding,1,4688,chr7_43768897_43773585
Klk11,7,43774604,43779263,protein_coding,1,4659,chr7_43774604_43779263
Klk10,7,43781035,43785410,protein_coding,1,4375,chr7_43781035_43785410
Klk9,7,43791891,43796757,protein_coding,1,4866,chr7_43791891_43796757
Klk8,7,43797577,43803826,protein_coding,1,6249,chr7_43797577_43803826
Klk7,7,43811294,43816359,protein_coding,1,5065,chr7_43811294_43816359
Klk6,7,43824499,43832030,protein_coding,1,7531,chr7_43824499_43832030
Klk5,7,43841971,43851181,protein_coding,1,9210,chr7_43841971_43851181
Klk15,7,43933740,43939639,protein_coding,1,5899,chr7_43933740_43939639
Gm44756,7,43938057,43976573,antisense,-1,38516,chr7_43938057_43976573
Klk1b1,7,43966751,43971318,protein_coding,1,4567,chr7_43966751_43971318
Klk1b27,7,44052290,44056712,protein_coding,1,4422,chr7_44052290_44056712
Klk1b21,7,44102328,44106583,protein_coding,1,4255,chr7_44102328_44106583
1700028J19Rik,7,44229811,44246695,protein_coding,-1,16884,chr7_44229811_44246695
Gm36864,7,44236177,44243191,protein_coding,1,7014,chr7_44236177_44243191
2410002F23Rik,7,44246722,44252319,protein_coding,1,5597,chr7_44246722_44252319
Acp4,7,44252148,44257378,protein_coding,-1,5230,chr7_44252148_44257378
Clec11a,7,44302687,44306902,protein_coding,-1,4215,chr7_44302687_44306902
Shank1,7,44310253,44360572,protein_coding,1,50319,chr7_44310253_44360572
1700008O03Rik,7,44360043,44385820,protein_coding,-1,25777,chr7_44360043_44385820
Gm44780,7,44362564,44363288,antisense,1,724,chr7_44362564_44363288
Syt3,7,44384102,44400187,protein_coding,1,16085,chr7_44384102_44400187
Lrrc4b,7,44429018,44463351,protein_coding,1,34333,chr7_44429018_44463351
Aspdh,7,44465391,44467758,protein_coding,1,2367,chr7_44465391_44467758
Josd2,7,44467980,44471662,protein_coding,1,3682,chr7_44467980_44471662
5430431A17Rik,7,44473538,44486138,lincRNA,1,12600,chr7_44473538_44486138
Emc10,7,44489937,44496529,protein_coding,-1,6592,chr7_44489937_44496529
Fam71e1,7,44496581,44501486,protein_coding,1,4905,chr7_44496581_44501486
Mybpc2,7,44501699,44524656,protein_coding,-1,22957,chr7_44501699_44524656
Spib,7,44525993,44532071,protein_coding,-1,6078,chr7_44525993_44532071
Pold1,7,44532746,44548849,protein_coding,-1,16103,chr7_44532746_44548849
Nr1h2,7,44549616,44553951,protein_coding,-1,4335,chr7_44549616_44553951
Napsa,7,44572380,44586862,protein_coding,1,14482,chr7_44572380_44586862
Gm15396,7,44579968,44590624,antisense,-1,10656,chr7_44579968_44590624
Kcnc3,7,44590664,44604754,protein_coding,1,14090,chr7_44590664_44604754
Gm44832,7,44593577,44595879,antisense,-1,2302,chr7_44593577_44595879
Myh14,7,44605803,44670843,protein_coding,-1,65040,chr7_44605803_44670843
2310016G11Rik,7,44668233,44678235,antisense,1,10002,chr7_44668233_44678235
Izumo2,7,44708742,44719844,protein_coding,1,11102,chr7_44708742_44719844
Zfp473,7,44731480,44751050,protein_coding,-1,19570,chr7_44731480_44751050
Vrk3,7,44748413,44777515,protein_coding,1,29102,chr7_44748413_44777515
Atf5,7,44812256,44816658,protein_coding,-1,4402,chr7_44812256_44816658
Nup62,7,44816088,44830812,protein_coding,1,14724,chr7_44816088_44830812
Il4i1,7,44816387,44840809,protein_coding,1,24422,chr7_44816387_44840809
Tbc1d17,7,44834623,44849079,protein_coding,-1,14456,chr7_44834623_44849079
Akt1s1,7,44848991,44855421,protein_coding,1,6430,chr7_44848991_44855421
Pnkp,7,44857139,44862992,protein_coding,1,5853,chr7_44857139_44862992
Ptov1,7,44863067,44869788,protein_coding,-1,6721,chr7_44863067_44869788
Med25,7,44876765,44892712,protein_coding,-1,15947,chr7_44876765_44892712
Fuz,7,44896079,44902631,protein_coding,1,6552,chr7_44896079_44902631
Ap2a1,7,44900373,44929496,protein_coding,-1,29123,chr7_44900373_44929496
Tsks,7,44943204,44958035,protein_coding,1,14831,chr7_44943204_44958035
Cpt1c,7,44959372,44974851,protein_coding,-1,15479,chr7_44959372_44974851
6530437J22Rik,7,44970429,44974303,antisense,1,3874,chr7_44970429_44974303
Prmt1,7,44975989,44986568,protein_coding,-1,10579,chr7_44975989_44986568
Gm15545,7,44986900,44994597,antisense,1,7697,chr7_44986900_44994597
Bcl2l12,7,44991222,44998712,protein_coding,-1,7490,chr7_44991222_44998712
Irf3,7,44997648,45002848,protein_coding,1,5200,chr7_44997648_45002848
Scaf1,7,45002948,45016363,protein_coding,-1,13415,chr7_45002948_45016363
Rras,7,45017961,45021647,protein_coding,1,3686,chr7_45017961_45021647
Prr12,7,45027563,45052881,protein_coding,-1,25318,chr7_45027563_45052881
Prrg2,7,45053584,45062677,protein_coding,-1,9093,chr7_45053584_45062677
Nosip,7,45062429,45078210,protein_coding,1,15781,chr7_45062429_45078210
Rcn3,7,45082913,45092221,protein_coding,-1,9308,chr7_45082913_45092221
Gm45669,7,45091409,45098320,antisense,1,6911,chr7_45091409_45098320
Fcgrt,7,45092990,45103851,protein_coding,-1,10861,chr7_45092990_45103851
Gm45552,7,45121917,45124144,antisense,1,2227,chr7_45121917_45124144
Rps11,7,45122379,45124439,protein_coding,-1,2060,chr7_45122379_45124439
Rpl13a,7,45125558,45128761,protein_coding,-1,3203,chr7_45125558_45128761
Gm45713,7,45125922,45136231,protein_coding,-1,10309,chr7_45125922_45136231
Flt3l,7,45129788,45136432,protein_coding,-1,6644,chr7_45129788_45136432
Aldh16a1,7,45140684,45154584,protein_coding,-1,13900,chr7_45140684_45154584
Pih1d1,7,45154303,45160065,protein_coding,1,5762,chr7_45154303_45160065
Slc17a7,7,45163949,45176142,protein_coding,1,12193,chr7_45163949_45176142
Gfy,7,45176349,45179569,protein_coding,-1,3220,chr7_45176349_45179569
Pth2,7,45180995,45181838,protein_coding,1,843,chr7_45180995_45181838
Ccdc155,7,45183624,45204892,protein_coding,-1,21268,chr7_45183624_45204892
Dkkl1,7,45207519,45212147,protein_coding,-1,4628,chr7_45207519_45212147
Tead2,7,45215753,45233644,protein_coding,1,17891,chr7_45215753_45233644
Cd37,7,45233632,45239115,protein_coding,-1,5483,chr7_45233632_45239115
Slc6a16,7,45241085,45273367,protein_coding,1,32282,chr7_45241085_45273367
Slc6a21,7,45277513,45288998,protein_coding,1,11485,chr7_45277513_45288998
Trpm4,7,45302632,45333780,protein_coding,-1,31148,chr7_45302632_45333780
Hrc,7,45335290,45338974,protein_coding,1,3684,chr7_45335290_45338974
Ppfia3,7,45339122,45367019,protein_coding,-1,27897,chr7_45339122_45367019
Mtag2,7,45366163,45367948,antisense,1,1785,chr7_45366163_45367948
Lin7b,7,45367891,45370583,protein_coding,-1,2692,chr7_45367891_45370583
Gm45619,7,45368177,45368704,lincRNA,1,527,chr7_45368177_45368704
Snrnp70,7,45376453,45395742,protein_coding,-1,19289,chr7_45376453_45395742
Kcna7,7,45405653,45409763,protein_coding,1,4110,chr7_45405653_45409763
Ntf5,7,45413695,45417179,protein_coding,1,3484,chr7_45413695_45417179
Lhb,7,45420820,45421897,protein_coding,1,1077,chr7_45420820_45421897
Ruvbl2,7,45421760,45438096,protein_coding,-1,16336,chr7_45421760_45438096
Gys1,7,45434844,45456619,protein_coding,1,21775,chr7_45434844_45456619
Ftl1,7,45457944,45459884,protein_coding,-1,1940,chr7_45457944_45459884
Bax,7,45461697,45466898,protein_coding,-1,5201,chr7_45461697_45466898
Gm45808,7,45465984,45486811,protein_coding,-1,20827,chr7_45465984_45486811
Dhdh,7,45470987,45488805,protein_coding,-1,17818,chr7_45470987_45488805
Tulp2,7,45481877,45523632,protein_coding,1,41755,chr7_45481877_45523632
Nucb1,7,45490458,45510406,protein_coding,-1,19948,chr7_45490458_45510406
Ppp1r15a,7,45522916,45526268,protein_coding,-1,3352,chr7_45522916_45526268
Plekha4,7,45526330,45554229,protein_coding,1,27899,chr7_45526330_45554229
Gm45564,7,45550534,45551615,antisense,-1,1081,chr7_45550534_45551615
Hsd17b14,7,45554893,45567752,protein_coding,1,12859,chr7_45554893_45567752
0610005C13Rik,7,45567794,45575327,antisense,-1,7533,chr7_45567794_45575327
Bcat2,7,45570153,45589711,protein_coding,1,19558,chr7_45570153_45589711
Gm31479,7,45597140,45599569,lincRNA,1,2429,chr7_45597140_45599569
Fut1,7,45617289,45621059,protein_coding,1,3770,chr7_45617289_45621059
Izumo1,7,45621811,45628823,protein_coding,1,7012,chr7_45621811_45628823
Rasip1,7,45627488,45639093,protein_coding,1,11605,chr7_45627488_45639093
Gm45437,7,45630664,45633077,antisense,-1,2413,chr7_45630664_45633077
A030001D20Rik,7,45635680,45638765,antisense,-1,3085,chr7_45635680_45638765
Mamstr,7,45639977,45646521,protein_coding,1,6544,chr7_45639977_45646521
Fut2,7,45648591,45666394,protein_coding,-1,17803,chr7_45648591_45666394
Sec1,7,45677686,45694402,protein_coding,-1,16716,chr7_45677686_45694402
Ntn5,7,45684022,45694556,protein_coding,1,10534,chr7_45684022_45694556
Car11,7,45699843,45704682,protein_coding,1,4839,chr7_45699843_45704682
Dbp,7,45705088,45710203,protein_coding,1,5115,chr7_45705088_45710203
Sphk2,7,45709467,45718002,protein_coding,-1,8535,chr7_45709467_45718002
Rpl18,7,45715457,45720836,protein_coding,1,5379,chr7_45715457_45720836
Fam83e,7,45721212,45729492,protein_coding,1,8280,chr7_45721212_45729492
Sult2b1,7,45729983,45784669,protein_coding,-1,54686,chr7_45729983_45784669
Gm31597,7,45742049,45750257,antisense,1,8208,chr7_45742049_45750257
Lmtk3,7,45783738,45804144,protein_coding,1,20406,chr7_45783738_45804144
Cyth2,7,45806637,45814581,protein_coding,-1,7944,chr7_45806637_45814581
Kcnj14,7,45816460,45824782,protein_coding,-1,8322,chr7_45816460_45824782
Grwd1,7,45825223,45830944,protein_coding,-1,5721,chr7_45825223_45830944
Gm45441,7,45830895,45835249,antisense,1,4354,chr7_45830895_45835249
Grin2d,7,45831883,45878378,protein_coding,-1,46495,chr7_45831883_45878378
Kdelr1,7,45872772,45883732,protein_coding,1,10960,chr7_45872772_45883732
Syngr4,7,45885222,45896714,protein_coding,-1,11492,chr7_45885222_45896714
Tmem143,7,45896941,45917413,protein_coding,1,20472,chr7_45896941_45917413
Emp3,7,45918023,45921404,protein_coding,-1,3381,chr7_45918023_45921404
Gm45442,7,45922215,45924174,antisense,-1,1959,chr7_45922215_45924174
Ccdc114,7,45924072,45948963,protein_coding,1,24891,chr7_45924072_45948963
Abcc6,7,45967555,46030302,protein_coding,-1,62747,chr7_45967555_46030302
Nomo1,7,46033698,46084212,protein_coding,1,50514,chr7_46033698_46084212
Kcnj11,7,46093953,46100764,protein_coding,-1,6811,chr7_46093953_46100764
Abcc8,7,46104523,46180033,protein_coding,-1,75510,chr7_46104523_46180033
Gm45486,7,46123352,46130568,antisense,1,7216,chr7_46123352_46130568
Ush1c,7,46195350,46238503,protein_coding,-1,43153,chr7_46195350_46238503
Otog,7,46240987,46311434,protein_coding,1,70447,chr7_46240987_46311434
1700025L06Rik,7,46345771,46349373,lincRNA,-1,3602,chr7_46345771_46349373
Myod1,7,46376474,46379099,protein_coding,1,2625,chr7_46376474_46379099
Kcnc1,7,46396497,46438704,protein_coding,1,42207,chr7_46396497_46438704
Sergef,7,46443154,46639807,protein_coding,-1,196653,chr7_46443154_46639807
Gm15700,7,46561301,46578201,antisense,1,16900,chr7_46561301_46578201
Tph1,7,46644641,46672537,protein_coding,-1,27896,chr7_46644641_46672537
Saal1,7,46686108,46710680,protein_coding,-1,24572,chr7_46686108_46710680
Saa3,7,46711998,46715700,protein_coding,-1,3702,chr7_46711998_46715700
Saa4,7,46727998,46732603,protein_coding,-1,4605,chr7_46727998_46732603
Saa1,7,46740497,46742980,protein_coding,-1,2483,chr7_46740497_46742980
Hps5,7,46760466,46796064,protein_coding,-1,35598,chr7_46760466_46796064
Gtf2h1,7,46796103,46823800,protein_coding,1,27697,chr7_46796103_46823800
Ldha,7,46841475,46855627,protein_coding,1,14152,chr7_46841475_46855627
Ldhc,7,46861203,46878142,protein_coding,1,16939,chr7_46861203_46878142
Tsg101,7,46888949,46919969,protein_coding,-1,31020,chr7_46888949_46919969
Uevld,7,46923216,46958527,protein_coding,-1,35311,chr7_46923216_46958527
C86187,7,46967711,46975911,lincRNA,-1,8200,chr7_46967711_46975911
Gm9999,7,46983580,46987803,protein_coding,1,4223,chr7_46983580_46987803
Spty2d1,7,46990396,47008411,protein_coding,-1,18015,chr7_46990396_47008411
Gm45474,7,47049889,47050296,lincRNA,-1,407,chr7_47049889_47050296
Tmem86a,7,47050601,47054777,protein_coding,1,4176,chr7_47050601_47054777
Ptpn5,7,47077795,47133684,protein_coding,-1,55889,chr7_47077795_47133684
Gm14377,7,47110851,47125990,antisense,1,15139,chr7_47110851_47125990
Mrgpra6,7,47185707,47204920,protein_coding,-1,19213,chr7_47185707_47204920
Mrgpra9,7,47234861,47252848,protein_coding,-1,17987,chr7_47234861_47252848
Mrgpra1,7,47334875,47354240,protein_coding,-1,19365,chr7_47334875_47354240
Mrgpra2a,7,47426328,47452139,protein_coding,-1,25811,chr7_47426328_47452139
Mrgpra2b,7,47463806,47528862,protein_coding,-1,65056,chr7_47463806_47528862
Mrgpra3,7,47588950,47601372,protein_coding,-1,12422,chr7_47588950_47601372
Mrgprx1,7,48020971,48027597,protein_coding,-1,6626,chr7_48020971_48027597
Mrgprx2,7,48478619,48499321,protein_coding,-1,20702,chr7_48478619_48499321
Zdhhc13,7,48789003,48827440,protein_coding,1,38437,chr7_48789003_48827440
Csrp3,7,48830398,48848033,protein_coding,-1,17635,chr7_48830398_48848033
Gm45282,7,48893685,48910062,lincRNA,-1,16377,chr7_48893685_48910062
Nav2,7,48908716,49610090,protein_coding,1,701374,chr7_48908716_49610090
9130015G15Rik,7,49122334,49159819,antisense,-1,37485,chr7_49122334_49159819
Htatip2,7,49759115,49773975,protein_coding,1,14860,chr7_49759115_49773975
Prmt3,7,49778346,49858265,protein_coding,1,79919,chr7_49778346_49858265
Slc6a5,7,49910146,49963856,protein_coding,1,53710,chr7_49910146_49963856
Nell1,7,49974864,50866608,protein_coding,1,891744,chr7_49974864_50866608
Nell1os,7,50517309,50575971,antisense,-1,58662,chr7_50517309_50575971
Ano5,7,51511029,51598709,protein_coding,1,87680,chr7_51511029_51598709
Slc17a6,7,51622006,51671119,protein_coding,1,49113,chr7_51622006_51671119
Gm29296,7,51750796,51772726,lincRNA,-1,21930,chr7_51750796_51772726
Fancf,7,51860577,51862267,protein_coding,-1,1690,chr7_51860577_51862267
Gas2,7,51862015,51994975,protein_coding,1,132960,chr7_51862015_51994975
Svip,7,51997171,52006018,protein_coding,-1,8847,chr7_51997171_52006018
1700015G11Rik,7,52011683,52015728,protein_coding,-1,4045,chr7_52011683_52015728
Luzp2,7,54835498,55268885,protein_coding,1,433387,chr7_54835498_55268885
Siglech,7,55768178,55778925,protein_coding,1,10747,chr7_55768178_55778925
Tubgcp5,7,55794154,55831677,protein_coding,1,37523,chr7_55794154_55831677
Cyfip1,7,55841745,55932602,protein_coding,1,90857,chr7_55841745_55932602
Nipa2,7,55931287,55962476,protein_coding,-1,31189,chr7_55931287_55962476
Nipa1,7,55977567,56019954,protein_coding,-1,42387,chr7_55977567_56019954
Herc2,7,56050196,56231800,protein_coding,1,181604,chr7_56050196_56231800
Oca2,7,56239760,56536518,protein_coding,1,296758,chr7_56239760_56536518
Gabrg3,7,56716465,57387188,protein_coding,-1,670723,chr7_56716465_57387188
Gm9962,7,57387272,57409941,antisense,1,22669,chr7_57387272_57409941
Gabra5,7,57407672,57510059,protein_coding,-1,102387,chr7_57407672_57510059
Gabrb3,7,57419692,57828802,protein_coding,1,409110,chr7_57419692_57828802
Atp10a,7,58656166,58829420,protein_coding,1,173254,chr7_58656166_58829420
Ube3a,7,59228750,59311536,protein_coding,1,82786,chr7_59228750_59311536
Gm38393,7,59974149,60005064,protein_coding,-1,30915,chr7_59974149_60005064
Snrpn,7,59982495,60140219,protein_coding,-1,157724,chr7_59982495_60140219
Gm44644,7,60915550,60922910,lincRNA,-1,7360,chr7_60915550_60922910
Gm44643,7,60922922,60961385,lincRNA,-1,38463,chr7_60922922_60961385
A230006K03Rik,7,61127996,61311721,lincRNA,-1,183725,chr7_61127996_61311721
B230209E15Rik,7,61529871,61615327,lincRNA,-1,85456,chr7_61529871_61615327
A230057D06Rik,7,61704519,61928690,lincRNA,-1,224171,chr7_61704519_61928690
Gm9801,7,62094506,62209479,lincRNA,-1,114973,chr7_62094506_62209479
Gm32061,7,62337794,62423245,lincRNA,-1,85451,chr7_62337794_62423245
Ndn,7,62346569,62350262,protein_coding,1,3693,chr7_62346569_62350262
Magel2,7,62377010,62381640,protein_coding,1,4630,chr7_62377010_62381640
Peg12,7,62461871,62464510,protein_coding,-1,2639,chr7_62461871_62464510
A26c2,7,62778423,62823673,protein_coding,-1,45250,chr7_62778423_62823673
Chrna7,7,63098692,63212569,protein_coding,-1,113877,chr7_63098692_63212569
4930554H23Rik,7,63344690,63444529,lincRNA,-1,99839,chr7_63344690_63444529
Otud7a,7,63444751,63759028,protein_coding,1,314277,chr7_63444751_63759028
Gm44718,7,63765874,63766232,lincRNA,1,358,chr7_63765874_63766232
Klf13,7,63886351,63938915,protein_coding,-1,52564,chr7_63886351_63938915
E030018B13Rik,7,63916857,63920539,protein_coding,1,3682,chr7_63916857_63920539
Gm45052,7,63962240,63967744,lincRNA,1,5504,chr7_63962240_63967744
Gm32633,7,64001885,64020959,lincRNA,1,19074,chr7_64001885_64020959
Gm45054,7,64034246,64040826,lincRNA,-1,6580,chr7_64034246_64040826
Gm20670,7,64057602,64062958,lincRNA,1,5356,chr7_64057602_64062958
Trpm1,7,64153835,64269775,protein_coding,1,115940,chr7_64153835_64269775
Mtmr10,7,64287653,64340806,protein_coding,1,53153,chr7_64287653_64340806
Gm20457,7,64337550,64345964,antisense,-1,8414,chr7_64337550_64345964
Fan1,7,64346758,64374095,protein_coding,-1,27337,chr7_64346758_64374095
Mphosph10,7,64376527,64392268,protein_coding,-1,15741,chr7_64376527_64392268
Mcee,7,64392607,64412125,protein_coding,1,19518,chr7_64392607_64412125
Apba2,7,64501706,64753878,protein_coding,1,252172,chr7_64501706_64753878
Fam189a1,7,64756091,65156570,protein_coding,-1,400479,chr7_64756091_65156570
Tjp1,7,65296165,65527781,protein_coding,-1,231616,chr7_65296165_65527781
BC046251,7,65582070,65618884,lincRNA,1,36814,chr7_65582070_65618884
Tarsl2,7,65644898,65692091,protein_coding,1,47193,chr7_65644898_65692091
Tm2d3,7,65691169,65701913,protein_coding,1,10744,chr7_65691169_65701913
Pcsk6,7,65861734,66050386,protein_coding,1,188652,chr7_65861734_66050386
Gm45213,7,66043602,66062271,protein_coding,1,18669,chr7_66043602_66062271
Snrpa1,7,66059003,66074587,protein_coding,1,15584,chr7_66059003_66074587
Gm45081,7,66078902,66079473,lincRNA,-1,571,chr7_66078902_66079473
Selenos,7,66079649,66089405,protein_coding,1,9756,chr7_66079649_66089405
Gm26827,7,66109515,66173121,antisense,-1,63606,chr7_66109515_66173121
Chsy1,7,66109515,66173798,protein_coding,1,64283,chr7_66109515_66173798
Lrrk1,7,66226912,66388350,protein_coding,-1,161438,chr7_66226912_66388350
Gm44752,7,66309195,66312499,antisense,1,3304,chr7_66309195_66312499
Gm10974,7,66365905,66386309,protein_coding,1,20404,chr7_66365905_66386309
Aldh1a3,7,66390890,66427517,protein_coding,-1,36627,chr7_66390890_66427517
Asb7,7,66644565,66689596,protein_coding,-1,45031,chr7_66644565_66689596
Lins1,7,66689889,66717256,protein_coding,1,27367,chr7_66689889_66717256
Cers3,7,66743504,66823691,protein_coding,1,80187,chr7_66743504_66823691
Adamts17,7,66839735,67153171,protein_coding,1,313436,chr7_66839735_67153171
1700112J16Rik,7,67204082,67222536,lincRNA,-1,18454,chr7_67204082_67222536
Lysmd4,7,67222544,67307330,protein_coding,1,84786,chr7_67222544_67307330
Mef2a,7,67231163,67372858,protein_coding,-1,141695,chr7_67231163_67372858
Gm33926,7,67429073,67443933,lincRNA,-1,14860,chr7_67429073_67443933
Lrrc28,7,67513410,67645268,protein_coding,-1,131858,chr7_67513410_67645268
Ttc23,7,67647410,67762912,protein_coding,1,115502,chr7_67647410_67762912
Synm,7,67730160,67759742,protein_coding,-1,29582,chr7_67730160_67759742
4833412C05Rik,7,67784538,67804139,lincRNA,-1,19601,chr7_67784538_67804139
Gm34350,7,67819250,67829618,lincRNA,1,10368,chr7_67819250_67829618
Gm39027,7,67832291,67849632,lincRNA,-1,17341,chr7_67832291_67849632
Igf1r,7,67952827,68233668,protein_coding,1,280841,chr7_67952827_68233668
Pgpep1l,7,68236610,68264233,protein_coding,-1,27623,chr7_68236610_68264233
Gm16157,7,68266339,68276594,antisense,-1,10255,chr7_68266339_68276594
Fam169b,7,68273839,68363092,protein_coding,1,89253,chr7_68273839_68363092
Gm16158,7,68338668,68353201,antisense,-1,14533,chr7_68338668_68353201
4933436H12Rik,7,68417402,68427362,lincRNA,1,9960,chr7_68417402_68427362
Gm34549,7,68429215,68490892,lincRNA,1,61677,chr7_68429215_68490892
Arrdc4,7,68736995,68749241,protein_coding,-1,12246,chr7_68736995_68749241
Gm34664,7,68843099,68916016,lincRNA,-1,72917,chr7_68843099_68916016
Gm44691,7,68989404,69008173,lincRNA,1,18769,chr7_68989404_69008173
Gm34838,7,69354372,69396932,lincRNA,-1,42560,chr7_69354372_69396932
Gm38584,7,69485424,69490801,lincRNA,-1,5377,chr7_69485424_69490801
4930402F11Rik,7,69496094,69550673,lincRNA,1,54579,chr7_69496094_69550673
Gm29683,7,70178868,70337852,lincRNA,-1,158984,chr7_70178868_70337852
Gm44946,7,70345239,70345810,lincRNA,-1,571,chr7_70345239_70345810
Nr2f2,7,70351944,70366735,protein_coding,-1,14791,chr7_70351944_70366735
Gm28258,7,70372038,70388410,lincRNA,-1,16372,chr7_70372038_70388410
Gm44532,7,70420915,70453222,lincRNA,-1,32307,chr7_70420915_70453222
Gm35842,7,70548869,70554924,lincRNA,1,6055,chr7_70548869_70554924
Gm44813,7,70571322,70574414,lincRNA,1,3092,chr7_70571322_70574414
Gm44812,7,70574834,70585751,lincRNA,1,10917,chr7_70574834_70585751
Gm42397,7,70870913,71073345,lincRNA,1,202432,chr7_70870913_71073345
Gm36011,7,71088427,71116539,lincRNA,-1,28112,chr7_71088427_71116539
Gm39033,7,71097047,71123594,lincRNA,1,26547,chr7_71097047_71123594
Gm29328,7,71264275,71379972,lincRNA,1,115697,chr7_71264275_71379972
Gm29295,7,71351451,71391272,lincRNA,1,39821,chr7_71351451_71391272
4930441H08Rik,7,71909693,71939191,lincRNA,1,29498,chr7_71909693_71939191
Gm36633,7,71947520,71962018,lincRNA,-1,14498,chr7_71947520_71962018
1700011C11Rik,7,71961173,72027317,lincRNA,1,66144,chr7_71961173_72027317
Mctp2,7,72077830,72306608,protein_coding,-1,228778,chr7_72077830_72306608
Gm36696,7,72110761,72113456,antisense,1,2695,chr7_72110761_72113456
Gm20083,7,73185744,73189446,lincRNA,1,3702,chr7_73185744_73189446
Gm30075,7,73202775,73238531,lincRNA,-1,35756,chr7_73202775_73238531
4930429H19Rik,7,73310380,73315193,lincRNA,1,4813,chr7_73310380_73315193
A730056A06Rik,7,73314003,73375774,antisense,-1,61771,chr7_73314003_73375774
Rgma,7,73375509,73419899,protein_coding,1,44390,chr7_73375509_73419899
Chd2,7,73426638,73541830,protein_coding,-1,115192,chr7_73426638_73541830
Gm44686,7,73538013,73554801,antisense,1,16788,chr7_73538013_73554801
Gm44734,7,73608948,73614625,lincRNA,1,5677,chr7_73608948_73614625
Gm44738,7,73626701,73627435,lincRNA,-1,734,chr7_73626701_73627435
Gm44737,7,73630617,73638088,lincRNA,1,7471,chr7_73630617_73638088
Gm44736,7,73670299,73672390,lincRNA,-1,2091,chr7_73670299_73672390
Gm44739,7,73676880,73678305,lincRNA,-1,1425,chr7_73676880_73678305
Fam174b,7,73740302,73776919,protein_coding,1,36617,chr7_73740302_73776919
Gm10619,7,73781429,73816503,lincRNA,-1,35074,chr7_73781429_73816503
Gm21269,7,73816546,73838898,lincRNA,1,22352,chr7_73816546_73838898
St8sia2,7,73939119,74013690,protein_coding,-1,74571,chr7_73939119_74013690
Slco3a1,7,74275419,74554780,protein_coding,-1,279361,chr7_74275419_74554780
Gm7580,7,74392698,74411233,antisense,1,18535,chr7_74392698_74411233
0610006L08Rik,7,74818818,74853813,lincRNA,-1,34995,chr7_74818818_74853813
4930533N22Rik,7,75030194,75075164,lincRNA,1,44970,chr7_75030194_75075164
Sv2b,7,75114894,75309262,protein_coding,-1,194368,chr7_75114894_75309262
Akap13,7,75455534,75754609,protein_coding,1,299075,chr7_75455534_75754609
AU020206,7,75769038,75782099,lincRNA,-1,13061,chr7_75769038_75782099
Klhl25,7,75848310,75874131,protein_coding,1,25821,chr7_75848310_75874131
Agbl1,7,76229887,77124698,protein_coding,1,894811,chr7_76229887_77124698
Ntrk3,7,78175959,78738012,protein_coding,-1,562053,chr7_78175959_78738012
4921513I08Rik,7,78254296,78255421,antisense,1,1125,chr7_78254296_78255421
Gm9885,7,78578830,78581038,antisense,1,2208,chr7_78578830_78581038
Mrpl46,7,78775236,78783531,protein_coding,-1,8295,chr7_78775236_78783531
Mrps11,7,78783119,78792989,protein_coding,1,9870,chr7_78783119_78792989
5330411O13Rik,7,78818285,78820663,lincRNA,1,2378,chr7_78818285_78820663
Det1,7,78821547,78847263,protein_coding,-1,25716,chr7_78821547_78847263
1700011D18Rik,7,78847254,78847530,lincRNA,1,276,chr7_78847254_78847530
Gm44730,7,78855488,78858442,lincRNA,-1,2954,chr7_78855488_78858442
Aen,7,78895854,78911209,protein_coding,1,15355,chr7_78895854_78911209
Isg20,7,78913424,78920396,protein_coding,1,6972,chr7_78913424_78920396
Gm26633,7,79018053,79053323,antisense,-1,35270,chr7_79018053_79053323
Acan,7,79053483,79115099,protein_coding,1,61616,chr7_79053483_79115099
Hapln3,7,79115102,79131018,protein_coding,-1,15916,chr7_79115102_79131018
Mfge8,7,79133768,79149060,protein_coding,-1,15292,chr7_79133768_79149060
Abhd2,7,79273199,79365508,protein_coding,1,92309,chr7_79273199_79365508
Rlbp1,7,79374870,79387048,protein_coding,-1,12178,chr7_79374870_79387048
Fanci,7,79391929,79450264,protein_coding,1,58335,chr7_79391929_79450264
Polg,7,79446231,79466362,protein_coding,-1,20131,chr7_79446231_79466362
Mir9-3hg,7,79500026,79534403,lincRNA,1,34377,chr7_79500026_79534403
Gm35040,7,79536043,79560033,lincRNA,1,23990,chr7_79536043_79560033
Gm45168,7,79577755,79579079,lincRNA,-1,1324,chr7_79577755_79579079
Gm45169,7,79586648,79592613,lincRNA,-1,5965,chr7_79586648_79592613
Rhcg,7,79593363,79617657,protein_coding,-1,24294,chr7_79593363_79617657
Ticrr,7,79660196,79698148,protein_coding,1,37952,chr7_79660196_79698148
Kif7,7,79698098,79715720,protein_coding,-1,17622,chr7_79698098_79715720
9330171B17Rik,7,79710283,79712357,antisense,1,2074,chr7_79710283_79712357
Plin1,7,79720218,79732903,protein_coding,-1,12685,chr7_79720218_79732903
Pex11a,7,79735957,79743131,protein_coding,-1,7174,chr7_79735957_79743131
Gm44706,7,79740678,79742016,antisense,1,1338,chr7_79740678_79742016
Wdr93,7,79743163,79785950,protein_coding,1,42787,chr7_79743163_79785950
Mesp1,7,79792241,79793788,protein_coding,-1,1547,chr7_79792241_79793788
Mesp2,7,79810727,79813439,protein_coding,1,2712,chr7_79810727_79813439
Anpep,7,79821803,79861059,protein_coding,-1,39256,chr7_79821803_79861059
Ap3s2,7,79875325,79920649,protein_coding,-1,45324,chr7_79875325_79920649
Gm26646,7,79916937,79920641,antisense,1,3704,chr7_79916937_79920641
Arpin,7,79925361,79935359,protein_coding,-1,9998,chr7_79925361_79935359
Zfp710,7,80024814,80094173,protein_coding,1,69359,chr7_80024814_80094173
Gm21057,7,80062710,80075267,antisense,-1,12557,chr7_80062710_80075267
Gm44949,7,80088982,80090431,antisense,-1,1449,chr7_80088982_80090431
Idh2,7,80094846,80115392,protein_coding,-1,20546,chr7_80094846_80115392
Sema4b,7,80186841,80226527,protein_coding,1,39686,chr7_80186841_80226527
Cib1,7,80227147,80232813,protein_coding,-1,5666,chr7_80227147_80232813
Gdpgp1,7,80232865,80242061,protein_coding,1,9196,chr7_80232865_80242061
Ttll13,7,80246376,80260821,protein_coding,1,14445,chr7_80246376_80260821
Ngrn,7,80261215,80265374,protein_coding,1,4159,chr7_80261215_80265374
Vps33b,7,80269649,80291754,protein_coding,1,22105,chr7_80269649_80291754
Rccd1,7,80293229,80324454,protein_coding,-1,31225,chr7_80293229_80324454
Prc1,7,80294450,80316259,protein_coding,1,21809,chr7_80294450_80316259
Unc45a,7,80325292,80347993,protein_coding,-1,22701,chr7_80325292_80347993
Hddc3,7,80343104,80350547,protein_coding,1,7443,chr7_80343104_80350547
Man2a2,7,80349097,80371375,protein_coding,-1,22278,chr7_80349097_80371375
Fes,7,80377756,80387946,protein_coding,-1,10190,chr7_80377756_80387946
Furin,7,80388585,80405436,protein_coding,-1,16851,chr7_80388585_80405436
Gm44851,7,80404269,80406577,antisense,1,2308,chr7_80404269_80406577
Blm,7,80454733,80535119,protein_coding,-1,80386,chr7_80454733_80535119
Crtc3,7,80586627,80688877,protein_coding,-1,102250,chr7_80586627_80688877
Gm15880,7,80636017,80644384,antisense,1,8367,chr7_80636017_80644384
Iqgap1,7,80711583,80825974,protein_coding,-1,114391,chr7_80711583_80825974
Gm44649,7,80751822,80758612,antisense,1,6790,chr7_80751822_80758612
Zscan2,7,80860920,80876537,protein_coding,1,15617,chr7_80860920_80876537
Wdr73,7,80890723,80901269,protein_coding,-1,10546,chr7_80890723_80901269
Nmb,7,80902227,80905076,protein_coding,-1,2849,chr7_80902227_80905076
Sec11a,7,80904889,80947780,protein_coding,-1,42891,chr7_80904889_80947780
Gm44899,7,80980846,80993415,lincRNA,-1,12569,chr7_80980846_80993415
Zfp592,7,80993681,81045164,protein_coding,1,51483,chr7_80993681_81045164
Alpk3,7,81057600,81105612,protein_coding,1,48012,chr7_81057600_81105612
Slc28a1,7,81114799,81170416,protein_coding,1,55617,chr7_81114799_81170416
Gm44968,7,81205010,81210876,lincRNA,1,5866,chr7_81205010_81210876
Pde8a,7,81213596,81334533,protein_coding,1,120937,chr7_81213596_81334533
Rps17,7,81342732,81345254,protein_coding,-1,2522,chr7_81342732_81345254
Cpeb1,7,81347026,81455465,protein_coding,-1,108439,chr7_81347026_81455465
Ap3b2,7,81460399,81493925,protein_coding,-1,33526,chr7_81460399_81493925
2900076A07Rik,7,81523550,81531498,lincRNA,1,7948,chr7_81523550_81531498
Fsd2,7,81533308,81566944,protein_coding,-1,33636,chr7_81533308_81566944
Whamm,7,81571266,81596836,protein_coding,1,25570,chr7_81571266_81596836
Homer2,7,81600481,81707527,protein_coding,-1,107046,chr7_81600481_81707527
Gm44570,7,81610109,81614166,antisense,1,4057,chr7_81610109_81614166
3110040N11Rik,7,81782182,81789478,protein_coding,-1,7296,chr7_81782182_81789478
Gm45016,7,81789477,81794685,antisense,1,5208,chr7_81789477_81794685
Btbd1,7,81792074,81829431,protein_coding,-1,37357,chr7_81792074_81829431
Gm10160,7,81855533,81855794,protein_coding,-1,261,chr7_81855533_81855794
Tm6sf1,7,81859001,81884434,protein_coding,1,25433,chr7_81859001_81884434
Gm45014,7,81860293,81862527,antisense,-1,2234,chr7_81860293_81862527
Hdgfl3,7,81881251,81934473,protein_coding,-1,53222,chr7_81881251_81934473
Bnc1,7,81966653,81992307,protein_coding,-1,25654,chr7_81966653_81992307
Gm20744,7,82070387,82081758,lincRNA,1,11371,chr7_82070387_82081758
Gm32850,7,82120053,82161719,lincRNA,1,41666,chr7_82120053_82161719
Sh3gl3,7,82173840,82307419,protein_coding,1,133579,chr7_82173840_82307419
Adamtsl3,7,82335694,82614450,protein_coding,1,278756,chr7_82335694_82614450
Saxo2,7,82632960,82648528,protein_coding,-1,15568,chr7_82632960_82648528
Efl1,7,82648614,82777852,protein_coding,1,129238,chr7_82648614_82777852
4933406J10Rik,7,82743368,82755644,antisense,-1,12276,chr7_82743368_82755644
1700010L04Rik,7,82851599,82859849,lincRNA,1,8250,chr7_82851599_82859849
Gm36584,7,82852498,82867074,lincRNA,-1,14576,chr7_82852498_82867074
Mex3b,7,82867333,82871515,protein_coding,1,4182,chr7_82867333_82871515
4933430H16Rik,7,82937936,82940688,lincRNA,-1,2752,chr7_82937936_82940688
A530021J07Rik,7,83061783,83179429,lincRNA,1,117646,chr7_83061783_83179429
5930435M05Rik,7,83178570,83201586,lincRNA,-1,23016,chr7_83178570_83201586
Gm44724,7,83327738,83369429,lincRNA,-1,41691,chr7_83327738_83369429
Gm10610,7,83536192,83550258,lincRNA,-1,14066,chr7_83536192_83550258
Tmc3,7,83584927,83625614,protein_coding,1,40687,chr7_83584927_83625614
Gm16638,7,83597048,83631880,antisense,-1,34832,chr7_83597048_83631880
Stard5,7,83631959,83653127,protein_coding,1,21168,chr7_83631959_83653127
Il16,7,83642825,83745726,protein_coding,-1,102901,chr7_83642825_83745726
2310044K18Rik,7,83659575,83660963,antisense,1,1388,chr7_83659575_83660963
Cfap161,7,83774101,83794880,protein_coding,-1,20779,chr7_83774101_83794880
Gm44993,7,83800422,83834599,lincRNA,-1,34177,chr7_83800422_83834599
Gm39043,7,83814707,83838345,lincRNA,1,23638,chr7_83814707_83838345
Tlnrd1,7,83879873,83884305,protein_coding,-1,4432,chr7_83879873_83884305
Mesd,7,83884466,83901532,protein_coding,1,17066,chr7_83884466_83901532
Cemip,7,83932857,84086502,protein_coding,-1,153645,chr7_83932857_84086502
Abhd17c,7,84109356,84151893,protein_coding,-1,42537,chr7_84109356_84151893
Gm44827,7,84226829,84232919,lincRNA,-1,6090,chr7_84226829_84232919
Arnt2,7,84246278,84410176,protein_coding,-1,163898,chr7_84246278_84410176
Gm30873,7,84338095,84347869,antisense,1,9774,chr7_84338095_84347869
Gm44933,7,84435993,84439226,lincRNA,-1,3233,chr7_84435993_84439226
Gm45175,7,84442831,84444551,lincRNA,-1,1720,chr7_84442831_84444551
Gm2115,7,84528954,84583531,protein_coding,1,54577,chr7_84528954_84583531
Fah,7,84585159,84606722,protein_coding,-1,21563,chr7_84585159_84606722
Zfand6,7,84613766,84689959,protein_coding,-1,76193,chr7_84613766_84689959
2610206C17Rik,7,84689640,84779053,antisense,1,89413,chr7_84689640_84779053
Vmn2r65,7,84935565,84964115,protein_coding,-1,28550,chr7_84935565_84964115
Vmn2r66,7,84985366,85012268,protein_coding,-1,26902,chr7_84985366_85012268
Vmn2r69,7,85393826,85415920,protein_coding,-1,22094,chr7_85393826_85415920
Vmn2r70,7,85548407,85569192,protein_coding,-1,20785,chr7_85548407_85569192
Vmn2r71,7,85563087,85624680,protein_coding,1,61593,chr7_85563087_85624680
Vmn2r72,7,85735940,85755097,protein_coding,-1,19157,chr7_85735940_85755097
Vmn2r73,7,85850673,85876266,protein_coding,-1,25593,chr7_85850673_85876266
Vmn2r74,7,85944614,85961629,protein_coding,-1,17015,chr7_85944614_85961629
Vmn2r75,7,86145286,86171778,protein_coding,-1,26492,chr7_86145286_86171778
Vmn2r76,7,86202024,86246308,protein_coding,-1,44284,chr7_86202024_86246308
Olfr310,7,86268487,86277172,protein_coding,-1,8685,chr7_86268487_86277172
Olfr301,7,86403846,86414024,protein_coding,1,10178,chr7_86403846_86414024
Olfr298,7,86486322,86492484,protein_coding,-1,6162,chr7_86486322_86492484
Folh1,7,86718977,86775943,protein_coding,-1,56966,chr7_86718977_86775943
Vmn2r77,7,86795027,86815140,protein_coding,1,20113,chr7_86795027_86815140
Vmn2r78,7,86915094,86955312,protein_coding,1,40218,chr7_86915094_86955312
Vmn2r79,7,86996115,87044941,protein_coding,1,48826,chr7_86996115_87044941
Nox4,7,87246096,87398710,protein_coding,1,152614,chr7_87246096_87398710
Tyr,7,87424771,87493512,protein_coding,-1,68741,chr7_87424771_87493512
Grm5,7,87584168,88134907,protein_coding,1,550739,chr7_87584168_88134907
Ctsc,7,88278085,88310888,protein_coding,1,32803,chr7_88278085_88310888
Gm44751,7,88311478,88315864,lincRNA,1,4386,chr7_88311478_88315864
Rab38,7,88430273,88491572,protein_coding,1,61299,chr7_88430273_88491572
Gm45144,7,88853043,88864892,lincRNA,-1,11849,chr7_88853043_88864892
Tmem135,7,89139714,89404222,protein_coding,-1,264508,chr7_89139714_89404222
Gm44995,7,89338370,89346288,antisense,1,7918,chr7_89338370_89346288
Fzd4,7,89404355,89413134,protein_coding,1,8779,chr7_89404355_89413134
AI314278,7,89426306,89441928,lincRNA,1,15622,chr7_89426306_89441928
Prss23,7,89507783,89527187,protein_coding,-1,19404,chr7_89507783_89527187
Prss23os,7,89510007,89511873,antisense,1,1866,chr7_89510007_89511873
Gm45064,7,89552366,89568079,lincRNA,1,15713,chr7_89552366_89568079
A230065N10Rik,7,89632097,89633124,antisense,-1,1027,chr7_89632097_89633124
Me3,7,89632392,89854359,protein_coding,1,221967,chr7_89632392_89854359
Ccdc81,7,89866148,89903629,protein_coding,-1,37481,chr7_89866148_89903629
Hikeshi,7,89917529,89941204,protein_coding,-1,23675,chr7_89917529_89941204
Eed,7,89954654,89980983,protein_coding,-1,26329,chr7_89954654_89980983
Picalm,7,90130213,90213465,protein_coding,1,83252,chr7_90130213_90213465
Ccdc83,7,90223873,90265777,protein_coding,-1,41904,chr7_90223873_90265777
Sytl2,7,90302252,90410719,protein_coding,1,108467,chr7_90302252_90410719
Ccdc89,7,90426577,90428669,protein_coding,1,2092,chr7_90426577_90428669
Crebzf,7,90442729,90447994,protein_coding,1,5265,chr7_90442729_90447994
Tmem126a,7,90450700,90457229,protein_coding,-1,6529,chr7_90450700_90457229
Tmem126b,7,90467438,90476001,protein_coding,-1,8563,chr7_90467438_90476001
Dlg2,7,90476672,92449247,protein_coding,1,1972575,chr7_90476672_92449247
4930567K12Rik,7,92092206,92119511,antisense,-1,27305,chr7_92092206_92119511
Ccdc90b,7,92561149,92582294,protein_coding,1,21145,chr7_92561149_92582294
Ankrd42,7,92581723,92637142,protein_coding,-1,55419,chr7_92581723_92637142
Gm26944,7,92639739,92647442,antisense,1,7703,chr7_92639739_92647442
Pcf11,7,92643543,92669934,protein_coding,-1,26391,chr7_92643543_92669934
Gm26981,7,92729840,92733748,lincRNA,1,3908,chr7_92729840_92733748
Rab30,7,92741603,92844535,protein_coding,1,102932,chr7_92741603_92844535
Ddias,7,92857525,92874247,protein_coding,-1,16722,chr7_92857525_92874247
Prcp,7,92874470,92934583,protein_coding,1,60113,chr7_92874470_92934583
Gm9934,7,93052081,93081027,antisense,-1,28946,chr7_93052081_93081027
Fam181b,7,93079865,93081867,protein_coding,1,2002,chr7_93079865_93081867
Gm44947,7,93290700,93323950,lincRNA,-1,33250,chr7_93290700_93323950
Gm45037,7,93361678,93380864,lincRNA,1,19186,chr7_93361678_93380864
Gm32647,7,94042691,94709171,lincRNA,1,666480,chr7_94042691_94709171
Gm44601,7,94368983,94372572,lincRNA,-1,3589,chr7_94368983_94372572
Tenm4,7,96171246,96911093,protein_coding,1,739847,chr7_96171246_96911093
Gm15412,7,96339483,96341964,antisense,-1,2481,chr7_96339483_96341964
Gm15414,7,96596652,96629069,antisense,-1,32417,chr7_96596652_96629069
Gm15413,7,96791433,96801549,antisense,-1,10116,chr7_96791433_96801549
Gm15416,7,96812433,96817485,antisense,-1,5052,chr7_96812433_96817485
Gm44633,7,96813869,96818306,antisense,-1,4437,chr7_96813869_96818306
Nars2,7,96951505,97064758,protein_coding,1,113253,chr7_96951505_97064758
Gab2,7,97081586,97308946,protein_coding,1,227360,chr7_97081586_97308946
Usp35,7,97309380,97332020,protein_coding,-1,22640,chr7_97309380_97332020
Kctd21,7,97332327,97350213,protein_coding,1,17886,chr7_97332327_97350213
Alg8,7,97371606,97392185,protein_coding,1,20579,chr7_97371606_97392185
Ndufc2,7,97400003,97407802,protein_coding,1,7799,chr7_97400003_97407802
Thrsp,7,97412938,97417730,protein_coding,-1,4792,chr7_97412938_97417730
Kctd14,7,97451323,97459557,protein_coding,1,8234,chr7_97451323_97459557
Ints4,7,97480956,97541395,protein_coding,1,60439,chr7_97480956_97541395
Aamdc,7,97550331,97579497,protein_coding,-1,29166,chr7_97550331_97579497
Rsf1,7,97579889,97692778,protein_coding,1,112889,chr7_97579889_97692778
Rsf1os1,7,97598349,97645112,antisense,-1,46763,chr7_97598349_97645112
Rsf1os2,7,97650010,97696828,antisense,-1,46818,chr7_97650010_97696828
Clns1a,7,97696634,97720796,protein_coding,1,24162,chr7_97696634_97720796
Aqp11,7,97724006,97738289,protein_coding,-1,14283,chr7_97724006_97738289
Pak1,7,97788541,97912381,protein_coding,1,123840,chr7_97788541_97912381
Gdpd4,7,97919955,98049663,protein_coding,1,129708,chr7_97919955_98049663
Myo7a,7,98051060,98119524,protein_coding,-1,68464,chr7_98051060_98119524
Capn5,7,98121559,98178274,protein_coding,-1,56715,chr7_98121559_98178274
B3gnt6,7,98192417,98199481,protein_coding,-1,7064,chr7_98192417_98199481
Acer3,7,98206389,98321208,protein_coding,-1,114819,chr7_98206389_98321208
Tsku,7,98350668,98361328,protein_coding,-1,10660,chr7_98350668_98361328
Gm44507,7,98388091,98415624,lincRNA,-1,27533,chr7_98388091_98415624
Gucy2d,7,98440416,98477479,protein_coding,1,37063,chr7_98440416_98477479
Lrrc32,7,98489283,98502181,protein_coding,1,12898,chr7_98489283_98502181
A630091E08Rik,7,98543320,98562990,lincRNA,-1,19670,chr7_98543320_98562990
Emsy,7,98587137,98656783,protein_coding,-1,69646,chr7_98587137_98656783
Thap12,7,98703103,98718062,protein_coding,1,14959,chr7_98703103_98718062
Gm19656,7,98720057,98728760,lincRNA,-1,8703,chr7_98720057_98728760
Wnt11,7,98835112,98855195,protein_coding,1,20083,chr7_98835112_98855195
Uvrag,7,98885021,99141141,protein_coding,-1,256120,chr7_98885021_99141141
Gm45188,7,98895930,98899545,antisense,1,3615,chr7_98895930_98899545
Gm45187,7,98904268,98908055,antisense,1,3787,chr7_98904268_98908055
Dgat2,7,99153658,99182719,protein_coding,-1,29061,chr7_99153658_99182719
Gm45012,7,99202366,99227080,antisense,1,24714,chr7_99202366_99227080
Mogat2,7,99219084,99238619,protein_coding,-1,19535,chr7_99219084_99238619
Gm26705,7,99260481,99267218,lincRNA,-1,6737,chr7_99260481_99267218
Map6,7,99267447,99337137,protein_coding,1,69690,chr7_99267447_99337137
Serpinh1,7,99345376,99353239,protein_coding,-1,7863,chr7_99345376_99353239
Gdpd5,7,99381414,99461877,protein_coding,1,80463,chr7_99381414_99461877
Klhl35,7,99466004,99474022,protein_coding,1,8018,chr7_99466004_99474022
Rps3,7,99477896,99483738,protein_coding,-1,5842,chr7_99477896_99483738
Arrb1,7,99535466,99606771,protein_coding,1,71305,chr7_99535466_99606771
Tpbgl,7,99624082,99627103,protein_coding,-1,3021,chr7_99624082_99627103
Gm10605,7,99625936,99631711,lincRNA,1,5775,chr7_99625936_99631711
Slco2b1,7,99657804,99711340,protein_coding,-1,53536,chr7_99657804_99711340
Gm15635,7,99660130,99667500,antisense,1,7370,chr7_99660130_99667500
Gm34280,7,99694297,99712777,antisense,1,18480,chr7_99694297_99712777
Olfr520,7,99730273,99736399,protein_coding,1,6126,chr7_99730273_99736399
Olfr521,7,99763507,99769321,protein_coding,1,5814,chr7_99763507_99769321
F730035P03Rik,7,99780001,99781539,lincRNA,-1,1538,chr7_99780001_99781539
Neu3,7,99811439,99828417,protein_coding,-1,16978,chr7_99811439_99828417
Spcs2,7,99837569,99863462,protein_coding,-1,25893,chr7_99837569_99863462
Xrra1,7,99859116,99917822,protein_coding,1,58706,chr7_99859116_99917822
Gm38405,7,99870666,99889358,antisense,-1,18692,chr7_99870666_99889358
Rnf169,7,99920254,99980448,protein_coding,-1,60194,chr7_99920254_99980448
Chrdl2,7,100006172,100034728,protein_coding,1,28556,chr7_100006172_100034728
Pold3,7,100082111,100121565,protein_coding,-1,39454,chr7_100082111_100121565
Lipt2,7,100159277,100161365,protein_coding,1,2088,chr7_100159277_100161365
Gm34821,7,100171416,100227207,antisense,-1,55791,chr7_100171416_100227207
Kcne3,7,100176502,100184869,protein_coding,1,8367,chr7_100176502_100184869
Pgm2l1,7,100227394,100278868,protein_coding,1,51474,chr7_100227394_100278868
P4ha3,7,100285520,100319699,protein_coding,1,34179,chr7_100285520_100319699
Ppme1,7,100326737,100372307,protein_coding,-1,45570,chr7_100326737_100372307
C2cd3,7,100372233,100470152,protein_coding,1,97919,chr7_100372233_100470152
Gm10603,7,100446737,100474846,antisense,-1,28109,chr7_100446737_100474846
Ucp3,7,100472990,100486432,protein_coding,1,13442,chr7_100472990_100486432
Ucp2,7,100493337,100502020,protein_coding,1,8683,chr7_100493337_100502020
Dnajb13,7,100501716,100514960,protein_coding,-1,13244,chr7_100501716_100514960
Coa4,7,100537071,100540369,protein_coding,1,3298,chr7_100537071_100540369
Gm39059,7,100542338,100543180,lincRNA,-1,842,chr7_100542338_100543180
Mrpl48,7,100545751,100608301,protein_coding,-1,62550,chr7_100545751_100608301
Rab6a,7,100607410,100641268,protein_coding,1,33858,chr7_100607410_100641268
Plekhb1,7,100642892,100662414,protein_coding,-1,19522,chr7_100642892_100662414
Gm35082,7,100675088,100677760,lincRNA,1,2672,chr7_100675088_100677760
Fam168a,7,100706635,100841656,protein_coding,1,135021,chr7_100706635_100841656
Relt,7,100845847,100863446,protein_coding,-1,17599,chr7_100845847_100863446
Arhgef17,7,100869752,100932107,protein_coding,-1,62355,chr7_100869752_100932107
P2ry6,7,100937630,100974649,protein_coding,-1,37019,chr7_100937630_100974649
P2ry2,7,100996568,101012866,protein_coding,-1,16298,chr7_100996568_101012866
Fchsd2,7,101092863,101284405,protein_coding,1,191542,chr7_101092863_101284405
Atg16l2,7,101263034,101302251,protein_coding,-1,39217,chr7_101263034_101302251
Stard10,7,101317086,101346626,protein_coding,1,29540,chr7_101317086_101346626
Gm20476,7,101317724,101326231,antisense,-1,8507,chr7_101317724_101326231
Gm45620,7,101347409,101347984,lincRNA,-1,575,chr7_101347409_101347984
Arap1,7,101348067,101412586,protein_coding,1,64519,chr7_101348067_101412586
Gm45837,7,101410886,101512819,protein_coding,1,101933,chr7_101410886_101512819
Pde2a,7,101421691,101512827,protein_coding,1,91136,chr7_101421691_101512827
Gm35363,7,101525376,101538330,lincRNA,-1,12954,chr7_101525376_101538330
Art2b,7,101576970,101585600,protein_coding,-1,8630,chr7_101576970_101585600
Clpb,7,101663633,101795506,protein_coding,1,131873,chr7_101663633_101795506
Phox2a,7,101818313,101822726,protein_coding,1,4413,chr7_101818313_101822726
Inppl1,7,101822632,101838229,protein_coding,-1,15597,chr7_101822632_101838229
Gm10602,7,101836503,101842771,antisense,1,6268,chr7_101836503_101842771
Folr2,7,101839988,101857194,protein_coding,-1,17206,chr7_101839988_101857194
Folr1,7,101858331,101870788,protein_coding,-1,12457,chr7_101858331_101870788
Anapc15,7,101863715,101901849,protein_coding,1,38134,chr7_101863715_101901849
Tomt,7,101898370,101906359,protein_coding,-1,7989,chr7_101898370_101906359
Lamtor1,7,101905904,101926675,protein_coding,1,20771,chr7_101905904_101926675
Lrrc51,7,101912984,101933895,protein_coding,-1,20911,chr7_101912984_101933895
Numa1,7,101934111,102014964,protein_coding,1,80853,chr7_101934111_102014964
Il18bp,7,102014885,102018690,protein_coding,-1,3805,chr7_102014885_102018690
Rnf121,7,102019137,102065469,protein_coding,-1,46332,chr7_102019137_102065469
Xndc1,7,102065511,102083765,protein_coding,1,18254,chr7_102065511_102083765
Xntrpc,7,102065713,102096864,protein_coding,1,31151,chr7_102065713_102096864
Art5,7,102096879,102109489,protein_coding,-1,12610,chr7_102096879_102109489
Art1,7,102101743,102113933,protein_coding,1,12190,chr7_102101743_102113933
Chrna10,7,102111266,102116828,protein_coding,-1,5562,chr7_102111266_102116828
Nup98,7,102119398,102210176,protein_coding,-1,90778,chr7_102119398_102210176
Pgap2,7,102210208,102238567,protein_coding,1,28359,chr7_102210208_102238567
Rhog,7,102239123,102256054,protein_coding,-1,16931,chr7_102239123_102256054
Stim1,7,102267806,102437319,protein_coding,1,169513,chr7_102267806_102437319
Rrm1,7,102441695,102469771,protein_coding,1,28076,chr7_102441695_102469771
Olfr543,7,102476579,102481679,protein_coding,-1,5100,chr7_102476579_102481679
Olfr544,7,102482031,102488313,protein_coding,-1,6282,chr7_102482031_102488313
Olfr545,7,102491466,102499573,protein_coding,-1,8107,chr7_102491466_102499573
Trim21,7,102557921,102565486,protein_coding,-1,7565,chr7_102557921_102565486
Olfr550,7,102571442,102583011,protein_coding,1,11569,chr7_102571442_102583011
Olfr551,7,102583510,102591886,protein_coding,-1,8376,chr7_102583510_102591886
Olfr552,7,102597770,102608125,protein_coding,1,10355,chr7_102597770_102608125
Olfr553,7,102611281,102618218,protein_coding,-1,6937,chr7_102611281_102618218
Olfr554,7,102638432,102642555,protein_coding,1,4123,chr7_102638432_102642555
Olfr556,7,102664899,102673270,protein_coding,1,8371,chr7_102664899_102673270
Trim68,7,102677582,102687327,protein_coding,-1,9745,chr7_102677582_102687327
Olfr557,7,102695910,102700707,protein_coding,1,4797,chr7_102695910_102700707
Olfr558,7,102702215,102712064,protein_coding,1,9849,chr7_102702215_102712064
Olfr33,7,102712151,102719070,protein_coding,-1,6919,chr7_102712151_102719070
Olfr559,7,102723207,102727491,protein_coding,-1,4284,chr7_102723207_102727491
Olfr78,7,102738511,102759471,protein_coding,-1,20960,chr7_102738511_102759471
Olfr561,7,102771221,102776857,protein_coding,1,5636,chr7_102771221_102776857
Olfr570,7,102894577,102901710,protein_coding,1,7133,chr7_102894577_102901710
Olfr571,7,102905090,102917536,protein_coding,-1,12446,chr7_102905090_102917536
Olfr576,7,102962660,102975160,protein_coding,1,12500,chr7_102962660_102975160
Olfr577,7,102971180,102975943,protein_coding,-1,4763,chr7_102971180_102975943
Olfr578,7,102981608,102989324,protein_coding,-1,7716,chr7_102981608_102989324
Olfr582,7,103038024,103044040,protein_coding,1,6016,chr7_103038024_103044040
Olfr584,7,103081885,103088315,protein_coding,1,6430,chr7_103081885_103088315
Olfr588-ps1,7,103140879,103147864,protein_coding,1,6985,chr7_103140879_103147864
Olfr591,7,103167074,103178340,protein_coding,-1,11266,chr7_103167074_103178340
Olfr592,7,103184803,103192965,protein_coding,1,8162,chr7_103184803_103192965
Olfr594,7,103216996,103222313,protein_coding,1,5317,chr7_103216996_103222313
Olfr597,7,103316315,103322799,protein_coding,1,6484,chr7_103316315_103322799
Olfr599,7,103335917,103339564,protein_coding,1,3647,chr7_103335917_103339564
Olfr600,7,103343482,103349669,protein_coding,-1,6187,chr7_103343482_103349669
Olfr601,7,103357094,103362655,protein_coding,-1,5561,chr7_103357094_103362655
Usp17lc,7,103415072,103419880,protein_coding,1,4808,chr7_103415072_103419880
Olfr607,7,103455526,103464151,protein_coding,-1,8625,chr7_103455526_103464151
Olfr612,7,103537222,103542717,protein_coding,-1,5495,chr7_103537222_103542717
Olfr613,7,103548074,103555506,protein_coding,1,7432,chr7_103548074_103555506
Olfr616,7,103563747,103569143,protein_coding,-1,5396,chr7_103563747_103569143
Olfr617,7,103573061,103586795,protein_coding,1,13734,chr7_103573061_103586795
Olfr620,7,103604895,103612534,protein_coding,-1,7639,chr7_103604895_103612534
Olfr624,7,103665461,103671191,protein_coding,-1,5730,chr7_103665461_103671191
Olfr243,7,103714671,103721166,protein_coding,1,6495,chr7_103714671_103721166
Olfr630,7,103753480,103757333,protein_coding,-1,3853,chr7_103753480_103757333
Olfr66,7,103879443,103886252,protein_coding,-1,6809,chr7_103879443_103886252
Olfr633,7,103944437,103948963,protein_coding,1,4526,chr7_103944437_103948963
Olfr635,7,103971152,103987540,protein_coding,1,16388,chr7_103971152_103987540
Olfr643,7,103998800,104137405,protein_coding,-1,138605,chr7_103998800_104137405
Olfr646,7,104104873,104109766,protein_coding,1,4893,chr7_104104873_104109766
Olfm5,7,104153013,104164831,protein_coding,-1,11818,chr7_104153013_104164831
Olfr648,7,104177598,104183392,protein_coding,-1,5794,chr7_104177598_104183392
Olfr649,7,104188992,104195985,protein_coding,-1,6993,chr7_104188992_104195985
Trim6,7,104218793,104235152,protein_coding,1,16359,chr7_104218793_104235152
Trim34a,7,104244457,104262234,protein_coding,1,17777,chr7_104244457_104262234
Trim5,7,104263386,104288094,protein_coding,-1,24708,chr7_104263386_104288094
Trim12a,7,104299894,104315466,protein_coding,-1,15572,chr7_104299894_104315466
Gm15133,7,104315019,104324838,antisense,1,9819,chr7_104315019_104324838
Trim34b,7,104329471,104336909,protein_coding,1,7438,chr7_104329471_104336909
Trim12c,7,104338754,104353362,protein_coding,-1,14608,chr7_104338754_104353362
Trim30b,7,104355382,104369884,protein_coding,-1,14502,chr7_104355382_104369884
Trim30c,7,104382065,104400837,protein_coding,-1,18772,chr7_104382065_104400837
Trim30a,7,104409025,104465193,protein_coding,-1,56168,chr7_104409025_104465193
Trim30d,7,104470014,104507849,protein_coding,-1,37835,chr7_104470014_104507849
Olfr651,7,104550133,104554422,protein_coding,1,4289,chr7_104550133_104554422
Olfr652,7,104560901,104568634,protein_coding,1,7733,chr7_104560901_104568634
Olfr653,7,104577314,104584117,protein_coding,1,6803,chr7_104577314_104584117
Olfr654,7,104587025,104590718,protein_coding,1,3693,chr7_104587025_104590718
Olfr655,7,104595301,104601779,protein_coding,-1,6478,chr7_104595301_104601779
Olfr656,7,104613955,104621603,protein_coding,1,7648,chr7_104613955_104621603
Olfr657,7,104624794,104637481,protein_coding,1,12687,chr7_104624794_104637481
Olfr658,7,104642877,104647305,protein_coding,-1,4428,chr7_104642877_104647305
Olfr659,7,104666753,104674948,protein_coding,1,8195,chr7_104666753_104674948
Usp17le,7,104768049,104777470,protein_coding,-1,9421,chr7_104768049_104777470
Usp17la,7,104857009,104862667,protein_coding,1,5658,chr7_104857009_104862667
Olfr667,7,104914742,104921482,protein_coding,-1,6740,chr7_104914742_104921482
Olfr669,7,104934240,104940477,protein_coding,1,6237,chr7_104934240_104940477
Olfr670,7,104957114,104962620,protein_coding,-1,5506,chr7_104957114_104962620
Olfr671,7,104972896,104979126,protein_coding,-1,6230,chr7_104972896_104979126
Olfr672,7,104995760,105002029,protein_coding,-1,6269,chr7_104995760_105002029
Olfr675,7,105021370,105028460,protein_coding,-1,7090,chr7_105021370_105028460
Olfr677,7,105051372,105059006,protein_coding,1,7634,chr7_105051372_105059006
Olfr678,7,105064475,105071639,protein_coding,1,7164,chr7_105064475_105071639
Olfr679,7,105081205,105090642,protein_coding,1,9437,chr7_105081205_105090642
Olfr681,7,105116836,105125523,protein_coding,1,8687,chr7_105116836_105125523
Olfr683,7,105140839,105147012,protein_coding,-1,6173,chr7_105140839_105147012
Olfr684,7,105154692,105163653,protein_coding,-1,8961,chr7_105154692_105163653
Olfr685,7,105178416,105186012,protein_coding,-1,7596,chr7_105178416_105186012
Olfr686,7,105201858,105207485,protein_coding,-1,5627,chr7_105201858_105207485
Olfr688,7,105288095,105289060,protein_coding,1,965,chr7_105288095_105289060
Olfr689,7,105311165,105319662,protein_coding,1,8497,chr7_105311165_105319662
Olfr690,7,105328225,105334104,protein_coding,-1,5879,chr7_105328225_105334104
Olfr691,7,105335509,105342270,protein_coding,-1,6761,chr7_105335509_105342270
Olfr692,7,105368230,105369355,protein_coding,1,1125,chr7_105368230_105369355
Fam160a2,7,105371211,105400054,protein_coding,-1,28843,chr7_105371211_105400054
Gm5901,7,105375038,105378377,protein_coding,1,3339,chr7_105375038_105378377
Cnga4,7,105404568,105408742,protein_coding,1,4174,chr7_105404568_105408742
Cckbr,7,105425731,105470898,protein_coding,1,45167,chr7_105425731_105470898
Cavin3,7,105480083,105482300,protein_coding,-1,2217,chr7_105480083_105482300
Smpd1,7,105554360,105558389,protein_coding,1,4029,chr7_105554360_105558389
Apbb1,7,105558483,105581653,protein_coding,-1,23170,chr7_105558483_105581653
Hpx,7,105591613,105600137,protein_coding,-1,8524,chr7_105591613_105600137
Trim3,7,105604463,105633571,protein_coding,-1,29108,chr7_105604463_105633571
Arfip2,7,105634203,105640416,protein_coding,-1,6213,chr7_105634203_105640416
Timm10b,7,105640056,105643637,protein_coding,1,3581,chr7_105640056_105643637
Gm45799,7,105640552,105684439,protein_coding,1,43887,chr7_105640552_105684439
Dnhd1,7,105650827,105721799,protein_coding,1,70972,chr7_105650827_105721799
Rrp8,7,105731730,105737385,protein_coding,-1,5655,chr7_105731730_105737385
Ilk,7,105736592,105742925,protein_coding,1,6333,chr7_105736592_105742925
Taf10,7,105739393,105744361,protein_coding,-1,4968,chr7_105739393_105744361
Tpp1,7,105744811,105752235,protein_coding,-1,7424,chr7_105744811_105752235
Dchs1,7,105752990,105787654,protein_coding,-1,34664,chr7_105752990_105787654
Mrpl17,7,105803206,105811099,protein_coding,-1,7893,chr7_105803206_105811099
Gm4070,7,105895139,105953967,protein_coding,-1,58828,chr7_105895139_105953967
Gm20663,7,105901568,106093337,antisense,1,191769,chr7_105901568_106093337
Gvin1,7,106156556,106215326,protein_coding,-1,58770,chr7_106156556_106215326
Olfr694,7,106684980,106691814,protein_coding,-1,6834,chr7_106684980_106691814
Olfr698,7,106749889,106755397,protein_coding,-1,5508,chr7_106749889_106755397
Olfr699,7,106787963,106793198,protein_coding,-1,5235,chr7_106787963_106793198
Olfr702,7,106823489,106833893,protein_coding,-1,10404,chr7_106823489_106833893
Olfr707,7,106890446,106901241,protein_coding,-1,10795,chr7_106890446_106901241
Olfr709-ps1,7,106922874,106932219,protein_coding,-1,9345,chr7_106922874_106932219
Olfr2,7,106995399,107006072,protein_coding,-1,10673,chr7_106995399_107006072
Olfr714,7,107070981,107077802,protein_coding,1,6821,chr7_107070981_107077802
Olfr17,7,107093220,107099808,protein_coding,1,6588,chr7_107093220_107099808
Olfr715b,7,107103748,107110369,protein_coding,-1,6621,chr7_107103748_107110369
Gm45868,7,107113388,107127822,lincRNA,1,14434,chr7_107113388_107127822
Olfr715,7,107125267,107131083,protein_coding,-1,5816,chr7_107125267_107131083
Olfr716,7,107138327,107150581,protein_coding,1,12254,chr7_107138327_107150581
Nlrp14,7,107166990,107198102,protein_coding,1,31112,chr7_107166990_107198102
Platr28,7,107243022,107300396,lincRNA,1,57374,chr7_107243022_107300396
Syt9,7,107370728,107548656,protein_coding,1,177928,chr7_107370728_107548656
Olfml1,7,107567446,107591094,protein_coding,1,23648,chr7_107567446_107591094
Ppfibp2,7,107595207,107748583,protein_coding,1,153376,chr7_107595207_107748583
Cyb5r2,7,107748455,107758032,protein_coding,-1,9577,chr7_107748455_107758032
Ovch2,7,107781544,107801208,protein_coding,-1,19664,chr7_107781544_107801208
Olfr469,7,107820566,107825541,protein_coding,-1,4975,chr7_107820566_107825541
Olfr472,7,107897902,107907762,protein_coding,1,9860,chr7_107897902_107907762
Olfr477,7,107986693,107992723,protein_coding,1,6030,chr7_107986693_107992723
Olfr482,7,108092999,108097586,protein_coding,-1,4587,chr7_108092999_108097586
Olfr484,7,108120691,108127449,protein_coding,-1,6758,chr7_108120691_108127449
Olfr509,7,108644336,108651906,protein_coding,-1,7570,chr7_108644336_108651906
Olfr510,7,108666418,108670259,protein_coding,1,3841,chr7_108666418_108670259
Olfr513,7,108750973,108756800,protein_coding,1,5827,chr7_108750973_108756800
Olfr516,7,108844788,108850529,protein_coding,-1,5741,chr7_108844788_108850529
Nlrp10,7,108921852,108930178,protein_coding,-1,8326,chr7_108921852_108930178
Eif3f,7,108934417,108942951,protein_coding,1,8534,chr7_108934417_108942951
Tub,7,108950338,109034460,protein_coding,1,84122,chr7_108950338_109034460
Ric3,7,109034312,109083331,protein_coding,-1,49019,chr7_109034312_109083331
Lmo1,7,109138572,109175207,protein_coding,-1,36635,chr7_109138572_109175207
Gm44781,7,109142887,109146604,antisense,1,3717,chr7_109142887_109146604
Gm45024,7,109208301,109224200,lincRNA,-1,15899,chr7_109208301_109224200
Stk33,7,109279223,109439081,protein_coding,-1,159858,chr7_109279223_109439081
1700095J03Rik,7,109438618,109444893,antisense,1,6275,chr7_109438618_109444893
Trim66,7,109449006,109508134,protein_coding,-1,59128,chr7_109449006_109508134
Rpl27a,7,109519147,109522367,protein_coding,1,3220,chr7_109519147_109522367
Gm44864,7,109699525,109703608,antisense,1,4083,chr7_109699525_109703608
Akip1,7,109703690,109712189,protein_coding,1,8499,chr7_109703690_109712189
BC051019,7,109712181,109723850,protein_coding,-1,11669,chr7_109712181_109723850
Ascl3,7,109727465,109731726,protein_coding,-1,4261,chr7_109727465_109731726
Tmem9b,7,109735834,109752875,protein_coding,-1,17041,chr7_109735834_109752875
Nrip3,7,109758055,109782025,protein_coding,-1,23970,chr7_109758055_109782025
Scube2,7,109798676,109865679,protein_coding,-1,67003,chr7_109798676_109865679
Dennd5a,7,109893780,109960470,protein_coding,-1,66690,chr7_109893780_109960470
Tmem41b,7,109972187,109986929,protein_coding,-1,14742,chr7_109972187_109986929
1600010M07Rik,7,109998376,110151202,antisense,-1,152826,chr7_109998376_110151202
Ipo7,7,110018274,110056609,protein_coding,1,38335,chr7_110018274_110056609
Zfp143,7,110061217,110095394,protein_coding,1,34177,chr7_110061217_110095394
Wee1,7,110122046,110143286,protein_coding,1,21240,chr7_110122046_110143286
Swap70,7,110221711,110283506,protein_coding,1,61795,chr7_110221711_110283506
Sbf2,7,110308013,110614922,protein_coding,-1,306909,chr7_110308013_110614922
Gm28863,7,110626281,110639358,antisense,-1,13077,chr7_110626281_110639358
Adm,7,110627661,110629820,protein_coding,1,2159,chr7_110627661_110629820
Gm21123,7,110690163,110699734,lincRNA,-1,9571,chr7_110690163_110699734
Ampd3,7,110768206,110812405,protein_coding,1,44199,chr7_110768206_110812405
Rnf141,7,110800432,110844457,protein_coding,-1,44025,chr7_110800432_110844457
Lyve1,7,110850607,110863239,protein_coding,-1,12632,chr7_110850607_110863239
Mrvi1,7,110868266,110982461,protein_coding,-1,114195,chr7_110868266_110982461
Ctr9,7,111028951,111056377,protein_coding,1,27426,chr7_111028951_111056377
Eif4g2,7,111067750,111083030,protein_coding,-1,15280,chr7_111067750_111083030
5430402P08Rik,7,111366298,111395608,lincRNA,1,29310,chr7_111366298_111395608
Galnt18,7,111471661,111779977,protein_coding,-1,308316,chr7_111471661_111779977
Usp47,7,112023504,112111661,protein_coding,1,88157,chr7_112023504_112111661
Dkk3,7,112116017,112159057,protein_coding,-1,43040,chr7_112116017_112159057
Mical2,7,112225856,112413106,protein_coding,1,187250,chr7_112225856_112413106
Parva,7,112427505,112591692,protein_coding,1,164187,chr7_112427505_112591692
Parvaos,7,112526972,112535683,antisense,-1,8711,chr7_112526972_112535683
Tead1,7,112679318,112906807,protein_coding,1,227489,chr7_112679318_112906807
Rassf10,7,112953962,112957457,protein_coding,1,3495,chr7_112953962_112957457
Gm33586,7,112983903,113010892,lincRNA,1,26989,chr7_112983903_113010892
4930543E12Rik,7,113100168,113142023,lincRNA,-1,41855,chr7_113100168_113142023
Arntl,7,113207465,113314126,protein_coding,1,106661,chr7_113207465_113314126
Gm45355,7,113292944,113295337,antisense,-1,2393,chr7_113292944_113295337
Btbd10,7,113315626,113369392,protein_coding,-1,53766,chr7_113315626_113369392
Far1,7,113513834,113571511,protein_coding,1,57677,chr7_113513834_113571511
Far1os,7,113530489,113564987,antisense,-1,34498,chr7_113530489_113564987
Gm5600,7,113700890,113708442,lincRNA,-1,7552,chr7_113700890_113708442
Gm29507,7,113729654,113752166,lincRNA,1,22512,chr7_113729654_113752166
Spon1,7,113765998,114043370,protein_coding,1,277372,chr7_113765998_114043370
Rras2,7,114046782,114117781,protein_coding,-1,70999,chr7_114046782_114117781
Gm45615,7,114086898,114088357,antisense,1,1459,chr7_114086898_114088357
Copb1,7,114215559,114254711,protein_coding,-1,39152,chr7_114215559_114254711
Psma1,7,114264606,114276118,protein_coding,-1,11512,chr7_114264606_114276118
4933406I18Rik,7,114315479,114415161,lincRNA,-1,99682,chr7_114315479_114415161
Pde3b,7,114415281,114539251,protein_coding,1,123970,chr7_114415281_114539251
Cyp2r1,7,114549682,114562972,protein_coding,-1,13290,chr7_114549682_114562972
Calca,7,114631478,114636357,protein_coding,-1,4879,chr7_114631478_114636357
Calcb,7,114718643,114723365,protein_coding,1,4722,chr7_114718643_114723365
Insc,7,114743694,114850383,protein_coding,1,106689,chr7_114743694_114850383
A730082K24Rik,7,114948650,114983960,lincRNA,1,35310,chr7_114948650_114983960
Gm34225,7,115031937,115066824,lincRNA,1,34887,chr7_115031937_115066824
Sox6,7,115470872,116038796,protein_coding,-1,567924,chr7_115470872_116038796
Gm45025,7,115995274,116014145,antisense,1,18871,chr7_115995274_116014145
Sox6os,7,116031979,116032550,antisense,1,571,chr7_116031979_116032550
1110004F10Rik,7,116039397,116105210,protein_coding,1,65813,chr7_116039397_116105210
Gm4353,7,116083367,116084558,processed_pseudogene,-1,1191,chr7_116083367_116084558
Plekha7,7,116123485,116308376,protein_coding,-1,184891,chr7_116123485_116308376
Rps13,7,116331505,116334195,protein_coding,-1,2690,chr7_116331505_116334195
Gm44777,7,116334255,116338633,antisense,1,4378,chr7_116334255_116338633
Pik3c2a,7,116337265,116443449,protein_coding,-1,106184,chr7_116337265_116443449
Nucb2,7,116504369,116540584,protein_coding,1,36215,chr7_116504369_116540584
Gm45151,7,116543656,116545755,lincRNA,1,2099,chr7_116543656_116545755
4732496C06Rik,7,116546865,116549364,lincRNA,1,2499,chr7_116546865_116549364
Gm39075,7,117229607,117278839,lincRNA,1,49232,chr7_117229607_117278839
Xylt1,7,117380979,117673580,protein_coding,1,292601,chr7_117380979_117673580
Rps15a,7,118104372,118116188,protein_coding,-1,11816,chr7_118104372_118116188
Arl6ip1,7,118118891,118129662,protein_coding,-1,10771,chr7_118118891_118129662
Smg1,7,118131308,118243670,protein_coding,-1,112362,chr7_118131308_118243670
Gm45155,7,118273292,118275363,lincRNA,-1,2071,chr7_118273292_118275363
Syt17,7,118380717,118448222,protein_coding,-1,67505,chr7_118380717_118448222
Itpripl2,7,118485111,118491975,protein_coding,-1,6864,chr7_118485111_118491975
Coq7,7,118509659,118533356,protein_coding,-1,23697,chr7_118509659_118533356
Tmc7,7,118535841,118584736,protein_coding,-1,48895,chr7_118535841_118584736
B230311B06Rik,7,118592328,118596838,lincRNA,1,4510,chr7_118592328_118596838
Tmc5,7,118597297,118675086,protein_coding,1,77789,chr7_118597297_118675086
Gde1,7,118688545,118705778,protein_coding,-1,17233,chr7_118688545_118705778
Ccp110,7,118712552,118737024,protein_coding,1,24472,chr7_118712552_118737024
Knop1,7,118842222,118856254,protein_coding,-1,14032,chr7_118842222_118856254
Iqck,7,118855752,118972652,protein_coding,1,116900,chr7_118855752_118972652
Gm44763,7,118967668,118969686,antisense,-1,2018,chr7_118967668_118969686
Gprc5b,7,118972047,118995211,protein_coding,-1,23164,chr7_118972047_118995211
Gpr139,7,119140747,119184603,protein_coding,-1,43856,chr7_119140747_119184603
Gp2,7,119442537,119459285,protein_coding,-1,16748,chr7_119442537_119459285
Umod,7,119462711,119479282,protein_coding,-1,16571,chr7_119462711_119479282
Gm44588,7,119462821,119472478,antisense,1,9657,chr7_119462821_119472478
Pdilt,7,119486587,119523489,protein_coding,-1,36902,chr7_119486587_119523489
Acsm5,7,119519463,119545551,protein_coding,1,26088,chr7_119519463_119545551
Acsm2,7,119554340,119600690,protein_coding,1,46350,chr7_119554340_119600690
Gm39078,7,119600840,119604780,lincRNA,-1,3940,chr7_119600840_119604780
Acsm1,7,119607026,119662515,protein_coding,1,55489,chr7_119607026_119662515
Gm19950,7,119607681,119643469,antisense,-1,35788,chr7_119607681_119643469
Acsm4,7,119690026,119714565,protein_coding,1,24539,chr7_119690026_119714565
Thumpd1,7,119715093,119720798,protein_coding,-1,5705,chr7_119715093_119720798
Gm44866,7,119720811,119735760,lincRNA,-1,14949,chr7_119720811_119735760
Acsm3,7,119760923,119787513,protein_coding,1,26590,chr7_119760923_119787513
Eri2,7,119768679,119794058,protein_coding,-1,25379,chr7_119768679_119794058
Rexo5,7,119794006,119848943,protein_coding,1,54937,chr7_119794006_119848943
Dcun1d3,7,119852796,119896298,protein_coding,-1,43502,chr7_119852796_119896298
Lyrm1,7,119895861,119956963,protein_coding,1,61102,chr7_119895861_119956963
Dnah3,7,119922671,120095280,protein_coding,-1,172609,chr7_119922671_120095280
Tmem159,7,120102353,120120992,protein_coding,1,18639,chr7_120102353_120120992
Zp2,7,120126772,120145291,protein_coding,-1,18519,chr7_120126772_120145291
4930505K13Rik,7,120156115,120166000,lincRNA,1,9885,chr7_120156115_120166000
Anks4b,7,120173858,120185586,protein_coding,1,11728,chr7_120173858_120185586
Crym,7,120186380,120202111,protein_coding,-1,15731,chr7_120186380_120202111
Abca14,7,120203961,120325352,protein_coding,1,121391,chr7_120203961_120325352
Abca15,7,120328670,120407687,protein_coding,1,79017,chr7_120328670_120407687
Abca16,7,120409647,120544813,protein_coding,1,135166,chr7_120409647_120544813
Gm32916,7,120593151,120629769,lincRNA,1,36618,chr7_120593151_120629769
Uqcrc2,7,120635176,120659524,protein_coding,1,24348,chr7_120635176_120659524
Pdzd9,7,120658731,120670343,protein_coding,-1,11612,chr7_120658731_120670343
4930588G17Rik,7,120670296,120675902,antisense,1,5606,chr7_120670296_120675902
Mosmo,7,120677618,120734854,protein_coding,1,57236,chr7_120677618_120734854
Vwa3a,7,120739318,120805742,protein_coding,1,66424,chr7_120739318_120805742
Gm5737,7,120812365,120831193,protein_coding,1,18828,chr7_120812365_120831193
Eef2k,7,120842831,120907450,protein_coding,1,64619,chr7_120842831_120907450
Gm15774,7,120865509,120875298,antisense,-1,9789,chr7_120865509_120875298
Polr3e,7,120917744,120947432,protein_coding,1,29688,chr7_120917744_120947432
Cdr2,7,120957036,120982312,protein_coding,-1,25276,chr7_120957036_120982312
Mfsd13b,7,120982509,121014787,protein_coding,1,32278,chr7_120982509_121014787
Mettl9,7,121034445,121078329,protein_coding,1,43884,chr7_121034445_121078329
Igsf6,7,121064067,121074572,protein_coding,-1,10505,chr7_121064067_121074572
Otoa,7,121081650,121163097,protein_coding,1,81447,chr7_121081650_121163097
Gm45079,7,121257359,121295852,lincRNA,1,38493,chr7_121257359_121295852
Gm36736,7,121314810,121393101,antisense,-1,78291,chr7_121314810_121393101
Hs3st2,7,121391859,121501770,protein_coding,1,109911,chr7_121391859_121501770
4933432K03Rik,7,121468844,121609334,antisense,-1,140490,chr7_121468844_121609334
1700025J12Rik,7,121589903,121591591,lincRNA,1,1688,chr7_121589903_121591591
Usp31,7,121642021,121707253,protein_coding,-1,65232,chr7_121642021_121707253
1700069B07Rik,7,121707075,121708013,antisense,1,938,chr7_121707075_121708013
Scnn1g,7,121734479,121768475,protein_coding,1,33996,chr7_121734479_121768475
Scnn1b,7,121865038,121918514,protein_coding,1,53476,chr7_121865038_121918514
Cog7,7,121879363,121981711,protein_coding,-1,102348,chr7_121879363_121981711
Gm44987,7,121981761,121989116,antisense,1,7355,chr7_121981761_121989116
Gga2,7,121986722,122021222,protein_coding,-1,34500,chr7_121986722_122021222
Ears2,7,122037213,122067263,protein_coding,-1,30050,chr7_122037213_122067263
Ubfd1,7,122067175,122082194,protein_coding,1,15019,chr7_122067175_122082194
Ndufab1,7,122085403,122101886,protein_coding,-1,16483,chr7_122085403_122101886
Palb2,7,122107262,122132985,protein_coding,-1,25723,chr7_122107262_122132985
Dctn5,7,122133041,122149044,protein_coding,1,16003,chr7_122133041_122149044
Gm15489,7,122139008,122159401,antisense,-1,20393,chr7_122139008_122159401
Plk1,7,122159439,122169873,protein_coding,1,10434,chr7_122159439_122169873
Ern2,7,122169893,122186207,protein_coding,-1,16314,chr7_122169893_122186207
Prkcb,7,122288751,122634402,protein_coding,1,345651,chr7_122288751_122634402
Cacng3,7,122670492,122769393,protein_coding,1,98901,chr7_122670492_122769393
Rbbp6,7,122965686,123002557,protein_coding,1,36871,chr7_122965686_123002557
Gm45846,7,123031374,123169678,lincRNA,1,138304,chr7_123031374_123169678
Tnrc6a,7,123123885,123195296,protein_coding,1,71411,chr7_123123885_123195296
Slc5a11,7,123214780,123273253,protein_coding,1,58473,chr7_123214780_123273253
Arhgap17,7,123279218,123369915,protein_coding,-1,90697,chr7_123279218_123369915
Lcmt1,7,123369784,123430358,protein_coding,1,60574,chr7_123369784_123430358
Zkscan2,7,123475384,123500449,protein_coding,-1,25065,chr7_123475384_123500449
Gm27040,7,123971046,123983454,antisense,-1,12408,chr7_123971046_123983454
Hs3st4,7,123982869,124398989,protein_coding,1,416120,chr7_123982869_124398989
Gm15339,7,124476541,124494301,lincRNA,-1,17760,chr7_124476541_124494301
3100003L05Rik,7,124625670,124708935,lincRNA,-1,83265,chr7_124625670_124708935
Gm45092,7,124907609,124914418,lincRNA,1,6809,chr7_124907609_124914418
4933440M02Rik,7,125284025,125349788,lincRNA,-1,65763,chr7_125284025_125349788
Kdm8,7,125444676,125462269,protein_coding,1,17593,chr7_125444676_125462269
Nsmce1,7,125467640,125491596,protein_coding,-1,23956,chr7_125467640_125491596
Il4ra,7,125552120,125579474,protein_coding,1,27354,chr7_125552120_125579474
Il21r,7,125603429,125633570,protein_coding,1,30141,chr7_125603429_125633570
Gtf3c1,7,125640954,125707780,protein_coding,-1,66826,chr7_125640954_125707780
D430042O09Rik,7,125707888,125874793,protein_coding,1,166905,chr7_125707888_125874793
Gsg1l,7,125878420,126082411,protein_coding,-1,203991,chr7_125878420_126082411
Xpo6,7,126101715,126200501,protein_coding,-1,98786,chr7_126101715_126200501
1700123J17Rik,7,126224247,126248238,lincRNA,-1,23991,chr7_126224247_126248238
Sbk1,7,126248862,126295016,protein_coding,1,46154,chr7_126248862_126295016
Gm30928,7,126348372,126351619,lincRNA,-1,3247,chr7_126348372_126351619
Lat,7,126363824,126369570,protein_coding,-1,5746,chr7_126363824_126369570
Spns1,7,126370060,126377450,protein_coding,-1,7390,chr7_126370060_126377450
Nfatc2ip,7,126382854,126396737,protein_coding,-1,13883,chr7_126382854_126396737
Rabep2,7,126428759,126449245,protein_coding,1,20486,chr7_126428759_126449245
Atp2a1,7,126445858,126463108,protein_coding,-1,17250,chr7_126445858_126463108
Sh2b1,7,126466994,126475424,protein_coding,-1,8430,chr7_126466994_126475424
Tufm,7,126487361,126490731,protein_coding,1,3370,chr7_126487361_126490731
Atxn2l,7,126491708,126503437,protein_coding,-1,11729,chr7_126491708_126503437
Eif3c,7,126546455,126566411,protein_coding,-1,19956,chr7_126546455_126566411
Cln3,7,126571207,126585817,protein_coding,-1,14610,chr7_126571207_126585817
Apobr,7,126584942,126589112,protein_coding,1,4170,chr7_126584942_126589112
Il27,7,126589010,126594941,protein_coding,-1,5931,chr7_126589010_126594941
Nupr1,7,126623249,126630861,protein_coding,-1,7612,chr7_126623249_126630861
2510046G10Rik,7,126648543,126649594,antisense,-1,1051,chr7_126648543_126649594
Sgf29,7,126649309,126672925,protein_coding,1,23616,chr7_126649309_126672925
Sult1a1,7,126672865,126676432,protein_coding,-1,3567,chr7_126672865_126676432
Slx1b,7,126689468,126695784,protein_coding,-1,6316,chr7_126689468_126695784
Bola2,7,126695401,126699798,protein_coding,1,4397,chr7_126695401_126699798
Coro1a,7,126699773,126707787,protein_coding,-1,8014,chr7_126699773_126707787
Mapk3,7,126759601,126765819,protein_coding,1,6218,chr7_126759601_126765819
Gdpd3,7,126766334,126775649,protein_coding,1,9315,chr7_126766334_126775649
Ypel3,7,126776955,126780514,protein_coding,1,3559,chr7_126776955_126780514
Tbx6,7,126781483,126785560,protein_coding,1,4077,chr7_126781483_126785560
Ppp4c,7,126785866,126792496,protein_coding,-1,6630,chr7_126785866_126792496
Aldoa,7,126795234,126809108,protein_coding,-1,13874,chr7_126795234_126809108
Fam57b,7,126797668,126830219,protein_coding,1,32551,chr7_126797668_126830219
4930451I11Rik,7,126830468,126831639,protein_coding,-1,1171,chr7_126830468_126831639
Gm44854,7,126837212,126846388,lincRNA,1,9176,chr7_126837212_126846388
Doc2a,7,126847416,126852705,protein_coding,1,5289,chr7_126847416_126852705
Ino80e,7,126850960,126862377,protein_coding,-1,11417,chr7_126850960_126862377
Hirip3,7,126861972,126865377,protein_coding,1,3405,chr7_126861972_126865377
Taok2,7,126865678,126884703,protein_coding,-1,19025,chr7_126865678_126884703
Tmem219,7,126886171,126922917,protein_coding,-1,36746,chr7_126886171_126922917
Kctd13,7,126928879,126945631,protein_coding,1,16752,chr7_126928879_126945631
Asphd1,7,126945567,126949582,protein_coding,-1,4015,chr7_126945567_126949582
Sez6l2,7,126950563,126970606,protein_coding,1,20043,chr7_126950563_126970606
Cdiptos,7,126971722,126976098,protein_coding,-1,4376,chr7_126971722_126976098
Cdipt,7,126975914,126980501,protein_coding,1,4587,chr7_126975914_126980501
Mvp,7,126986860,127014621,protein_coding,-1,27761,chr7_126986860_127014621
Pagr1b,7,127001480,127016484,protein_coding,-1,15004,chr7_127001480_127016484
Gm42742,7,127015051,127021097,protein_coding,-1,6046,chr7_127015051_127021097
Prrt2,7,127017531,127021211,protein_coding,-1,3680,chr7_127017531_127021211
Maz,7,127022130,127027037,protein_coding,-1,4907,chr7_127022130_127027037
Kif22,7,127027729,127042471,protein_coding,-1,14742,chr7_127027729_127042471
Gm31749,7,127031468,127035291,antisense,1,3823,chr7_127031468_127035291
Zg16,7,127050156,127087328,protein_coding,-1,37172,chr7_127050156_127087328
Gm44939,7,127068456,127071039,lincRNA,1,2583,chr7_127068456_127071039
AI467606,7,127091359,127093986,protein_coding,1,2627,chr7_127091359_127093986
Qprt,7,127107114,127122226,protein_coding,-1,15112,chr7_127107114_127122226
Spn,7,127132232,127137823,protein_coding,-1,5591,chr7_127132232_127137823
Cd2bp2,7,127191660,127196050,protein_coding,-1,4390,chr7_127191660_127196050
Tbc1d10b,7,127197459,127208468,protein_coding,-1,11009,chr7_127197459_127208468
Mylpf,7,127208890,127214298,protein_coding,1,5408,chr7_127208890_127214298
Zfp553,7,127233061,127238179,protein_coding,1,5118,chr7_127233061_127238179
Zfp771,7,127244274,127254803,protein_coding,1,10529,chr7_127244274_127254803
Dctpp1,7,127256959,127260709,protein_coding,-1,3750,chr7_127256959_127260709
Sephs2,7,127271879,127274055,protein_coding,-1,2176,chr7_127271879_127274055
Gm31897,7,127287729,127290619,lincRNA,1,2890,chr7_127287729_127290619
Itgal,7,127296260,127335138,protein_coding,1,38878,chr7_127296260_127335138
Zfp768,7,127342795,127345589,protein_coding,-1,2794,chr7_127342795_127345589
Zfp747,7,127372537,127376050,protein_coding,-1,3513,chr7_127372537_127376050
9130019O22Rik,7,127382260,127387166,protein_coding,-1,4906,chr7_127382260_127387166
E430018J23Rik,7,127389673,127393629,protein_coding,-1,3956,chr7_127389673_127393629
Zfp764,7,127403668,127406822,protein_coding,-1,3154,chr7_127403668_127406822
Zfp688,7,127418967,127422068,protein_coding,-1,3101,chr7_127418967_127422068
Gm45184,7,127434422,127439392,lincRNA,1,4970,chr7_127434422_127439392
Zfp689,7,127442136,127449158,protein_coding,-1,7022,chr7_127442136_127449158
Prr14,7,127459611,127476759,protein_coding,1,17148,chr7_127459611_127476759
Fbrs,7,127479199,127491711,protein_coding,1,12512,chr7_127479199_127491711
1700008J07Rik,7,127510438,127512869,antisense,-1,2431,chr7_127510438_127512869
Srcap,7,127511983,127561219,protein_coding,1,49236,chr7_127511983_127561219
Gm42715,7,127519584,127567054,protein_coding,1,47470,chr7_127519584_127567054
Gm28198,7,127559142,127573116,antisense,-1,13974,chr7_127559142_127573116
Phkg2,7,127573340,127583307,protein_coding,1,9967,chr7_127573340_127583307
Ccdc189,7,127582383,127588595,protein_coding,-1,6212,chr7_127582383_127588595
Rnf40,7,127588767,127604799,protein_coding,1,16032,chr7_127588767_127604799
Gm44759,7,127590416,127595900,antisense,-1,5484,chr7_127590416_127595900
Zfp629,7,127607031,127615797,protein_coding,-1,8766,chr7_127607031_127615797
Bcl7c,7,127661456,127708933,protein_coding,-1,47477,chr7_127661456_127708933
Gm39090,7,127691935,127700793,lincRNA,1,8858,chr7_127691935_127700793
Ctf1,7,127712736,127718192,protein_coding,1,5456,chr7_127712736_127718192
Ctf2,7,127718106,127732166,protein_coding,-1,14060,chr7_127718106_127732166
Fbxl19,7,127744543,127769483,protein_coding,1,24940,chr7_127744543_127769483
Orai3,7,127769815,127775150,protein_coding,1,5335,chr7_127769815_127775150
Setd1a,7,127776670,127800122,protein_coding,1,23452,chr7_127776670_127800122
Gm49388,7,127785608,127803802,protein_coding,1,18194,chr7_127785608_127803802
Stx1b,7,127803900,127824549,protein_coding,-1,20649,chr7_127803900_127824549
Stx4a,7,127824294,127849019,protein_coding,1,24725,chr7_127824294_127849019
Zfp668,7,127863047,127876828,protein_coding,-1,13781,chr7_127863047_127876828
Zfp646,7,127876221,127885996,protein_coding,1,9775,chr7_127876221_127885996
Prss53,7,127885841,127890970,protein_coding,-1,5129,chr7_127885841_127890970
Gm21974,7,127886227,127895454,protein_coding,-1,9227,chr7_127886227_127895454
Vkorc1,7,127893063,127895617,protein_coding,-1,2554,chr7_127893063_127895617
Bckdk,7,127904082,127910221,protein_coding,1,6139,chr7_127904082_127910221
Kat8,7,127912516,127925837,protein_coding,1,13321,chr7_127912516_127925837
Prss8,7,127925716,127930104,protein_coding,-1,4388,chr7_127925716_127930104
Prss36,7,127932638,127946725,protein_coding,-1,14087,chr7_127932638_127946725
Fus,7,127967457,127985701,protein_coding,1,18244,chr7_127967457_127985701
Pycard,7,127989708,127993867,protein_coding,-1,4159,chr7_127989708_127993867
Gm15533,7,128001899,128005190,antisense,-1,3291,chr7_128001899_128005190
Trim72,7,128003949,128011033,protein_coding,1,7084,chr7_128003949_128011033
Gm49368,7,128062683,128128160,protein_coding,1,65477,chr7_128062683_128128160
Itgax,7,128129547,128150657,protein_coding,1,21110,chr7_128129547_128150657
Itgad,7,128154376,128223816,protein_coding,1,69440,chr7_128154376_128223816
Cox6a2,7,128205435,128206387,protein_coding,-1,952,chr7_128205435_128206387
Gm44850,7,128215616,128220788,antisense,-1,5172,chr7_128215616_128220788
9130023H24Rik,7,128234458,128238031,protein_coding,-1,3573,chr7_128234458_128238031
Armc5,7,128237342,128245100,protein_coding,1,7758,chr7_128237342_128245100
Tgfb1i1,7,128246812,128255699,protein_coding,1,8887,chr7_128246812_128255699
Slc5a2,7,128265657,128272430,protein_coding,1,6773,chr7_128265657_128272430
BC017158,7,128271379,128298170,protein_coding,-1,26791,chr7_128271379_128298170
Rgs10,7,128373621,128418758,protein_coding,-1,45137,chr7_128373621_128418758
Tial1,7,128439777,128461717,protein_coding,-1,21940,chr7_128439777_128461717
Gm40457,7,128487945,128500187,lincRNA,-1,12242,chr7_128487945_128500187
Bag3,7,128523616,128546981,protein_coding,1,23365,chr7_128523616_128546981
Gm45121,7,128590926,128593343,lincRNA,-1,2417,chr7_128590926_128593343
Inpp5f,7,128611328,128696425,protein_coding,1,85097,chr7_128611328_128696425
Mcmbp,7,128696441,128740495,protein_coding,-1,44054,chr7_128696441_128740495
Gm44674,7,128728394,128729522,antisense,1,1128,chr7_128728394_128729522
Gm44672,7,128744179,128745276,antisense,-1,1097,chr7_128744179_128745276
Sec23ip,7,128744943,128784836,protein_coding,1,39893,chr7_128744943_128784836
Gm32884,7,128795194,128928013,lincRNA,1,132819,chr7_128795194_128928013
Plpp4,7,129257031,129391412,protein_coding,1,134381,chr7_129257031_129391412
Gm33027,7,129398102,129403090,lincRNA,-1,4988,chr7_129398102_129403090
Wdr11,7,129591863,129635738,protein_coding,1,43875,chr7_129591863_129635738
Gm39094,7,129658928,129731647,lincRNA,1,72719,chr7_129658928_129731647
Gm44778,7,129833046,129853779,lincRNA,1,20733,chr7_129833046_129853779
Gm4265,7,129962165,129978669,lincRNA,1,16504,chr7_129962165_129978669
Fgfr2,7,130162451,133123350,protein_coding,-1,2960899,chr7_130162451_133123350
Gm44647,7,130520845,130521272,lincRNA,1,427,chr7_130520845_130521272
Tacc2,7,130577438,130764785,protein_coding,1,187347,chr7_130577438_130764785
Btbd16,7,130774069,130825899,protein_coding,1,51830,chr7_130774069_130825899
Plekha1,7,130865756,130913312,protein_coding,1,47556,chr7_130865756_130913312
Htra1,7,130936111,130985660,protein_coding,1,49549,chr7_130936111_130985660
Dmbt1,7,131032046,131121628,protein_coding,1,89582,chr7_131032046_131121628
Fam24a,7,131333864,131336927,protein_coding,1,3063,chr7_131333864_131336927
Pstk,7,131371141,131394482,protein_coding,1,23341,chr7_131371141_131394482
Acadsb,7,131410601,131448944,protein_coding,1,38343,chr7_131410601_131448944
Bub3,7,131560222,131571895,protein_coding,1,11673,chr7_131560222_131571895
Gm44546,7,131824013,131883856,lincRNA,1,59843,chr7_131824013_131883856
Gpr26,7,131966460,131994405,protein_coding,1,27945,chr7_131966460_131994405
Gm15677,7,132154171,132155301,antisense,1,1130,chr7_132154171_132155301
Gm10584,7,132315664,132318291,antisense,1,2627,chr7_132315664_132318291
Gm44893,7,132420030,132423713,lincRNA,1,3683,chr7_132420030_132423713
Lhpp,7,132610638,132706420,protein_coding,1,95782,chr7_132610638_132706420
Abraxas2,7,132859225,132885111,protein_coding,1,25886,chr7_132859225_132885111
Gm45502,7,132911089,132919732,lincRNA,1,8643,chr7_132911089_132919732
Zranb1,7,132931142,132986391,protein_coding,1,55249,chr7_132931142_132986391
Ctbp2,7,132987563,133124354,protein_coding,-1,136791,chr7_132987563_133124354
4930483O08Rik,7,133128251,133142457,lincRNA,1,14206,chr7_133128251_133142457
Gm45672,7,133319985,133333201,lincRNA,-1,13216,chr7_133319985_133333201
Tex36,7,133587024,133602158,protein_coding,-1,15134,chr7_133587024_133602158
Gm45671,7,133608226,133616265,lincRNA,1,8039,chr7_133608226_133616265
Edrf1,7,133637543,133672971,protein_coding,1,35428,chr7_133637543_133672971
Mmp21,7,133674270,133680061,protein_coding,-1,5791,chr7_133674270_133680061
Uros,7,133686243,133710072,protein_coding,-1,23829,chr7_133686243_133710072
Bccip,7,133709333,133721145,protein_coding,1,11812,chr7_133709333_133721145
Dhx32,7,133720942,133782726,protein_coding,-1,61784,chr7_133720942_133782726
Gm45670,7,133747624,133753038,antisense,1,5414,chr7_133747624_133753038
Fank1,7,133776861,133881532,protein_coding,1,104671,chr7_133776861_133881532
Adam12,7,133883199,134232146,protein_coding,-1,348947,chr7_133883199_134232146
D7Ertd443e,7,134265779,134501160,protein_coding,-1,235381,chr7_134265779_134501160
Dock1,7,134670654,135173639,protein_coding,1,502985,chr7_134670654_135173639
1700120G07Rik,7,135191764,135196002,lincRNA,-1,4238,chr7_135191764_135196002
Nps,7,135258703,135272942,protein_coding,1,14239,chr7_135258703_135272942
Gm45339,7,135274658,135277146,lincRNA,-1,2488,chr7_135274658_135277146
Gm36356,7,135486029,135491315,lincRNA,1,5286,chr7_135486029_135491315
Clrn3,7,135511466,135528654,protein_coding,-1,17188,chr7_135511466_135528654
Ptpre,7,135537481,135686293,protein_coding,1,148812,chr7_135537481_135686293
5830432E09Rik,7,135635931,135652314,antisense,-1,16383,chr7_135635931_135652314
Mki67,7,135689784,135716361,protein_coding,-1,26577,chr7_135689784_135716361
Gm36431,7,135742676,135833187,lincRNA,1,90511,chr7_135742676_135833187
C030029H02Rik,7,136268324,136318513,lincRNA,1,50189,chr7_136268324_136318513
Gm36849,7,136353364,136356270,lincRNA,1,2906,chr7_136353364_136356270
Gm6249,7,136667955,136710604,lincRNA,-1,42649,chr7_136667955_136710604
Mgmt,7,136894614,137130266,protein_coding,1,235652,chr7_136894614_137130266
Ebf3,7,137193673,137314445,protein_coding,-1,120772,chr7_137193673_137314445
9430038I01Rik,7,137375574,137410762,protein_coding,-1,35188,chr7_137375574_137410762
Glrx3,7,137437614,137468594,protein_coding,1,30980,chr7_137437614_137468594
Gm45397,7,137557112,137564588,lincRNA,-1,7476,chr7_137557112_137564588
Gm45682,7,137734266,137737959,lincRNA,1,3693,chr7_137734266_137737959
Tcerg1l,7,138208974,138397730,protein_coding,-1,188756,chr7_138208974_138397730
Gm45686,7,138413614,138421765,lincRNA,1,8151,chr7_138413614_138421765
4930543N07Rik,7,138554230,138567709,lincRNA,1,13479,chr7_138554230_138567709
Mapk1ip1,7,138835823,138846273,protein_coding,-1,10450,chr7_138835823_138846273
Ppp2r2d,7,138846079,138883057,protein_coding,1,36978,chr7_138846079_138883057
Bnip3,7,138890836,138909519,protein_coding,-1,18683,chr7_138890836_138909519
Gm45507,7,138890964,138894675,antisense,1,3711,chr7_138890964_138894675
Jakmip3,7,138940730,139083977,protein_coding,1,143247,chr7_138940730_139083977
Gm45613,CHR_MG3251_PATCH,139019160,139020999,antisense;lncRNA,-1,1839,chrCHR_MG3251_PATCH_139019160_139020999
Dpysl4,7,139064188,139102704,protein_coding,1,38516,chr7_139064188_139102704
Stk32c,7,139081825,139213307,protein_coding,-1,131482,chr7_139081825_139213307
Lrrc27,7,139191175,139242979,protein_coding,1,51804,chr7_139191175_139242979
Pwwp2b,7,139226669,139269903,protein_coding,1,43234,chr7_139226669_139269903
Inpp5a,7,139389109,139579652,protein_coding,1,190543,chr7_139389109_139579652
Nkx6-2,7,139579376,139582797,protein_coding,-1,3421,chr7_139579376_139582797
Cfap46,7,139600951,139683817,protein_coding,-1,82866,chr7_139600951_139683817
Adgra1,7,139834174,139878088,protein_coding,1,43914,chr7_139834174_139878088
Kndc1,7,139894696,139941537,protein_coding,1,46841,chr7_139894696_139941537
Utf1,7,139943789,139945112,protein_coding,1,1323,chr7_139943789_139945112
Gm2044,7,139957005,139958039,lincRNA,-1,1034,chr7_139957005_139958039
Adam8,7,139978932,139992562,protein_coding,-1,13630,chr7_139978932_139992562
Tubgcp2,7,139995955,140036669,protein_coding,-1,40714,chr7_139995955_140036669
Zfp511,7,140036391,140040602,protein_coding,1,4211,chr7_140036391_140040602
Msx3,7,140046157,140049089,protein_coding,-1,2932,chr7_140046157_140049089
Caly,7,140069880,140082548,protein_coding,-1,12668,chr7_140069880_140082548
Prap1,7,140093395,140097200,protein_coding,1,3805,chr7_140093395_140097200
Fuom,7,140096770,140102441,protein_coding,-1,5671,chr7_140096770_140102441
Echs1,7,140105710,140116476,protein_coding,-1,10766,chr7_140105710_140116476
Paox,7,140115799,140137224,protein_coding,1,21425,chr7_140115799_140137224
Mtg1,7,140137564,140150786,protein_coding,1,13222,chr7_140137564_140150786
Sprn,7,140150628,140154877,protein_coding,-1,4249,chr7_140150628_140154877
Olfr523,7,140173217,140178758,protein_coding,1,5541,chr7_140173217_140178758
Olfr524,7,140198499,140205964,protein_coding,-1,7465,chr7_140198499_140205964
Cd163l1,7,140218267,140231145,protein_coding,1,12878,chr7_140218267_140231145
5830411N06Rik,7,140247284,140300736,protein_coding,1,53452,chr7_140247284_140300736
Olfr525,7,140320858,140327625,protein_coding,1,6767,chr7_140320858_140327625
Olfr60,7,140343815,140361671,protein_coding,-1,17856,chr7_140343815_140361671
Olfr532,7,140415710,140421639,protein_coding,-1,5929,chr7_140415710_140421639
Olfr533,7,140463370,140468128,protein_coding,1,4758,chr7_140463370_140468128
Olfr535,7,140484216,140497104,protein_coding,1,12888,chr7_140484216_140497104
Olfr536,7,140500849,140507396,protein_coding,-1,6547,chr7_140500849_140507396
Olfr538,7,140567886,140575793,protein_coding,1,7907,chr7_140567886_140575793
Olfr46,7,140601269,140617678,protein_coding,1,16409,chr7_140601269_140617678
Olfr61,7,140628970,140638798,protein_coding,1,9828,chr7_140628970_140638798
Olfr53,7,140646452,140653085,protein_coding,1,6633,chr7_140646452_140653085
Olfr539,7,140659930,140678580,protein_coding,1,18650,chr7_140659930_140678580
Olfr45,7,140681951,140696845,protein_coding,1,14894,chr7_140681951_140696845
Olfr541,7,140697267,140705606,protein_coding,1,8339,chr7_140697267_140705606
Cyp2e1,7,140763739,140774987,protein_coding,1,11248,chr7_140763739_140774987
Syce1,7,140777229,140787852,protein_coding,-1,10623,chr7_140777229_140787852
Zfp941,7,140807449,140822178,protein_coding,-1,14729,chr7_140807449_140822178
Gm45785,7,140818087,140856331,protein_coding,-1,38244,chr7_140818087_140856331
Urah,7,140835018,140837966,protein_coding,1,2948,chr7_140835018_140837966
Scgb1c1,7,140845547,140846769,protein_coding,1,1222,chr7_140845547_140846769
Odf3,7,140847805,140851018,protein_coding,1,3213,chr7_140847805_140851018
Bet1l,7,140853394,140857577,protein_coding,-1,4183,chr7_140853394_140857577
Ric8a,7,140856957,140864372,protein_coding,1,7415,chr7_140856957_140864372
Sirt3,7,140863666,140882309,protein_coding,-1,18643,chr7_140863666_140882309
Psmd13,7,140881968,140898643,protein_coding,1,16675,chr7_140881968_140898643
Cox8b,7,140898945,140900446,protein_coding,-1,1501,chr7_140898945_140900446
Nlrp6,7,140920902,140929192,protein_coding,1,8290,chr7_140920902_140929192
Pgghg,7,140941391,140947664,protein_coding,1,6273,chr7_140941391_140947664
Ifitm5,7,140948958,140950291,protein_coding,-1,1333,chr7_140948958_140950291
Gm45717,7,140949222,140955937,protein_coding,-1,6715,chr7_140949222_140955937
Ifitm1,7,140967221,140969825,protein_coding,1,2604,chr7_140967221_140969825
Ifitm3,7,141009586,141010770,protein_coding,-1,1184,chr7_141009586_141010770
Ifitm6,7,141015699,141017924,protein_coding,-1,2225,chr7_141015699_141017924
Gm17387,7,141029131,141029620,protein_coding,1,489,chr7_141029131_141029620
B4galnt4,7,141061104,141072400,protein_coding,1,11296,chr7_141061104_141072400
Pkp3,7,141078218,141090510,protein_coding,1,12292,chr7_141078218_141090510
Sigirr,7,141091175,141100572,protein_coding,-1,9397,chr7_141091175_141100572
Ano9,7,141101212,141117806,protein_coding,-1,16594,chr7_141101212_141117806
Ptdss2,7,141122382,141157606,protein_coding,1,35224,chr7_141122382_141157606
Rnh1,7,141160326,141172857,protein_coding,-1,12531,chr7_141160326_141172857
Hras,7,141189105,141194005,protein_coding,-1,4900,chr7_141189105_141194005
Lrrc56,7,141194157,141210055,protein_coding,1,15898,chr7_141194157_141210055
Lmntd2,7,141209992,141214080,protein_coding,-1,4088,chr7_141209992_141214080
Rassf7,7,141215860,141218658,protein_coding,1,2798,chr7_141215860_141218658
Phrf1,7,141228784,141262750,protein_coding,1,33966,chr7_141228784_141262750
Irf7,7,141262706,141266481,protein_coding,-1,3775,chr7_141262706_141266481
Cdhr5,7,141269083,141276786,protein_coding,-1,7703,chr7_141269083_141276786
Sct,7,141278330,141279133,protein_coding,-1,803,chr7_141278330_141279133
Drd4,7,141292006,141296464,protein_coding,1,4458,chr7_141292006_141296464
Deaf1,7,141297180,141327690,protein_coding,-1,30510,chr7_141297180_141327690
Tmem80,7,141327739,141337156,protein_coding,1,9417,chr7_141327739_141337156
Eps8l2,7,141338880,141363020,protein_coding,1,24140,chr7_141338880_141363020
Taldo1,7,141392199,141402968,protein_coding,1,10769,chr7_141392199_141402968
Gatd1,7,141407794,141414136,protein_coding,-1,6342,chr7_141407794_141414136
Cend1,7,141426446,141429491,protein_coding,-1,3045,chr7_141426446_141429491
Slc25a22,7,141429744,141437892,protein_coding,-1,8148,chr7_141429744_141437892
Pidd1,7,141438113,141444025,protein_coding,-1,5912,chr7_141438113_141444025
Rplp2,7,141447370,141451585,protein_coding,1,4215,chr7_141447370_141451585
Pnpla2,7,141455198,141460743,protein_coding,1,5545,chr7_141455198_141460743
Cracr2b,7,141461094,141466613,protein_coding,1,5519,chr7_141461094_141466613
Cd151,7,141467392,141471473,protein_coding,1,4081,chr7_141467392_141471473
Polr2l,7,141471860,141475132,protein_coding,-1,3272,chr7_141471860_141475132
Tspan4,7,141475240,141493427,protein_coding,1,18187,chr7_141475240_141493427
Chid1,7,141493136,141539857,protein_coding,-1,46721,chr7_141493136_141539857
Ap2a2,7,141562173,141633011,protein_coding,1,70838,chr7_141562173_141633011
Gm16982,7,141610066,141613747,antisense,-1,3681,chr7_141610066_141613747
Muc6,7,141633456,141655319,protein_coding,-1,21863,chr7_141633456_141655319
Muc2,7,141690340,141754693,protein_coding,1,64353,chr7_141690340_141754693
Muc5b,7,141839070,141873084,protein_coding,1,34014,chr7_141839070_141873084
Tollip,7,141874813,141918507,protein_coding,-1,43694,chr7_141874813_141918507
Brsk2,7,141949751,142004247,protein_coding,1,54496,chr7_141949751_142004247
Mob2,7,142008535,142061065,protein_coding,-1,52530,chr7_142008535_142061065
Dusp8,7,142079490,142095843,protein_coding,-1,16353,chr7_142079490_142095843
Gm45618,7,142120070,142120729,protein_coding,-1,659,chr7_142120070_142120729
Krtap5-3,7,142201364,142203015,protein_coding,1,1651,chr7_142201364_142203015
Gm45889,7,142283210,142290418,lincRNA,1,7208,chr7_142283210_142290418
Ifitm10,7,142325837,142373753,protein_coding,-1,47916,chr7_142325837_142373753
Gm49369,7,142371096,142382667,protein_coding,-1,11571,chr7_142371096_142382667
Ctsd,7,142375911,142388038,protein_coding,-1,12127,chr7_142375911_142388038
Syt8,7,142434850,142440396,protein_coding,1,5546,chr7_142434850_142440396
Lsp1,7,142460809,142494867,protein_coding,1,34058,chr7_142460809_142494867
Prr33,7,142491074,142506771,protein_coding,-1,15697,chr7_142491074_142506771
Tnnt3,7,142498836,142516009,protein_coding,1,17173,chr7_142498836_142516009
Mrpl23,7,142532686,142540747,protein_coding,1,8061,chr7_142532686_142540747
H19,7,142575529,142578143,lincRNA,-1,2614,chr7_142575529_142578143
Gm33148,7,142591744,142620804,lincRNA,1,29060,chr7_142591744_142620804
Ins2,7,142678656,142743381,protein_coding,-1,64725,chr7_142678656_142743381
Gm6471,7,142815252,142852266,lincRNA,1,37014,chr7_142815252_142852266
Gm39117,7,142837271,142857582,lincRNA,-1,20311,chr7_142837271_142857582
Th,7,142892752,142931128,protein_coding,-1,38376,chr7_142892752_142931128
Ascl2,7,142966829,142969264,protein_coding,-1,2435,chr7_142966829_142969264
Tspan32os,7,142988969,143008033,antisense,-1,19064,chr7_142988969_143008033
Tspan32,7,143005046,143019644,protein_coding,1,14598,chr7_143005046_143019644
Cd81,7,143052739,143067934,protein_coding,1,15195,chr7_143052739_143067934
Trpm5,7,143069153,143094642,protein_coding,-1,25489,chr7_143069153_143094642
Tssc4,7,143069249,143071093,protein_coding,1,1844,chr7_143069249_143071093
Kcnq1,7,143106362,143427042,protein_coding,1,320680,chr7_143106362_143427042
Kcnq1ot1,7,143203458,143296549,antisense,-1,93091,chr7_143203458_143296549
4933417O13Rik,7,143322773,143364625,antisense,-1,41852,chr7_143322773_143364625
Cdkn1c,7,143458339,143461050,protein_coding,-1,2711,chr7_143458339_143461050
Slc22a18,7,143473736,143499334,protein_coding,1,25598,chr7_143473736_143499334
Phlda2,7,143501545,143503150,protein_coding,-1,1605,chr7_143501545_143503150
Nap1l4,7,143513579,143549106,protein_coding,-1,35527,chr7_143513579_143549106
Cars,7,143557230,143600090,protein_coding,-1,42860,chr7_143557230_143600090
Gm15579,7,143600134,143601299,antisense,1,1165,chr7_143600134_143601299
Tnfrsf26,7,143607659,143628722,protein_coding,-1,21063,chr7_143607659_143628722
E230032D23Rik,7,143628024,143670614,antisense,1,42590,chr7_143628024_143670614
Tnfrsf22,7,143634806,143649661,protein_coding,-1,14855,chr7_143634806_143649661
Tnfrsf23,7,143665809,143685872,protein_coding,-1,20063,chr7_143665809_143685872
Osbpl5,7,143688762,143756985,protein_coding,-1,68223,chr7_143688762_143756985
Mrgpre,7,143778363,143784500,protein_coding,-1,6137,chr7_143778363_143784500
Nadsyn1,7,143795584,143822849,protein_coding,-1,27265,chr7_143795584_143822849
Dhcr7,7,143823145,143848410,protein_coding,1,25265,chr7_143823145_143848410
Shank2,7,144001928,144424494,protein_coding,1,422566,chr7_144001928_144424494
Gm14372,7,144368048,144406933,antisense,-1,38885,chr7_144368048_144406933
Cttn,7,144435733,144471009,protein_coding,-1,35276,chr7_144435733_144471009
Ppfia1,7,144476758,144553729,protein_coding,-1,76971,chr7_144476758_144553729
Faddos,7,144567355,144581512,antisense,1,14157,chr7_144567355_144581512
Fadd,7,144577318,144582463,protein_coding,-1,5145,chr7_144577318_144582463
Ano1,7,144588549,144751974,protein_coding,-1,163425,chr7_144588549_144751974
Gm44929,7,144764763,144770571,lincRNA,1,5808,chr7_144764763_144770571
Gm34964,7,144787041,144791808,lincRNA,-1,4767,chr7_144787041_144791808
Fgf3,7,144838083,144844436,protein_coding,1,6353,chr7_144838083_144844436
Fgf4,7,144847367,144865243,protein_coding,1,17876,chr7_144847367_144865243
Gm26793,7,144894560,144897461,antisense,-1,2901,chr7_144894560_144897461
Gm39119,7,144899313,144910085,antisense,-1,10772,chr7_144899313_144910085
Bc1,7,144914470,144914637,lincRNA,1,167,chr7_144914470_144914637
Ccnd1,7,144929931,144939925,protein_coding,-1,9994,chr7_144929931_144939925
Gm45181,7,145162996,145166957,lincRNA,1,3961,chr7_145162996_145166957
Tpcn2,7,145186524,145284011,protein_coding,-1,97487,chr7_145186524_145284011
Mrgprf,7,145300828,145309557,protein_coding,1,8729,chr7_145300828_145309557
Mrgprd,7,145314835,145324086,protein_coding,1,9251,chr7_145314835_145324086
B020014A21Rik,10,3125091,3133193,lincRNA,-1,8102,chr10_3125091_3133193
H60c,10,3256208,3267771,protein_coding,-1,11563,chr10_3256208_3267771
Ppp1r14c,10,3366057,3464975,protein_coding,1,98918,chr10_3366057_3464975
Iyd,10,3540240,3554877,protein_coding,1,14637,chr10_3540240_3554877
Plekhg1,10,3740364,3967303,protein_coding,1,226939,chr10_3740364_3967303
Mthfd1l,10,3973118,4167081,protein_coding,1,193963,chr10_3973118_4167081
Gm30570,10,4206426,4213114,lincRNA,-1,6688,chr10_4206426_4213114
Akap12,10,4266380,4359470,protein_coding,1,93090,chr10_4266380_4359470
Zbtb2,10,4367075,4388108,protein_coding,-1,21033,chr10_4367075_4388108
Gm21781,10,4391587,4396424,lincRNA,1,4837,chr10_4391587_4396424
Rmnd1,10,4401915,4432388,protein_coding,-1,30473,chr10_4401915_4432388
Armt1,10,4432467,4455141,protein_coding,1,22674,chr10_4432467_4455141
Ccdc170,10,4482502,4562231,protein_coding,1,79729,chr10_4482502_4562231
Esr1,10,4611593,5005614,protein_coding,1,394021,chr10_4611593_5005614
Syne1,10,5020917,5551482,protein_coding,-1,530565,chr10_5020917_5551482
Gm10097,10,5069192,5071975,antisense,1,2783,chr10_5069192_5071975
Myct1,10,5593775,5606904,protein_coding,1,13129,chr10_5593775_5606904
Vip,10,5639218,5647617,protein_coding,1,8399,chr10_5639218_5647617
Fbxo5,10,5799160,5805600,protein_coding,-1,6440,chr10_5799160_5805600
Mtrf1l,10,5811887,5823910,protein_coding,-1,12023,chr10_5811887_5823910
Rgs17,10,5825663,5922400,protein_coding,-1,96737,chr10_5825663_5922400
Gm10945,10,6740629,6761761,protein_coding,-1,21132,chr10_6740629_6761761
Oprm1,10,6758506,7038198,protein_coding,1,279692,chr10_6758506_7038198
Ipcef1,10,6885796,7052478,protein_coding,-1,166682,chr10_6885796_7052478
Cnksr3,10,7119063,7212237,protein_coding,-1,93174,chr10_7119063_7212237
Ulbp1,10,7440362,7473638,protein_coding,-1,33276,chr10_7440362_7473638
Lrp11,10,7515564,7625483,protein_coding,1,109919,chr10_7515564_7625483
Pcmt1,10,7555137,7681136,protein_coding,-1,125999,chr10_7555137_7681136
Nup43,10,7593267,7678881,protein_coding,1,85614,chr10_7593267_7678881
Lats1,10,7606978,7716460,protein_coding,1,109482,chr10_7606978_7716460
Katna1,10,7651764,7763150,protein_coding,1,111386,chr10_7651764_7763150
Ginm1,10,7693711,7792824,protein_coding,-1,99113,chr10_7693711_7792824
B430219N15Rik,10,7780185,7781357,antisense,1,1172,chr10_7780185_7781357
Ppil4,10,7792891,7823135,protein_coding,1,30244,chr10_7792891_7823135
Zc3h12d,10,7832470,7870396,protein_coding,1,37926,chr10_7832470_7870396
Tab2,10,7905653,7956230,protein_coding,-1,50577,chr10_7905653_7956230
Gm48614,10,8001943,8021292,lincRNA,-1,19349,chr10_8001943_8021292
Gm30906,10,8176131,8193340,lincRNA,1,17209,chr10_8176131_8193340
Ust,10,8204756,8518825,protein_coding,-1,314069,chr10_8204756_8518825
Gm48654,10,8713241,8717073,lincRNA,1,3832,chr10_8713241_8717073
Sash1,10,8722219,8886070,protein_coding,-1,163851,chr10_8722219_8886070
Gm26674,10,8884637,8886878,antisense,1,2241,chr10_8884637_8886878
Gm48727,10,8903981,8945137,lincRNA,1,41156,chr10_8903981_8945137
Gm48728,10,8951949,8967244,lincRNA,1,15295,chr10_8951949_8967244
Gm48748,10,9329851,9336618,lincRNA,-1,6767,chr10_9329851_9336618
Gm48749,10,9336682,9395259,lincRNA,1,58577,chr10_9336682_9395259
Gm48757,10,9566376,9567605,lincRNA,1,1229,chr10_9566376_9567605
Gm48759,10,9596472,9599423,lincRNA,1,2951,chr10_9596472_9599423
Samd5,10,9622936,9675208,protein_coding,-1,52272,chr10_9622936_9675208
Stxbp5,10,9755547,9901079,protein_coding,-1,145532,chr10_9755547_9901079
Gm46210,10,9901313,9918843,lincRNA,1,17530,chr10_9901313_9918843
Gm28905,10,9976627,10207981,lincRNA,1,231354,chr10_9976627_10207981
Gm48281,10,10100420,10110099,lincRNA,-1,9679,chr10_10100420_10110099
Gm31904,10,10230736,10234850,lincRNA,-1,4114,chr10_10230736_10234850
Gm48324,10,10270402,10296929,lincRNA,-1,26527,chr10_10270402_10296929
Adgb,10,10335703,10472326,protein_coding,-1,136623,chr10_10335703_10472326
Rab32,10,10545002,10558265,protein_coding,-1,13263,chr10_10545002_10558265
Grm1,10,10686059,11082356,protein_coding,-1,396297,chr10_10686059_11082356
4930567K20Rik,10,10748930,10778370,antisense,1,29440,chr10_10748930_10778370
Shprh,10,11149427,11217595,protein_coding,1,68168,chr10_11149427_11217595
Gm16577,10,11212280,11212979,antisense,-1,699,chr10_11212280_11212979
Fbxo30,10,11281330,11298052,protein_coding,1,16722,chr10_11281330_11298052
Epm2a,10,11343404,11459644,protein_coding,1,116240,chr10_11343404_11459644
Gm48680,10,11580086,11587244,lincRNA,1,7158,chr10_11580086_11587244
Gm48697,10,11824413,11841931,lincRNA,-1,17518,chr10_11824413_11841931
Gm48721,10,12002790,12009771,lincRNA,-1,6981,chr10_12002790_12009771
Gm48722,10,12020860,12031440,lincRNA,-1,10580,chr10_12020860_12031440
Gm48723,10,12323421,12324661,lincRNA,-1,1240,chr10_12323421_12324661
Gm48724,10,12324822,12329224,lincRNA,-1,4402,chr10_12324822_12329224
Utrn,10,12382188,12869365,protein_coding,-1,487177,chr10_12382188_12869365
B230208H11Rik,10,12916648,12923090,lincRNA,-1,6442,chr10_12916648_12923090
Stx11,10,12938209,12964298,protein_coding,-1,26089,chr10_12938209_12964298
Sf3b5,10,13005343,13009183,protein_coding,1,3840,chr10_13005343_13009183
Gm47691,10,13043097,13051385,lincRNA,-1,8288,chr10_13043097_13051385
Plagl1,10,13060504,13131694,protein_coding,1,71190,chr10_13060504_13131694
Zc2hc1b,10,13149540,13178023,protein_coding,-1,28483,chr10_13149540_13178023
Ltv1,10,13178140,13193168,protein_coding,-1,15028,chr10_13178140_13193168
Phactr2,10,13207717,13474412,protein_coding,-1,266695,chr10_13207717_13474412
Fuca2,10,13499540,13519035,protein_coding,1,19495,chr10_13499540_13519035
Pex3,10,13523842,13553142,protein_coding,-1,29300,chr10_13523842_13553142
Adat2,10,13552894,13563376,protein_coding,1,10482,chr10_13552894_13563376
Gm48773,10,13627198,13635107,lincRNA,1,7909,chr10_13627198_13635107
Aig1,10,13647054,13868980,protein_coding,-1,221926,chr10_13647054_13868980
Gm32172,10,13871280,13879208,lincRNA,1,7928,chr10_13871280_13879208
Gm32105,10,13877893,13883293,lincRNA,-1,5400,chr10_13877893_13883293
Hivep2,10,13966075,14151374,protein_coding,1,185299,chr10_13966075_14151374
Gm28289,10,14149084,14154446,antisense,-1,5362,chr10_14149084_14154446
Gm48843,10,14197015,14206821,lincRNA,1,9806,chr10_14197015_14206821
Gm48845,10,14226489,14266790,lincRNA,1,40301,chr10_14226489_14266790
Gm48844,10,14226667,14233958,lincRNA,-1,7291,chr10_14226667_14233958
Gm40603,10,14296921,14324756,lincRNA,1,27835,chr10_14296921_14324756
Gm48854,10,14327411,14336615,lincRNA,1,9204,chr10_14327411_14336615
Adgrg6,10,14402583,14545659,protein_coding,-1,143076,chr10_14402583_14545659
Gm46212,10,14544490,14551031,antisense,1,6541,chr10_14544490_14551031
Vta1,10,14654755,14705560,protein_coding,-1,50805,chr10_14654755_14705560
Gm16234,10,14664220,14668318,antisense,1,4098,chr10_14664220_14668318
Nmbr,10,14705591,14770850,protein_coding,1,65259,chr10_14705591_14770850
Gje1,10,14715623,14718214,protein_coding,-1,2591,chr10_14715623_14718214
B230364G03Rik,10,14758635,14760720,antisense,-1,2085,chr10_14758635_14760720
Gm47698,10,14771940,14774519,lincRNA,1,2579,chr10_14771940_14774519
Gm47710,10,15300231,15392942,lincRNA,1,92711,chr10_15300231_15392942
Gm47712,10,15600227,15780010,lincRNA,1,179783,chr10_15600227_15780010
Gm40604,10,15697996,15760012,lincRNA,-1,62016,chr10_15697996_15760012
C330004P14Rik,10,15791777,15807065,lincRNA,1,15288,chr10_15791777_15807065
Gm47729,10,16584268,16644555,lincRNA,1,60287,chr10_16584268_16644555
Gm47760,10,17294698,17332877,lincRNA,-1,38179,chr10_17294698_17332877
Gm47769,10,17512114,17520608,lincRNA,-1,8494,chr10_17512114_17520608
Gm47770,10,17522613,17526914,lincRNA,-1,4301,chr10_17522613_17526914
Gm47771,10,17562743,17658513,lincRNA,-1,95770,chr10_17562743_17658513
Cited2,10,17723218,17725674,protein_coding,1,2456,chr10_17723218_17725674
Gm20655,10,17790522,17799921,antisense,-1,9399,chr10_17790522_17799921
Txlnb,10,17796226,17845665,protein_coding,1,49439,chr10_17796226_17845665
Heca,10,17868612,17948067,protein_coding,-1,79455,chr10_17868612_17948067
Abracl,10,18011260,18023288,protein_coding,-1,12028,chr10_18011260_18023288
Reps1,10,18055861,18125155,protein_coding,1,69294,chr10_18055861_18125155
Ect2l,10,18128903,18210890,protein_coding,-1,81987,chr10_18128903_18210890
Ccdc28a,10,18213676,18234998,protein_coding,-1,21322,chr10_18213676_18234998
Gm10827,10,18235053,18246019,lincRNA,1,10966,chr10_18235053_18246019
Nhsl1,10,18318985,18533892,protein_coding,1,214907,chr10_18318985_18533892
Hebp2,10,18539498,18546076,protein_coding,-1,6578,chr10_18539498_18546076
Arfgef3,10,18581839,18743949,protein_coding,-1,162110,chr10_18581839_18743949
Gm32926,10,18743469,18837979,antisense,1,94510,chr10_18743469_18837979
Gm4922,10,18779725,18786793,protein_coding,-1,7068,chr10_18779725_18786793
4930444F02Rik,10,18796806,18831930,lincRNA,-1,35124,chr10_18796806_18831930
Perp,10,18845020,18857073,protein_coding,1,12053,chr10_18845020_18857073
Gm48483,10,18879735,18887029,lincRNA,-1,7294,chr10_18879735_18887029
Tnfaip3,10,19000910,19015657,protein_coding,-1,14747,chr10_19000910_19015657
Gm48545,10,19094050,19101595,lincRNA,-1,7545,chr10_19094050_19101595
Gm20139,10,19141751,19206702,lincRNA,1,64951,chr10_19141751_19206702
Gm33056,10,19290989,19325817,lincRNA,1,34828,chr10_19290989_19325817
Gm33104,10,19486715,19507311,lincRNA,1,20596,chr10_19486715_19507311
Ifngr1,10,19591949,19610229,protein_coding,1,18280,chr10_19591949_19610229
9230106D20Rik,10,19644750,19660801,lincRNA,1,16051,chr10_19644750_19660801
Il20ra,10,19712570,19760053,protein_coding,1,47483,chr10_19712570_19760053
Slc35d3,10,19847916,19851459,protein_coding,-1,3543,chr10_19847916_19851459
Pex7,10,19853900,19907689,protein_coding,-1,53789,chr10_19853900_19907689
Map3k5,10,19934472,20142753,protein_coding,1,208281,chr10_19934472_20142753
Map7,10,20148471,20281590,protein_coding,1,133119,chr10_20148471_20281590
4930405J17Rik,10,20199240,20201838,antisense,-1,2598,chr10_20199240_20201838
Gm48249,10,20267049,20286647,antisense,-1,19598,chr10_20267049_20286647
4933406P04Rik,10,20310506,20312294,lincRNA,-1,1788,chr10_20310506_20312294
Bclaf1,10,20312469,20344613,protein_coding,1,32144,chr10_20312469_20344613
Mtfr2,10,20347770,20361304,protein_coding,1,13534,chr10_20347770_20361304
Pde7b,10,20398004,20725078,protein_coding,-1,327074,chr10_20398004_20725078
Gm48651,10,20756117,20831303,lincRNA,1,75186,chr10_20756117_20831303
Ahi1,10,20952547,21080429,protein_coding,1,127882,chr10_20952547_21080429
Gm20149,10,21034304,21048899,antisense,-1,14595,chr10_21034304_21048899
Myb,10,21124935,21160984,protein_coding,-1,36049,chr10_21124935_21160984
Gm26577,10,21145094,21154374,antisense,1,9280,chr10_21145094_21154374
Gm40608,10,21177627,21189182,lincRNA,-1,11555,chr10_21177627_21189182
Gm33619,10,21182695,21188620,lincRNA,1,5925,chr10_21182695_21188620
Gm33728,10,21198101,21252114,lincRNA,-1,54013,chr10_21198101_21252114
Hbs1l,10,21295979,21368898,protein_coding,1,72919,chr10_21295979_21368898
4930455C13Rik,10,21319088,21342057,antisense,-1,22969,chr10_21319088_21342057
Aldh8a1,10,21377291,21396585,protein_coding,1,19294,chr10_21377291_21396585
1700021A07Rik,10,21419358,21426565,lincRNA,1,7207,chr10_21419358_21426565
1700020N01Rik,10,21593145,21622376,protein_coding,1,29231,chr10_21593145_21622376
Gm5420,10,21686411,21707440,lincRNA,1,21029,chr10_21686411_21707440
Gm29323,10,21743867,21747006,lincRNA,1,3139,chr10_21743867_21747006
Platr6,10,21830499,21844851,lincRNA,-1,14352,chr10_21830499_21844851
Sgk1,10,21882184,21999903,protein_coding,1,117719,chr10_21882184_21999903
4930444G20Rik,10,22066307,22068079,protein_coding,-1,1772,chr10_22066307_22068079
E030030I06Rik,10,22113050,22149270,protein_coding,-1,36220,chr10_22113050_22149270
Raet1e,10,22158569,22374139,protein_coding,1,215570,chr10_22158569_22374139
Gm26740,10,22187013,22302835,antisense,-1,115822,chr10_22187013_22302835
Gm10825,10,22402883,22407470,lincRNA,1,4587,chr10_22402883_22407470
Slc2a12,10,22645011,22704285,protein_coding,1,59274,chr10_22645011_22704285
Tbpl1,10,22703879,22731938,protein_coding,-1,28059,chr10_22703879_22731938
Eya4,10,23102963,23350786,protein_coding,-1,247823,chr10_23102963_23350786
Gm47843,10,23573020,23609431,lincRNA,-1,36411,chr10_23573020_23609431
4930520K02Rik,10,23611263,23622148,lincRNA,-1,10885,chr10_23611263_23622148
Rps12,10,23785183,23787275,protein_coding,-1,2092,chr10_23785183_23787275
Slc18b1,10,23796986,23827968,protein_coding,1,30982,chr10_23796986_23827968
Vnn3,10,23851462,23869843,protein_coding,1,18381,chr10_23851462_23869843
Vnn1,10,23894688,23905343,protein_coding,1,10655,chr10_23894688_23905343
Taar3,10,23949558,23950589,protein_coding,1,1031,chr10_23949558_23950589
Gm40614,10,24123214,24132480,lincRNA,-1,9266,chr10_24123214_24132480
Stx7,10,24149302,24190222,protein_coding,1,40920,chr10_24149302_24190222
Moxd1,10,24223517,24302790,protein_coding,1,79273,chr10_24223517_24302790
Gm15271,10,24447490,24452657,lincRNA,1,5167,chr10_24447490_24452657
Enpp1,10,24637914,24712159,protein_coding,-1,74245,chr10_24637914_24712159
Enpp3,10,24772406,24842823,protein_coding,-1,70417,chr10_24772406_24842823
Med23,10,24869986,24913681,protein_coding,1,43695,chr10_24869986_24913681
Arg1,10,24915221,24927484,protein_coding,-1,12263,chr10_24915221_24927484
Gm47715,10,25000020,25031035,lincRNA,1,31015,chr10_25000020_25031035
Akap7,10,25169090,25307870,protein_coding,-1,138780,chr10_25169090_25307870
Gm40617,10,25298609,25306432,antisense,1,7823,chr10_25298609_25306432
Epb41l2,10,25359798,25523519,protein_coding,1,163721,chr10_25359798_25523519
Smlr1,10,25527943,25536267,protein_coding,-1,8324,chr10_25527943_25536267
Gm29571,10,25536386,25673343,antisense,1,136957,chr10_25536386_25673343
Gm36908,10,25615632,25621563,lincRNA,-1,5931,chr10_25615632_25621563
Gm36543,10,25701410,25707943,lincRNA,-1,6533,chr10_25701410_25707943
4930401C15Rik,10,25779314,25837437,lincRNA,-1,58123,chr10_25779314_25837437
Gm47939,10,25899279,25903916,lincRNA,1,4637,chr10_25899279_25903916
Tmem200a,10,25912331,26079052,protein_coding,-1,166721,chr10_25912331_26079052
Gm9767,10,26078255,26079447,antisense,1,1192,chr10_26078255_26079447
Samd3,10,26229707,26272172,protein_coding,1,42465,chr10_26229707_26272172
L3mbtl3,10,26274468,26375971,protein_coding,-1,101503,chr10_26274468_26375971
Gm48893,10,26695574,26742860,lincRNA,1,47286,chr10_26695574_26742860
Arhgap18,10,26753421,26918648,protein_coding,1,165227,chr10_26753421_26918648
Gm48084,10,26949740,26982036,antisense,1,32296,chr10_26949740_26982036
Lama2,10,26980036,27619758,protein_coding,-1,639722,chr10_26980036_27619758
4930579H20Rik,10,27389866,27397225,antisense,1,7359,chr10_27389866_27397225
Gm30165,10,27646313,27698327,lincRNA,-1,52014,chr10_27646313_27698327
Gm30228,10,27744884,27809624,lincRNA,-1,64740,chr10_27744884_27809624
Ptprk,10,28074820,28597397,protein_coding,1,522577,chr10_28074820_28597397
Themis,10,28668360,28883818,protein_coding,1,215458,chr10_28668360_28883818
2310057J18Rik,10,28972288,28986303,protein_coding,-1,14015,chr10_28972288_28986303
Soga3,10,29143839,29199630,protein_coding,1,55791,chr10_29143839_29199630
Gm49353,10,29198954,29221940,protein_coding,1,22986,chr10_29198954_29221940
9330159F19Rik,10,29211606,29230779,protein_coding,1,19173,chr10_29211606_29230779
Gm46218,10,29297934,29313825,antisense,-1,15891,chr10_29297934_29313825
Echdc1,10,29313166,29347469,protein_coding,1,34303,chr10_29313166_29347469
Rnf146,10,29344176,29362442,protein_coding,-1,18266,chr10_29344176_29362442
Gm40621,10,29366740,29374945,lincRNA,1,8205,chr10_29366740_29374945
Rspo3,10,29452416,29535867,protein_coding,-1,83451,chr10_29452416_29535867
Gm48159,10,29534717,29614471,antisense,1,79754,chr10_29534717_29614471
Gm48215,10,29984178,30004378,lincRNA,-1,20200,chr10_29984178_30004378
Cenpw,10,30194569,30200560,protein_coding,-1,5991,chr10_30194569_30200560
Trmt11,10,30534225,30600749,protein_coding,-1,66524,chr10_30534225_30600749
Gm20300,10,30603195,30606634,lincRNA,-1,3439,chr10_30603195_30606634
Hint3,10,30608141,30629632,protein_coding,-1,21491,chr10_30608141_30629632
Ncoa7,10,30628999,30803326,protein_coding,-1,174327,chr10_30628999_30803326
Hey2,10,30832359,30842801,protein_coding,-1,10442,chr10_30832359_30842801
Gm30676,10,31006412,31066244,lincRNA,-1,59832,chr10_31006412_31066244
Hddc2,10,31313383,31328204,protein_coding,1,14821,chr10_31313383_31328204
Tpd52l1,10,31332376,31445958,protein_coding,-1,113582,chr10_31332376_31445958
Gm48094,10,31398923,31414401,antisense,1,15478,chr10_31398923_31414401
Gm48093,10,31429993,31433506,antisense,1,3513,chr10_31429993_31433506
Rnf217,10,31493193,31609184,protein_coding,-1,115991,chr10_31493193_31609184
Nkain2,10,31689310,32890462,protein_coding,-1,1201152,chr10_31689310_32890462
Gm47823,10,32917208,32939685,lincRNA,-1,22477,chr10_32917208_32939685
Trdn,10,33080554,33476709,protein_coding,1,396155,chr10_33080554_33476709
D830005E20Rik,10,33222345,33256418,antisense,-1,34073,chr10_33222345_33256418
Clvs2,10,33512286,33624769,protein_coding,-1,112483,chr10_33512286_33624769
Gm15939,10,33624246,33662432,antisense,1,38186,chr10_33624246_33662432
Sult3a2,10,33766424,33786704,protein_coding,-1,20280,chr10_33766424_33786704
Sult3a1,10,33857721,33879532,protein_coding,1,21811,chr10_33857721_33879532
Rsph4a,10,33905111,33916021,protein_coding,1,10910,chr10_33905111_33916021
Rwdd1,10,33996555,34019624,protein_coding,-1,23069,chr10_33996555_34019624
Gm48045,10,34018815,34020762,antisense,1,1947,chr10_34018815_34020762
Trappc3l,10,34037597,34109815,protein_coding,1,72218,chr10_34037597_34109815
Dse,10,34151393,34207715,protein_coding,-1,56322,chr10_34151393_34207715
Gm26564,10,34230907,34233531,lincRNA,-1,2624,chr10_34230907_34233531
Tspyl1,10,34282190,34285275,protein_coding,1,3085,chr10_34282190_34285275
Nt5dc1,10,34288288,34418552,protein_coding,-1,130264,chr10_34288288_34418552
Tspyl4,10,34297442,34301320,protein_coding,1,3878,chr10_34297442_34301320
Col10a1,10,34389981,34397085,protein_coding,1,7104,chr10_34389981_34397085
Frk,10,34483399,34611278,protein_coding,1,127879,chr10_34483399_34611278
1700054O05Rik,10,35478827,35485396,lincRNA,-1,6569,chr10_35478827_35485396
Amd2,10,35708675,35711892,protein_coding,-1,3217,chr10_35708675_35711892
Gm47049,10,36391592,36396928,lincRNA,1,5336,chr10_36391592_36396928
Hs3st5,10,36506814,36834397,protein_coding,1,327583,chr10_36506814_36834397
Hdac2,10,36974544,37001889,protein_coding,1,27345,chr10_36974544_37001889
Marcks,10,37133375,37138920,protein_coding,-1,5545,chr10_37133375_37138920
Gm26535,10,37337486,37379652,lincRNA,1,42166,chr10_37337486_37379652
Gm31378,10,38116245,38122061,lincRNA,-1,5816,chr10_38116245_38122061
4930591E09Rik,10,38175780,38181903,lincRNA,1,6123,chr10_38175780_38181903
Gm48197,10,38295074,38313846,lincRNA,-1,18772,chr10_38295074_38313846
Lama4,10,38965515,39110188,protein_coding,1,144673,chr10_38965515_39110188
Fam229b,10,39118804,39133914,protein_coding,-1,15110,chr10_39118804_39133914
Tube1,10,39133976,39152542,protein_coding,1,18566,chr10_39133976_39152542
D030034A15Rik,10,39169300,39173252,lincRNA,-1,3952,chr10_39169300_39173252
Gm48486,10,39282341,39323417,lincRNA,-1,41076,chr10_39282341_39323417
Fyn,10,39368855,39565381,protein_coding,1,196526,chr10_39368855_39565381
Gm16364,10,39556071,39613682,antisense,-1,57611,chr10_39556071_39613682
Traf3ip2,10,39612934,39655307,protein_coding,1,42373,chr10_39612934_39655307
E130307A14Rik,10,39621412,39732007,antisense,-1,110595,chr10_39621412_39732007
Rev3l,10,39732118,39875211,protein_coding,1,143093,chr10_39732118_39875211
Mfsd4b4,10,39890013,39899238,protein_coding,-1,9225,chr10_39890013_39899238
Mfsd4b2,10,39920380,39937313,transcribed_unprocessed_pseudogene,-1,16933,chr10_39920380_39937313
Mfsd4b5,10,39958036,39986646,protein_coding,-1,28610,chr10_39958036_39986646
Mfsd4b1,10,40001575,40025268,protein_coding,-1,23693,chr10_40001575_40025268
Slc16a10,10,40033532,40142258,protein_coding,-1,108726,chr10_40033532_40142258
Gm31992,10,40164110,40169759,lincRNA,1,5649,chr10_40164110_40169759
Gm47598,10,40180657,40183692,lincRNA,-1,3035,chr10_40180657_40183692
Rpf2,10,40223246,40247036,protein_coding,-1,23790,chr10_40223246_40247036
Gtf3c6,10,40247703,40258108,protein_coding,-1,10405,chr10_40247703_40258108
A930033M14Rik,10,40260934,40261333,lincRNA,1,399,chr10_40260934_40261333
Amd1,10,40287458,40302188,protein_coding,-1,14730,chr10_40287458_40302188
Cdk19,10,40339564,40483818,protein_coding,1,144254,chr10_40339564_40483818
Cdk19os,10,40348508,40350103,antisense,-1,1595,chr10_40348508_40350103
Slc22a16,10,40570336,40604132,protein_coding,1,33796,chr10_40570336_40604132
Ddo,10,40630011,40681847,protein_coding,1,51836,chr10_40630011_40681847
Mettl24,10,40683282,40811083,protein_coding,1,127801,chr10_40683282_40811083
Cdc40,10,40831621,40883311,protein_coding,-1,51690,chr10_40831621_40883311
Wasf1,10,40883475,40938570,protein_coding,1,55095,chr10_40883475_40938570
Gpr6,10,41069977,41072285,protein_coding,-1,2308,chr10_41069977_41072285
Gm32284,10,41075368,41101794,lincRNA,1,26426,chr10_41075368_41101794
Fig4,10,41188172,41303260,protein_coding,-1,115088,chr10_41188172_41303260
Ak9,10,41303980,41434534,protein_coding,1,130554,chr10_41303980_41434534
Zbtb24,10,41450383,41465574,protein_coding,1,15191,chr10_41450383_41465574
Mical1,10,41476314,41487032,protein_coding,1,10718,chr10_41476314_41487032
Smpd2,10,41485642,41490369,protein_coding,-1,4727,chr10_41485642_41490369
Ppil6,10,41490439,41514286,protein_coding,1,23847,chr10_41490439_41514286
Cd164,10,41519414,41531048,protein_coding,1,11634,chr10_41519414_41531048
Ccdc162,10,41538846,41716634,protein_coding,-1,177788,chr10_41538846_41716634
Gm17196,10,41553762,41556552,antisense,1,2790,chr10_41553762_41556552
Cep57l1,10,41718840,41809871,protein_coding,-1,91031,chr10_41718840_41809871
BC048559,10,41746721,41783437,antisense,1,36716,chr10_41746721_41783437
Sesn1,10,41809935,41908424,protein_coding,1,98489,chr10_41809935_41908424
Armc2,10,41914990,42018442,protein_coding,-1,103452,chr10_41914990_42018442
Foxo3,10,42181841,42276755,protein_coding,-1,94914,chr10_42181841_42276755
Afg1l,10,42312585,42478565,protein_coding,-1,165980,chr10_42312585_42478565
Snx3,10,42502030,42535381,protein_coding,1,33351,chr10_42502030_42535381
Nr2e1,10,42561963,42583632,protein_coding,-1,21669,chr10_42561963_42583632
Ostm1,10,42583822,42702459,protein_coding,1,118637,chr10_42583822_42702459
Gm15200,10,42698036,42698518,antisense,-1,482,chr10_42698036_42698518
Gm15199,10,42740539,42758660,antisense,-1,18121,chr10_42740539_42758660
Sec63,10,42761496,42832514,protein_coding,1,71018,chr10_42761496_42832514
Scml4,10,42860370,42960780,protein_coding,1,100410,chr10_42860370_42960780
Gm34006,10,42861382,42864699,antisense,-1,3317,chr10_42861382_42864699
Gm48671,10,42886705,42888797,lincRNA,-1,2092,chr10_42886705_42888797
Sobp,10,43002500,43174530,protein_coding,-1,172030,chr10_43002500_43174530
Gm47815,10,43034993,43050219,antisense,1,15226,chr10_43034993_43050219
Gm29246,10,43173263,43173958,antisense,1,695,chr10_43173263_43173958
9030612E09Rik,10,43174699,43176562,bidirectional_promoter_lncRNA,1,1863,chr10_43174699_43176562
Pdss2,10,43221486,43464882,protein_coding,1,243396,chr10_43221486_43464882
Bend3,10,43478831,43515396,protein_coding,1,36565,chr10_43478831_43515396
Gm47889,10,43518571,43555817,lincRNA,1,37246,chr10_43518571_43555817
Cd24a,10,43578284,43584265,protein_coding,1,5981,chr10_43578284_43584265
F930017D23Rik,10,43593397,43709668,lincRNA,1,116271,chr10_43593397_43709668
Gm40634,10,43740114,43743087,lincRNA,-1,2973,chr10_43740114_43743087
1700027J07Rik,10,43745809,43765836,lincRNA,1,20027,chr10_43745809_43765836
4933404K13Rik,10,43824200,43833392,lincRNA,1,9192,chr10_43824200_43833392
Qrsl1,10,43874188,43901745,protein_coding,-1,27557,chr10_43874188_43901745
Rtn4ip1,10,43901807,43957201,protein_coding,1,55394,chr10_43901807_43957201
Crybg1,10,43950636,44148853,protein_coding,-1,198217,chr10_43950636_44148853
Atg5,10,44268358,44364291,protein_coding,1,95933,chr10_44268358_44364291
Gm35028,10,44418400,44424324,lincRNA,-1,5924,chr10_44418400_44424324
Prdm1,10,44437177,44528501,protein_coding,-1,91324,chr10_44437177_44528501
Gm48061,10,44580517,44590238,lincRNA,-1,9721,chr10_44580517_44590238
Gm35154,10,44598720,44689081,lincRNA,1,90361,chr10_44598720_44689081
4930431F10Rik,10,44730769,44738900,lincRNA,-1,8131,chr10_44730769_44738900
Gm47392,10,44730940,44823886,lincRNA,1,92946,chr10_44730940_44823886
Gm47398,10,44851393,44866786,lincRNA,-1,15393,chr10_44851393_44866786
Gm40638,10,44902558,44943294,lincRNA,-1,40736,chr10_44902558_44943294
Prep,10,45067203,45167198,protein_coding,1,99995,chr10_45067203_45167198
Popdc3,10,45178098,45318452,protein_coding,1,140354,chr10_45178098_45318452
Gm15934,10,45287311,45289424,antisense,-1,2113,chr10_45287311_45289424
Bves,10,45335772,45372479,protein_coding,1,36707,chr10_45335772_45372479
Lin28b,10,45376620,45486395,protein_coding,-1,109775,chr10_45376620_45486395
Hace1,10,45577829,45712345,protein_coding,1,134516,chr10_45577829_45712345
D030045P18Rik,10,45807562,45852283,lincRNA,1,44721,chr10_45807562_45852283
Gm35552,10,47016652,47102832,lincRNA,-1,86180,chr10_47016652_47102832
Gm47568,10,47024247,47037346,lincRNA,1,13099,chr10_47024247_47037346
Gm47354,10,48534981,48536356,lincRNA,-1,1375,chr10_48534981_48536356
Grik2,10,49094833,49788766,protein_coding,-1,693933,chr10_49094833_49788766
Ascc3,10,50592669,50851485,protein_coding,1,258816,chr10_50592669_50851485
Sim1,10,50894754,50989152,protein_coding,1,94398,chr10_50894754_50989152
Gm49339,10,51480612,51496613,protein_coding,1,16001,chr10_51480612_51496613
Gm40645,10,51489530,51522447,antisense,-1,32917,chr10_51489530_51522447
Gm46224,10,51526340,51531161,lincRNA,1,4821,chr10_51526340_51531161
Fam162b,10,51585416,51590517,protein_coding,-1,5101,chr10_51585416_51590517
Gprc6a,10,51614823,51631461,protein_coding,-1,16638,chr10_51614823_51631461
1700042O05Rik,10,51666989,51675831,lincRNA,1,8842,chr10_51666989_51675831
Rfx6,10,51677756,51730432,protein_coding,1,52676,chr10_51677756_51730432
Gm47613,10,51757257,51761015,lincRNA,1,3758,chr10_51757257_51761015
Gm40646,10,51863852,51970291,lincRNA,-1,106439,chr10_51863852_51970291
Vgll2,10,52022502,52028471,protein_coding,1,5969,chr10_52022502_52028471
Ros1,10,52045721,52195244,protein_coding,-1,149523,chr10_52045721_52195244
Dcbld1,10,52233619,52321378,protein_coding,1,87759,chr10_52233619_52321378
Gopc,10,52335850,52382124,protein_coding,-1,46274,chr10_52335850_52382124
Nepn,10,52388972,52404625,protein_coding,1,15653,chr10_52388972_52404625
Nus1,10,52417547,52440183,protein_coding,1,22636,chr10_52417547_52440183
Gm36065,10,52594012,52600673,lincRNA,1,6661,chr10_52594012_52600673
Slc35f1,10,52690533,53111622,protein_coding,1,421089,chr10_52690533_53111622
Gm40649,10,53181180,53220463,lincRNA,1,39283,chr10_53181180_53220463
Gm36173,10,53235187,53260736,lincRNA,1,25549,chr10_53235187_53260736
Cep85l,10,53273443,53379947,protein_coding,-1,106504,chr10_53273443_53379947
Gm19395,10,53280281,53283686,antisense,1,3405,chr10_53280281_53283686
Pln,10,53337667,53345987,protein_coding,1,8320,chr10_53337667_53345987
Gm36229,10,53409882,53424272,lincRNA,1,14390,chr10_53409882_53424272
Gm20597,10,53498443,53518989,lincRNA,-1,20546,chr10_53498443_53518989
Mcm9,10,53536315,53630439,protein_coding,-1,94124,chr10_53536315_53630439
Gm47738,10,53569669,53571582,antisense,1,1913,chr10_53569669_53571582
Asf1a,10,53596757,53609225,protein_coding,1,12468,chr10_53596757_53609225
Fam184a,10,53633145,53751123,protein_coding,-1,117978,chr10_53633145_53751123
Gm47915,10,53798024,53803529,lincRNA,-1,5505,chr10_53798024_53803529
Man1a,10,53904785,54076609,protein_coding,-1,171824,chr10_53904785_54076609
Gm47917,10,54063811,54065069,antisense,1,1258,chr10_54063811_54065069
Tbc1d32,10,56014293,56228689,protein_coding,-1,214396,chr10_56014293_56228689
Msl3l2,10,56106917,56116880,protein_coding,1,9963,chr10_56106917_56116880
Gja1,10,56377330,56402513,protein_coding,1,25183,chr10_56377330_56402513
Gm36595,10,56431981,56475967,lincRNA,1,43986,chr10_56431981_56475967
Gm36827,10,56970329,56982232,lincRNA,-1,11903,chr10_56970329_56982232
Gm40652,10,57117222,57157621,lincRNA,1,40399,chr10_57117222_57157621
4930467K11Rik,10,57478381,57486351,lincRNA,-1,7970,chr10_57478381_57486351
Hsf2,10,57486385,57513135,protein_coding,1,26750,chr10_57486385_57513135
Serinc1,10,57515774,57532530,protein_coding,-1,16756,chr10_57515774_57532530
Pkib,10,57631981,57741112,protein_coding,1,109131,chr10_57631981_57741112
Fabp7,10,57784881,57788450,protein_coding,1,3569,chr10_57784881_57788450
Smpdl3a,10,57794335,57811830,protein_coding,1,17495,chr10_57794335_57811830
Duxf3,10,58229979,58257172,protein_coding,-1,27193,chr10_58229979_58257172
Gm4981,10,58234848,58261198,protein_coding,-1,26350,chr10_58234848_58261198
Gcc2,10,58255497,58330096,protein_coding,1,74599,chr10_58255497_58330096
Lims1,10,58323466,58424691,protein_coding,1,101225,chr10_58323466_58424691
Ranbp2,10,58446920,58494356,protein_coding,1,47436,chr10_58446920_58494356
Ccdc138,10,58497948,58576244,protein_coding,1,78296,chr10_58497948_58576244
Edar,10,58600789,58675654,protein_coding,-1,74865,chr10_58600789_58675654
BB019430,10,58696745,58704279,lincRNA,1,7534,chr10_58696745_58704279
Gm17542,10,58713606,58718210,protein_coding,-1,4604,chr10_58713606_58718210
Sh3rf3,10,58813359,59138916,protein_coding,1,325557,chr10_58813359_59138916
Sowahc,10,59221953,59226434,protein_coding,1,4481,chr10_59221953_59226434
P4ha1,10,59323296,59373304,protein_coding,1,50008,chr10_59323296_59373304
Gm10273,10,59395755,59396384,processed_pseudogene,1,629,chr10_59395755_59396384
Pla2g12b,10,59403660,59421976,protein_coding,1,18316,chr10_59403660_59421976
Oit3,10,59422958,59441778,protein_coding,-1,18820,chr10_59422958_59441778
Mcu,10,59446984,59616692,protein_coding,-1,169708,chr10_59446984_59616692
Gm10322,10,59616063,59617416,antisense,1,1353,chr10_59616063_59617416
Micu1,10,59702477,59864132,protein_coding,1,161655,chr10_59702477_59864132
Gm17059,10,59799199,59800254,antisense,-1,1055,chr10_59799199_59800254
Dnajb12,10,59879556,59899302,protein_coding,1,19746,chr10_59879556_59899302
Ddit4,10,59949669,59951834,protein_coding,-1,2165,chr10_59949669_59951834
Anapc16,10,59987409,60003135,protein_coding,-1,15726,chr10_59987409_60003135
Ascc1,10,60002805,60099988,protein_coding,1,97183,chr10_60002805_60099988
Spock2,10,60106219,60135198,protein_coding,1,28979,chr10_60106219_60135198
Chst3,10,60181532,60219260,protein_coding,-1,37728,chr10_60181532_60219260
Psap,10,60277627,60302597,protein_coding,1,24970,chr10_60277627_60302597
Cdh23,10,60302748,60696490,protein_coding,-1,393742,chr10_60302748_60696490
Vsir,10,60346851,60372684,protein_coding,1,25833,chr10_60346851_60372684
Gm17455,10,60399726,60403559,protein_coding,1,3833,chr10_60399726_60403559
Slc29a3,10,60712072,60752794,protein_coding,-1,40722,chr10_60712072_60752794
Unc5b,10,60762593,60831581,protein_coding,-1,68988,chr10_60762593_60831581
Pldi,10,60928226,60938132,lincRNA,-1,9906,chr10_60928226_60938132
Gm26947,10,60931991,60940942,antisense,1,8951,chr10_60931991_60940942
Gm20611,10,61031303,61038080,lincRNA,1,6777,chr10_61031303_61038080
Gm20625,10,61038229,61042811,lincRNA,-1,4582,chr10_61038229_61042811
Gm20610,10,61046422,61051900,lincRNA,-1,5478,chr10_61046422_61051900
Pcbd1,10,61089331,61094324,protein_coding,1,4993,chr10_61089331_61094324
Sgpl1,10,61098642,61147703,protein_coding,-1,49061,chr10_61098642_61147703
Tbata,10,61171954,61188841,protein_coding,1,16887,chr10_61171954_61188841
Adamts14,10,61197112,61273438,protein_coding,-1,76326,chr10_61197112_61273438
Prf1,10,61297833,61304680,protein_coding,1,6847,chr10_61297833_61304680
Pald1,10,61319656,61383530,protein_coding,-1,63874,chr10_61319656_61383530
Nodal,10,61417972,61425338,protein_coding,1,7366,chr10_61417972_61425338
Eif4ebp2,10,61428491,61452661,protein_coding,-1,24170,chr10_61428491_61452661
D830039M14Rik,10,61473576,61476937,antisense,-1,3361,chr10_61473576_61476937
Lrrc20,10,61475801,61582791,protein_coding,1,106990,chr10_61475801_61582791
Gm47595,10,61494917,61496290,antisense,-1,1373,chr10_61494917_61496290
Gm47593,10,61496600,61499601,antisense,-1,3001,chr10_61496600_61499601
Npffr1,10,61595492,61628565,protein_coding,1,33073,chr10_61595492_61628565
Ppa1,10,61648552,61674168,protein_coding,1,25616,chr10_61648552_61674168
Sar1a,10,61680299,61693297,protein_coding,1,12998,chr10_61680299_61693297
Tysnd1,10,61695514,61702773,protein_coding,1,7259,chr10_61695514_61702773
Aifm2,10,61715263,61739260,protein_coding,1,23997,chr10_61715263_61739260
Col13a1,10,61838236,61979108,protein_coding,-1,140872,chr10_61838236_61979108
Fam241b,10,62107655,62143920,protein_coding,-1,36265,chr10_62107655_62143920
Neurog3,10,62133090,62134763,protein_coding,1,1673,chr10_62133090_62134763
Tspan15,10,62185396,62231251,protein_coding,-1,45855,chr10_62185396_62231251
Tacr2,10,62252438,62265990,protein_coding,1,13552,chr10_62252438_62265990
Hk1,10,62268855,62379908,protein_coding,-1,111053,chr10_62268855_62379908
Hk1os,10,62340256,62363367,antisense,1,23111,chr10_62340256_62363367
Hkdc1,10,62383137,62422491,protein_coding,-1,39354,chr10_62383137_62422491
Supv3l1,10,62429209,62449738,protein_coding,-1,20529,chr10_62429209_62449738
4930507D05Rik,10,62449489,62451353,bidirectional_promoter_lncRNA,1,1864,chr10_62449489_62451353
Vps26a,10,62455235,62486805,protein_coding,-1,31570,chr10_62455235_62486805
Srgn,10,62493833,62527451,protein_coding,-1,33618,chr10_62493833_62527451
4933428P19Rik,10,62577694,62579069,antisense,1,1375,chr10_62577694_62579069
Ddx21,10,62580251,62602281,protein_coding,-1,22030,chr10_62580251_62602281
Ddx50,10,62615895,62651218,protein_coding,-1,35323,chr10_62615895_62651218
Stox1,10,62659043,62726128,protein_coding,-1,67085,chr10_62659043_62726128
Ccar1,10,62743928,62792286,protein_coding,-1,48358,chr10_62743928_62792286
Tet1,10,62804570,62908996,protein_coding,-1,104426,chr10_62804570_62908996
Slc25a16,10,62920633,62946498,protein_coding,1,25865,chr10_62920633_62946498
Dna2,10,62947026,62974185,protein_coding,1,27159,chr10_62947026_62974185
Rufy2,10,62980223,63017210,protein_coding,1,36987,chr10_62980223_63017210
Hnrnph3,10,63014664,63024217,protein_coding,-1,9553,chr10_63014664_63024217
Pbld2,10,63024315,63058813,protein_coding,1,34498,chr10_63024315_63058813
Gm16143,10,63055603,63057467,antisense,-1,1864,chr10_63055603_63057467
Pbld1,10,63060162,63077962,protein_coding,1,17800,chr10_63060162_63077962
Gm48072,10,63072052,63075060,antisense,-1,3008,chr10_63072052_63075060
Atoh7,10,63099651,63101279,protein_coding,1,1628,chr10_63099651_63101279
Mypn,10,63115795,63203952,protein_coding,-1,88157,chr10_63115795_63203952
Herc4,10,63243810,63317878,protein_coding,1,74068,chr10_63243810_63317878
Gm26789,10,63292286,63295793,antisense,-1,3507,chr10_63292286_63295793
Sirt1,10,63319005,63381704,protein_coding,-1,62699,chr10_63319005_63381704
Gm16145,10,63353853,63366887,antisense,1,13034,chr10_63353853_63366887
Dnajc12,10,63382443,63410576,protein_coding,1,28133,chr10_63382443_63410576
Ctnna3,10,63430098,65003667,protein_coding,1,1573569,chr10_63430098_65003667
Lrrtm3,10,63928472,64090277,protein_coding,-1,161805,chr10_63928472_64090277
Gm30853,10,65875605,65908250,lincRNA,-1,32645,chr10_65875605_65908250
1700023F02Rik,10,66120605,66254223,lincRNA,-1,133618,chr10_66120605_66254223
4930407I19Rik,10,66145296,66179514,lincRNA,1,34218,chr10_66145296_66179514
Gm31181,10,66698241,66705961,lincRNA,1,7720,chr10_66698241_66705961
Gm47895,10,66759454,66762095,lincRNA,1,2641,chr10_66759454_66762095
Gm47896,10,66809840,66822354,lincRNA,1,12514,chr10_66809840_66822354
Gm47897,10,66824169,66827403,lincRNA,1,3234,chr10_66824169_66827403
Gm47903,10,66889671,66891612,lincRNA,-1,1941,chr10_66889671_66891612
1110002J07Rik,10,66912489,66920258,lincRNA,-1,7769,chr10_66912489_66920258
Gm26576,10,66920302,66923599,lincRNA,1,3297,chr10_66920302_66923599
Gm31763,10,67005020,67041326,antisense,1,36306,chr10_67005020_67041326
Reep3,10,67009189,67096945,protein_coding,-1,87756,chr10_67009189_67096945
Jmjd1c,10,67096125,67256326,protein_coding,1,160201,chr10_67096125_67256326
Nrbf2,10,67266689,67285305,protein_coding,-1,18616,chr10_67266689_67285305
Gm47531,10,67435277,67443429,lincRNA;lncRNA,-1,8152,chr10_67435277_67443429
Egr2,10,67535475,67542217,protein_coding,1,6742,chr10_67535475_67542217
Ado,10,67544511,67549097,protein_coding,-1,4586,chr10_67544511_67549097
4930563J15Rik,10,67568522,67572018,lincRNA;lncRNA,-1,3496,chr10_67568522_67572018
Gm32364,10,67575883,67586416,lincRNA;lncRNA,1,10533,chr10_67575883_67586416
1700030E10Rik,10,67708588,67718039,lincRNA,-1,9451,chr10_67708588_67718039
Zfp365,10,67886103,67912662,protein_coding,-1,26559,chr10_67886103_67912662
4930521O17Rik,10,67962479,67973708,lincRNA,-1,11229,chr10_67962479_67973708
Rtkn2,10,67979570,68059740,protein_coding,1,80170,chr10_67979570_68059740
Gm16212,10,68025450,68026626,antisense,-1,1176,chr10_68025450_68026626
Arid5b,10,68092520,68278740,protein_coding,-1,186220,chr10_68092520_68278740
Gm47078,10,68313008,68326978,lincRNA,1,13970,chr10_68313008_68326978
4930545H06Rik,10,68319071,68321142,lincRNA,-1,2071,chr10_68319071_68321142
Cabcoco1,10,68430953,68541896,protein_coding,-1,110943,chr10_68430953_68541896
Gm32872,10,68530094,68533936,antisense,1,3842,chr10_68530094_68533936
Tmem26,10,68723646,68782650,protein_coding,1,59004,chr10_68723646_68782650
Gm33035,10,69020740,69033888,lincRNA,-1,13148,chr10_69020740_69033888
Gm33263,10,69147773,69151132,lincRNA,-1,3359,chr10_69147773_69151132
Rhobtb1,10,69151434,69291791,protein_coding,1,140357,chr10_69151434_69291791
A930033H14Rik,10,69209762,69213098,protein_coding,-1,3336,chr10_69209762_69213098
Gm40685,10,69312139,69315376,lincRNA,1,3237,chr10_69312139_69315376
Cdk1,10,69335146,69352938,protein_coding,-1,17792,chr10_69335146_69352938
Ank3,10,69398773,70027438,protein_coding,1,628665,chr10_69398773_70027438
Ccdc6,10,70097121,70193200,protein_coding,1,96079,chr10_70097121_70193200
Mrln,10,70204664,70219711,protein_coding,1,15047,chr10_70204664_70219711
Slc16a9,10,70245100,70285968,protein_coding,1,40868,chr10_70245100_70285968
Gm47946,10,70412460,70415581,lincRNA,-1,3121,chr10_70412460_70415581
Fam13c,10,70440481,70558736,protein_coding,1,118255,chr10_70440481_70558736
Phyhipl,10,70557682,70655965,protein_coding,-1,98283,chr10_70557682_70655965
Gm33979,10,70714928,70738844,lincRNA,-1,23916,chr10_70714928_70738844
Gm48021,10,70807242,70813822,lincRNA,1,6580,chr10_70807242_70813822
Gm48022,10,70813845,70816052,lincRNA,1,2207,chr10_70813845_70816052
Gm40689,10,70830755,70837863,lincRNA,1,7108,chr10_70830755_70837863
Gm48023,10,70847017,70853726,lincRNA,1,6709,chr10_70847017_70853726
Gm48024,10,70863399,70868452,lincRNA,-1,5053,chr10_70863399_70868452
4930533K18Rik,10,70868644,70934324,antisense,1,65680,chr10_70868644_70934324
Bicc1,10,70922832,71159700,protein_coding,-1,236868,chr10_70922832_71159700
Gm15647,10,71082876,71083651,antisense,1,775,chr10_71082876_71083651
Tfam,10,71225464,71238280,protein_coding,-1,12816,chr10_71225464_71238280
Ube2d1,10,71254980,71285262,protein_coding,-1,30282,chr10_71254980_71285262
Gm34376,10,71287729,71292483,lincRNA,1,4754,chr10_71287729_71292483
Gm20609,10,71310745,71313977,lincRNA,1,3232,chr10_71310745_71313977
Cisd1,10,71330480,71344954,protein_coding,-1,14474,chr10_71330480_71344954
Ipmk,10,71347763,71433327,protein_coding,1,85564,chr10_71347763_71433327
4930551I15Rik,10,71476405,71485520,lincRNA,-1,9115,chr10_71476405_71485520
Gm34609,10,72026982,72111778,lincRNA,1,84796,chr10_72026982_72111778
Zwint,10,72654845,72674964,protein_coding,1,20119,chr10_72654845_72674964
Gm34776,10,72940238,72949792,lincRNA,-1,9554,chr10_72940238_72949792
A330049N07Rik,10,72973303,73086705,lincRNA,-1,113402,chr10_72973303_73086705
Pcdh15,10,73099342,74649737,protein_coding,1,1550395,chr10_73099342_74649737
Gm15398,10,73201399,73327175,lincRNA,-1,125776,chr10_73201399_73327175
Rsph14,10,74957477,75032586,protein_coding,-1,75109,chr10_74957477_75032586
Gnaz,10,74967177,75016907,protein_coding,1,49730,chr10_74967177_75016907
Rab36,10,75037058,75054748,protein_coding,1,17690,chr10_75037058_75054748
Bcr,10,75060592,75184921,protein_coding,1,124329,chr10_75060592_75184921
Specc1l,10,75212073,75312743,protein_coding,1,100670,chr10_75212073_75312743
Adora2a,10,75316877,75334784,protein_coding,1,17907,chr10_75316877_75334784
Gucd1,10,75351111,75517972,protein_coding,-1,166861,chr10_75351111_75517972
Upb1,10,75401115,75441679,protein_coding,1,40564,chr10_75401115_75441679
Snrpd3,10,75517551,75537381,protein_coding,1,19830,chr10_75517551_75537381
Lrrc75b,10,75550123,75560330,protein_coding,-1,10207,chr10_75550123_75560330
Ggt1,10,75561604,75586200,protein_coding,1,24596,chr10_75561604_75586200
Ggt5,10,75589340,75617200,protein_coding,1,27860,chr10_75589340_75617200
Susd2,10,75636706,75644008,protein_coding,-1,7302,chr10_75636706_75644008
Cabin1,10,75646112,75764341,protein_coding,-1,118229,chr10_75646112_75764341
Ddt,10,75771230,75773414,protein_coding,-1,2184,chr10_75771230_75773414
Gm20441,10,75771451,75780954,protein_coding,-1,9503,chr10_75771451_75780954
Gstt1,10,75783813,75798584,protein_coding,-1,14771,chr10_75783813_75798584
Gstt4,10,75814943,75822543,protein_coding,-1,7600,chr10_75814943_75822543
Gstt2,10,75831114,75837424,protein_coding,-1,6310,chr10_75831114_75837424
Mif,10,75859353,75860240,protein_coding,-1,887,chr10_75859353_75860240
Derl3,10,75893413,75895941,protein_coding,1,2528,chr10_75893413_75895941
Smarcb1,10,75896769,75921617,protein_coding,-1,24848,chr10_75896769_75921617
Mmp11,10,75923222,75936496,protein_coding,-1,13274,chr10_75923222_75936496
Chchd10,10,75933130,75937747,protein_coding,1,4617,chr10_75933130_75937747
Gm867,10,75937723,75940672,protein_coding,-1,2949,chr10_75937723_75940672
Vpreb3,10,75943057,75949657,protein_coding,1,6600,chr10_75943057_75949657
Gm5134,10,75954514,76009591,protein_coding,1,55077,chr10_75954514_76009591
Zfp280b,10,76032650,76043234,protein_coding,1,10584,chr10_76032650_76043234
Slc5a4b,10,76057494,76110961,protein_coding,-1,53467,chr10_76057494_76110961
Gm16222,10,76078617,76080502,antisense,1,1885,chr10_76078617_76080502
Slc5a4a,10,76147451,76189265,protein_coding,1,41814,chr10_76147451_76189265
Prmt2,10,76207222,76237865,protein_coding,-1,30643,chr10_76207222_76237865
S100b,10,76253853,76261159,protein_coding,1,7306,chr10_76253853_76261159
Dip2a,10,76259429,76345291,protein_coding,-1,85862,chr10_76259429_76345291
Gm16240,10,76293165,76294860,antisense,1,1695,chr10_76293165_76294860
Pcnt,10,76351263,76442786,protein_coding,-1,91523,chr10_76351263_76442786
1700094J05Rik,10,76389015,76401507,antisense,1,12492,chr10_76389015_76401507
2610028H24Rik,10,76449081,76461110,protein_coding,1,12029,chr10_76449081_76461110
Ybey,10,76459567,76469114,protein_coding,-1,9547,chr10_76459567_76469114
Mcm3ap,10,76468927,76515857,protein_coding,1,46930,chr10_76468927_76515857
Lss,10,76531588,76557138,protein_coding,1,25550,chr10_76531588_76557138
4930483K19Rik,10,76545871,76562226,antisense,-1,16355,chr10_76545871_76562226
Spatc1l,10,76562272,76570201,protein_coding,1,7929,chr10_76562272_76570201
Gm15343,10,76564765,76570532,antisense,-1,5767,chr10_76564765_76570532
Ftcd,10,76575648,76590338,protein_coding,1,14690,chr10_76575648_76590338
Col6a2,10,76595762,76623630,protein_coding,-1,27868,chr10_76595762_76623630
Gm35608,10,76684432,76686801,lincRNA,1,2369,chr10_76684432_76686801
Col6a1,10,76708792,76726168,protein_coding,-1,17376,chr10_76708792_76726168
Gm48276,10,76726583,76730273,lincRNA,-1,3690,chr10_76726583_76730273
Pcbp3,10,76761857,76961887,protein_coding,-1,200030,chr10_76761857_76961887
Gm35721,10,76964653,77008569,lincRNA,-1,43916,chr10_76964653_77008569
Gm3137,10,77011501,77029575,lincRNA,-1,18074,chr10_77011501_77029575
Gm10787,10,77011995,77022214,lincRNA,1,10219,chr10_77011995_77022214
Slc19a1,10,77032241,77061002,protein_coding,1,28761,chr10_77032241_77061002
Col18a1,10,77052178,77166548,protein_coding,-1,114370,chr10_77052178_77166548
Pofut2,10,77259218,77269575,protein_coding,1,10357,chr10_77259218_77269575
Adarb1,10,77290726,77418270,protein_coding,-1,127544,chr10_77290726_77418270
Fam207a,10,77486661,77515785,protein_coding,-1,29124,chr10_77486661_77515785
Itgb2,10,77530252,77565708,protein_coding,1,35456,chr10_77530252_77565708
Pttg1ip,10,77581720,77598732,protein_coding,1,17012,chr10_77581720_77598732
Sumo3,10,77606097,77618331,protein_coding,1,12234,chr10_77606097_77618331
Gm49325,10,77606197,77641543,protein_coding,1,35346,chr10_77606197_77641543
Ube2g2,10,77622275,77645993,protein_coding,1,23718,chr10_77622275_77645993
Tspear,10,77686569,77887021,protein_coding,1,200452,chr10_77686569_77887021
Lrrc3,10,77897575,77902536,protein_coding,-1,4961,chr10_77897575_77902536
Trpm2,10,77907722,77970563,protein_coding,-1,62841,chr10_77907722_77970563
Pfkl,10,77986947,78010083,protein_coding,-1,23136,chr10_77986947_78010083
Aire,10,78030022,78043610,protein_coding,-1,13588,chr10_78030022_78043610
Dnmt3l,10,78041947,78063622,protein_coding,1,21675,chr10_78041947_78063622
Icosl,10,78069302,78083913,protein_coding,1,14611,chr10_78069302_78083913
Gm47922,10,78121433,78138097,lincRNA,-1,16664,chr10_78121433_78138097
Pwp2,10,78170909,78185149,protein_coding,-1,14240,chr10_78170909_78185149
Trappc10,10,78186725,78244641,protein_coding,-1,57916,chr10_78186725_78244641
Gm30122,10,78248880,78264139,lincRNA,-1,15259,chr10_78248880_78264139
Agpat3,10,78269178,78352489,protein_coding,-1,83311,chr10_78269178_78352489
Rrp1,10,78400384,78413043,protein_coding,-1,12659,chr10_78400384_78413043
Cstb,10,78425669,78427622,protein_coding,1,1953,chr10_78425669_78427622
4921516A02Rik,10,78428271,78438847,antisense,1,10576,chr10_78428271_78438847
Pdxk,10,78436744,78464975,protein_coding,-1,28231,chr10_78436744_78464975
Gm47944,10,78501925,78520219,lincRNA,-1,18294,chr10_78501925_78520219
Ilvbl,10,78574346,78584502,protein_coding,1,10156,chr10_78574346_78584502
Syde1,10,78584503,78591964,protein_coding,-1,7461,chr10_78584503_78591964
Gm47459,10,78629554,78632624,lincRNA,1,3070,chr10_78629554_78632624
Ccdc105,10,78746926,78753065,protein_coding,-1,6139,chr10_78746926_78753065
Slc1a6,10,78780496,78814765,protein_coding,1,34269,chr10_78780496_78814765
Olfr1356,10,78845052,78852166,protein_coding,-1,7114,chr10_78845052_78852166
Olfr1355,10,78875540,78882266,protein_coding,1,6726,chr10_78875540_78882266
Olfr8,10,78950636,78958378,protein_coding,1,7742,chr10_78950636_78958378
Gm47343,10,78972103,79012892,lincRNA,-1,40789,chr10_78972103_79012892
Olfr1351,10,79012472,79019645,protein_coding,1,7173,chr10_79012472_79019645
Olfr57,10,79028741,79036274,protein_coding,1,7533,chr10_79028741_79036274
2610008E11Rik,10,79064374,79097600,protein_coding,-1,33226,chr10_79064374_79097600
Vmn2r80,10,79148769,79195012,protein_coding,1,46243,chr10_79148769_79195012
Vmn2r81,10,79247692,79294535,protein_coding,1,46843,chr10_79247692_79294535
Vmn2r82,10,79356520,79397849,protein_coding,1,41329,chr10_79356520_79397849
Gm47015,10,79412962,79417905,lincRNA,-1,4943,chr10_79412962_79417905
Vmn2r83,10,79468731,79493585,protein_coding,1,24854,chr10_79468731_79493585
Plpp2,10,79526430,79533796,protein_coding,-1,7366,chr10_79526430_79533796
Mier2,10,79540245,79555199,protein_coding,-1,14954,chr10_79540245_79555199
Theg,10,79576379,79587331,protein_coding,-1,10952,chr10_79576379_79587331
C2cd4c,10,79606854,79614025,protein_coding,-1,7171,chr10_79606854_79614025
Shc2,10,79618051,79637918,protein_coding,-1,19867,chr10_79618051_79637918
Odf3l2,10,79639526,79645738,protein_coding,-1,6212,chr10_79639526_79645738
Madcam1,10,79664559,79668537,protein_coding,1,3978,chr10_79664559_79668537
Tpgs1,10,79669369,79676127,protein_coding,1,6758,chr10_79669369_79676127
Cdc34,10,79682195,79688398,protein_coding,1,6203,chr10_79682195_79688398
Gzmm,10,79689020,79695261,protein_coding,1,6241,chr10_79689020_79695261
Bsg,10,79704491,79711969,protein_coding,1,7478,chr10_79704491_79711969
Hcn2,10,79716634,79736108,protein_coding,1,19474,chr10_79716634_79736108
Polrmt,10,79736123,79746581,protein_coding,-1,10458,chr10_79736123_79746581
Fgf22,10,79755076,79758596,protein_coding,1,3520,chr10_79755076_79758596
Rnf126,10,79758515,79766952,protein_coding,-1,8437,chr10_79758515_79766952
Fstl3,10,79777272,79782630,protein_coding,1,5358,chr10_79777272_79782630
Prss57,10,79781474,79790961,protein_coding,-1,9487,chr10_79781474_79790961
Palm,10,79793572,79820896,protein_coding,1,27324,chr10_79793572_79820896
Gm48495,10,79793781,79794656,antisense,-1,875,chr10_79793781_79794656
Misp,10,79820989,79830490,protein_coding,1,9501,chr10_79820989_79830490
Ptbp1,10,79854427,79864771,protein_coding,1,10344,chr10_79854427_79864771
Plppr3,10,79860475,79874634,protein_coding,-1,14159,chr10_79860475_79874634
Prtn3,10,79874476,79883174,protein_coding,1,8698,chr10_79874476_79883174
Elane,10,79886247,79888215,protein_coding,1,1968,chr10_79886247_79888215
Med16,10,79894708,79908923,protein_coding,-1,14215,chr10_79894708_79908923
R3hdm4,10,79910052,79921208,protein_coding,-1,11156,chr10_79910052_79921208
Gm26602,10,79910856,79911140,protein_coding,1,284,chr10_79910856_79911140
Kiss1r,10,79916971,79922273,protein_coding,1,5302,chr10_79916971_79922273
Arid3a,10,79927043,79955018,protein_coding,1,27975,chr10_79927043_79955018
Wdr18,10,79960152,79970203,protein_coding,1,10051,chr10_79960152_79970203
Grin3b,10,79970715,79977190,protein_coding,1,6475,chr10_79970715_79977190
Tmem259,10,79974948,79984330,protein_coding,-1,9382,chr10_79974948_79984330
Cnn2,10,79988584,79996062,protein_coding,1,7478,chr10_79988584_79996062
Abca7,10,79996494,80015572,protein_coding,1,19078,chr10_79996494_80015572
Arhgap45,10,80016653,80031472,protein_coding,1,14819,chr10_80016653_80031472
Polr2e,10,80035949,80039795,protein_coding,-1,3846,chr10_80035949_80039795
Gpx4,10,80047166,80056439,protein_coding,1,9273,chr10_80047166_80056439
Sbno2,10,80056992,80105571,protein_coding,-1,48579,chr10_80056992_80105571
Stk11,10,80115803,80130682,protein_coding,1,14879,chr10_80115803_80130682
Cbarp,10,80130451,80140835,protein_coding,-1,10384,chr10_80130451_80140835
Atp5d,10,80138632,80145818,protein_coding,1,7186,chr10_80138632_80145818
Midn,10,80148272,80158368,protein_coding,1,10096,chr10_80148272_80158368
Cirbp,10,80165985,80172786,protein_coding,1,6801,chr10_80165985_80172786
Efna2,10,80179482,80190010,protein_coding,1,10528,chr10_80179482_80190010
Ndufs7,10,80249121,80256794,protein_coding,1,7673,chr10_80249121_80256794
Gamt,10,80258151,80261012,protein_coding,-1,2861,chr10_80258151_80261012
Dazap1,10,80261486,80288408,protein_coding,1,26922,chr10_80261486_80288408
Gm15122,10,80282444,80283006,antisense,-1,562,chr10_80282444_80283006
Rps15,10,80292453,80294114,protein_coding,1,1661,chr10_80292453_80294114
Apc2,10,80295977,80318263,protein_coding,1,22286,chr10_80295977_80318263
2310011J03Rik,10,80318254,80320537,protein_coding,-1,2283,chr10_80318254_80320537
Pcsk4,10,80321283,80329498,protein_coding,-1,8215,chr10_80321283_80329498
Reep6,10,80329953,80336441,protein_coding,1,6488,chr10_80329953_80336441
Adamtsl5,10,80339110,80348412,protein_coding,-1,9302,chr10_80339110_80348412
Plk5,10,80356459,80365489,protein_coding,1,9030,chr10_80356459_80365489
Gm15124,10,80371955,80373216,antisense,1,1261,chr10_80371955_80373216
Mex3d,10,80380355,80387659,protein_coding,-1,7304,chr10_80380355_80387659
Mbd3,10,80392539,80399550,protein_coding,-1,7011,chr10_80392539_80399550
Uqcr11,10,80402997,80406830,protein_coding,-1,3833,chr10_80402997_80406830
Tcf3,10,80409514,80433647,protein_coding,-1,24133,chr10_80409514_80433647
Onecut3,10,80494835,80517276,protein_coding,1,22441,chr10_80494835_80517276
Atp8b3,10,80519584,80539124,protein_coding,-1,19540,chr10_80519584_80539124
Rexo1,10,80540922,80561560,protein_coding,-1,20638,chr10_80540922_80561560
Klf16,10,80567124,80577321,protein_coding,-1,10197,chr10_80567124_80577321
Abhd17a,10,80583654,80590341,protein_coding,-1,6687,chr10_80583654_80590341
Gm49322,10,80606021,80615784,protein_coding,1,9763,chr10_80606021_80615784
Csnk1g2,10,80622838,80640749,protein_coding,1,17911,chr10_80622838_80640749
Btbd2,10,80642617,80657071,protein_coding,-1,14454,chr10_80642617_80657071
Mknk2,10,80665327,80678112,protein_coding,-1,12785,chr10_80665327_80678112
Mob3a,10,80685253,80701977,protein_coding,-1,16724,chr10_80685253_80701977
Izumo4,10,80702184,80705373,protein_coding,1,3189,chr10_80702184_80705373
Ap3d1,10,80706956,80742264,protein_coding,-1,35308,chr10_80706956_80742264
Dot1l,10,80755206,80795461,protein_coding,1,40255,chr10_80755206_80795461
Gm17151,10,80766859,80768987,antisense,-1,2128,chr10_80766859_80768987
Plekhj1,10,80796099,80798626,protein_coding,-1,2527,chr10_80796099_80798626
Sf3a2,10,80798198,80804924,protein_coding,1,6726,chr10_80798198_80804924
Amh,10,80805243,80807648,protein_coding,1,2405,chr10_80805243_80807648
Jsrp1,10,80808496,80813498,protein_coding,-1,5002,chr10_80808496_80813498
Oaz1,10,80826656,80829290,protein_coding,1,2634,chr10_80826656_80829290
Lingo3,10,80832801,80844039,protein_coding,-1,11238,chr10_80832801_80844039
Lsm7,10,80852821,80855209,protein_coding,-1,2388,chr10_80852821_80855209
Sppl2b,10,80855275,80868708,protein_coding,1,13433,chr10_80855275_80868708
Tmprss9,10,80871848,80899492,protein_coding,1,27644,chr10_80871848_80899492
Timm13,10,80899450,80900969,protein_coding,-1,1519,chr10_80899450_80900969
Lmnb2,10,80901203,80918245,protein_coding,-1,17042,chr10_80901203_80918245
Gadd45b,10,80930073,80932204,protein_coding,1,2131,chr10_80930073_80932204
Gng7,10,80948624,81014945,protein_coding,-1,66321,chr10_80948624_81014945
Diras1,10,81019589,81025662,protein_coding,-1,6073,chr10_81019589_81025662
Gm16099,10,81024811,81026567,antisense,1,1756,chr10_81024811_81026567
Slc39a3,10,81028538,81037426,protein_coding,-1,8888,chr10_81028538_81037426
Sgta,10,81044075,81060181,protein_coding,-1,16106,chr10_81044075_81060181
Thop1,10,81070035,81082559,protein_coding,1,12524,chr10_81070035_81082559
Creb3l3,10,81084324,81098874,protein_coding,-1,14550,chr10_81084324_81098874
Map2k2,10,81105915,81133975,protein_coding,1,28060,chr10_81105915_81133975
Zbtb7a,10,81135220,81152995,protein_coding,1,17775,chr10_81135220_81152995
Pias4,10,81153266,81167923,protein_coding,-1,14657,chr10_81153266_81167923
Eef2,10,81176631,81182498,protein_coding,1,5867,chr10_81176631_81182498
Dapk3,10,81183005,81193197,protein_coding,1,10192,chr10_81183005_81193197
Atcayos,10,81194609,81210877,antisense,1,16268,chr10_81194609_81210877
Nmrk2,10,81198170,81202051,protein_coding,-1,3881,chr10_81198170_81202051
Atcay,10,81204508,81230833,protein_coding,-1,26325,chr10_81204508_81230833
Zfr2,10,81233155,81252123,protein_coding,1,18968,chr10_81233155_81252123
Matk,10,81252935,81263365,protein_coding,1,10430,chr10_81252935_81263365
Mrpl54,10,81264713,81266934,protein_coding,-1,2221,chr10_81264713_81266934
Apba3,10,81266960,81273246,protein_coding,1,6286,chr10_81266960_81273246
Tjp3,10,81273207,81291581,protein_coding,-1,18374,chr10_81273207_81291581
Pip5k1c,10,81292963,81319973,protein_coding,1,27010,chr10_81292963_81319973
Gm16315,10,81301701,81302917,antisense,-1,1216,chr10_81301701_81302917
Cactin,10,81321103,81326242,protein_coding,1,5139,chr10_81321103_81326242
Tbxa2r,10,81328731,81335172,protein_coding,1,6441,chr10_81328731_81335172
Gipc3,10,81335265,81343266,protein_coding,-1,8001,chr10_81335265_81343266
Hmg20b,10,81346048,81350480,protein_coding,-1,4432,chr10_81346048_81350480
Mfsd12,10,81357491,81366225,protein_coding,1,8734,chr10_81357491_81366225
4930404N11Rik,10,81363067,81365816,protein_coding,-1,2749,chr10_81363067_81365816
Fzr1,10,81366222,81378516,protein_coding,-1,12294,chr10_81366222_81378516
Dohh,10,81384428,81388352,protein_coding,1,3924,chr10_81384428_81388352
Gm48551,10,81384466,81391560,protein_coding,1,7094,chr10_81384466_81391560
Smim24,10,81393051,81395392,protein_coding,1,2341,chr10_81393051_81395392
Nfic,10,81396186,81455635,protein_coding,-1,59449,chr10_81396186_81455635
Gm16104,10,81409575,81411579,antisense,1,2004,chr10_81409575_81411579
Celf5,10,81459227,81482709,protein_coding,-1,23482,chr10_81459227_81482709
Gm16105,10,81461159,81462972,antisense,1,1813,chr10_81461159_81462972
Ncln,10,81486249,81496392,protein_coding,-1,10143,chr10_81486249_81496392
S1pr4,10,81497747,81500132,protein_coding,-1,2385,chr10_81497747_81500132
Gna15,10,81502306,81524225,protein_coding,-1,21919,chr10_81502306_81524225
Gm47697,10,81525411,81526988,lincRNA,1,1577,chr10_81525411_81526988
Gna11,10,81528724,81545190,protein_coding,-1,16466,chr10_81528724_81545190
Gm15917,10,81572612,81575940,antisense,-1,3328,chr10_81572612_81575940
Tle2,10,81574561,81590845,protein_coding,1,16284,chr10_81574561_81590845
Tle6,10,81590904,81601073,protein_coding,-1,10169,chr10_81590904_81601073
BC025920,10,81606270,81620703,protein_coding,1,14433,chr10_81606270_81620703
Sirt6,10,81621785,81627797,protein_coding,-1,6012,chr10_81621785_81627797
Ankrd24,10,81628540,81647610,protein_coding,1,19070,chr10_81628540_81647610
Gm10778,10,81649059,81667361,protein_coding,1,18302,chr10_81649059_81667361
Zfp433,10,81704825,81726686,protein_coding,1,21861,chr10_81704825_81726686
Gm3055,10,81742821,81771161,protein_coding,-1,28340,chr10_81742821_81771161
Gm4767,10,81812186,81826490,protein_coding,1,14304,chr10_81812186_81826490
Gm32687,10,81863934,81881081,protein_coding,1,17147,chr10_81863934_81881081
Zfp781,10,81901911,81930480,protein_coding,-1,28569,chr10_81901911_81930480
Zfp873,10,82048123,82064745,protein_coding,1,16622,chr10_82048123_82064745
BC024063,10,82083353,82111216,protein_coding,1,27863,chr10_82083353_82111216
AU041133,10,82128013,82153065,protein_coding,1,25052,chr10_82128013_82153065
Zfp938,10,82224850,82241280,protein_coding,-1,16430,chr10_82224850_82241280
4932415D10Rik,10,82282116,82316582,protein_coding,-1,34466,chr10_82282116_82316582
Gm4924,10,82354255,82422882,protein_coding,1,68627,chr10_82354255_82422882
Gm1553,10,82486537,82492618,protein_coding,-1,6081,chr10_82486537_82492618
1190007I07Rik,10,82619851,82623228,protein_coding,-1,3377,chr10_82619851_82623228
Tdg,10,82629828,82650799,protein_coding,1,20971,chr10_82629828_82650799
Glt8d2,10,82650433,82690650,protein_coding,-1,40217,chr10_82650433_82690650
Hcfc2,10,82696160,82742428,protein_coding,1,46268,chr10_82696160_82742428
Nfyb,10,82748701,82764144,protein_coding,-1,15443,chr10_82748701_82764144
Gm47561,10,82771321,82777781,lincRNA,1,6460,chr10_82771321_82777781
1700028I16Rik,10,82812123,82824242,lincRNA,1,12119,chr10_82812123_82824242
Txnrd1,10,82833951,82897712,protein_coding,1,63761,chr10_82833951_82897712
Chst11,10,82985498,83195900,protein_coding,1,210402,chr10_82985498_83195900
1700025N21Rik,10,83139150,83142038,antisense,-1,2888,chr10_83139150_83142038
Slc41a2,10,83230848,83337882,protein_coding,-1,107034,chr10_83230848_83337882
Gm40723,10,83344513,83351079,lincRNA,1,6566,chr10_83344513_83351079
D10Wsu102e,10,83360221,83488505,protein_coding,1,128284,chr10_83360221_83488505
Aldh1l2,10,83487450,83534140,protein_coding,-1,46690,chr10_83487450_83534140
Washc4,10,83543752,83596473,protein_coding,1,52721,chr10_83543752_83596473
Appl2,10,83600033,83648738,protein_coding,-1,48705,chr10_83600033_83648738
1500009L16Rik,10,83722865,83762762,protein_coding,1,39897,chr10_83722865_83762762
C230099D08Rik,10,83992728,84004860,lincRNA,-1,12132,chr10_83992728_84004860
Gm34184,10,84036560,84100697,lincRNA,-1,64137,chr10_84036560_84100697
Gm34113,10,84092266,84096249,lincRNA,1,3983,chr10_84092266_84096249
Gm47253,10,84191820,84222057,lincRNA,-1,30237,chr10_84191820_84222057
Nuak1,10,84370905,84440597,protein_coding,-1,69692,chr10_84370905_84440597
4930463O16Rik,10,84488293,84497435,lincRNA,1,9142,chr10_84488293_84497435
E230014E18Rik,10,84518045,84523270,lincRNA,1,5225,chr10_84518045_84523270
Ckap4,10,84526305,84534062,protein_coding,-1,7757,chr10_84526305_84534062
Platr7,10,84547417,84553338,lincRNA,-1,5921,chr10_84547417_84553338
Tcp11l2,10,84576626,84614359,protein_coding,1,37733,chr10_84576626_84614359
Polr3b,10,84622292,84727178,protein_coding,1,104886,chr10_84622292_84727178
Rfx4,10,84756062,84906538,protein_coding,1,150476,chr10_84756062_84906538
Ric8b,10,84917616,85018337,protein_coding,1,100721,chr10_84917616_85018337
Fhl4,10,85096287,85102495,protein_coding,-1,6208,chr10_85096287_85102495
Tmem263,10,85102627,85120618,protein_coding,1,17991,chr10_85102627_85120618
Mterf2,10,85119433,85128027,protein_coding,-1,8594,chr10_85119433_85128027
Cry1,10,85131700,85185064,protein_coding,-1,53364,chr10_85131700_85185064
Btbd11,10,85386814,85660292,protein_coding,1,273478,chr10_85386814_85660292
Gm1559,10,85806213,85810887,lincRNA,-1,4674,chr10_85806213_85810887
Pwp1,10,85829494,85889096,protein_coding,1,59602,chr10_85829494_85889096
Prdm4,10,85891966,85917142,protein_coding,-1,25176,chr10_85891966_85917142
Ascl4,10,85927681,85946206,protein_coding,1,18525,chr10_85927681_85946206
Rtcb,10,85938637,85957823,protein_coding,-1,19186,chr10_85938637_85957823
Bpifc,10,85959340,86011895,protein_coding,-1,52555,chr10_85959340_86011895
A230060F14Rik,10,86020441,86022329,antisense,-1,1888,chr10_86020441_86022329
Fbxo7,10,86021972,86051873,protein_coding,1,29901,chr10_86021972_86051873
Syn3,10,86055125,86498896,protein_coding,-1,443771,chr10_86055125_86498896
4930486F22Rik,10,86095859,86113586,antisense,1,17727,chr10_86095859_86113586
Gm15990,10,86125827,86129854,antisense,1,4027,chr10_86125827_86129854
Timp3,10,86300372,86349506,protein_coding,1,49134,chr10_86300372_86349506
Gm6729,10,86526299,86541334,lincRNA;processed_pseudogene,-1,15035,chr10_86526299_86541334
Gm48485,10,86657405,86671018,lincRNA,1,13613,chr10_86657405_86671018
Hsp90b1,10,86690209,86705509,protein_coding,-1,15300,chr10_86690209_86705509
Ttc41,10,86705811,86776844,protein_coding,1,71033,chr10_86705811_86776844
Gm49358,10,86763972,86833972,protein_coding,1,70000,chr10_86763972_86833972
Nt5dc3,10,86779005,86838389,protein_coding,1,59384,chr10_86779005_86838389
Gm16268,10,86839094,86874954,antisense,1,35860,chr10_86839094_86874954
Stab2,10,86841198,87008025,protein_coding,-1,166827,chr10_86841198_87008025
Gm16271,10,86972216,87028015,antisense,1,55799,chr10_86972216_87028015
1700113H08Rik,10,87058045,87230589,protein_coding,1,172544,chr10_87058045_87230589
4930555G07Rik,10,87230760,87297555,lincRNA,1,66795,chr10_87230760_87297555
Ascl1,10,87490819,87493660,protein_coding,-1,2841,chr10_87490819_87493660
Pah,10,87521795,87584136,protein_coding,1,62341,chr10_87521795_87584136
Igf1os,10,87826377,87863381,antisense,-1,37004,chr10_87826377_87863381
Igf1,10,87858265,87937042,protein_coding,1,78777,chr10_87858265_87937042
Gm48306,10,87980462,87984220,lincRNA,1,3758,chr10_87980462_87984220
Parpbp,10,88091432,88146941,protein_coding,-1,55509,chr10_88091432_88146941
4921515L22Rik,10,88135919,88137531,antisense,1,1612,chr10_88135919_88137531
Nup37,10,88146992,88178390,protein_coding,1,31398,chr10_88146992_88178390
Washc3,10,88201093,88246158,protein_coding,1,45065,chr10_88201093_88246158
Dram1,10,88322804,88379080,protein_coding,-1,56276,chr10_88322804_88379080
Gnptab,10,88379132,88447329,protein_coding,1,68197,chr10_88379132_88447329
Gm16235,10,88444236,88449887,antisense,-1,5651,chr10_88444236_88449887
Chpt1,10,88452745,88504073,protein_coding,-1,51328,chr10_88452745_88504073
Sycp3,10,88459569,88473236,protein_coding,1,13667,chr10_88459569_88473236
Mybpc1,10,88518279,88605152,protein_coding,-1,86873,chr10_88518279_88605152
Spic,10,88674772,88685015,protein_coding,-1,10243,chr10_88674772_88685015
Arl1,10,88730858,88744094,protein_coding,1,13236,chr10_88730858_88744094
Utp20,10,88746607,88826804,protein_coding,-1,80197,chr10_88746607_88826804
Slc5a8,10,88885992,88929515,protein_coding,1,43523,chr10_88885992_88929515
Ano4,10,88948994,89344762,protein_coding,-1,395768,chr10_88948994_89344762
Gas2l3,10,89408823,89443967,protein_coding,-1,35144,chr10_89408823_89443967
Nr1h4,10,89454234,89533585,protein_coding,-1,79351,chr10_89454234_89533585
Slc17a8,10,89574020,89621253,protein_coding,-1,47233,chr10_89574020_89621253
Scyl2,10,89638721,89686285,protein_coding,-1,47564,chr10_89638721_89686285
Actr6,10,89711971,89732295,protein_coding,-1,20324,chr10_89711971_89732295
Uhrf1bp1l,10,89744991,89819871,protein_coding,1,74880,chr10_89744991_89819871
Anks1b,10,89873509,90973300,protein_coding,1,1099791,chr10_89873509_90973300
Apaf1,10,90989311,91082770,protein_coding,-1,93459,chr10_90989311_91082770
Ikbip,10,91082940,91102607,protein_coding,1,19667,chr10_91082940_91102607
Slc25a3,10,91116574,91124059,protein_coding,-1,7485,chr10_91116574_91124059
Tmpo,10,91147571,91181315,protein_coding,-1,33744,chr10_91147571_91181315
4930534H03Rik,10,91208258,91220642,lincRNA,-1,12384,chr10_91208258_91220642
Gm31592,10,91888829,91953580,lincRNA,1,64751,chr10_91888829_91953580
Rmst,10,92071037,92165170,lincRNA,-1,94133,chr10_92071037_92165170
Gm20757,10,92171301,92375373,lincRNA,-1,204072,chr10_92171301_92375373
4930401A07Rik,10,92401014,92417495,lincRNA,1,16481,chr10_92401014_92417495
Gm31822,10,92644091,92651734,lincRNA,1,7643,chr10_92644091_92651734
Nedd1,10,92684746,92722420,protein_coding,-1,37674,chr10_92684746_92722420
Cfap54,10,92775619,93081618,protein_coding,-1,305999,chr10_92775619_93081618
Gm32468,10,93084206,93093727,lincRNA,1,9521,chr10_93084206_93093727
Cdk17,10,93160875,93267071,protein_coding,1,106196,chr10_93160875_93267071
Elk3,10,93247414,93311135,protein_coding,-1,63721,chr10_93247414_93311135
Gm32688,10,93317403,93322725,lincRNA,1,5322,chr10_93317403_93322725
Gm17745,10,93335393,93348877,lincRNA,1,13484,chr10_93335393_93348877
Lta4h,10,93453411,93484875,protein_coding,1,31464,chr10_93453411_93484875
Hal,10,93488768,93519304,protein_coding,1,30536,chr10_93488768_93519304
Amdhd1,10,93523338,93540033,protein_coding,-1,16695,chr10_93523338_93540033
Ccdc38,10,93540632,93584327,protein_coding,1,43695,chr10_93540632_93584327
Snrpf,10,93583029,93589706,protein_coding,-1,6677,chr10_93583029_93589706
4933408J17Rik,10,93589413,93605245,lincRNA,1,15832,chr10_93589413_93605245
Gm47156,10,93618862,93634323,lincRNA,1,15461,chr10_93618862_93634323
Ntn4,10,93640681,93747207,protein_coding,1,106526,chr10_93640681_93747207
Gm15915,10,93674218,93683322,antisense,-1,9104,chr10_93674218_93683322
Gm15963,10,93726726,93728207,antisense,-1,1481,chr10_93726726_93728207
Usp44,10,93831555,93858088,protein_coding,1,26533,chr10_93831555_93858088
Metap2,10,93858489,93897093,protein_coding,-1,38604,chr10_93858489_93897093
Vezt,10,93939165,94035817,protein_coding,-1,96652,chr10_93939165_94035817
Fgd6,10,94036001,94145339,protein_coding,1,109338,chr10_94036001_94145339
Nr2c1,10,94148023,94197211,protein_coding,1,49188,chr10_94148023_94197211
Ndufa12,10,94198720,94221443,protein_coding,1,22723,chr10_94198720_94221443
Gm4792,10,94293665,94298703,protein_coding,-1,5038,chr10_94293665_94298703
Tmcc3,10,94311949,94590956,protein_coding,1,279007,chr10_94311949_94590956
Tmcc3os,10,94567828,94612084,antisense,-1,44256,chr10_94567828_94612084
Gm48657,10,94620540,94648657,lincRNA,1,28117,chr10_94620540_94648657
Cep83,10,94688654,94790853,protein_coding,1,102199,chr10_94688654_94790853
Gm48689,10,94781974,94787161,antisense,-1,5187,chr10_94781974_94787161
Plxnc1,10,94790866,94944835,protein_coding,-1,153969,chr10_94790866_94944835
Gm48867,10,94993952,94999442,lincRNA,-1,5490,chr10_94993952_94999442
Gm29684,10,95120582,95145825,lincRNA,-1,25243,chr10_95120582_95145825
Cradd,10,95174746,95324133,protein_coding,-1,149387,chr10_95174746_95324133
Gm48882,10,95318247,95324358,antisense,1,6111,chr10_95318247_95324358
2310039L15Rik,10,95336276,95366202,lincRNA,1,29926,chr10_95336276_95366202
Socs2,10,95385362,95417180,protein_coding,-1,31818,chr10_95385362_95417180
Gm47599,10,95445316,95461224,lincRNA,-1,15908,chr10_95445316_95461224
Mrpl42,10,95480805,95501940,protein_coding,-1,21135,chr10_95480805_95501940
Ube2n,10,95515145,95545657,protein_coding,1,30512,chr10_95515145_95545657
Nudt4,10,95547007,95564146,protein_coding,-1,17139,chr10_95547007_95564146
Anapc15-ps,10,95672991,95673451,protein_coding,-1,460,chr10_95672991_95673451
Gm47671,10,95714001,95717507,lincRNA,-1,3506,chr10_95714001_95717507
Gm47708,10,95730183,95739356,lincRNA,1,9173,chr10_95730183_95739356
4732465J04Rik,10,95746077,95797236,lincRNA,1,51159,chr10_95746077_95797236
Gm47718,10,95811337,95817895,lincRNA,-1,6558,chr10_95811337_95817895
Gm47719,10,95817570,95849118,lincRNA,1,31548,chr10_95817570_95849118
Gm33543,10,95823973,95842930,protein_coding,-1,18957,chr10_95823973_95842930
Gm47725,10,95893443,95897257,lincRNA,1,3814,chr10_95893443_95897257
Eea1,10,95940650,96045518,protein_coding,1,104868,chr10_95940650_96045518
Gm5426,10,96136603,96136914,protein_coding,1,311,chr10_96136603_96136914
4930459C07Rik,10,96226020,96248866,lincRNA,1,22846,chr10_96226020_96248866
Gm33782,10,96310131,96362367,lincRNA,1,52236,chr10_96310131_96362367
Gm48428,10,96336090,96345824,lincRNA,-1,9734,chr10_96336090_96345824
Gm48505,10,96495721,96523982,lincRNA,-1,28261,chr10_96495721_96523982
Gm33843,10,96519157,96595731,lincRNA,-1,76574,chr10_96519157_96595731
Btg1,10,96617006,96622809,protein_coding,1,5803,chr10_96617006_96622809
Gm48521,10,96801039,96884708,lincRNA,1,83669,chr10_96801039_96884708
Gm33981,10,96903158,96958871,lincRNA,-1,55713,chr10_96903158_96958871
4930556N09Rik,10,97035768,97061059,lincRNA,1,25291,chr10_97035768_97061059
Dcn,10,97479609,97518143,protein_coding,1,38534,chr10_97479609_97518143
Lum,10,97565128,97572703,protein_coding,1,7575,chr10_97565128_97572703
4930473O22Rik,10,97590984,97596931,lincRNA,-1,5947,chr10_97590984_97596931
Kera,10,97606879,97613692,protein_coding,1,6813,chr10_97606879_97613692
Epyc,10,97644068,97682454,protein_coding,1,38386,chr10_97644068_97682454
Gm10754,10,97681414,97967090,lincRNA,-1,285676,chr10_97681414_97967090
Ccer1,10,97693059,97694923,protein_coding,1,1864,chr10_97693059_97694923
4930525C09Rik,10,97714772,97753702,lincRNA,1,38930,chr10_97714772_97753702
Gm8633,10,98299927,98351874,lincRNA,-1,51947,chr10_98299927_98351874
Gm34297,10,98537478,98569836,lincRNA,1,32358,chr10_98537478_98569836
Gm5427,10,98653799,98699710,lincRNA,-1,45911,chr10_98653799_98699710
Atp2b1,10,98914406,99026143,protein_coding,1,111737,chr10_98914406_99026143
Poc1b,10,99107036,99198074,protein_coding,1,91038,chr10_99107036_99198074
Phxr2,10,99125167,99126325,protein_coding,-1,1158,chr10_99125167_99126325
Gm16239,10,99179184,99184610,antisense,-1,5426,chr10_99179184_99184610
Gm34574,10,99216442,99228906,lincRNA,-1,12464,chr10_99216442_99228906
Gm34777,10,99233117,99243062,lincRNA,1,9945,chr10_99233117_99243062
Dusp6,10,99263231,99267489,protein_coding,1,4258,chr10_99263231_99267489
Gm34921,10,99267686,99270446,lincRNA,-1,2760,chr10_99267686_99270446
Gm48089,10,99267896,99279084,lincRNA,1,11188,chr10_99267896_99279084
B530045E10Rik,10,99298888,99423047,lincRNA,1,124159,chr10_99298888_99423047
Gm35035,10,99452654,99460230,lincRNA,-1,7576,chr10_99452654_99460230
Gm34983,10,99459689,99488610,lincRNA,1,28921,chr10_99459689_99488610
Gm20110,10,99609171,99658134,lincRNA,1,48963,chr10_99609171_99658134
Gm35101,10,99669514,99675623,lincRNA,1,6109,chr10_99669514_99675623
Gm47578,10,99719143,99891158,antisense,1,172015,chr10_99719143_99891158
Csl,10,99757706,99759658,protein_coding,-1,1952,chr10_99757706_99759658
Kitl,10,100015630,100100416,protein_coding,1,84786,chr10_100015630_100100416
Tmtc3,10,100443902,100487350,protein_coding,-1,43448,chr10_100443902_100487350
Cep290,10,100487558,100574840,protein_coding,1,87282,chr10_100487558_100574840
4930430F08Rik,10,100572265,100590423,protein_coding,-1,18158,chr10_100572265_100590423
1700017N19Rik,10,100590484,100618401,protein_coding,1,27917,chr10_100590484_100618401
Gm35722,10,100707535,100741635,lincRNA,-1,34100,chr10_100707535_100741635
Mgat4c,10,101681487,102391469,protein_coding,1,709982,chr10_101681487_102391469
Gm47033,10,102415883,102418014,lincRNA,1,2131,chr10_102415883_102418014
Nts,10,102481756,102490486,protein_coding,-1,8730,chr10_102481756_102490486
Rassf9,10,102512222,102549736,protein_coding,1,37514,chr10_102512222_102549736
Gm47143,10,102683265,102694569,lincRNA,1,11304,chr10_102683265_102694569
Alx1,10,102998707,103030215,protein_coding,-1,31508,chr10_102998707_103030215
Lrriq1,10,103046031,103236322,protein_coding,-1,190291,chr10_103046031_103236322
Slc6a15,10,103367783,103419377,protein_coding,1,51594,chr10_103367783_103419377
Gm47221,10,103512928,103571685,lincRNA,1,58757,chr10_103512928_103571685
Gm47224,10,103856267,103858332,lincRNA,-1,2065,chr10_103856267_103858332
Gm21293,10,104142987,104153674,protein_coding,1,10687,chr10_104142987_104153674
Tmtc2,10,105187663,105574451,protein_coding,-1,386788,chr10_105187663_105574451
Mettl25,10,105763189,105841380,protein_coding,-1,78191,chr10_105763189_105841380
Ccdc59,10,105841067,105847833,protein_coding,1,6766,chr10_105841067_105847833
Ppfia2,10,106470339,106935952,protein_coding,1,465613,chr10_106470339_106935952
4930532I03Rik,10,106555195,106602480,antisense,-1,47285,chr10_106555195_106602480
Acss3,10,106933517,107123668,protein_coding,-1,190151,chr10_106933517_107123668
Gm29674,10,107199912,107205775,lincRNA,-1,5863,chr10_107199912_107205775
Lin7a,10,107271686,107421474,protein_coding,1,149788,chr10_107271686_107421474
Myf6,10,107492853,107494737,protein_coding,-1,1884,chr10_107492853_107494737
Ptprq,10,107517049,107720051,protein_coding,-1,203002,chr10_107517049_107720051
Otogl,10,107760531,107912134,protein_coding,-1,151603,chr10_107760531_107912134
Gm29685,10,107946645,107977834,lincRNA,1,31189,chr10_107946645_107977834
Ppp1r12a,10,108162193,108284475,protein_coding,1,122282,chr10_108162193_108284475
Pawr,10,108332121,108414240,protein_coding,1,82119,chr10_108332121_108414240
Gm36283,10,108417251,108453297,lincRNA,1,36046,chr10_108417251_108453297
Syt1,10,108497650,109010982,protein_coding,-1,513332,chr10_108497650_109010982
Nav3,10,109681259,110456204,protein_coding,-1,774945,chr10_109681259_110456204
9230102K24Rik,10,110596266,110615961,lincRNA,1,19695,chr10_110596266_110615961
E2f7,10,110745439,110787384,protein_coding,1,41945,chr10_110745439_110787384
1700020G17Rik,10,110784585,110896550,antisense,-1,111965,chr10_110784585_110896550
Csrp2,10,110919789,110939622,protein_coding,1,19833,chr10_110919789_110939622
Zdhhc17,10,110941780,111010140,protein_coding,-1,68360,chr10_110941780_111010140
Osbpl8,10,111164752,111297249,protein_coding,1,132497,chr10_111164752_111297249
Bbs10,10,111298679,111301727,protein_coding,1,3048,chr10_111298679_111301727
Gm40761,10,111337124,111347185,lincRNA,1,10061,chr10_111337124_111347185
Nap1l1,10,111473223,111498150,protein_coding,1,24927,chr10_111473223_111498150
Phlda1,10,111506286,111508645,protein_coding,1,2359,chr10_111506286_111508645
Gm28592,10,111506575,111507662,lincRNA,-1,1087,chr10_111506575_111507662
4933440J02Rik,10,111586719,111594273,lincRNA,-1,7554,chr10_111586719_111594273
Gm30262,10,111599177,111611338,lincRNA,1,12161,chr10_111599177_111611338
Gm30624,10,111725184,111843048,lincRNA,1,117864,chr10_111725184_111843048
Gm47865,10,111757258,111799853,lincRNA,-1,42595,chr10_111757258_111799853
Gm20758,10,111854521,111874376,lincRNA,-1,19855,chr10_111854521_111874376
Krr1,10,111972664,111988432,protein_coding,1,15768,chr10_111972664_111988432
Glipr1,10,111985448,112002631,protein_coding,-1,17183,chr10_111985448_112002631
Glipr1l1,10,112060189,112078510,protein_coding,1,18321,chr10_112060189_112078510
Glipr1l2,10,112083354,112108098,protein_coding,1,24744,chr10_112083354_112108098
Glipr1l3,10,112141754,112160327,protein_coding,-1,18573,chr10_112141754_112160327
Caps2,10,112163621,112216555,protein_coding,1,52934,chr10_112163621_112216555
Gm47419,10,112213787,112231141,antisense,-1,17354,chr10_112213787_112231141
Kcnc2,10,112271121,112467024,protein_coding,1,195903,chr10_112271121_112467024
1700010J16Rik,10,112726888,112785602,lincRNA,1,58714,chr10_112726888_112785602
Gm3942,10,112837752,112845385,lincRNA,1,7633,chr10_112837752_112845385
Atxn7l3b,10,112925430,112929001,protein_coding,-1,3571,chr10_112925430_112929001
Gm47524,10,113113389,113117926,lincRNA,1,4537,chr10_113113389_113117926
Gm47532,10,113424184,113446080,lincRNA,1,21896,chr10_113424184_113446080
Gm40765,10,113551631,113562763,lincRNA,-1,11132,chr10_113551631_113562763
Trhde,10,114398821,114802307,protein_coding,-1,403486,chr10_114398821_114802307
4930473D10Rik,10,114757747,114785104,antisense,1,27357,chr10_114757747_114785104
Gm15723,10,114801726,114816831,antisense,1,15105,chr10_114801726_114816831
Gm31182,10,114875007,114885131,lincRNA,1,10124,chr10_114875007_114885131
Gm31267,10,114947931,114952835,lincRNA,1,4904,chr10_114947931_114952835
Tph2,10,115078641,115185022,protein_coding,-1,106381,chr10_115078641_115185022
Tbc1d15,10,115197872,115251467,protein_coding,-1,53595,chr10_115197872_115251467
Rab21,10,115287084,115315594,protein_coding,-1,28510,chr10_115287084_115315594
Tmem19,10,115339674,115362501,protein_coding,-1,22827,chr10_115339674_115362501
Thap2,10,115368404,115384443,protein_coding,-1,16039,chr10_115368404_115384443
Zfc3h1,10,115384959,115432772,protein_coding,1,47813,chr10_115384959_115432772
Lgr5,10,115450311,115587780,protein_coding,-1,137469,chr10_115450311_115587780
A930009A15Rik,10,115569986,115582448,protein_coding,1,12462,chr10_115569986_115582448
Tspan8,10,115816832,115849893,protein_coding,1,33061,chr10_115816832_115849893
Ptprr,10,116018213,116274932,protein_coding,1,256719,chr10_116018213_116274932
Ptprb,10,116275523,116389535,protein_coding,1,114012,chr10_116275523_116389535
Kcnmb4,10,116417861,116473878,protein_coding,-1,56017,chr10_116417861_116473878
Kcnmb4os1,10,116418052,116421237,antisense,1,3185,chr10_116418052_116421237
Kcnmb4os2,10,116473163,116475319,antisense,1,2156,chr10_116473163_116475319
Cnot2,10,116485161,116581511,protein_coding,-1,96350,chr10_116485161_116581511
Gm26579,10,116674591,116679303,lincRNA,1,4712,chr10_116674591_116679303
1700030O20Rik,10,116723067,116729177,lincRNA,-1,6110,chr10_116723067_116729177
4930579P08Rik,10,116729253,116739760,lincRNA,1,10507,chr10_116729253_116739760
Myrfl,10,116776535,116896919,protein_coding,-1,120384,chr10_116776535_116896919
Rab3ip,10,116905784,116950769,protein_coding,-1,44985,chr10_116905784_116950769
Gm10271,10,116956824,116972609,protein_coding,-1,15785,chr10_116956824_116972609
D630029K05Rik,10,116964707,116969105,lincRNA,1,4398,chr10_116964707_116969105
Best3,10,116986314,117025040,protein_coding,1,38726,chr10_116986314_117025040
Gm10747,10,117043746,117045101,lincRNA,1,1355,chr10_117043746_117045101
Lrrc10,10,117045341,117046768,protein_coding,1,1427,chr10_117045341_117046768
Cct2,10,117051001,117063814,protein_coding,-1,12813,chr10_117051001_117063814
Frs2,10,117069427,117148534,protein_coding,-1,79107,chr10_117069427_117148534
4930423D24Rik,10,117177303,117181112,lincRNA,1,3809,chr10_117177303_117181112
Yeats4,10,117215221,117224507,protein_coding,-1,9286,chr10_117215221_117224507
9530003J23Rik,10,117232237,117238703,protein_coding,-1,6466,chr10_117232237_117238703
Lyz2,10,117277331,117282321,protein_coding,-1,4990,chr10_117277331_117282321
Lyz1,10,117287797,117292868,protein_coding,-1,5071,chr10_117287797_117292868
Cpsf6,10,117344673,117380015,protein_coding,-1,35342,chr10_117344673_117380015
Gm48903,10,117390022,117398587,lincRNA,1,8565,chr10_117390022_117398587
Gm40770,10,117408872,117413904,lincRNA,-1,5032,chr10_117408872_117413904
Gm32141,10,117446015,117447493,lincRNA,-1,1478,chr10_117446015_117447493
Cpm,10,117629500,117687352,protein_coding,1,57852,chr10_117629500_117687352
Mdm2,10,117688875,117710758,protein_coding,-1,21883,chr10_117688875_117710758
Slc35e3,10,117733679,117746365,protein_coding,-1,12686,chr10_117733679_117746365
Nup107,10,117750621,117792705,protein_coding,-1,42084,chr10_117750621_117792705
Rap1b,10,117813871,117846035,protein_coding,-1,32164,chr10_117813871_117846035
Gm32552,10,117863681,117866715,lincRNA,-1,3034,chr10_117863681_117866715
4933411E08Rik,10,117925459,117948292,lincRNA,1,22833,chr10_117925459_117948292
5330439M10Rik,10,118112517,118124094,lincRNA,1,11577,chr10_118112517_118124094
Mdm1,10,118141811,118168997,protein_coding,1,27186,chr10_118141811_118168997
Gm47958,10,118163985,118165162,antisense,-1,1177,chr10_118163985_118165162
Il22,10,118204942,118210047,protein_coding,1,5105,chr10_118204942_118210047
Iltifb,10,118289629,118295038,protein_coding,-1,5409,chr10_118289629_118295038
Ifngas1,10,118502035,118556525,lincRNA,-1,54490,chr10_118502035_118556525
Gm33337,10,118714481,118715726,lincRNA,-1,1245,chr10_118714481_118715726
Gm47425,10,118718146,118719428,lincRNA,-1,1282,chr10_118718146_118719428
Gm4065,10,118803719,118805290,lincRNA,-1,1571,chr10_118803719_118805290
Dyrk2,10,118855603,118870209,protein_coding,-1,14606,chr10_118855603_118870209
Gm38403,10,118920381,118927143,lincRNA,-1,6762,chr10_118920381_118927143
Gm47461,10,119018346,119021670,lincRNA,-1,3324,chr10_119018346_119021670
Gm33677,10,119028290,119050499,lincRNA,-1,22209,chr10_119028290_119050499
1700064J06Rik,10,119092905,119103107,lincRNA,1,10202,chr10_119092905_119103107
Gm47480,10,119111624,119122966,lincRNA,1,11342,chr10_119111624_119122966
Gm34045,10,119135164,119166385,lincRNA,-1,31221,chr10_119135164_119166385
Cand1,10,119199255,119240055,protein_coding,-1,40800,chr10_119199255_119240055
4930477N07Rik,10,119320234,119331862,lincRNA,1,11628,chr10_119320234_119331862
1700025F24Rik,10,119413444,119426864,lincRNA,1,13420,chr10_119413444_119426864
Grip1os3,10,119429367,119455379,antisense,-1,26012,chr10_119429367_119455379
Grip1,10,119453830,120087261,protein_coding,1,633431,chr10_119453830_120087261
Gm47027,10,119600363,119617720,antisense,-1,17357,chr10_119600363_119617720
Grip1os2,10,119746063,119761699,antisense,-1,15636,chr10_119746063_119761699
Grip1os1,10,119825204,119852390,antisense,-1,27186,chr10_119825204_119852390
Helb,10,120083608,120112987,protein_coding,-1,29379,chr10_120083608_120112987
Irak3,10,120141648,120202130,protein_coding,-1,60482,chr10_120141648_120202130
Gm47009,10,120168649,120170345,antisense,1,1696,chr10_120168649_120170345
Tmbim4,10,120201590,120224917,protein_coding,1,23327,chr10_120201590_120224917
Llph,10,120227070,120232582,protein_coding,1,5512,chr10_120227070_120232582
Hmga2,10,120361275,120476469,protein_coding,-1,115194,chr10_120361275_120476469
1700006J14Rik,10,120364157,120384336,antisense,1,20179,chr10_120364157_120384336
9230105E05Rik,10,120389523,120392793,antisense,1,3270,chr10_120389523_120392793
4930471E19Rik,10,120632672,120699203,lincRNA,-1,66531,chr10_120632672_120699203
Gm48202,10,120760821,120766028,lincRNA,-1,5207,chr10_120760821_120766028
4921513I03Rik,10,120765732,120778886,lincRNA,1,13154,chr10_120765732_120778886
Msrb3,10,120781096,120899101,protein_coding,-1,118005,chr10_120781096_120899101
Gm15961,10,120800677,120801794,antisense,1,1117,chr10_120800677_120801794
Gm15910,10,120857629,120863326,antisense,1,5697,chr10_120857629_120863326
Lemd3,10,120923413,120979332,protein_coding,-1,55919,chr10_120923413_120979332
Gm48341,10,120984756,121001061,lincRNA,-1,16305,chr10_120984756_121001061
Wif1,10,121033960,121100650,protein_coding,1,66690,chr10_121033960_121100650
Gm48410,10,121113524,121115245,lincRNA,-1,1721,chr10_121113524_121115245
Tbc1d30,10,121263820,121351278,protein_coding,-1,87458,chr10_121263820_121351278
Gns,10,121365090,121397249,protein_coding,1,32159,chr10_121365090_121397249
Rassf3,10,121410350,121476347,protein_coding,-1,65997,chr10_121410350_121476347
Gm40787,10,121488986,121490147,lincRNA,1,1161,chr10_121488986_121490147
Gm46204,10,121505351,121505976,lincRNA,1,625,chr10_121505351_121505976
Gm35696,10,121506623,121526101,lincRNA,1,19478,chr10_121506623_121526101
Tbk1,10,121546455,121586787,protein_coding,-1,40332,chr10_121546455_121586787
Xpot,10,121587380,121626332,protein_coding,-1,38952,chr10_121587380_121626332
D930020B18Rik,10,121641588,121693915,protein_coding,1,52327,chr10_121641588_121693915
BC048403,10,121739937,121752878,protein_coding,1,12941,chr10_121739937_121752878
Srgap1,10,121780991,122047315,protein_coding,-1,266324,chr10_121780991_122047315
Gm4489,10,122119700,122130558,lincRNA,1,10858,chr10_122119700_122130558
Gm36041,10,122386892,122435033,lincRNA,1,48141,chr10_122386892_122435033
Gm48877,10,122405113,122546498,antisense,-1,141385,chr10_122405113_122546498
Avpr1a,10,122448499,122453452,protein_coding,1,4953,chr10_122448499_122453452
A130077B15Rik,10,122565023,122569891,lincRNA,-1,4868,chr10_122565023_122569891
Ppm1h,10,122678762,122945795,protein_coding,1,267033,chr10_122678762_122945795
Gm36208,10,122792055,122792483,antisense,-1,428,chr10_122792055_122792483
Mon2,10,122992060,123076505,protein_coding,-1,84445,chr10_122992060_123076505
Usp15,10,123105006,123196995,protein_coding,-1,91989,chr10_123105006_123196995
Gm47839,10,124821112,124845481,lincRNA,-1,24369,chr10_124821112_124845481
Gm36719,10,124995983,125019801,lincRNA,1,23818,chr10_124995983_125019801
Slc16a7,10,125219270,125389465,protein_coding,-1,170195,chr10_125219270_125389465
Gm45604,10,125308912,125310679,antisense,1,1767,chr10_125308912_125310679
Lrig3,10,125966168,126015359,protein_coding,1,49191,chr10_125966168_126015359
1700025K04Rik,10,126371975,126375062,lincRNA,1,3087,chr10_126371975_126375062
Gm40797,10,126663998,126674452,lincRNA,1,10454,chr10_126663998_126674452
Gm47966,10,126714005,126719394,lincRNA,-1,5389,chr10_126714005_126719394
4930484H19Rik,10,126788864,126793710,lincRNA,-1,4846,chr10_126788864_126793710
Atp23,10,126868427,126901355,protein_coding,-1,32928,chr10_126868427_126901355
Gm49335,10,126958023,126960997,lincRNA,1,2974,chr10_126958023_126960997
Gm47972,10,126962323,126962750,lincRNA,1,427,chr10_126962323_126962750
Ctdsp2,10,126978717,126999975,protein_coding,1,21258,chr10_126978717_126999975
Avil,10,127000709,127020994,protein_coding,1,20285,chr10_127000709_127020994
Tsfm,10,127011572,127030840,protein_coding,-1,19268,chr10_127011572_127030840
Eef1akmt3,10,127031004,127041513,protein_coding,-1,10509,chr10_127031004_127041513
Mettl1,10,127041414,127046365,protein_coding,1,4951,chr10_127041414_127046365
Cyp27b1,10,127048250,127053006,protein_coding,1,4756,chr10_127048250_127053006
Cdk4,10,127063534,127067920,protein_coding,1,4386,chr10_127063534_127067920
Tspan31,10,127067280,127070264,protein_coding,-1,2984,chr10_127067280_127070264
A730063M14Rik,10,127070375,127074796,lincRNA,1,4421,chr10_127070375_127074796
Agap2,10,127075284,127093169,protein_coding,1,17885,chr10_127075284_127093169
Os9,10,127095650,127121131,protein_coding,-1,25481,chr10_127095650_127121131
B4galnt1,10,127165225,127172330,protein_coding,1,7105,chr10_127165225_127172330
Slc26a10,10,127171393,127180645,protein_coding,-1,9252,chr10_127171393_127180645
Arhgef25,10,127182525,127190083,protein_coding,-1,7558,chr10_127182525_127190083
Dtx3,10,127190378,127195728,protein_coding,-1,5350,chr10_127190378_127195728
F420014N23Rik,10,127195249,127202643,lincRNA,1,7394,chr10_127195249_127202643
Pip4k2c,10,127197067,127211585,protein_coding,-1,14518,chr10_127197067_127211585
Kif5a,10,127225696,127263348,protein_coding,-1,37652,chr10_127225696_127263348
Dctn2,10,127266368,127281950,protein_coding,1,15582,chr10_127266368_127281950
Mbd6,10,127281956,127289018,protein_coding,-1,7062,chr10_127281956_127289018
Ddit3,10,127290774,127296288,protein_coding,1,5514,chr10_127290774_127296288
Arhgap9,10,127321964,127329943,protein_coding,1,7979,chr10_127321964_127329943
Gli1,10,127329882,127341974,protein_coding,-1,12092,chr10_127329882_127341974
Gm47200,10,127332391,127370406,antisense,1,38015,chr10_127332391_127370406
Inhbe,10,127348857,127354411,protein_coding,-1,5554,chr10_127348857_127354411
Inhbc,10,127356322,127370431,protein_coding,-1,14109,chr10_127356322_127370431
R3hdm2,10,127380327,127499384,protein_coding,1,119057,chr10_127380327_127499384
Stac3,10,127501686,127508823,protein_coding,1,7137,chr10_127501686_127508823
Ndufa4l2,10,127514967,127517154,protein_coding,1,2187,chr10_127514967_127517154
Shmt2,10,127517123,127522444,protein_coding,-1,5321,chr10_127517123_127522444
Nxph4,10,127525473,127534559,protein_coding,-1,9086,chr10_127525473_127534559
Lrp1,10,127538161,127621148,protein_coding,-1,82987,chr10_127538161_127621148
Gm16217,10,127596548,127597870,antisense,1,1322,chr10_127596548_127597870
Stat6,10,127642986,127660957,protein_coding,1,17971,chr10_127642986_127660957
Nab2,10,127660918,127668568,protein_coding,-1,7650,chr10_127660918_127668568
Gm16229,10,127663839,127665484,antisense,1,1645,chr10_127663839_127665484
Nemp1,10,127666901,127701049,protein_coding,1,34148,chr10_127666901_127701049
Gm16230,10,127671604,127676724,antisense,-1,5120,chr10_127671604_127676724
Myo1a,10,127705170,127720940,protein_coding,1,15770,chr10_127705170_127720940
Tac2,10,127724478,127731768,protein_coding,1,7290,chr10_127724478_127731768
Zbtb39,10,127739538,127747349,protein_coding,1,7811,chr10_127739538_127747349
Gpr182,10,127747276,127751732,protein_coding,-1,4456,chr10_127747276_127751732
Rdh16f1,10,127759787,127792694,protein_coding,1,32907,chr10_127759787_127792694
Rdh9,10,127776386,127792697,protein_coding,1,16311,chr10_127776386_127792697
Rdh16,10,127801152,127846565,protein_coding,1,45413,chr10_127801152_127846565
Rdh19,10,127849928,127861176,protein_coding,1,11248,chr10_127849928_127861176
Rdh16f2,10,127866474,127877317,protein_coding,1,10843,chr10_127866474_127877317
Rdh7,10,127884028,127888817,protein_coding,-1,4789,chr10_127884028_127888817
Sdr9c7,10,127898518,127911761,protein_coding,1,13243,chr10_127898518_127911761
Hsd17b6,10,127990936,128007611,protein_coding,-1,16675,chr10_127990936_128007611
Prim1,10,128015168,128030037,protein_coding,1,14869,chr10_128015168_128030037
Naca,10,128035575,128048637,protein_coding,1,13062,chr10_128035575_128048637
Ptges3,10,128058954,128077272,protein_coding,1,18318,chr10_128058954_128077272
Gm47438,10,128081354,128082970,lincRNA,-1,1616,chr10_128081354_128082970
Atp5b,10,128083273,128090391,protein_coding,1,7118,chr10_128083273_128090391
Baz2a,10,128091577,128129303,protein_coding,1,37726,chr10_128091577_128129303
Rbms2,10,128131558,128180297,protein_coding,-1,48739,chr10_128131558_128180297
Gls2,10,128194457,128210004,protein_coding,1,15547,chr10_128194457_128210004
Spryd4,10,128209908,128211807,protein_coding,-1,1899,chr10_128209908_128211807
Mip,10,128225838,128231812,protein_coding,1,5974,chr10_128225838_128231812
Timeless,10,128232065,128252941,protein_coding,1,20876,chr10_128232065_128252941
Stat2,10,128270559,128292849,protein_coding,1,22290,chr10_128270559_128292849
Il23a,10,128296139,128298752,protein_coding,-1,2613,chr10_128296139_128298752
Pan2,10,128303335,128321358,protein_coding,1,18023,chr10_128303335_128321358
Cnpy2,10,128322459,128327553,protein_coding,1,5094,chr10_128322459_128327553
Cs,10,128337734,128362479,protein_coding,1,24745,chr10_128337734_128362479
Coq10a,10,128363100,128368997,protein_coding,-1,5897,chr10_128363100_128368997
Ankrd52,10,128377115,128408704,protein_coding,1,31589,chr10_128377115_128408704
Gm17201,10,128391842,128395563,antisense,-1,3721,chr10_128391842_128395563
Slc39a5,10,128395931,128401229,protein_coding,-1,5298,chr10_128395931_128401229
Nabp2,10,128401395,128411492,protein_coding,-1,10097,chr10_128401395_128411492
Rnf41,10,128411657,128441441,protein_coding,1,29784,chr10_128411657_128441441
Smarcc2,10,128459248,128490482,protein_coding,1,31234,chr10_128459248_128490482
Myl6,10,128490860,128494145,protein_coding,-1,3285,chr10_128490860_128494145
Myl6b,10,128494157,128498685,protein_coding,-1,4528,chr10_128494157_128498685
Esyt1,10,128509965,128525871,protein_coding,-1,15906,chr10_128509965_128525871
Gm29585,10,128522263,128545359,antisense,1,23096,chr10_128522263_128545359
Zc3h10,10,128541963,128547774,protein_coding,-1,5811,chr10_128541963_128547774
Rpl41,10,128548114,128549305,protein_coding,-1,1191,chr10_128548114_128549305
Pa2g4,10,128557766,128565987,protein_coding,-1,8221,chr10_128557766_128565987
Erbb3,10,128567523,128589652,protein_coding,-1,22129,chr10_128567523_128589652
Rps26,10,128624534,128626747,protein_coding,-1,2213,chr10_128624534_128626747
Ikzf4,10,128630843,128669358,protein_coding,-1,38515,chr10_128630843_128669358
Gm26876,10,128645884,128649811,lincRNA,1,3927,chr10_128645884_128649811
Suox,10,128669894,128674073,protein_coding,-1,4179,chr10_128669894_128674073
Rab5b,10,128677175,128696264,protein_coding,-1,19089,chr10_128677175_128696264
Cdk2,10,128697939,128705031,protein_coding,-1,7092,chr10_128697939_128705031
Pmel,10,128704195,128720238,protein_coding,1,16043,chr10_128704195_128720238
Dgka,10,128720134,128744855,protein_coding,-1,24721,chr10_128720134_128744855
Pym1,10,128747889,128766564,protein_coding,1,18675,chr10_128747889_128766564
Gm47093,10,128789429,128801393,antisense,-1,11964,chr10_128789429_128801393
Mmp19,10,128790910,128800824,protein_coding,1,9914,chr10_128790910_128800824
Tmem198b,10,128800036,128804370,protein_coding,-1,4334,chr10_128800036_128804370
Dnajc14,10,128804062,128819446,protein_coding,1,15384,chr10_128804062_128819446
Sarnp,10,128817333,128877629,protein_coding,1,60296,chr10_128817333_128877629
Ormdl2,10,128817902,128821645,protein_coding,-1,3743,chr10_128817902_128821645
Gdf11,10,128882295,128891718,protein_coding,-1,9423,chr10_128882295_128891718
Cd63,10,128900989,128912822,protein_coding,1,11833,chr10_128900989_128912822
Rdh5,10,128913593,128922888,protein_coding,-1,9295,chr10_128913593_128922888
Bloc1s1,10,128917882,128924035,protein_coding,-1,6153,chr10_128917882_128924035
Itga7,10,128933818,128958282,protein_coding,1,24464,chr10_128933818_128958282
Mettl7b,10,128958274,128960988,protein_coding,-1,2714,chr10_128958274_128960988
9030616G12Rik,10,128971197,128978115,lincRNA,1,6918,chr10_128971197_128978115
Olfr763,10,129010791,129013313,protein_coding,1,2522,chr10_129010791_129013313
Olfr765,10,129044817,129049998,protein_coding,-1,5181,chr10_129044817_129049998
Olfr767,10,129074825,129082910,protein_coding,-1,8085,chr10_129074825_129082910
Olfr768,10,129090222,129099375,protein_coding,-1,9153,chr10_129090222_129099375
Olfr769,10,129108952,129117861,protein_coding,-1,8909,chr10_129108952_129117861
Olfr770,10,129132578,129138998,protein_coding,-1,6420,chr10_129132578_129138998
Olfr771,10,129160003,129164751,protein_coding,-1,4748,chr10_129160003_129164751
Olfr775,10,129248412,129253924,protein_coding,1,5512,chr10_129248412_129253924
Olfr777,10,129264407,129271485,protein_coding,-1,7078,chr10_129264407_129271485
Olfr780,10,129318117,129324141,protein_coding,1,6024,chr10_129318117_129324141
Olfr784,10,129384083,129390198,protein_coding,1,6115,chr10_129384083_129390198
Olfr788,10,129470998,129476618,protein_coding,1,5620,chr10_129470998_129476618
Olfr789,10,129484752,129490542,protein_coding,1,5790,chr10_129484752_129490542
Olfr794,10,129567655,129573110,protein_coding,1,5455,chr10_129567655_129573110
Olfr798,10,129622615,129627934,protein_coding,-1,5319,chr10_129622615_129627934
Olfr799,10,129637484,129648326,protein_coding,1,10842,chr10_129637484_129648326
Olfr802,10,129677683,129688169,protein_coding,-1,10486,chr10_129677683_129688169
Olfr803,10,129690621,129694286,protein_coding,-1,3665,chr10_129690621_129694286
Olfr804,10,129703210,129710018,protein_coding,1,6808,chr10_129703210_129710018
Olfr805,10,129721221,129729375,protein_coding,-1,8154,chr10_129721221_129729375
Olfr808,10,129765482,129771713,protein_coding,1,6231,chr10_129765482_129771713
Olfr809,10,129774638,129778937,protein_coding,1,4299,chr10_129774638_129778937
Olfr814,10,129871473,129879851,protein_coding,-1,8378,chr10_129871473_129879851
Olfr816,10,129909163,129915597,protein_coding,-1,6434,chr10_129909163_129915597
Gm10310,10,129980075,129985062,protein_coding,-1,4987,chr10_129980075_129985062
Olfr820,10,130012621,130021286,protein_coding,1,8665,chr10_130012621_130021286
Olfr821,10,130030348,130035071,protein_coding,1,4723,chr10_130030348_130035071
Olfr822,10,130071210,130076909,protein_coding,1,5699,chr10_130071210_130076909
Olfr823,10,130111527,130115383,protein_coding,-1,3856,chr10_130111527_130115383
Olfr825,10,130159732,130166766,protein_coding,-1,7034,chr10_130159732_130166766
Olfr827,10,130203049,130214403,protein_coding,-1,11354,chr10_130203049_130214403
Neurod4,10,130268152,130280240,protein_coding,-1,12088,chr10_130268152_130280240
Tespa1,10,130322870,130364111,protein_coding,1,41241,chr10_130322870_130364111
Vmn2r84,10,130377925,130394332,protein_coding,-1,16407,chr10_130377925_130394332
Vmn2r85,10,130414064,130429703,protein_coding,-1,15639,chr10_130414064_130429703
Vmn2r86,10,130441562,130456050,protein_coding,-1,14488,chr10_130441562_130456050
Vmn2r87,10,130471052,130497396,protein_coding,-1,26344,chr10_130471052_130497396
Gm31793,10,130542347,130571793,lincRNA,1,29446,chr10_130542347_130571793
Insr,8,3122061,3279617,protein_coding,-1,157556,chr8_3122061_3279617
Gm16180,8,3259704,3260641,antisense,1,937,chr8_3259704_3260641
Arhgef18,8,3353415,3456601,protein_coding,1,103186,chr8_3353415_3456601
Pex11g,8,3457105,3467680,protein_coding,-1,10575,chr8_3457105_3467680
Tex45,8,3470862,3487181,protein_coding,1,16319,chr8_3470862_3487181
Zfp358,8,3493138,3497208,protein_coding,1,4070,chr8_3493138_3497208
Mcoln1,8,3500457,3515232,protein_coding,1,14775,chr8_3500457_3515232
Pnpla6,8,3515384,3544267,protein_coding,1,28883,chr8_3515384_3544267
Camsap3,8,3587293,3609075,protein_coding,1,21782,chr8_3587293_3609075
Xab2,8,3608421,3621316,protein_coding,-1,12895,chr8_3608421_3621316
Pet100,8,3621548,3625848,protein_coding,1,4300,chr8_3621548_3625848
Pcp2,8,3623371,3625545,protein_coding,-1,2174,chr8_3623371_3625545
Stxbp2,8,3630955,3643644,protein_coding,1,12689,chr8_3630955_3643644
Retn,8,3655770,3660110,protein_coding,1,4340,chr8_3655770_3660110
Mcemp1,8,3665754,3669259,protein_coding,1,3505,chr8_3665754_3669259
Fcor,8,3671188,3672362,protein_coding,-1,1174,chr8_3671188_3672362
Gm39121,8,3672430,3672954,lincRNA,1,524,chr8_3672430_3672954
Gm45231,8,3674035,3676954,antisense,-1,2919,chr8_3674035_3676954
Trappc5,8,3676299,3681255,protein_coding,1,4956,chr8_3676299_3681255
Fcer2a,8,3681737,3694175,protein_coding,-1,12438,chr8_3681737_3694175
Clec4g,8,3707064,3720651,protein_coding,-1,13587,chr8_3707064_3720651
Gm16553,8,3709804,3739044,antisense,1,29240,chr8_3709804_3739044
Cd209a,8,3743397,3748984,protein_coding,-1,5587,chr8_3743397_3748984
Cd209c,8,3940222,3954746,protein_coding,-1,14524,chr8_3940222_3954746
Cd209f,8,4102787,4105835,protein_coding,-1,3048,chr8_4102787_4105835
4932443L11Rik,8,4162522,4206882,antisense,-1,44360,chr8_4162522_4206882
Evi5l,8,4166567,4211257,protein_coding,1,44690,chr8_4166567_4211257
Prr36,8,4209543,4217459,protein_coding,-1,7916,chr8_4209543_4217459
Lrrc8e,8,4226827,4237470,protein_coding,1,10643,chr8_4226827_4237470
Map2k7,8,4238740,4247897,protein_coding,1,9157,chr8_4238740_4247897
Gm49320,8,4238865,4251423,protein_coding,1,12558,chr8_4238865_4251423
Snapc2,8,4253080,4256220,protein_coding,1,3140,chr8_4253080_4256220
Ctxn1,8,4257660,4259274,protein_coding,-1,1614,chr8_4257660_4259274
Timm44,8,4259731,4275913,protein_coding,-1,16182,chr8_4259731_4275913
Elavl1,8,4285382,4325413,protein_coding,-1,40031,chr8_4285382_4325413
Ccl25,8,4325210,4360020,protein_coding,1,34810,chr8_4325210_4360020
Cers4,8,4493026,4531680,protein_coding,1,38654,chr8_4493026_4531680
Zfp958,8,4613167,4630231,protein_coding,1,17064,chr8_4613167_4630231
Gm6410,8,4678462,4688494,lincRNA,1,10032,chr8_4678462_4688494
Shcbp1,8,4735976,4779567,protein_coding,-1,43591,chr8_4735976_4779567
Slc10a2,8,5083219,5105351,protein_coding,-1,22132,chr8_5083219_5105351
Gm44693,8,5436984,5440990,lincRNA,-1,4006,chr8_5436984_5440990
Gm17215,8,7381015,7428569,lincRNA,1,47554,chr8_7381015_7428569
Gm30954,8,7468669,7580205,lincRNA,-1,111536,chr8_7468669_7580205
Gm31135,8,8044577,8484730,lincRNA,-1,440153,chr8_8044577_8484730
Gm31401,8,8066666,8093355,lincRNA,1,26689,chr8_8066666_8093355
A630009H07Rik,8,8335077,8342428,lincRNA,1,7351,chr8_8335077_8342428
Gm31343,8,8377090,8391702,lincRNA,1,14612,chr8_8377090_8391702
D530014G21Rik,8,8488302,8495535,lincRNA,1,7233,chr8_8488302_8495535
Gm31463,8,8576522,8580342,lincRNA,1,3820,chr8_8576522_8580342
Gm45075,8,8612264,8615862,lincRNA,1,3598,chr8_8612264_8615862
Efnb2,8,8617434,8661242,protein_coding,-1,43808,chr8_8617434_8661242
4921522P10Rik,8,8661801,8664728,lincRNA,1,2927,chr8_8661801_8664728
Arglu1,8,8665075,8690521,protein_coding,-1,25446,chr8_8665075_8690521
Gm44626,8,8727111,8853647,lincRNA,1,126536,chr8_8727111_8853647
Gm44515,8,8920937,8932699,lincRNA,-1,11762,chr8_8920937_8932699
4930453L07Rik,8,9144669,9149050,lincRNA,1,4381,chr8_9144669_9149050
Gm44516,8,9152600,9157221,lincRNA,-1,4621,chr8_9152600_9157221
Gm39128,8,9167517,9174793,lincRNA,1,7276,chr8_9167517_9174793
Fam155a,8,9205902,9771161,protein_coding,-1,565259,chr8_9205902_9771161
Gm44761,8,9800194,9811974,lincRNA,1,11780,chr8_9800194_9811974
Gm10217,8,9864251,9870315,protein_coding,1,6064,chr8_9864251_9870315
Gm10067,8,9875530,9919463,lincRNA,-1,43933,chr8_9875530_9919463
Lig4,8,9969049,9977686,protein_coding,-1,8637,chr8_9969049_9977686
Abhd13,8,9977707,9992155,protein_coding,1,14448,chr8_9977707_9992155
Tnfsf13b,8,10006467,10039072,protein_coding,1,32605,chr8_10006467_10039072
Gm44788,8,10065054,10119632,lincRNA,1,54578,chr8_10065054_10119632
Myo16,8,10153911,10634742,protein_coding,1,480831,chr8_10153911_10634742
Gm44786,8,10685351,10687390,lincRNA,1,2039,chr8_10685351_10687390
Gm44785,8,10687948,10691706,lincRNA,1,3758,chr8_10687948_10691706
Gm44784,8,10723486,10725161,lincRNA,1,1675,chr8_10723486_10725161
Gm45045,8,10732676,10736533,lincRNA,1,3857,chr8_10732676_10736533
Gm39129,8,10738890,10770849,lincRNA,1,31959,chr8_10738890_10770849
B930025P03Rik,8,10870422,10882454,lincRNA,-1,12032,chr8_10870422_10882454
Gm45044,8,10884453,10891591,lincRNA,-1,7138,chr8_10884453_10891591
Gm2814,8,10898169,10900558,lincRNA,-1,2389,chr8_10898169_10900558
3930402G23Rik,8,10924427,10928696,lincRNA,-1,4269,chr8_10924427_10928696
Gm44955,8,10943326,10947890,lincRNA,-1,4564,chr8_10943326_10947890
Gm44956,8,10962957,10970814,lincRNA,-1,7857,chr8_10962957_10970814
Irs2,8,10984681,11008458,protein_coding,-1,23777,chr8_10984681_11008458
B830042I05Rik,8,11071046,11076881,lincRNA,1,5835,chr8_11071046_11076881
Gm44717,8,11135641,11149246,lincRNA,-1,13605,chr8_11135641_11149246
Gm15418,8,11187755,11204503,antisense,1,16748,chr8_11187755_11204503
Col4a1,8,11198423,11312826,protein_coding,-1,114403,chr8_11198423_11312826
Col4a2,8,11312805,11449287,protein_coding,1,136482,chr8_11312805_11449287
Gm15419,8,11399186,11417892,antisense,-1,18706,chr8_11399186_11417892
Rab20,8,11453518,11478710,protein_coding,-1,25192,chr8_11453518_11478710
Naxd,8,11497506,11514960,protein_coding,1,17454,chr8_11497506_11514960
Cars2,8,11513977,11550783,protein_coding,-1,36806,chr8_11513977_11550783
Ing1,8,11555571,11563251,protein_coding,1,7680,chr8_11555571_11563251
Ankrd10,8,11611583,11635757,protein_coding,-1,24174,chr8_11611583_11635757
1700016D06Rik,8,11654924,11701063,protein_coding,-1,46139,chr8_11654924_11701063
1700128E19Rik,8,11713264,11722620,lincRNA,1,9356,chr8_11713264_11722620
Arhgef7,8,11727721,11835219,protein_coding,1,107498,chr8_11727721_11835219
Tex29,8,11840474,11855761,protein_coding,1,15287,chr8_11840474_11855761
Gm39132,8,11874159,11894113,lincRNA,1,19954,chr8_11874159_11894113
Gm45680,8,11945465,11948297,lincRNA,-1,2832,chr8_11945465_11948297
B020031H02Rik,8,11948339,12000216,lincRNA,1,51877,chr8_11948339_12000216
A230072I06Rik,8,12278819,12280657,protein_coding,1,1838,chr8_12278819_12280657
Gm33175,8,12315004,12319480,lincRNA,-1,4476,chr8_12315004_12319480
Sox1,8,12395295,12400126,protein_coding,1,4831,chr8_12395295_12400126
4933439N14Rik,8,12502899,12505341,lincRNA,1,2442,chr8_12502899_12505341
Spaca7,8,12573029,12600744,protein_coding,1,27715,chr8_12573029_12600744
Tubgcp3,8,12614277,12672248,protein_coding,-1,57971,chr8_12614277_12672248
Gm15348,8,12706944,12719127,lincRNA,-1,12183,chr8_12706944_12719127
Atp11a,8,12757014,12868728,protein_coding,1,111714,chr8_12757014_12868728
Gm15350,8,12828335,12833865,antisense,-1,5530,chr8_12828335_12833865
Gm15347,8,12860358,12877344,antisense,-1,16986,chr8_12860358_12877344
Mcf2l,8,12873806,13020905,protein_coding,1,147099,chr8_12873806_13020905
Gm15353,8,12879878,12883726,antisense,-1,3848,chr8_12879878_12883726
Gm15351,8,12899146,12915758,antisense,-1,16612,chr8_12899146_12915758
F7,8,13026034,13035809,protein_coding,1,9775,chr8_13026034_13035809
F10,8,13037308,13056676,protein_coding,1,19368,chr8_13037308_13056676
Proz,8,13060914,13076026,protein_coding,1,15112,chr8_13060914_13076026
Gm17023,8,13076077,13082740,antisense,1,6663,chr8_13076077_13082740
Pcid2,8,13077189,13105459,protein_coding,-1,28270,chr8_13077189_13105459
Cul4a,8,13105621,13147940,protein_coding,1,42319,chr8_13105621_13147940
Lamp1,8,13159161,13175338,protein_coding,1,16177,chr8_13159161_13175338
Grtp1,8,13172022,13200620,protein_coding,-1,28598,chr8_13172022_13200620
Adprhl1,8,13221663,13254162,protein_coding,-1,32499,chr8_13221663_13254162
Dcun1d2,8,13255963,13288131,protein_coding,-1,32168,chr8_13255963_13288131
Tmco3,8,13288190,13322924,protein_coding,1,34734,chr8_13288190_13322924
Tfdp1,8,13338751,13378448,protein_coding,1,39697,chr8_13338751_13378448
Atp4b,8,13386205,13396825,protein_coding,-1,10620,chr8_13386205_13396825
Grk1,8,13405081,13421951,protein_coding,1,16870,chr8_13405081_13421951
Tmem255b,8,13435189,13468473,protein_coding,1,33284,chr8_13435189_13468473
Gas6,8,13465374,13494490,protein_coding,-1,29116,chr8_13465374_13494490
Gm5608,8,13537678,13547028,lincRNA,-1,9350,chr8_13537678_13547028
1700029H14Rik,8,13550733,13562461,protein_coding,-1,11728,chr8_13550733_13562461
Rasa3,8,13566948,13677603,protein_coding,-1,110655,chr8_13566948_13677603
Cdc16,8,13757676,13781938,protein_coding,1,24262,chr8_13757676_13781938
Upf3a,8,13785615,13799193,protein_coding,1,13578,chr8_13785615_13799193
AF366264,8,13835233,13838389,protein_coding,-1,3156,chr8_13835233_13838389
Champ1,8,13869641,13881639,protein_coding,1,11998,chr8_13869641_13881639
Coprs,8,13884794,13890281,protein_coding,-1,5487,chr8_13884794_13890281
Fbxo25,8,13907803,13940522,protein_coding,1,32719,chr8_13907803_13940522
Tdrp,8,13952008,13975032,protein_coding,-1,23024,chr8_13952008_13975032
Gm5907,8,13986090,14003561,lincRNA,1,17471,chr8_13986090_14003561
Erich1,8,14027561,14090301,protein_coding,-1,62740,chr8_14027561_14090301
Dlgap2,8,14095865,14847680,protein_coding,1,751815,chr8_14095865_14847680
C030037F17Rik,8,14745329,14747427,antisense,-1,2098,chr8_14745329_14747427
Cln8,8,14881335,14901720,protein_coding,1,20385,chr8_14881335_14901720
Arhgef10,8,14911663,15001085,protein_coding,1,89422,chr8_14911663_15001085
Gm16350,8,14961066,14961586,antisense,-1,520,chr8_14961066_14961586
Kbtbd11,8,15011025,15033333,protein_coding,1,22308,chr8_15011025_15033333
5830468F06Rik,8,15015092,15018907,antisense,-1,3815,chr8_15015092_15018907
BB014433,8,15041444,15046078,protein_coding,-1,4634,chr8_15041444_15046078
Myom2,8,15057653,15133541,protein_coding,1,75888,chr8_15057653_15133541
Gm7706,8,15141044,15371982,lincRNA,1,230938,chr8_15141044_15371982
Gm45271,8,15182089,15189612,lincRNA,-1,7523,chr8_15182089_15189612
Gm35392,8,15375639,15382429,lincRNA,1,6790,chr8_15375639_15382429
Gm35453,8,15580279,15583962,lincRNA,-1,3683,chr8_15580279_15583962
Gm45676,8,15581943,15584719,lincRNA,1,2776,chr8_15581943_15584719
Gm45408,8,15584723,15670425,lincRNA,1,85702,chr8_15584723_15670425
Csmd1,8,15892537,17535586,protein_coding,-1,1643049,chr8_15892537_17535586
Gm16346,8,16226003,16232305,antisense,1,6302,chr8_16226003_16232305
Gm16347,8,16433175,16437040,antisense,1,3865,chr8_16433175_16437040
1700014L14Rik,8,18319523,18334338,lincRNA,-1,14815,chr8_18319523_18334338
Mcph1,8,18595131,18803189,protein_coding,1,208058,chr8_18595131_18803189
Gm16725,8,18652801,18678056,antisense,-1,25255,chr8_18652801_18678056
Angpt2,8,18690263,18741562,protein_coding,-1,51299,chr8_18690263_18741562
Agpat5,8,18846277,18891361,protein_coding,1,45084,chr8_18846277_18891361
Gm35934,8,18889210,18902316,antisense,-1,13106,chr8_18889210_18902316
Xkr5,8,18932729,18950975,protein_coding,-1,18246,chr8_18932729_18950975
Defb40,8,18974940,18978256,protein_coding,-1,3316,chr8_18974940_18978256
Defb37,8,18986233,18991055,protein_coding,-1,4822,chr8_18986233_18991055
Defb38,8,19023407,19026566,protein_coding,-1,3159,chr8_19023407_19026566
Defb39,8,19052826,19064810,protein_coding,-1,11984,chr8_19052826_19064810
Defb34,8,19123752,19126540,protein_coding,1,2788,chr8_19123752_19126540
Gm45826,8,19140778,19159440,protein_coding,1,18662,chr8_19140778_19159440
Gm39139,8,19163520,19188015,lincRNA,-1,24495,chr8_19163520_19188015
Defb14,8,19194357,19195212,protein_coding,1,855,chr8_19194357_19195212
Defb4,8,19198706,19201545,protein_coding,1,2839,chr8_19198706_19201545
Defb6,8,19225478,19228209,protein_coding,1,2731,chr8_19225478_19228209
Defb5,8,19247580,19250828,protein_coding,1,3248,chr8_19247580_19250828
Defb7,8,19495097,19497775,protein_coding,1,2678,chr8_19495097_19497775
Gm35998,8,19594900,19665322,lincRNA,-1,70422,chr8_19594900_19665322
4930467E23Rik,8,19729576,19753527,protein_coding,1,23951,chr8_19729576_19753527
Gm31371,8,19903392,19925713,protein_coding,1,22321,chr8_19903392_19925713
Gm15319,8,20337664,20363210,protein_coding,-1,25546,chr8_20337664_20363210
Gm21119,8,20614919,20640703,protein_coding,1,25784,chr8_20614919_20640703
Gm6040,8,20916490,20922071,protein_coding,-1,5581,chr8_20916490_20922071
Defb1,8,21776599,21795185,protein_coding,1,18586,chr8_21776599_21795185
Defb9,8,21881713,21885421,protein_coding,-1,3708,chr8_21881713_21885421
Defb11,8,21905376,21906412,protein_coding,-1,1036,chr8_21905376_21906412
Gm36879,8,21906664,21934313,antisense,1,27649,chr8_21906664_21934313
Defb35,8,21938352,21940878,protein_coding,1,2526,chr8_21938352_21940878
Ccdc70,8,21969775,21974041,protein_coding,1,4266,chr8_21969775_21974041
Atp7b,8,21992785,22060305,protein_coding,-1,67520,chr8_21992785_22060305
Alg11,8,22060721,22071627,protein_coding,1,10906,chr8_22060721_22071627
Nek5,8,22073616,22125053,protein_coding,-1,51437,chr8_22073616_22125053
Nek3,8,22128283,22166435,protein_coding,-1,38152,chr8_22128283_22166435
Ckap2,8,22168160,22185819,protein_coding,-1,17659,chr8_22168160_22185819
Vps36,8,22192809,22220843,protein_coding,1,28034,chr8_22192809_22220843
Thsd1,8,22227313,22261334,protein_coding,1,34021,chr8_22227313_22261334
Tpte,8,22283441,22371418,protein_coding,1,87977,chr8_22283441_22371418
Slc25a15,8,22375551,22398597,protein_coding,-1,23046,chr8_22375551_22398597
1810012K16Rik,8,22398721,22399596,lincRNA,1,875,chr8_22398721_22399596
Mrps31,8,22411361,22429665,protein_coding,1,18304,chr8_22411361_22429665
Smim19,8,22462614,22476882,protein_coding,-1,14268,chr8_22462614_22476882
Slc20a2,8,22476788,22569612,protein_coding,1,92824,chr8_22476788_22569612
Vdac3,8,22577075,22593813,protein_coding,-1,16738,chr8_22577075_22593813
Dkk4,8,22624043,22627547,protein_coding,1,3504,chr8_22624043_22627547
Polb,8,22628126,22653435,protein_coding,-1,25309,chr8_22628126_22653435
Ikbkb,8,22659212,22706589,protein_coding,-1,47377,chr8_22659212_22706589
Gm15346,8,22686265,22695646,antisense,1,9381,chr8_22686265_22695646
Plat,8,22757727,22782844,protein_coding,1,25117,chr8_22757727_22782844
Ap3m2,8,22787354,22805622,protein_coding,-1,18268,chr8_22787354_22805622
1700041G16Rik,8,22805766,22809537,lincRNA,1,3771,chr8_22805766_22809537
Kat6a,8,22859535,22943259,protein_coding,1,83724,chr8_22859535_22943259
Ank1,8,22974844,23150497,protein_coding,1,175653,chr8_22974844_23150497
Gm15816,8,23138794,23149585,antisense,-1,10791,chr8_23138794_23149585
Nkx6-3,8,23153269,23158948,protein_coding,1,5679,chr8_23153269_23158948
Gpat4,8,23171265,23208346,protein_coding,-1,37081,chr8_23171265_23208346
Gins4,8,23226616,23237659,protein_coding,-1,11043,chr8_23226616_23237659
Golga7,8,23241346,23257074,protein_coding,-1,15728,chr8_23241346_23257074
Sfrp1,8,23411502,23449632,protein_coding,1,38130,chr8_23411502_23449632
Zmat4,8,23636019,24156585,protein_coding,1,520566,chr8_23636019_24156585
A730045E13Rik,8,24173904,24185568,lincRNA,1,11664,chr8_24173904_24185568
Gm45163,8,24220510,24230146,lincRNA,1,9636,chr8_24220510_24230146
Gm45164,8,24353944,24359436,lincRNA,-1,5492,chr8_24353944_24359436
Gm30692,8,24412179,24416937,lincRNA,1,4758,chr8_24412179_24416937
Gm26714,8,24422404,24440008,antisense,1,17604,chr8_24422404_24440008
Tcim,8,24437180,24438984,protein_coding,-1,1804,chr8_24437180_24438984
Ido2,8,24531892,24576333,protein_coding,-1,44441,chr8_24531892_24576333
Ido1,8,24584136,24597009,protein_coding,-1,12873,chr8_24584136_24597009
Adam18,8,24602246,24674755,protein_coding,-1,72509,chr8_24602246_24674755
Adam3,8,24677225,24725852,protein_coding,-1,48627,chr8_24677225_24725852
Adam5,8,24727093,24824369,protein_coding,-1,97276,chr8_24727093_24824369
Adam32,8,24836140,24948804,protein_coding,-1,112664,chr8_24836140_24948804
Adam9,8,24949611,25016927,protein_coding,-1,67316,chr8_24949611_25016927
Tm2d2,8,25017211,25023260,protein_coding,1,6049,chr8_25017211_25023260
Htra4,8,25024929,25038962,protein_coding,-1,14033,chr8_25024929_25038962
Gm16933,8,25037052,25041892,lincRNA,1,4840,chr8_25037052_25041892
Plekha2,8,25039144,25102376,protein_coding,-1,63232,chr8_25039144_25102376
Tacc1,8,25154552,25256588,protein_coding,-1,102036,chr8_25154552_25256588
5430421F17Rik,8,25302650,25306270,lincRNA,-1,3620,chr8_25302650_25306270
Gm30978,8,25415119,25429224,lincRNA,-1,14105,chr8_25415119_25429224
Gm45237,8,25440618,25448762,lincRNA,1,8144,chr8_25440618_25448762
Gm45238,8,25443668,25454107,lincRNA,-1,10439,chr8_25443668_25454107
Gm31045,8,25463677,25487585,lincRNA,-1,23908,chr8_25463677_25487585
Fgfr1,8,25513654,25575718,protein_coding,1,62064,chr8_25513654_25575718
Gm16159,8,25548661,25556083,antisense,-1,7422,chr8_25548661_25556083
Letm2,8,25578490,25597582,protein_coding,-1,19092,chr8_25578490_25597582
D830025C05Rik,8,25597012,25599207,antisense,1,2195,chr8_25597012_25599207
Nsd3,8,25601601,25719667,protein_coding,1,118066,chr8_25601601_25719667
Plpp5,8,25720037,25724887,protein_coding,1,4850,chr8_25720037_25724887
Ddhd2,8,25725346,25754596,protein_coding,-1,29250,chr8_25725346_25754596
Gm17484,8,25754480,25769704,lincRNA,1,15224,chr8_25754480_25769704
Bag4,8,25764538,25785287,protein_coding,-1,20749,chr8_25764538_25785287
Lsm1,8,25785288,25803975,protein_coding,1,18687,chr8_25785288_25803975
Star,8,25806555,25815982,protein_coding,1,9427,chr8_25806555_25815982
Ash2l,8,25815996,25847694,protein_coding,-1,31698,chr8_25815996_25847694
Kcnu1,8,25849623,25937939,protein_coding,1,88316,chr8_25849623_25937939
Hgsnat,8,25944453,25976753,protein_coding,-1,32300,chr8_25944453_25976753
Pomk,8,25980604,25994133,protein_coding,-1,13529,chr8_25980604_25994133
Fnta,8,25998722,26015650,protein_coding,-1,16928,chr8_25998722_26015650
Hook3,8,26021421,26119224,protein_coding,-1,97803,chr8_26021421_26119224
Gm45411,8,26023410,26032253,antisense,1,8843,chr8_26023410_26032253
1700047A11Rik,8,26082609,26096522,antisense,1,13913,chr8_26082609_26096522
Rnf170,8,26119368,26151790,protein_coding,1,32422,chr8_26119368_26151790
Gm45692,8,26119534,26160819,protein_coding,1,41285,chr8_26119534_26160819
Gm45250,8,26151888,26155479,lincRNA,-1,3591,chr8_26151888_26155479
Thap1,8,26158141,26164151,protein_coding,1,6010,chr8_26158141_26164151
Gm31727,8,26266977,26273555,lincRNA,1,6578,chr8_26266977_26273555
Gm31784,8,26298352,26312334,lincRNA,-1,13982,chr8_26298352_26312334
Gm45307,8,26298634,26354163,lincRNA,1,55529,chr8_26298634_26354163
Gm31898,8,26428281,26435713,lincRNA,-1,7432,chr8_26428281_26435713
Gm31983,8,26450460,26484652,lincRNA,-1,34192,chr8_26450460_26484652
Gm39149,8,26560461,26579802,lincRNA,-1,19341,chr8_26560461_26579802
Gm45584,8,26637675,26639952,lincRNA,1,2277,chr8_26637675_26639952
Gm32098,8,26665893,26668306,lincRNA,-1,2413,chr8_26665893_26668306
Gm45646,8,26745929,26760561,lincRNA,-1,14632,chr8_26745929_26760561
2310008N11Rik,8,26814593,26884380,lincRNA,-1,69787,chr8_26814593_26884380
Gm45572,8,26966434,26967474,lincRNA,1,1040,chr8_26966434_26967474
Zfp703,8,26977325,26981461,protein_coding,1,4136,chr8_26977325_26981461
Gm45371,8,26977391,26980001,antisense,-1,2610,chr8_26977391_26980001
Gm45370,8,26996250,26998954,lincRNA,1,2704,chr8_26996250_26998954
Gm32389,8,27008467,27012903,lincRNA,1,4436,chr8_27008467_27012903
Erlin2,8,27023261,27040328,protein_coding,1,17067,chr8_27023261_27040328
Proscos,8,27042377,27043042,antisense,-1,665,chr8_27042377_27043042
Plpbp,8,27042555,27056132,protein_coding,1,13577,chr8_27042555_27056132
Adgra2,8,27085583,27123436,protein_coding,1,37853,chr8_27085583_27123436
Brf2,8,27123364,27128680,protein_coding,-1,5316,chr8_27123364_27128680
Rab11fip1,8,27138773,27174646,protein_coding,-1,35873,chr8_27138773_27174646
4933416M07Rik,8,27142910,27146304,antisense,1,3394,chr8_27142910_27146304
Gm45267,8,27159828,27170691,antisense,1,10863,chr8_27159828_27170691
Got1l1,8,27197459,27223828,protein_coding,-1,26369,chr8_27197459_27223828
Adrb3,8,27225776,27250616,protein_coding,-1,24840,chr8_27225776_27250616
Gm45470,8,27228686,27240332,antisense,1,11646,chr8_27228686_27240332
Eif4ebp1,8,27260329,27276674,protein_coding,1,16345,chr8_27260329_27276674
Tex24,8,27344394,27349188,protein_coding,1,4794,chr8_27344394_27349188
Chrnb3,8,27368711,27399730,protein_coding,1,31019,chr8_27368711_27399730
Chrna6,8,27403212,27413944,protein_coding,-1,10732,chr8_27403212_27413944
Gm45861,8,27447100,27620917,protein_coding,1,173817,chr8_27447100_27620917
1700008N11Rik,8,28084828,28085596,lincRNA,1,768,chr8_28084828_28085596
Gm8110,8,28520676,28529237,lincRNA,1,8561,chr8_28520676_28529237
Gm45571,8,28527826,28529717,lincRNA,-1,1891,chr8_28527826_28529717
Gm26795,8,28593505,28595599,lincRNA,1,2094,chr8_28593505_28595599
Unc5d,8,28646717,29219636,protein_coding,-1,572919,chr8_28646717_29219636
Gm32567,8,29228598,29235104,lincRNA,-1,6506,chr8_29228598_29235104
Gm39154,8,30112310,30121214,lincRNA,-1,8904,chr8_30112310_30121214
Gm45489,8,30482983,30513811,lincRNA,-1,30828,chr8_30482983_30513811
4933433F19Rik,8,30568393,30575573,lincRNA,1,7180,chr8_30568393_30575573
Dusp26,8,31089471,31097047,protein_coding,1,7576,chr8_31089471_31097047
Rnf122,8,31111820,31131482,protein_coding,1,19662,chr8_31111820_31131482
Tti2,8,31150315,31164702,protein_coding,1,14387,chr8_31150315_31164702
Mak16,8,31159463,31168764,protein_coding,-1,9301,chr8_31159463_31168764
Fut10,8,31187331,31261738,protein_coding,1,74407,chr8_31187331_31261738
7420700N18Rik,8,31378813,31382439,lincRNA,1,3626,chr8_31378813_31382439
Gm45303,8,31491976,31500090,lincRNA,1,8114,chr8_31491976_31500090
Gm45304,8,31598979,31663828,lincRNA,-1,64849,chr8_31598979_31663828
Nrg1,8,31814551,32884797,protein_coding,-1,1070246,chr8_31814551_32884797
Gm3985,8,32888505,32950026,lincRNA,-1,61521,chr8_32888505_32950026
Gm45587,8,32972831,33056091,lincRNA,-1,83260,chr8_32972831_33056091
Wrn,8,33234384,33385527,protein_coding,-1,151143,chr8_33234384_33385527
Purg,8,33386325,33417467,protein_coding,1,31142,chr8_33386325_33417467
Tex15,8,33516738,33585582,protein_coding,1,68844,chr8_33516738_33585582
Ppp2cb,8,33599625,33619441,protein_coding,1,19816,chr8_33599625_33619441
Ubxn8,8,33619586,33641967,protein_coding,-1,22381,chr8_33619586_33641967
Gsr,8,33652523,33698163,protein_coding,1,45640,chr8_33652523_33698163
1700104B16Rik,8,33730534,33731819,lincRNA,-1,1285,chr8_33730534_33731819
Gtf2e2,8,33731833,33777173,protein_coding,1,45340,chr8_33731833_33777173
Smim18,8,33742112,33747770,protein_coding,-1,5658,chr8_33742112_33747770
Rbpms,8,33782643,33929863,protein_coding,-1,147220,chr8_33782643_33929863
Gm26632,8,33813203,33833094,antisense,1,19891,chr8_33813203_33833094
Gm39157,8,33985914,33990524,lincRNA,1,4610,chr8_33985914_33990524
Gm9951,8,34049262,34057046,lincRNA,1,7784,chr8_34049262_34057046
Dctn6,8,34090420,34108796,protein_coding,-1,18376,chr8_34090420_34108796
Gm10131,8,34111002,34111737,protein_coding,-1,735,chr8_34111002_34111737
Mboat4,8,34115030,34125182,protein_coding,1,10152,chr8_34115030_34125182
Gm39158,8,34119011,34120208,antisense,-1,1197,chr8_34119011_34120208
Leprotl1,8,34135572,34147033,protein_coding,-1,11461,chr8_34135572_34147033
Saraf,8,34154563,34170845,protein_coding,1,16282,chr8_34154563_34170845
Gm29243,8,34216859,34226145,lincRNA,1,9286,chr8_34216859_34226145
Gm45350,8,34344696,34362842,lincRNA,-1,18146,chr8_34344696_34362842
Gm33831,8,34380544,34385828,lincRNA,-1,5284,chr8_34380544_34385828
Gm45349,8,34419237,34472995,lincRNA,-1,53758,chr8_34419237_34472995
B930018H19Rik,8,34589420,34640316,lincRNA,-1,50896,chr8_34589420_34640316
Gm34096,8,34608305,34619429,lincRNA,1,11124,chr8_34608305_34619429
Gm45627,8,34658106,34659369,lincRNA,-1,1263,chr8_34658106_34659369
Dusp4,8,34807297,34819894,protein_coding,1,12597,chr8_34807297_34819894
Tnks,8,34826460,34965690,protein_coding,-1,139230,chr8_34826460_34965690
Gm34368,8,34967274,34979874,lincRNA,-1,12600,chr8_34967274_34979874
Gm34419,8,35094545,35105029,lincRNA,1,10484,chr8_35094545_35105029
Gm45625,8,35179103,35183886,lincRNA,-1,4783,chr8_35179103_35183886
Gm34474,8,35218638,35222071,lincRNA,1,3433,chr8_35218638_35222071
Gm34597,8,35233303,35245479,lincRNA,-1,12176,chr8_35233303_35245479
Ppp1r3b,8,35375739,35388139,protein_coding,1,12400,chr8_35375739_35388139
Gm45301,8,35407471,35409506,lincRNA,-1,2035,chr8_35407471_35409506
Gm34853,8,35439734,35443698,lincRNA,1,3964,chr8_35439734_35443698
Eri1,8,35465253,35496196,protein_coding,-1,30943,chr8_35465253_35496196
Mfhas1,8,35587798,35679449,protein_coding,1,91651,chr8_35587798_35679449
1700015I17Rik,8,35707660,35719949,lincRNA,-1,12289,chr8_35707660_35719949
Gm19410,8,35765790,35818047,protein_coding,1,52257,chr8_35765790_35818047
Cldn23,8,35824712,35826559,protein_coding,-1,1847,chr8_35824712_35826559
5430403N17Rik,8,35864085,35882957,lincRNA,-1,18872,chr8_35864085_35882957
Prag1,8,36094828,36147787,protein_coding,1,52959,chr8_36094828_36147787
Gm38414,8,36156010,36161588,lincRNA,1,5578,chr8_36156010_36161588
Gm39164,8,36174140,36176047,lincRNA,-1,1907,chr8_36174140_36176047
4933430A20Rik,8,36176141,36178423,lincRNA,1,2282,chr8_36176141_36178423
Gm35520,8,36188372,36202020,lincRNA,1,13648,chr8_36188372_36202020
Lonrf1,8,36216064,36249516,protein_coding,-1,33452,chr8_36216064_36249516
Dlc1,8,36567751,36953143,protein_coding,-1,385392,chr8_36567751_36953143
G630064G18Rik,8,36985573,37024238,antisense,-1,38665,chr8_36985573_37024238
AI429214,8,36993604,36995533,protein_coding,1,1929,chr8_36993604_36995533
Gm45524,8,37097018,37188061,lincRNA,1,91043,chr8_37097018_37188061
Gm45368,8,37322385,37350753,lincRNA,-1,28368,chr8_37322385_37350753
Sgcz,8,37522298,38661508,protein_coding,-1,1139210,chr8_37522298_38661508
Gm40493,8,38659763,38671066,antisense,1,11303,chr8_38659763_38671066
Tusc3,8,39005845,39165114,protein_coding,1,159269,chr8_39005845_39165114
Gm6213,8,39297980,39368268,lincRNA,1,70288,chr8_39297980_39368268
Msr1,8,39581685,39642673,protein_coding,-1,60988,chr8_39581685_39642673
Fgf20,8,40279166,40308331,protein_coding,-1,29165,chr8_40279166_40308331
Micu3,8,40307458,40386308,protein_coding,1,78850,chr8_40307458_40386308
Zdhhc2,8,40423815,40510268,protein_coding,1,86453,chr8_40423815_40510268
Cnot7,8,40492540,40515847,protein_coding,-1,23307,chr8_40492540_40515847
Vps37a,8,40511783,40550757,protein_coding,1,38974,chr8_40511783_40550757
Mtmr7,8,40551095,40634797,protein_coding,-1,83702,chr8_40551095_40634797
Adam24,8,40675077,40682199,protein_coding,1,7122,chr8_40675077_40682199
Slc7a2,8,40862396,40922308,protein_coding,1,59912,chr8_40862396_40922308
Pdgfrl,8,40926212,40990785,protein_coding,1,64573,chr8_40926212_40990785
Mtus1,8,40990914,41133726,protein_coding,-1,142812,chr8_40990914_41133726
B430010I23Rik,8,41017468,41024216,antisense,1,6748,chr8_41017468_41024216
Gm16192,8,41039756,41042053,antisense,1,2297,chr8_41039756_41042053
Gm16193,8,41053110,41064706,antisense,1,11596,chr8_41053110_41064706
Fgl1,8,41191434,41215156,protein_coding,-1,23722,chr8_41191434_41215156
Pcm1,8,41239752,41332344,protein_coding,1,92592,chr8_41239752_41332344
Asah1,8,41340197,41374773,protein_coding,-1,34576,chr8_41340197_41374773
Frg1,8,41397459,41417074,protein_coding,-1,19615,chr8_41397459_41417074
2810404M03Rik,8,41827267,42046202,lincRNA,1,218935,chr8_41827267_42046202
Triml1,8,43129807,43141486,protein_coding,-1,11679,chr8_43129807_43141486
Triml2,8,43180541,43193881,protein_coding,1,13340,chr8_43180541_43193881
Zfp42,8,43295063,43306980,protein_coding,-1,11917,chr8_43295063_43306980
Adam26b,8,43519762,43528106,protein_coding,-1,8344,chr8_43519762_43528106
Adam26a,8,43568278,43576707,protein_coding,-1,8429,chr8_43568278_43576707
Adam34,8,43650309,43710049,protein_coding,-1,59740,chr8_43650309_43710049
Gm45488,8,43703479,43754163,antisense,1,50684,chr8_43703479_43754163
Gm45659,8,43908656,43914604,lincRNA,-1,5948,chr8_43908656_43914604
Fat1,8,44935447,45052257,protein_coding,1,116810,chr8_44935447_45052257
Gm2366,8,45017216,45022385,antisense,-1,5169,chr8_45017216_45022385
AY512931,8,45060702,45065418,lincRNA,-1,4716,chr8_45060702_45065418
Mtnr1a,8,45069137,45088506,protein_coding,1,19369,chr8_45069137_45088506
Gm30504,8,45110481,45196541,lincRNA,1,86060,chr8_45110481_45196541
Gm6329,8,45160494,45165219,lincRNA,-1,4725,chr8_45160494_45165219
F11,8,45241174,45262031,protein_coding,-1,20857,chr8_45241174_45262031
Klkb1,8,45266689,45294859,protein_coding,-1,28170,chr8_45266689_45294859
Gm45753,8,45269671,45308466,protein_coding,-1,38795,chr8_45269671_45308466
Cyp4v3,8,45304944,45333216,protein_coding,-1,28272,chr8_45304944_45333216
Fam149a,8,45336717,45382291,protein_coding,-1,45574,chr8_45336717_45382291
Tlr3,8,45395665,45411080,protein_coding,-1,15415,chr8_45395665_45411080
Gm45542,8,45410063,45410760,antisense,1,697,chr8_45410063_45410760
Sorbs2,8,45507788,45827906,protein_coding,1,320118,chr8_45507788_45827906
Gm16351,8,45547377,45605140,antisense,-1,57763,chr8_45547377_45605140
Sorbs2os,8,45723325,45819297,antisense,-1,95972,chr8_45723325_45819297
Pdlim3,8,45885461,45919548,protein_coding,1,34087,chr8_45885461_45919548
Ccdc110,8,45934619,45944145,protein_coding,1,9526,chr8_45934619_45944145
1700029J07Rik,8,45953606,45975440,protein_coding,-1,21834,chr8_45953606_45975440
Ufsp2,8,45975528,45996958,protein_coding,1,21430,chr8_45975528_45996958
Ankrd37,8,45996902,46005707,protein_coding,-1,8805,chr8_45996902_46005707
Lrp2bp,8,45999303,46029477,protein_coding,1,30174,chr8_45999303_46029477
Snx25,8,46033261,46152159,protein_coding,-1,118898,chr8_46033261_46152159
Cfap97,8,46151771,46195590,protein_coding,1,43819,chr8_46151771_46195590
Slc25a4,8,46206797,46211284,protein_coding,-1,4487,chr8_46206797_46211284
Helt,8,46292039,46294671,protein_coding,-1,2632,chr8_46292039_46294671
Gm39168,8,46299131,46325674,lincRNA,1,26543,chr8_46299131_46325674
Gm30931,8,46363251,46367204,lincRNA,1,3953,chr8_46363251_46367204
Gm45253,8,46372106,46385888,lincRNA,-1,13782,chr8_46372106_46385888
Acsl1,8,46471037,46536051,protein_coding,1,65014,chr8_46471037_46536051
Cenpu,8,46552028,46580007,protein_coding,1,27979,chr8_46552028_46580007
Primpol,8,46575594,46617212,protein_coding,-1,41618,chr8_46575594_46617212
Gm45607,8,46604749,46605963,antisense,1,1214,chr8_46604749_46605963
Casp3,8,46617291,46639689,protein_coding,1,22398,chr8_46617291_46639689
Irf2,8,46739732,46847458,protein_coding,1,107726,chr8_46739732_46847458
Gm45479,8,46763251,46764973,antisense,-1,1722,chr8_46763251_46764973
Gm31172,8,46770553,46770985,antisense,-1,432,chr8_46770553_46770985
Enpp6,8,46986887,47096762,protein_coding,1,109875,chr8_46986887_47096762
Gm45600,8,46994795,47014177,antisense,-1,19382,chr8_46994795_47014177
4930579M01Rik,8,47026805,47038177,antisense,-1,11372,chr8_47026805_47038177
E330018M18Rik,8,47135651,47163704,lincRNA,1,28053,chr8_47135651_47163704
Stox2,8,47180048,47446362,protein_coding,-1,266314,chr8_47180048_47446362
Trappc11,8,47490115,47533470,protein_coding,-1,43355,chr8_47490115_47533470
Rwdd4a,8,47533664,47552955,protein_coding,1,19291,chr8_47533664_47552955
Gm45576,8,47557529,47567896,lincRNA,1,10367,chr8_47557529_47567896
Ing2,8,47667178,47675556,protein_coding,-1,8378,chr8_47667178_47675556
Cdkn2aip,8,47709344,47713932,protein_coding,-1,4588,chr8_47709344_47713932
E030037K01Rik,8,47713266,47715021,antisense,1,1755,chr8_47713266_47715021
Gm31786,8,47744712,47750134,lincRNA,-1,5422,chr8_47744712_47750134
Gm45824,8,47764054,47766125,lincRNA,-1,2071,chr8_47764054_47766125
Gm45864,8,47773555,47777802,lincRNA,1,4247,chr8_47773555_47777802
1700061N14Rik,8,47811724,47818221,lincRNA,-1,6497,chr8_47811724_47818221
Wwc2,8,47823959,47990924,protein_coding,-1,166965,chr8_47823959_47990924
Cldn22,8,47824482,47825476,protein_coding,1,994,chr8_47824482_47825476
Gm32052,8,48002210,48009133,lincRNA,-1,6923,chr8_48002210_48009133
Dctd,8,48099092,48153233,protein_coding,1,54141,chr8_48099092_48153233
Tenm3,8,48227682,48843951,protein_coding,-1,616269,chr8_48227682_48843951
Gm45830,8,49044280,49046017,lincRNA,1,1737,chr8_49044280_49046017
Gm45829,8,49063879,49071859,lincRNA,1,7980,chr8_49063879_49071859
4930555F03Rik,8,49370886,49548994,lincRNA,1,178108,chr8_49370886_49548994
Gm45321,8,49818937,49949006,lincRNA,1,130069,chr8_49818937_49949006
Gm45323,8,49959483,50013384,lincRNA,-1,53901,chr8_49959483_50013384
Gm45341,8,50117745,50517889,lincRNA,-1,400144,chr8_50117745_50517889
Gm2516,8,50368112,50416088,lincRNA,1,47976,chr8_50368112_50416088
C130073E24Rik,8,50743291,50916997,lincRNA,-1,173706,chr8_50743291_50916997
Gm45389,8,52024987,52031271,lincRNA,-1,6284,chr8_52024987_52031271
Gm45388,8,52080163,52099750,lincRNA,1,19587,chr8_52080163_52099750
1190028D05Rik,8,52356611,52403339,lincRNA,1,46728,chr8_52356611_52403339
Gm45554,8,53436100,53480650,lincRNA,1,44550,chr8_53436100_53480650
Aga,8,53511727,53523421,protein_coding,1,11694,chr8_53511727_53523421
Neil3,8,53586867,53639065,protein_coding,-1,52198,chr8_53586867_53639065
Vegfc,8,54077606,54187096,protein_coding,1,109490,chr8_54077606_54187096
Spcs3,8,54520433,54529998,protein_coding,-1,9565,chr8_54520433_54529998
Asb5,8,54529580,54587875,protein_coding,1,58295,chr8_54529580_54587875
5330439A09Rik,8,54568550,54600987,antisense,-1,32437,chr8_54568550_54600987
Spata4,8,54600781,54610098,protein_coding,1,9317,chr8_54600781_54610098
Wdr17,8,54629055,54887184,protein_coding,-1,258129,chr8_54629055_54887184
Gpm6a,8,54954843,55060871,protein_coding,1,106028,chr8_54954843_55060871
Adam29,8,55870912,55906948,protein_coding,-1,36036,chr8_55870912_55906948
Glra3,8,55940460,56130070,protein_coding,1,189610,chr8_55940460_56130070
Hpgd,8,56294585,56321043,protein_coding,1,26458,chr8_56294585_56321043
4930518J21Rik,8,56465622,56484968,lincRNA,-1,19346,chr8_56465622_56484968
Cep44,8,56531522,56551047,protein_coding,-1,19525,chr8_56531522_56551047
Fbxo8,8,56551090,56593939,protein_coding,1,42849,chr8_56551090_56593939
Gm33501,8,56860568,56888893,lincRNA,-1,28325,chr8_56860568_56888893
5033428I22Rik,8,57332118,57354580,lincRNA,1,22462,chr8_57332118_57354580
Gm34099,8,57403104,57415052,lincRNA,1,11948,chr8_57403104_57415052
Scrg1,8,57455923,57477585,protein_coding,1,21662,chr8_57455923_57477585
Sap30,8,57482707,57487860,protein_coding,-1,5153,chr8_57482707_57487860
Hmgb2,8,57511907,57515999,protein_coding,1,4092,chr8_57511907_57515999
Galnt7,8,57523828,57653032,protein_coding,-1,129204,chr8_57523828_57653032
Gm45359,8,57658262,57658688,lincRNA,1,426,chr8_57658262_57658688
Gm45356,8,57699774,57727344,lincRNA,1,27570,chr8_57699774_57727344
Galntl6,8,57774052,58912640,protein_coding,-1,1138588,chr8_57774052_58912640
Gm15882,8,58523294,58524326,antisense,1,1032,chr8_58523294_58524326
BC030500,8,58911755,58914298,protein_coding,1,2543,chr8_58911755_58914298
Gm34370,8,59419306,59451513,lincRNA,1,32207,chr8_59419306_59451513
4930470O06Rik,8,59825649,59844723,lincRNA,1,19074,chr8_59825649_59844723
Gm34623,8,60195802,60280346,lincRNA,1,84544,chr8_60195802_60280346
Gm10283,8,60430024,60503198,protein_coding,-1,73174,chr8_60430024_60503198
Aadat,8,60505932,60545677,protein_coding,1,39745,chr8_60505932_60545677
Mfap3l,8,60632827,60676729,protein_coding,1,43902,chr8_60632827_60676729
Gm45650,8,60719291,60725806,lincRNA,1,6515,chr8_60719291_60725806
Hpf1,8,60890418,60908671,protein_coding,1,18253,chr8_60890418_60908671
Clcn3,8,60910389,60983300,protein_coding,-1,72911,chr8_60910389_60983300
B230317F23Rik,8,60983437,60985908,lincRNA,1,2471,chr8_60983437_60985908
Nek1,8,60993195,61131346,protein_coding,1,138151,chr8_60993195_61131346
Gm16178,8,61117605,61194648,antisense,-1,77043,chr8_61117605_61194648
Sh3rf1,8,61223872,61396071,protein_coding,1,172199,chr8_61223872_61396071
1700001D01Rik,8,61281522,61288872,antisense,-1,7350,chr8_61281522_61288872
Cbr4,8,61487734,61506694,protein_coding,1,18960,chr8_61487734_61506694
Palld,8,61511433,61902690,protein_coding,-1,391257,chr8_61511433_61902690
4930512H18Rik,8,61849006,61922834,antisense,1,73828,chr8_61849006_61922834
Ddx60,8,61928087,62038244,protein_coding,1,110157,chr8_61928087_62038244
Anxa10,8,62057042,62123150,protein_coding,-1,66108,chr8_62057042_62123150
Gm45460,8,62616317,62634645,lincRNA,-1,18328,chr8_62616317_62634645
Gm45459,8,62646335,62855382,lincRNA,-1,209047,chr8_62646335_62855382
Spock3,8,62951009,63357103,protein_coding,1,406094,chr8_62951009_63357103
Gm45589,8,63700863,63739577,lincRNA,-1,38714,chr8_63700863_63739577
Sgo2b,8,63924694,63952248,protein_coding,-1,27554,chr8_63924694_63952248
Tll1,8,64014931,64206271,protein_coding,-1,191340,chr8_64014931_64206271
Gm35521,8,64408643,64417100,lincRNA,-1,8457,chr8_64408643_64417100
Cpe,8,64592542,64693054,protein_coding,-1,100512,chr8_64592542_64693054
Gm45518,8,64701107,64711076,lincRNA,-1,9969,chr8_64701107_64711076
Msmo1,8,64718139,64733792,protein_coding,-1,15653,chr8_64718139_64733792
Klhl2,8,64739675,64850017,protein_coding,-1,110342,chr8_64739675_64850017
Gm45345,8,64838234,64839390,antisense,1,1156,chr8_64838234_64839390
Gm32507,8,64937959,64943988,lincRNA,1,6029,chr8_64937959_64943988
Tmem192,8,64947185,64969033,protein_coding,1,21848,chr8_64947185_64969033
Trim75,8,64980884,64987831,protein_coding,-1,6947,chr8_64980884_64987831
Trim60,8,64999307,65018584,protein_coding,-1,19277,chr8_64999307_65018584
Apela,8,65028417,65037336,protein_coding,-1,8919,chr8_65028417_65037336
Gm10663,8,65075033,65077480,protein_coding,1,2447,chr8_65075033_65077480
Gm15354,8,66384623,66387535,antisense,-1,2912,chr8_66384623_66387535
Gm15356,8,66439455,66442809,antisense,-1,3354,chr8_66439455_66442809
Tma16,8,66473118,66486530,protein_coding,-1,13412,chr8_66473118_66486530
Tktl2,8,66511756,66518335,protein_coding,1,6579,chr8_66511756_66518335
Npy5r,8,66679965,66688128,protein_coding,-1,8163,chr8_66679965_66688128
Npy1r,8,66697192,66706792,protein_coding,1,9600,chr8_66697192_66706792
Gm45911,8,66780080,66795561,lincRNA,1,15481,chr8_66780080_66795561
Naf1,8,66860217,66890564,protein_coding,1,30347,chr8_66860217_66890564
Gm39185,8,66905997,66937826,lincRNA,1,31829,chr8_66905997_66937826
Gm45827,8,67176771,67177787,lincRNA,1,1016,chr8_67176771_67177787
Gm10660,8,67352104,67365004,lincRNA,-1,12900,chr8_67352104_67365004
Nat1,8,67480921,67492104,protein_coding,1,11183,chr8_67480921_67492104
Nat2,8,67494858,67502584,protein_coding,1,7726,chr8_67494858_67502584
Nat3,8,67523854,67548627,protein_coding,1,24773,chr8_67523854_67548627
Psd3,8,67689082,68212027,protein_coding,-1,522945,chr8_67689082_68212027
Gm15991,8,67956769,67978051,antisense,1,21282,chr8_67956769_67978051
Sh2d4a,8,68276567,68347699,protein_coding,1,71132,chr8_68276567_68347699
Csgalnact1,8,68356781,68735146,protein_coding,-1,378365,chr8_68356781_68735146
1700125H03Rik,8,68368434,68375710,antisense,1,7276,chr8_68368434_68375710
Gm15656,8,68457148,68458681,antisense,1,1533,chr8_68457148_68458681
Ints10,8,68793929,68831667,protein_coding,1,37738,chr8_68793929_68831667
Lpl,8,68880491,68907448,protein_coding,1,26957,chr8_68880491_68907448
Gm33103,8,68971145,69001683,lincRNA,-1,30538,chr8_68971145_69001683
Slc18a1,8,69037711,69089235,protein_coding,-1,51524,chr8_69037711_69089235
Gm15716,8,69044754,69063422,antisense,1,18668,chr8_69044754_69063422
Atp6v1b2,8,69088646,69113711,protein_coding,1,25065,chr8_69088646_69113711
Lzts1,8,69132669,69184225,protein_coding,-1,51556,chr8_69132669_69184225
Zfp930,8,69209038,69230536,protein_coding,1,21498,chr8_69209038_69230536
D130040H23Rik,8,69271080,69314207,protein_coding,1,43127,chr8_69271080_69314207
Gm45848,8,69419497,69425233,lincRNA,1,5736,chr8_69419497_69425233
Gm9495,8,69427980,69453565,protein_coding,-1,25585,chr8_69427980_69453565
Gm43263,8,69473492,69474842,lincRNA,-1,1350,chr8_69473492_69474842
Gm7697,8,69481346,69522976,protein_coding,-1,41630,chr8_69481346_69522976
Zfp868,8,69610857,69625548,protein_coding,-1,14691,chr8_69610857_69625548
Zfp964,8,69654479,69666982,protein_coding,1,12503,chr8_69654479_69666982
Zfp869,8,69702656,69716983,protein_coding,-1,14327,chr8_69702656_69716983
Zfp963,8,69741639,69749970,protein_coding,-1,8331,chr8_69741639_69749970
Gm20422,8,69742862,69774886,protein_coding,-1,32024,chr8_69742862_69774886
Zfp866,8,69761326,69791178,protein_coding,-1,29852,chr8_69761326_69791178
Atp13a1,8,69791163,69807749,protein_coding,1,16586,chr8_69791163_69807749
Gmip,8,69808679,69821870,protein_coding,1,13191,chr8_69808679_69821870
Lpar2,8,69822429,69831102,protein_coding,1,8673,chr8_69822429_69831102
Pbx4,8,69832491,69872292,protein_coding,1,39801,chr8_69832491_69872292
Cilp2,8,69880369,69887687,protein_coding,-1,7318,chr8_69880369_69887687
Yjefn3,8,69887788,69902712,protein_coding,-1,14924,chr8_69887788_69902712
Tssk6,8,69902184,69903518,protein_coding,1,1334,chr8_69902184_69903518
Gatad2a,8,69907076,69996384,protein_coding,-1,89308,chr8_69907076_69996384
Mau2,8,70016123,70042734,protein_coding,-1,26611,chr8_70016123_70042734
Sugp1,8,70042813,70072347,protein_coding,1,29534,chr8_70042813_70072347
Tm6sf2,8,70072924,70080066,protein_coding,1,7142,chr8_70072924_70080066
Hapln4,8,70083457,70090862,protein_coding,1,7405,chr8_70083457_70090862
Ncan,8,70093085,70120873,protein_coding,-1,27788,chr8_70093085_70120873
Rfxank,8,70130794,70139154,protein_coding,-1,8360,chr8_70130794_70139154
Nr2c2ap,8,70131333,70133749,protein_coding,1,2416,chr8_70131333_70133749
Borcs8,8,70139499,70147319,protein_coding,1,7820,chr8_70139499_70147319
Mef2b,8,70139711,70167488,protein_coding,1,27777,chr8_70139711_70167488
Tmem161a,8,70172356,70183681,protein_coding,1,11325,chr8_70172356_70183681
Slc25a42,8,70184340,70212305,protein_coding,-1,27965,chr8_70184340_70212305
Armc6,8,70220172,70234466,protein_coding,-1,14294,chr8_70220172_70234466
Sugp2,8,70234226,70279915,protein_coding,1,45689,chr8_70234226_70279915
Homer3,8,70282827,70294361,protein_coding,1,11534,chr8_70282827_70294361
Ddx49,8,70292866,70302489,protein_coding,-1,9623,chr8_70292866_70302489
Cope,8,70302518,70312993,protein_coding,1,10475,chr8_70302518_70312993
Cers1,8,70315775,70331592,protein_coding,1,15817,chr8_70315775_70331592
Upf1,8,70331525,70353278,protein_coding,-1,21753,chr8_70331525_70353278
Comp,8,70373558,70382066,protein_coding,1,8508,chr8_70373558_70382066
Crtc1,8,70382355,70439579,protein_coding,-1,57224,chr8_70382355_70439579
Klhl26,8,70450219,70476968,protein_coding,-1,26749,chr8_70450219_70476968
Tmem59l,8,70483867,70487358,protein_coding,-1,3491,chr8_70483867_70487358
Crlf1,8,70493158,70504081,protein_coding,1,10923,chr8_70493158_70504081
Rex1bd,8,70504292,70506752,protein_coding,-1,2460,chr8_70504292_70506752
Uba52,8,70508263,70510801,protein_coding,-1,2538,chr8_70508263_70510801
Kxd1,8,70508272,70527956,protein_coding,-1,19684,chr8_70508272_70527956
Fkbp8,8,70527724,70535328,protein_coding,1,7604,chr8_70527724_70535328
Ell,8,70539457,70592858,protein_coding,1,53401,chr8_70539457_70592858
Isyna1,8,70594373,70597290,protein_coding,1,2917,chr8_70594373_70597290
Ssbp4,8,70597490,70608872,protein_coding,-1,11382,chr8_70597490_70608872
Lrrc25,8,70616155,70621483,protein_coding,1,5328,chr8_70616155_70621483
Gdf15,8,70629393,70632456,protein_coding,-1,3063,chr8_70629393_70632456
Pgpep1,8,70646435,70660388,protein_coding,-1,13953,chr8_70646435_70660388
Lsm4,8,70673248,70678752,protein_coding,1,5504,chr8_70673248_70678752
Jund,8,70698949,70700616,protein_coding,1,1667,chr8_70698949_70700616
Gm11175,CHR_MG190_MG3751_PATCH,70699162,70700080,antisense;lncRNA,-1,918,chrCHR_MG190_MG3751_PATCH_70699162_70700080
Gm3336,8,70718543,70722634,protein_coding,1,4091,chr8_70718543_70722634
Pde4c,8,70723720,70751186,protein_coding,1,27466,chr8_70723720_70751186
Rab3a,8,70754679,70758677,protein_coding,1,3998,chr8_70754679_70758677
Mpv17l2,8,70758646,70760946,protein_coding,-1,2300,chr8_70758646_70760946
Pik3r2,8,70768171,70776713,protein_coding,-1,8542,chr8_70768171_70776713
2010320M18Rik,8,70776810,70777823,lincRNA;lncRNA,1,1013,chr8_70776810_70777823
Mast3,8,70778112,70805054,protein_coding,-1,26942,chr8_70778112_70805054
Il12rb1,8,70808444,70821424,protein_coding,1,12980,chr8_70808444_70821424
Arrdc2,8,70835124,70839720,protein_coding,-1,4596,chr8_70835124_70839720
Kcnn1,8,70842044,70863258,protein_coding,-1,21214,chr8_70842044_70863258
Ccdc124,8,70868227,70873935,protein_coding,-1,5708,chr8_70868227_70873935
Slc5a5,8,70882889,70892757,protein_coding,-1,9868,chr8_70882889_70892757
Rpl18a,8,70894722,70897412,protein_coding,-1,2690,chr8_70894722_70897412
Map1s,8,70905932,70917529,protein_coding,1,11597,chr8_70905932_70917529
1700026F02Rik,8,70948246,71085758,lincRNA,-1,137512,chr8_70948246_71085758
Gm35256,8,71026792,71126576,lincRNA,1,99784,chr8_71026792_71126576
Haus8,8,71248561,71272934,protein_coding,-1,24373,chr8_71248561_71272934
Myo9b,8,71272714,71360713,protein_coding,1,87999,chr8_71272714_71360713
Use1,8,71366848,71369732,protein_coding,1,2884,chr8_71366848_71369732
Ocel1,8,71371298,71379361,protein_coding,1,8063,chr8_71371298_71379361
Nr2f6,8,71374123,71381960,protein_coding,-1,7837,chr8_71374123_71381960
Ushbp1,8,71384272,71395802,protein_coding,-1,11530,chr8_71384272_71395802
Babam1,8,71396861,71404619,protein_coding,1,7758,chr8_71396861_71404619
Ankle1,8,71406010,71409904,protein_coding,1,3894,chr8_71406010_71409904
Abhd8,8,71456705,71463655,protein_coding,-1,6950,chr8_71456705_71463655
Mrpl34,8,71464959,71465747,protein_coding,1,788,chr8_71464959_71465747
Dda1,8,71469199,71476098,protein_coding,1,6899,chr8_71469199_71476098
Ano8,8,71476019,71485963,protein_coding,-1,9944,chr8_71476019_71485963
Gtpbp3,8,71488103,71499583,protein_coding,1,11480,chr8_71488103_71499583
Plvap,8,71497765,71511752,protein_coding,-1,13987,chr8_71497765_71511752
Bst2,8,71534255,71537456,protein_coding,-1,3201,chr8_71534255_71537456
Mvb12a,8,71542922,71548085,protein_coding,1,5163,chr8_71542922_71548085
Nxnl1,8,71560555,71566601,protein_coding,-1,6046,chr8_71560555_71566601
Slc27a1,8,71568882,71587302,protein_coding,1,18420,chr8_71568882_71587302
Pgls,8,71592176,71601092,protein_coding,1,8916,chr8_71592176_71601092
Fam129c,8,71597648,71607936,protein_coding,1,10288,chr8_71597648_71607936
Colgalt1,8,71610998,71624911,protein_coding,1,13913,chr8_71610998_71624911
Unc13a,8,71624417,71671757,protein_coding,-1,47340,chr8_71624417_71671757
Jak3,8,71676296,71690575,protein_coding,1,14279,chr8_71676296_71690575
B3gnt3,8,71690756,71701789,protein_coding,-1,11033,chr8_71690756_71701789
Fcho1,8,71708387,71725716,protein_coding,-1,17329,chr8_71708387_71725716
Gm35572,8,71752026,71781322,lincRNA,-1,29296,chr8_71752026_71781322
Zfp709,8,71882019,71895727,protein_coding,1,13708,chr8_71882019_71895727
Zfp882,8,71908608,71916354,protein_coding,1,7746,chr8_71908608_71916354
Zfp617,8,71908635,71934629,protein_coding,1,25994,chr8_71908635_71934629
Zfp961,8,71951038,71993792,protein_coding,1,42754,chr8_71951038_71993792
Cyp4f18,8,71988482,72009626,protein_coding,-1,21144,chr8_71988482_72009626
Olfr372,8,72041218,72060630,protein_coding,1,19412,chr8_72041218_72060630
Olfr373,8,72083177,72103084,protein_coding,1,19907,chr8_72083177_72103084
Olfr374,8,72107040,72118200,protein_coding,1,11160,chr8_72107040_72118200
Tpm4,8,72130174,72153142,protein_coding,1,22968,chr8_72130174_72153142
Gm26586,8,72137389,72140820,antisense,-1,3431,chr8_72137389_72140820
Rab8a,8,72161200,72183904,protein_coding,1,22704,chr8_72161200_72183904
Hsh2d,8,72189638,72201527,protein_coding,1,11889,chr8_72189638_72201527
Cib3,8,72204335,72212996,protein_coding,-1,8661,chr8_72204335_72212996
Fam32a,8,72219730,72224418,protein_coding,1,4688,chr8_72219730_72224418
Ap1m1,8,72240018,72257385,protein_coding,1,17367,chr8_72240018_72257385
Gm10282,8,72304110,72305260,protein_coding,-1,1150,chr8_72304110_72305260
Klf2,8,72319033,72321656,protein_coding,1,2623,chr8_72319033_72321656
Eps15l1,8,72340999,72421460,protein_coding,-1,80461,chr8_72340999_72421460
Calr3,8,72424176,72443870,protein_coding,-1,19694,chr8_72424176_72443870
1700030K09Rik,8,72443880,72461001,protein_coding,1,17121,chr8_72443880_72461001
Cherp,8,72460489,72475226,protein_coding,-1,14737,chr8_72460489_72475226
Slc35e1,8,72480641,72492614,protein_coding,-1,11973,chr8_72480641_72492614
Gm17435,8,72492934,72505499,antisense,1,12565,chr8_72492934_72505499
Med26,8,72494561,72548270,protein_coding,-1,53709,chr8_72494561_72548270
Smim7,8,72565188,72571088,protein_coding,-1,5900,chr8_72565188_72571088
Tmem38a,8,72572055,72587282,protein_coding,1,15227,chr8_72572055_72587282
Nwd1,8,72646711,72717876,protein_coding,1,71165,chr8_72646711_72717876
Sin3b,8,72723285,72758201,protein_coding,1,34916,chr8_72723285_72758201
F2rl3,8,72761880,72763874,protein_coding,1,1994,chr8_72761880_72763874
Large1,8,72814599,73353540,protein_coding,-1,538941,chr8_72814599_73353540
Gm11033,8,74590987,74833947,lincRNA,-1,242960,chr8_74590987_74833947
Isx,8,74873173,74893506,protein_coding,1,20333,chr8_74873173_74893506
Hmgxb4,8,74993356,75031978,protein_coding,1,38622,chr8_74993356_75031978
Gm45822,8,75024097,75033941,antisense,-1,9844,chr8_75024097_75033941
Tom1,8,75033705,75070121,protein_coding,1,36416,chr8_75033705_75070121
Gm45820,8,75037434,75045246,antisense,-1,7812,chr8_75037434_75045246
Hmox1,8,75093621,75100589,protein_coding,1,6968,chr8_75093621_75100589
Mcm5,8,75109569,75128439,protein_coding,1,18870,chr8_75109569_75128439
Gm45903,8,75201439,75210042,lincRNA,1,8603,chr8_75201439_75210042
Rasd2,8,75213944,75224113,protein_coding,1,10169,chr8_75213944_75224113
Gm10358,8,75405340,75406589,protein_coding,-1,1249,chr8_75405340_75406589
Iqcm,8,75448694,75984503,protein_coding,1,535809,chr8_75448694_75984503
Gm45740,8,75992509,76415040,lincRNA,-1,422531,chr8_75992509_76415040
Gm45741,8,76010026,76011139,lincRNA,1,1113,chr8_76010026_76011139
Gm45798,8,76289516,76296013,lincRNA,1,6497,chr8_76289516_76296013
Nr3c2,8,76899442,77245012,protein_coding,1,345570,chr8_76899442_77245012
Arhgap10,8,77250366,77517953,protein_coding,-1,267587,chr8_77250366_77517953
Gm45406,8,77282861,77286207,antisense,1,3346,chr8_77282861_77286207
4933421D24Rik,8,77305533,77313299,antisense,1,7766,chr8_77305533_77313299
Gm45285,8,77331970,77336922,antisense,1,4952,chr8_77331970_77336922
0610038B21Rik,8,77517056,77523898,antisense,1,6842,chr8_77517056_77523898
Prmt9,8,77549397,77581338,protein_coding,1,31941,chr8_77549397_77581338
Tmem184c,8,77595982,77610698,protein_coding,-1,14716,chr8_77595982_77610698
1700092C02Rik,8,77624172,77628957,lincRNA,1,4785,chr8_77624172_77628957
Ednra,8,77663031,77724464,protein_coding,-1,61433,chr8_77663031_77724464
Gm29895,8,78044010,78055473,lincRNA,1,11463,chr8_78044010_78055473
Ttc29,8,78213297,78394326,protein_coding,1,181029,chr8_78213297_78394326
Rbmxl1,8,78505269,78508898,protein_coding,-1,3629,chr8_78505269_78508898
Slc10a7,8,78509346,78734003,protein_coding,1,224657,chr8_78509346_78734003
Lsm6,8,78804865,78821140,protein_coding,-1,16275,chr8_78804865_78821140
Gm45326,8,78950851,78953914,lincRNA,-1,3063,chr8_78950851_78953914
Gm39204,8,78953926,79014119,lincRNA,1,60193,chr8_78953926_79014119
Zfp827,8,79028437,79193766,protein_coding,1,165329,chr8_79028437_79193766
1700011L22Rik,8,79210431,79248570,protein_coding,-1,38139,chr8_79210431_79248570
Gm30329,8,79225930,79233224,antisense,1,7294,chr8_79225930_79233224
Mmaa,8,79263598,79294937,protein_coding,-1,31339,chr8_79263598_79294937
Smad1,8,79338395,79399518,protein_coding,-1,61123,chr8_79338395_79399518
Gm45601,8,79404148,79411216,lincRNA,1,7068,chr8_79404148_79411216
Gm45602,8,79491142,79499737,lincRNA,1,8595,chr8_79491142_79499737
Otud4,8,79639618,79677724,protein_coding,1,38106,chr8_79639618_79677724
Abce1,8,79683462,79711740,protein_coding,-1,28278,chr8_79683462_79711740
Anapc10,8,79711820,79779059,protein_coding,1,67239,chr8_79711820_79779059
Gm45435,8,79747267,79752413,antisense,-1,5146,chr8_79747267_79752413
Hhip,8,79965851,80058006,protein_coding,-1,92155,chr8_79965851_80058006
Gm45431,8,80128194,80138667,lincRNA,-1,10473,chr8_80128194_80138667
Gm45430,8,80195199,80197656,lincRNA,1,2457,chr8_80195199_80197656
Gypa,8,80493781,80510542,protein_coding,1,16761,chr8_80493781_80510542
Frem3,8,80611080,80695356,protein_coding,1,84276,chr8_80611080_80695356
Smarca5,8,80698507,80739497,protein_coding,-1,40990,chr8_80698507_80739497
Gab1,8,80764438,80880519,protein_coding,-1,116081,chr8_80764438_80880519
Gm31105,8,80879940,80881169,antisense,1,1229,chr8_80879940_80881169
Usp38,8,80980733,81014928,protein_coding,-1,34195,chr8_80980733_81014928
Gm9725,8,81013576,81061195,antisense,1,47619,chr8_81013576_81061195
Gm45538,8,81061334,81069803,lincRNA,1,8469,chr8_81061334_81069803
Inpp4b,8,81342556,82127914,protein_coding,1,785358,chr8_81342556_82127914
Gm38590,8,82184799,82207535,lincRNA,-1,22736,chr8_82184799_82207535
Il15,8,82331632,82403222,protein_coding,-1,71590,chr8_82331632_82403222
Zfp330,8,82763607,82774160,protein_coding,-1,10553,chr8_82763607_82774160
Gm31545,8,82796146,82803361,lincRNA,-1,7215,chr8_82796146_82803361
Rnf150,8,82863356,83091268,protein_coding,1,227912,chr8_82863356_83091268
Gm45449,8,83082258,83086957,antisense,-1,4699,chr8_83082258_83086957
Tbc1d9,8,83165352,83272934,protein_coding,1,107582,chr8_83165352_83272934
Ucp1,8,83290352,83298452,protein_coding,1,8100,chr8_83290352_83298452
Elmod2,8,83312632,83332486,protein_coding,-1,19854,chr8_83312632_83332486
Mgat4d,8,83348471,83382320,protein_coding,1,33849,chr8_83348471_83382320
Clgn,8,83389867,83428552,protein_coding,1,38685,chr8_83389867_83428552
Scoc,8,83430084,83458391,protein_coding,-1,28307,chr8_83430084_83458391
Olfr370,8,83535780,83545227,protein_coding,1,9447,chr8_83535780_83545227
Ndufb7,8,83566671,83571626,protein_coding,1,4955,chr8_83566671_83571626
Tecr,8,83571698,83607971,protein_coding,-1,36273,chr8_83571698_83607971
D830024N08Rik,8,83576044,83585919,antisense,1,9875,chr8_83576044_83585919
Dnajb1,8,83608193,83612653,protein_coding,1,4460,chr8_83608193_83612653
Gipc1,8,83652677,83664694,protein_coding,1,12017,chr8_83652677_83664694
Pkn1,8,83666536,83699179,protein_coding,-1,32643,chr8_83666536_83699179
Ptger1,8,83666678,83672753,protein_coding,1,6075,chr8_83666678_83672753
Ddx39,8,83715177,83726892,protein_coding,1,11715,chr8_83715177_83726892
Adgre5,8,83723251,83741326,protein_coding,-1,18075,chr8_83723251_83741326
Adgrl1,8,83900105,83941954,protein_coding,1,41849,chr8_83900105_83941954
Gm10644,8,83932329,83955343,bidirectional_promoter_lncRNA,-1,23014,chr8_83932329_83955343
Asf1b,8,83955507,83970197,protein_coding,1,14690,chr8_83955507_83970197
Prkaca,8,83972993,83996443,protein_coding,1,23450,chr8_83972993_83996443
Samd1,8,83997501,84000409,protein_coding,1,2908,chr8_83997501_84000409
1700067K01Rik,8,84001502,84004770,protein_coding,1,3268,chr8_84001502_84004770
Palm3,8,84021471,84030295,protein_coding,1,8824,chr8_84021471_84030295
Il27ra,8,84030294,84042589,protein_coding,-1,12295,chr8_84030294_84042589
Gm10643,8,84063561,84065137,protein_coding,-1,1576,chr8_84063561_84065137
C330011M18Rik,8,84065236,84067287,antisense,-1,2051,chr8_84065236_84067287
Rfx1,8,84066834,84096992,protein_coding,1,30158,chr8_84066834_84096992
Dcaf15,8,84097072,84104768,protein_coding,-1,7696,chr8_84097072_84104768
Podnl1,8,84125989,84132527,protein_coding,1,6538,chr8_84125989_84132527
Cc2d1a,8,84132828,84147936,protein_coding,-1,15108,chr8_84132828_84147936
4930432K21Rik,8,84148025,84172590,protein_coding,1,24565,chr8_84148025_84172590
Nanos3,8,84173731,84185217,protein_coding,-1,11486,chr8_84173731_84185217
Gm26887,8,84192774,84197667,lincRNA,-1,4893,chr8_84192774_84197667
Gm26532,8,84208920,84209609,lincRNA,1,689,chr8_84208920_84209609
Zswim4,8,84210678,84237055,protein_coding,-1,26377,chr8_84210678_84237055
D8Ertd738e,8,84246238,84249719,protein_coding,-1,3481,chr8_84246238_84249719
Mri1,8,84249906,84257326,protein_coding,-1,7420,chr8_84249906_84257326
Ccdc130,8,84257795,84270380,protein_coding,-1,12585,chr8_84257795_84270380
Cacna1a,8,84338639,84640246,protein_coding,1,301607,chr8_84338639_84640246
Gm16183,8,84611202,84617184,antisense,-1,5982,chr8_84611202_84617184
Ier2,8,84661331,84662854,protein_coding,-1,1523,chr8_84661331_84662854
Nacc1,8,84670479,84687902,protein_coding,-1,17423,chr8_84670479_84687902
Trmt1,8,84686307,84699808,protein_coding,1,13501,chr8_84686307_84699808
Nfix,8,84699876,84800344,protein_coding,-1,100468,chr8_84699876_84800344
Lyl1,8,84701449,84704940,protein_coding,1,3491,chr8_84701449_84704940
G430095P16Rik,8,84723007,84726844,protein_coding,1,3837,chr8_84723007_84726844
Dand5,8,84815404,84832409,protein_coding,-1,17005,chr8_84815404_84832409
Gadd45gip1,8,84831522,84835482,protein_coding,1,3960,chr8_84831522_84835482
Rad23a,8,84834019,84840665,protein_coding,-1,6646,chr8_84834019_84840665
Calr,8,84841850,84846934,protein_coding,-1,5084,chr8_84841850_84846934
Farsa,8,84856989,84869257,protein_coding,1,12268,chr8_84856989_84869257
Syce2,8,84872111,84888221,protein_coding,1,16110,chr8_84872111_84888221
Gcdh,8,84886393,84893921,protein_coding,-1,7528,chr8_84886393_84893921
Klf1,8,84901928,84905295,protein_coding,1,3367,chr8_84901928_84905295
Dnase2a,8,84908560,84922915,protein_coding,1,14355,chr8_84908560_84922915
Mast1,8,84911903,84937359,protein_coding,-1,25456,chr8_84911903_84937359
Rtbdn,8,84946991,84956603,protein_coding,1,9612,chr8_84946991_84956603
Rnaseh2a,8,84956610,84969767,protein_coding,-1,13157,chr8_84956610_84969767
Prdx2,8,84969587,84974834,protein_coding,1,5247,chr8_84969587_84974834
Junb,8,84976910,84978718,protein_coding,-1,1808,chr8_84976910_84978718
Hook2,8,84990603,85003349,protein_coding,1,12746,chr8_84990603_85003349
Best2,8,85007202,85014531,protein_coding,-1,7329,chr8_85007202_85014531
Asna1,8,85017931,85025281,protein_coding,-1,7350,chr8_85017931_85025281
Trir,8,85026823,85030286,protein_coding,1,3463,chr8_85026823_85030286
Tnpo2,8,85036915,85057583,protein_coding,1,20668,chr8_85036915_85057583
Fbxw9,8,85060055,85067124,protein_coding,1,7069,chr8_85060055_85067124
Gm5741,8,85067568,85067982,protein_coding,-1,414,chr8_85067568_85067982
Dhps,8,85071757,85075162,protein_coding,1,3405,chr8_85071757_85075162
Wdr83,8,85075035,85081306,protein_coding,-1,6271,chr8_85075035_85081306
Wdr83os,8,85080740,85082339,protein_coding,1,1599,chr8_85080740_85082339
Man2b1,8,85083270,85098282,protein_coding,1,15012,chr8_85083270_85098282
Zfp791,8,85108553,85123095,protein_coding,-1,14542,chr8_85108553_85123095
Gm42031,8,85125872,85132289,lincRNA,-1,6417,chr8_85125872_85132289
Cks1brt,8,85151924,85173622,protein_coding,1,21698,chr8_85151924_85173622
Olfr371,8,85225988,85231509,protein_coding,1,5521,chr8_85225988_85231509
Vps35,8,85260392,85299802,protein_coding,-1,39410,chr8_85260392_85299802
Orc6,8,85299632,85308278,protein_coding,1,8646,chr8_85299632_85308278
Mylk3,8,85324303,85386345,protein_coding,-1,62042,chr8_85324303_85386345
AA672651,8,85339343,85340272,antisense,1,929,chr8_85339343_85340272
4921524J17Rik,8,85408759,85432833,protein_coding,-1,24074,chr8_85408759_85432833
Gpt2,8,85492576,85527560,protein_coding,1,34984,chr8_85492576_85527560
Dnaja2,8,85537633,85555344,protein_coding,-1,17711,chr8_85537633_85555344
Gm45425,8,85605462,85610761,lincRNA,1,5299,chr8_85605462_85610761
Neto2,8,85636588,85700924,protein_coding,-1,64336,chr8_85636588_85700924
Itfg1,8,85717578,85840921,protein_coding,-1,123343,chr8_85717578_85840921
Gm39214,8,85730816,85765095,lincRNA,1,34279,chr8_85730816_85765095
Phkb,8,85840959,86061376,protein_coding,1,220417,chr8_85840959_86061376
Abcc12,8,86482260,86580686,protein_coding,-1,98426,chr8_86482260_86580686
Lonp2,8,86624043,86723873,protein_coding,1,99830,chr8_86624043_86723873
Siah1a,8,86724007,86745934,protein_coding,-1,21927,chr8_86724007_86745934
Gm10638,8,86745453,86748655,antisense,1,3202,chr8_86745453_86748655
N4bp1,8,86808160,86885258,protein_coding,-1,77098,chr8_86808160_86885258
2010110E17Rik,8,86885688,86886566,lincRNA,1,878,chr8_86885688_86886566
Gm27167,8,86902453,86919422,lincRNA,1,16969,chr8_86902453_86919422
Gm5118,8,87093307,87100987,lincRNA,1,7680,chr8_87093307_87100987
Gm27246,8,87114645,87198404,lincRNA,1,83759,chr8_87114645_87198404
Gm10637,8,87169747,87199850,lincRNA,-1,30103,chr8_87169747_87199850
Gm27169,8,87203026,87293504,lincRNA,1,90478,chr8_87203026_87293504
Gm27207,8,87354501,87373075,lincRNA,-1,18574,chr8_87354501_87373075
Gm2694,8,87460469,87525554,lincRNA,1,65085,chr8_87460469_87525554
Cbln1,8,87468405,87472609,protein_coding,-1,4204,chr8_87468405_87472609
Gm27016,8,87476055,87495462,lincRNA,-1,19407,chr8_87476055_87495462
1700120C18Rik,8,87500049,87501231,lincRNA,-1,1182,chr8_87500049_87501231
4933402J07Rik,8,87563853,87589424,protein_coding,1,25571,chr8_87563853_87589424
Zfp423,8,87661810,87959595,protein_coding,-1,297785,chr8_87661810_87959595
Cnep1r1,8,88118769,88135110,protein_coding,1,16341,chr8_88118769_88135110
Heatr3,8,88137855,88172027,protein_coding,1,34172,chr8_88137855_88172027
9430002A10Rik,8,88174560,88175034,lincRNA,1,474,chr8_88174560_88175034
Adcy7,8,88272403,88329962,protein_coding,1,57559,chr8_88272403_88329962
Brd7,8,88331039,88362194,protein_coding,-1,31155,chr8_88331039_88362194
Nkd1,8,88521354,88594884,protein_coding,1,73530,chr8_88521354_88594884
Snx20,8,88626563,88636128,protein_coding,-1,9565,chr8_88626563_88636128
Nod2,8,88647315,88688474,protein_coding,1,41159,chr8_88647315_88688474
Cyld,8,88697028,88751945,protein_coding,1,54917,chr8_88697028_88751945
Sall1,8,89027235,89044162,protein_coding,-1,16927,chr8_89027235_89044162
Tox3,8,90247040,90348343,protein_coding,-1,101303,chr8_90247040_90348343
Gm45639,8,90669805,90674958,lincRNA,-1,5153,chr8_90669805_90674958
Gm35850,8,90709458,90740775,lincRNA,-1,31317,chr8_90709458_90740775
Gm35963,8,90759463,90762596,lincRNA,-1,3133,chr8_90759463_90762596
Gm19935,8,90816145,90817393,protein_coding,-1,1248,chr8_90816145_90817393
Chd9,8,90828352,91054516,protein_coding,1,226164,chr8_90828352_91054516
Gm45641,8,90848034,90849846,antisense,-1,1812,chr8_90848034_90849846
Rbl2,8,91070057,91123844,protein_coding,1,53787,chr8_91070057_91123844
Aktip,8,91111784,91199976,protein_coding,-1,88192,chr8_91111784_91199976
Gm45666,8,91160516,91171180,antisense,1,10664,chr8_91160516_91171180
Gm36243,8,91210570,91224667,antisense,1,14097,chr8_91210570_91224667
Rpgrip1l,8,91217030,91313262,protein_coding,-1,96232,chr8_91217030_91313262
Fto,8,91313525,91668439,protein_coding,1,354914,chr8_91313525_91668439
4831440D22Rik,8,91449521,91474598,antisense,-1,25077,chr8_91449521_91474598
Gm3235,8,91621448,91629729,antisense,-1,8281,chr8_91621448_91629729
Gm36325,8,91710233,91714413,lincRNA,-1,4180,chr8_91710233_91714413
Irx3,8,91798525,91802067,protein_coding,-1,3542,chr8_91798525_91802067
Gm28511,8,91865871,91872995,lincRNA,1,7124,chr8_91865871_91872995
Gm36670,8,91974095,91991947,lincRNA,-1,17852,chr8_91974095_91991947
Gm36843,8,91997594,92009006,lincRNA,1,11412,chr8_91997594_92009006
Gm28516,8,92024442,92038438,lincRNA,1,13996,chr8_92024442_92038438
Gm45332,8,92152096,92158266,lincRNA,-1,6170,chr8_92152096_92158266
Gm45335,8,92172587,92189124,lincRNA,1,16537,chr8_92172587_92189124
Gm45334,8,92233125,92247959,lincRNA,1,14834,chr8_92233125_92247959
Gm21817,8,92336668,92339250,lincRNA,-1,2582,chr8_92336668_92339250
Irx6,8,92674288,92680956,protein_coding,1,6668,chr8_92674288_92680956
Mmp2,8,92827291,92853420,protein_coding,1,26129,chr8_92827291_92853420
Gm45472,8,92853653,92856334,antisense,-1,2681,chr8_92853653_92856334
Lpcat2,8,92855339,92919279,protein_coding,1,63940,chr8_92855339_92919279
Slc6a2,8,92960079,93001667,protein_coding,1,41588,chr8_92960079_93001667
Ces1a,8,93020214,93048192,protein_coding,-1,27978,chr8_93020214_93048192
Ces1b,8,93056728,93080017,protein_coding,-1,23289,chr8_93056728_93080017
Ces1c,8,93099015,93131283,protein_coding,-1,32268,chr8_93099015_93131283
Ces1d,8,93166068,93197838,protein_coding,-1,31770,chr8_93166068_93197838
Ces1e,8,93201218,93229619,protein_coding,-1,28401,chr8_93201218_93229619
Ces1f,8,93256236,93279747,protein_coding,-1,23511,chr8_93256236_93279747
Ces1g,8,93302369,93337308,protein_coding,-1,34939,chr8_93302369_93337308
Ces1h,8,93351843,93379725,protein_coding,-1,27882,chr8_93351843_93379725
Gm45765,8,93363623,93431049,antisense,1,67426,chr8_93363623_93431049
Gm45766,8,93430475,93437174,lincRNA,-1,6699,chr8_93430475_93437174
Ces5a,8,93499064,93535830,protein_coding,-1,36766,chr8_93499064_93535830
Gm45708,8,93565977,93628624,lincRNA,-1,62647,chr8_93565977_93628624
Gm26843,8,93646386,93687958,lincRNA,-1,41572,chr8_93646386_93687958
Gm30606,8,93707015,93719975,lincRNA,-1,12960,chr8_93707015_93719975
4930488L21Rik,8,93750147,93813722,antisense,-1,63575,chr8_93750147_93813722
Gnao1,8,93809966,93969388,protein_coding,1,159422,chr8_93809966_93969388
Amfr,8,93971588,94012842,protein_coding,-1,41254,chr8_93971588_94012842
Nudt21,8,94015496,94037031,protein_coding,-1,21535,chr8_94015496_94037031
Ogfod1,8,94037198,94067921,protein_coding,1,30723,chr8_94037198_94067921
Bbs2,8,94067954,94098928,protein_coding,-1,30974,chr8_94067954_94098928
Mt3,8,94152607,94154146,protein_coding,1,1539,chr8_94152607_94154146
Gm45774,8,94170748,94173412,antisense,-1,2664,chr8_94170748_94173412
Mt2,8,94172664,94173568,protein_coding,1,904,chr8_94172664_94173568
Mt1,8,94179082,94180327,protein_coding,1,1245,chr8_94179082_94180327
Gm39228,8,94183289,94184969,lincRNA,1,1680,chr8_94183289_94184969
Nup93,8,94214564,94317227,protein_coding,1,102663,chr8_94214564_94317227
C78859,8,94322158,94328100,lincRNA,1,5942,chr8_94322158_94328100
Slc12a3,8,94329201,94366214,protein_coding,1,37013,chr8_94329201_94366214
Gm15890,8,94379184,94386972,antisense,-1,7788,chr8_94379184_94386972
Herpud1,8,94386438,94395377,protein_coding,1,8939,chr8_94386438_94395377
Nlrc5,8,94434356,94527272,protein_coding,1,92916,chr8_94434356_94527272
Cpne2,8,94532990,94570531,protein_coding,1,37541,chr8_94532990_94570531
Fam192a,8,94574138,94601997,protein_coding,-1,27859,chr8_94574138_94601997
Rspry1,8,94601937,94660275,protein_coding,1,58338,chr8_94601937_94660275
Arl2bp,8,94666600,94674425,protein_coding,1,7825,chr8_94666600_94674425
Pllp,8,94674894,94696278,protein_coding,-1,21384,chr8_94674894_94696278
Gm45767,8,94675606,94680166,antisense,1,4560,chr8_94675606_94680166
Ccl22,8,94745590,94751699,protein_coding,1,6109,chr8_94745590_94751699
Cx3cl1,8,94772009,94782427,protein_coding,1,10418,chr8_94772009_94782427
Ccl17,8,94810453,94812036,protein_coding,1,1583,chr8_94810453_94812036
Ciapin1,8,94819804,94838358,protein_coding,-1,18554,chr8_94819804_94838358
Coq9,8,94838321,94854895,protein_coding,1,16574,chr8_94838321_94854895
Polr2c,8,94857450,94873535,protein_coding,1,16085,chr8_94857450_94873535
Dok4,8,94863828,94876330,protein_coding,-1,12502,chr8_94863828_94876330
Ccdc102a,8,94902869,94918098,protein_coding,-1,15229,chr8_94902869_94918098
Adgrg5,8,94923694,94943280,protein_coding,1,19586,chr8_94923694_94943280
Adgrg1,8,94974751,95014217,protein_coding,1,39466,chr8_94974751_95014217
Adgrg3,8,95017692,95045250,protein_coding,1,27558,chr8_95017692_95045250
Drc7,8,95055103,95078141,protein_coding,1,23038,chr8_95055103_95078141
Katnb1,8,95081186,95103149,protein_coding,1,21963,chr8_95081186_95103149
Kifc3,8,95099828,95202812,protein_coding,-1,102984,chr8_95099828_95202812
Gm31224,8,95113566,95129590,antisense,1,16024,chr8_95113566_95129590
Gm45812,8,95126666,95134867,antisense,1,8201,chr8_95126666_95134867
Gm31036,8,95138310,95148386,antisense,1,10076,chr8_95138310_95148386
Cngb1,8,95239045,95306585,protein_coding,-1,67540,chr8_95239045_95306585
Tepp,8,95310566,95326323,protein_coding,1,15757,chr8_95310566_95326323
Zfp319,8,95323011,95331950,protein_coding,-1,8939,chr8_95323011_95331950
Usb1,8,95332284,95347507,protein_coding,1,15223,chr8_95332284_95347507
Mmp15,8,95352268,95375080,protein_coding,1,22812,chr8_95352268_95375080
Cfap20,8,95420249,95434869,protein_coding,-1,14620,chr8_95420249_95434869
Csnk2a2,8,95446096,95490039,protein_coding,-1,43943,chr8_95446096_95490039
4933406B17Rik,8,95496430,95503718,lincRNA,1,7288,chr8_95496430_95503718
Ccdc113,8,95534085,95558890,protein_coding,1,24805,chr8_95534085_95558890
Prss54,8,95559069,95576340,protein_coding,-1,17271,chr8_95559069_95576340
Gm31518,8,95593422,95621509,lincRNA,1,28087,chr8_95593422_95621509
Gm45702,8,95629173,95630391,lincRNA,-1,1218,chr8_95629173_95630391
Gins3,8,95633453,95645060,protein_coding,1,11607,chr8_95633453_95645060
Ndrg4,8,95676980,95715119,protein_coding,1,38139,chr8_95676980_95715119
Setd6,8,95715881,95719010,protein_coding,1,3129,chr8_95715881_95719010
Cnot1,8,95719451,95807464,protein_coding,-1,88013,chr8_95719451_95807464
4930513N10Rik,8,95806744,95821728,antisense,1,14984,chr8_95806744_95821728
Gm31659,8,95808552,95818274,lincRNA,-1,9722,chr8_95808552_95818274
Sap18b,8,95825346,95826134,protein_coding,1,788,chr8_95825346_95826134
Gm31805,8,95828598,95833675,lincRNA,-1,5077,chr8_95828598_95833675
Slc38a7,8,95835920,95853539,protein_coding,-1,17619,chr8_95835920_95853539
Got2,8,95864134,95888547,protein_coding,-1,24413,chr8_95864134_95888547
Gm45895,8,95910574,95934042,lincRNA,1,23468,chr8_95910574_95934042
Gm32005,8,96309519,96361523,lincRNA,1,52004,chr8_96309519_96361523
Gm32122,8,96371727,96403862,lincRNA,-1,32135,chr8_96371727_96403862
Gm45703,8,97149419,97164356,lincRNA,-1,14937,chr8_97149419_97164356
Gm39231,8,97840048,97847267,lincRNA,1,7219,chr8_97840048_97847267
Gm15679,8,99011886,99032740,antisense,1,20854,chr8_99011886_99032740
Cdh8,8,99024471,99416471,protein_coding,-1,392000,chr8_99024471_99416471
A330008L17Rik,8,99416642,99733438,lincRNA,1,316796,chr8_99416642_99733438
Gm39232,8,100661909,100726355,lincRNA,-1,64446,chr8_100661909_100726355
Cdh11,8,102632095,102785642,protein_coding,-1,153547,chr8_102632095_102785642
Gm45391,8,103130248,103144946,lincRNA,-1,14698,chr8_103130248_103144946
Gm32531,8,103271391,103340130,lincRNA,1,68739,chr8_103271391_103340130
1600027J07Rik,8,103343878,103347534,lincRNA,-1,3656,chr8_103343878_103347534
Gm45277,8,103531645,103563623,lincRNA,-1,31978,chr8_103531645_103563623
4933400L20Rik,8,103603782,103680384,lincRNA,1,76602,chr8_103603782_103680384
Gm29682,8,104088916,104105873,antisense,-1,16957,chr8_104088916_104105873
Cdh5,8,104101625,104144511,protein_coding,1,42886,chr8_104101625_104144511
Bean1,8,104170442,104219122,protein_coding,1,48680,chr8_104170442_104219122
Gm10631,8,104177795,104184599,antisense,-1,6804,chr8_104177795_104184599
Gm45892,8,104217202,104218299,antisense,-1,1097,chr8_104217202_104218299
Tk2,8,104226685,104248558,protein_coding,-1,21873,chr8_104226685_104248558
Cklf,8,104250861,104264938,protein_coding,1,14077,chr8_104250861_104264938
Cmtm2a,8,104281042,104293181,protein_coding,-1,12139,chr8_104281042_104293181
Cmtm2b,8,104322230,104330764,protein_coding,1,8534,chr8_104322230_104330764
Cmtm3,8,104339410,104347672,protein_coding,1,8262,chr8_104339410_104347672
Cmtm4,8,104348191,104395807,protein_coding,-1,47616,chr8_104348191_104395807
Dync1li2,8,104417680,104443047,protein_coding,-1,25367,chr8_104417680_104443047
K230015D01Rik,8,104442271,104443786,antisense,1,1515,chr8_104442271_104443786
Terb1,8,104446719,104509910,protein_coding,-1,63191,chr8_104446719_104509910
Nae1,8,104511028,104534637,protein_coding,-1,23609,chr8_104511028_104534637
Car7,8,104534689,104550343,protein_coding,1,15654,chr8_104534689_104550343
Gm45843,8,104551907,104556987,lincRNA,-1,5080,chr8_104551907_104556987
Pdp2,8,104591451,104599026,protein_coding,1,7575,chr8_104591451_104599026
Cdh16,8,104601911,104624396,protein_coding,-1,22485,chr8_104601911_104624396
Rrad,8,104628070,104631327,protein_coding,-1,3257,chr8_104628070_104631327
Gm33023,8,104630832,104636492,antisense,1,5660,chr8_104630832_104636492
1700082M22Rik,8,104641807,104658558,antisense,1,16751,chr8_104641807_104658558
4932416K20Rik,8,104794928,104799052,lincRNA,1,4124,chr8_104794928_104799052
Ces2b,8,104831572,104840093,protein_coding,1,8521,chr8_104831572_104840093
Ces2f,8,104947356,104960047,protein_coding,1,12691,chr8_104947356_104960047
Ces2g,8,104961718,104969537,protein_coding,1,7819,chr8_104961718_104969537
Ces2h,8,105000853,105021178,protein_coding,1,20325,chr8_105000853_105021178
Ces4a,8,105131800,105150109,protein_coding,1,18309,chr8_105131800_105150109
Gm3830,8,105164587,105170367,lincRNA,1,5780,chr8_105164587_105170367
Cbfb,8,105170674,105217989,protein_coding,1,47315,chr8_105170674_105217989
D230025D16Rik,8,105225145,105253053,protein_coding,1,27908,chr8_105225145_105253053
B3gnt9,8,105252638,105255153,protein_coding,-1,2515,chr8_105252638_105255153
Tradd,8,105258286,105264609,protein_coding,-1,6323,chr8_105258286_105264609
Fbxl8,8,105264648,105269326,protein_coding,1,4678,chr8_105264648_105269326
Hsf4,8,105269801,105275845,protein_coding,1,6044,chr8_105269801_105275845
Nol3,8,105276140,105281939,protein_coding,1,5799,chr8_105276140_105281939
4931428F04Rik,8,105280409,105289864,protein_coding,-1,9455,chr8_105280409_105289864
Gm20163,8,105289678,105291485,antisense,1,1807,chr8_105289678_105291485
Exoc3l,8,105289924,105296101,protein_coding,-1,6177,chr8_105289924_105296101
E2f4,8,105297663,105305370,protein_coding,1,7707,chr8_105297663_105305370
Elmo3,8,105305601,105310760,protein_coding,1,5159,chr8_105305601_105310760
Lrrc29,8,105312265,105326278,protein_coding,-1,14013,chr8_105312265_105326278
Tmem208,8,105326354,105335219,protein_coding,1,8865,chr8_105326354_105335219
Fhod1,8,105329163,105347953,protein_coding,-1,18790,chr8_105329163_105347953
Slc9a5,8,105348843,105369881,protein_coding,1,21038,chr8_105348843_105369881
Plekhg4,8,105373274,105382862,protein_coding,1,9588,chr8_105373274_105382862
Kctd19,8,105382807,105413502,protein_coding,-1,30695,chr8_105382807_105413502
Lrrc36,8,105413571,105464086,protein_coding,1,50515,chr8_105413571_105464086
Tppp3,8,105467493,105471526,protein_coding,-1,4033,chr8_105467493_105471526
Zdhhc1,8,105472423,105496902,protein_coding,-1,24479,chr8_105472423_105496902
Hsd11b2,8,105518755,105523988,protein_coding,1,5233,chr8_105518755_105523988
Atp6v0d1,8,105524465,105566047,protein_coding,-1,41582,chr8_105524465_105566047
Gm38250,8,105566324,105578109,antisense,1,11785,chr8_105566324_105578109
Agrp,8,105566698,105637393,protein_coding,-1,70695,chr8_105566698_105637393
Ripor1,8,105605255,105622219,protein_coding,1,16964,chr8_105605255_105622219
Gm5914,8,105624336,105637485,lincRNA,-1,13149,chr8_105624336_105637485
Ctcf,8,105636568,105682922,protein_coding,1,46354,chr8_105636568_105682922
Carmil2,8,105686274,105698187,protein_coding,1,11913,chr8_105686274_105698187
Acd,8,105695860,105701102,protein_coding,-1,5242,chr8_105695860_105701102
Pard6a,8,105701148,105703496,protein_coding,1,2348,chr8_105701148_105703496
Enkd1,8,105703651,105708210,protein_coding,-1,4559,chr8_105703651_105708210
4933405L10Rik,8,105707655,105710246,protein_coding,1,2591,chr8_105707655_105710246
Gfod2,8,105713854,105758664,protein_coding,-1,44810,chr8_105713854_105758664
Ranbp10,8,105768308,105827350,protein_coding,-1,59042,chr8_105768308_105827350
Tsnaxip1,8,105827731,105844680,protein_coding,1,16949,chr8_105827731_105844680
Cenpt,8,105844673,105853278,protein_coding,-1,8605,chr8_105844673_105853278
Thap11,8,105855132,105856950,protein_coding,1,1818,chr8_105855132_105856950
Nutf2,8,105860580,105879330,protein_coding,1,18750,chr8_105860580_105879330
Edc4,8,105880881,105894908,protein_coding,1,14027,chr8_105880881_105894908
Nrn1l,8,105893567,105895023,protein_coding,1,1456,chr8_105893567_105895023
Pskh1,8,105900441,105931778,protein_coding,1,31337,chr8_105900441_105931778
Ctrl,8,105932003,105933862,protein_coding,-1,1859,chr8_105932003_105933862
Gm16156,8,105934333,105945843,antisense,1,11510,chr8_105934333_105945843
Psmb10,8,105935735,105938444,protein_coding,-1,2709,chr8_105935735_105938444
Lcat,8,105939551,105943382,protein_coding,-1,3831,chr8_105939551_105943382
Slc12a4,8,105943590,105966097,protein_coding,-1,22507,chr8_105943590_105966097
Gm45752,8,105973097,105985879,transcribed_unprocessed_pseudogene,1,12782,chr8_105973097_105985879
Dpep3,8,105973513,105979429,protein_coding,-1,5916,chr8_105973513_105979429
Dpep2,8,105984944,105996423,protein_coding,-1,11479,chr8_105984944_105996423
Dus2,8,105991337,106053840,protein_coding,1,62503,chr8_105991337_106053840
Dpep2nb,8,105995466,106005975,protein_coding,-1,10509,chr8_105995466_106005975
Ddx28,8,106009621,106011882,protein_coding,-1,2261,chr8_106009621_106011882
Nfatc3,8,106058840,106130537,protein_coding,1,71697,chr8_106058840_106130537
Esrp2,8,106130319,106136974,protein_coding,-1,6655,chr8_106130319_106136974
Pla2g15,8,106150399,106164715,protein_coding,1,14316,chr8_106150399_106164715
Slc7a6,8,106168857,106198706,protein_coding,1,29849,chr8_106168857_106198706
Slc7a6os,8,106200717,106210935,protein_coding,-1,10218,chr8_106200717_106210935
Prmt7,8,106210936,106252794,protein_coding,1,41858,chr8_106210936_106252794
Gm10629,8,106283307,106300017,lincRNA,1,16710,chr8_106283307_106300017
Zfp90,8,106415327,106426598,protein_coding,1,11271,chr8_106415327_106426598
6030452D12Rik,8,106500505,106509656,lincRNA,1,9151,chr8_106500505_106509656
Cdh3,8,106510891,106557297,protein_coding,1,46406,chr8_106510891_106557297
Gm10073,8,106573009,106573350,processed_pseudogene,-1,341,chr8_106573009_106573350
1110028F18Rik,8,106587143,106594820,lincRNA,1,7677,chr8_106587143_106594820
Cdh1,8,106603351,106670246,protein_coding,1,66895,chr8_106603351_106670246
Tango6,8,106683068,106851439,protein_coding,1,168371,chr8_106683068_106851439
Has3,8,106870242,106884566,protein_coding,1,14324,chr8_106870242_106884566
Chtf8,8,106883863,106893601,protein_coding,-1,9738,chr8_106883863_106893601
Utp4,8,106893636,106923088,protein_coding,1,29452,chr8_106893636_106923088
Sntb2,8,106935750,107019714,protein_coding,1,83964,chr8_106935750_107019714
Gm16208,8,107029675,107031188,antisense,-1,1513,chr8_107029675_107031188
Vps4a,8,107031222,107045755,protein_coding,1,14533,chr8_107031222_107045755
Pdf,8,107044698,107048614,protein_coding,-1,3916,chr8_107044698_107048614
Cog8,8,107046289,107056689,protein_coding,-1,10400,chr8_107046289_107056689
Nip7,8,107056877,107060931,protein_coding,1,4054,chr8_107056877_107060931
Tmed6,8,107061476,107065644,protein_coding,-1,4168,chr8_107061476_107065644
Terf2,8,107069400,107096547,protein_coding,-1,27147,chr8_107069400_107096547
Cyb5b,8,107150640,107187471,protein_coding,1,36831,chr8_107150640_107187471
Nfat5,8,107293470,107379517,protein_coding,1,86047,chr8_107293470_107379517
Nqo1,8,107388225,107403206,protein_coding,-1,14981,chr8_107388225_107403206
Nob1,8,107412486,107425051,protein_coding,-1,12565,chr8_107412486_107425051
Wwp2,8,107436365,107558595,protein_coding,1,122230,chr8_107436365_107558595
Psmd7,8,107580381,107588464,protein_coding,-1,8083,chr8_107580381_107588464
5033426E14Rik,8,107869685,107885011,lincRNA,1,15326,chr8_107869685_107885011
Zfhx3,8,107942644,108961630,protein_coding,1,1018986,chr8_107942644_108961630
Gm39244,8,108526937,108537221,lincRNA,-1,10284,chr8_108526937_108537221
Lncbate1,8,108553252,108584595,lincRNA,-1,31343,chr8_108553252_108584595
Gm20686,8,108918264,108921874,antisense,-1,3610,chr8_108918264_108921874
D030068K23Rik,8,109075222,109273811,lincRNA,1,198589,chr8_109075222_109273811
Pmfbp1,8,109494027,109542640,protein_coding,1,48613,chr8_109494027_109542640
Dhx38,8,109548011,109565861,protein_coding,-1,17850,chr8_109548011_109565861
Txnl4b,8,109565892,109574051,protein_coding,1,8159,chr8_109565892_109574051
Hp,8,109575128,109579172,protein_coding,-1,4044,chr8_109575128_109579172
Dhodh,8,109591343,109608673,protein_coding,-1,17330,chr8_109591343_109608673
Pkd1l3,8,109614517,109674386,protein_coding,1,59869,chr8_109614517_109674386
Ist1,8,109671325,109693260,protein_coding,-1,21935,chr8_109671325_109693260
Zfp821,8,109705546,109724932,protein_coding,1,19386,chr8_109705546_109724932
Atxn1l,8,109726451,109737739,protein_coding,-1,11288,chr8_109726451_109737739
Ap1g1,8,109778554,109864204,protein_coding,1,85650,chr8_109778554_109864204
Gm17344,8,109859984,109868455,antisense,-1,8471,chr8_109859984_109868455
Phlpp2,8,109868542,109944671,protein_coding,1,76129,chr8_109868542_109944671
Marveld3,8,109947914,109962203,protein_coding,-1,14289,chr8_109947914_109962203
Tat,8,109990437,109999803,protein_coding,1,9366,chr8_109990437_109999803
Chst4,8,110029153,110039740,protein_coding,-1,10587,chr8_110029153_110039740
8030455M16Rik,8,110047432,110057176,lincRNA,1,9744,chr8_110047432_110057176
Zfp612,8,110079746,110092741,protein_coding,1,12995,chr8_110079746_110092741
Gm17720,8,110082803,110102753,protein_coding,-1,19950,chr8_110082803_110102753
Calb2,8,110137502,110168210,protein_coding,-1,30708,chr8_110137502_110168210
Cmtr2,8,110215665,110224486,protein_coding,1,8821,chr8_110215665_110224486
Gm26832,8,110265248,110267462,antisense,-1,2214,chr8_110265248_110267462
Hydin,8,110266977,110610253,protein_coding,1,343276,chr8_110266977_110610253
Vac14,8,110618585,110720398,protein_coding,1,101813,chr8_110618585_110720398
Il34,8,110741829,110805924,protein_coding,-1,64095,chr8_110741829_110805924
Gm15894,8,110754992,110758970,antisense,1,3978,chr8_110754992_110758970
Sf3b3,8,110810239,110846787,protein_coding,-1,36548,chr8_110810239_110846787
Cog4,8,110846600,110882227,protein_coding,1,35627,chr8_110846600_110882227
St3gal2,8,110919922,110972480,protein_coding,1,52558,chr8_110919922_110972480
Ddx19a,8,110974996,110997800,protein_coding,-1,22804,chr8_110974996_110997800
Ddx19b,8,111003188,111031751,protein_coding,-1,28563,chr8_111003188_111031751
Aars,8,111033144,111057664,protein_coding,1,24520,chr8_111033144_111057664
Clec18a,8,111058920,111092426,protein_coding,-1,33506,chr8_111058920_111092426
Pdpr,8,111094630,111137074,protein_coding,1,42444,chr8_111094630_111137074
Glg1,8,111154421,111259216,protein_coding,-1,104795,chr8_111154421_111259216
Rfwd3,8,111270944,111300222,protein_coding,-1,29278,chr8_111270944_111300222
Mlkl,8,111311797,111338177,protein_coding,-1,26380,chr8_111311797_111338177
Fa2h,8,111345135,111393824,protein_coding,-1,48689,chr8_111345135_111393824
Wdr59,8,111448797,111522092,protein_coding,-1,73295,chr8_111448797_111522092
Znrf1,8,111536097,111626030,protein_coding,1,89933,chr8_111536097_111626030
Ldhd,8,111623785,111630374,protein_coding,-1,6589,chr8_111623785_111630374
Zfp1,8,111643401,111671011,protein_coding,1,27610,chr8_111643401_111671011
Ctrb1,8,111686519,111691010,protein_coding,-1,4491,chr8_111686519_111691010
Bcar1,8,111710474,111743809,protein_coding,-1,33335,chr8_111710474_111743809
Cfdp1,8,111768491,111854291,protein_coding,-1,85800,chr8_111768491_111854291
Tmem170,8,111863038,111876750,protein_coding,-1,13712,chr8_111863038_111876750
Chst5,8,111889136,111910447,protein_coding,-1,21311,chr8_111889136_111910447
Tmem231,8,111912011,111933881,protein_coding,-1,21870,chr8_111912011_111933881
Gabarapl2,8,111940703,111953612,protein_coding,1,12909,chr8_111940703_111953612
Adat1,8,111966908,111992302,protein_coding,-1,25394,chr8_111966908_111992302
Kars,8,111993443,112011323,protein_coding,-1,17880,chr8_111993443_112011323
Terf2ip,8,112011398,112020528,protein_coding,1,9130,chr8_112011398_112020528
Gm6793,8,112013953,112015008,processed_pseudogene,-1,1055,chr8_112013953_112015008
Gm26994,8,112554617,112569575,antisense,-1,14958,chr8_112554617_112569575
Cntnap4,8,112570043,112882717,protein_coding,1,312674,chr8_112570043_112882717
Gm45904,8,112880460,113004997,antisense,-1,124537,chr8_112880460_113004997
Gm10280,8,113067262,113093334,lincRNA,1,26072,chr8_113067262_113093334
Mon1b,8,113635587,113645179,protein_coding,1,9592,chr8_113635587_113645179
Syce1l,8,113643213,113655533,protein_coding,1,12320,chr8_113643213_113655533
Gm30052,8,113667926,113676458,lincRNA,-1,8532,chr8_113667926_113676458
Adamts18,8,113697126,113848738,protein_coding,-1,151612,chr8_113697126_113848738
Nudt7,8,114133557,114154739,protein_coding,1,21182,chr8_114133557_114154739
Vat1l,8,114205612,114374071,protein_coding,1,168459,chr8_114205612_114374071
4933408N05Rik,8,114341160,114351479,antisense,-1,10319,chr8_114341160_114351479
Clec3a,8,114418086,114425846,protein_coding,1,7760,chr8_114418086_114425846
Wwox,8,114439655,115352708,protein_coding,1,913053,chr8_114439655_115352708
Gm16116,8,114591303,114594900,antisense,-1,3597,chr8_114591303_114594900
Gm16117,8,114639546,114642114,antisense,-1,2568,chr8_114639546_114642114
Gm16118,8,114698439,114708006,antisense,-1,9567,chr8_114698439_114708006
4930488N15Rik,8,115585392,115595152,lincRNA,1,9760,chr8_115585392_115595152
Maf,8,115682942,115707794,protein_coding,-1,24852,chr8_115682942_115707794
Gm15655,8,115705078,115707233,antisense,1,2155,chr8_115705078_115707233
Gm45733,8,115971635,115972071,lincRNA,-1,436,chr8_115971635_115972071
Dynlrb2,8,116504974,116515915,protein_coding,1,10941,chr8_116504974_116515915
Cdyl2,8,116574400,116732991,protein_coding,-1,158591,chr8_116574400_116732991
Cmc2,8,116888685,116921455,protein_coding,-1,32770,chr8_116888685_116921455
Cenpn,8,116921730,116941507,protein_coding,1,19777,chr8_116921730_116941507
Atmin,8,116943393,116960445,protein_coding,1,17052,chr8_116943393_116960445
1700030J22Rik,8,116969594,116978959,protein_coding,-1,9365,chr8_116969594_116978959
Gcsh,8,116981810,116993537,protein_coding,-1,11727,chr8_116981810_116993537
Pkd1l2,8,116995679,117082449,protein_coding,-1,86770,chr8_116995679_117082449
Gm15395,8,117036497,117043639,antisense,1,7142,chr8_117036497_117043639
Bco1,8,117095854,117133720,protein_coding,1,37866,chr8_117095854_117133720
Gan,8,117158135,117215997,protein_coding,1,57862,chr8_117158135_117215997
Cmip,8,117257064,117459430,protein_coding,1,202366,chr8_117257064_117459430
Plcg2,8,117498291,117635142,protein_coding,1,136851,chr8_117498291_117635142
Sdr42e1,8,117661399,117673689,protein_coding,-1,12290,chr8_117661399_117673689
Gm38416,8,117681622,117693198,lincRNA,1,11576,chr8_117681622_117693198
Hsd17b2,8,117701904,117759027,protein_coding,1,57123,chr8_117701904_117759027
Mphosph6,8,117791645,117801943,protein_coding,-1,10298,chr8_117791645_117801943
Cdh13,8,118283733,119324921,protein_coding,1,1041188,chr8_118283733_119324921
Gm45721,8,118607127,118610499,antisense,-1,3372,chr8_118607127_118610499
Gm45720,8,118610989,118615879,antisense,-1,4890,chr8_118610989_118615879
Hsbp1,8,119344488,119348922,protein_coding,1,4434,chr8_119344488_119348922
Gm45723,8,119378696,119386537,lincRNA,1,7841,chr8_119378696_119386537
Mlycd,8,119394878,119411102,protein_coding,1,16224,chr8_119394878_119411102
Osgin1,8,119434124,119446256,protein_coding,1,12132,chr8_119434124_119446256
Necab2,8,119446719,119472640,protein_coding,1,25921,chr8_119446719_119472640
Slc38a8,8,119479602,119501698,protein_coding,-1,22096,chr8_119479602_119501698
Mbtps1,8,119508156,119558735,protein_coding,-1,50579,chr8_119508156_119558735
Hsdl1,8,119561989,119575183,protein_coding,-1,13194,chr8_119561989_119575183
Dnaaf1,8,119575235,119598454,protein_coding,1,23219,chr8_119575235_119598454
Taf1c,8,119597871,119605222,protein_coding,-1,7351,chr8_119597871_119605222
Adad2,8,119612747,119616924,protein_coding,1,4177,chr8_119612747_119616924
Kcng4,8,119623854,119635680,protein_coding,-1,11826,chr8_119623854_119635680
Gm32352,8,119659475,119670881,antisense,-1,11406,chr8_119659475_119670881
Wfdc1,8,119666365,119688222,protein_coding,1,21857,chr8_119666365_119688222
Atp2c2,8,119700009,119757717,protein_coding,1,57708,chr8_119700009_119757717
Cotl1,8,119809222,119840544,protein_coding,-1,31322,chr8_119809222_119840544
Klhl36,8,119862266,119876995,protein_coding,1,14729,chr8_119862266_119876995
Usp10,8,119910360,119957560,protein_coding,1,47200,chr8_119910360_119957560
Gm15684,8,120036194,120045287,antisense,-1,9093,chr8_120036194_120045287
Zdhhc7,8,120080890,120101482,protein_coding,-1,20592,chr8_120080890_120101482
Fam92b,8,120166397,120177466,protein_coding,-1,11069,chr8_120166397_120177466
A330074K22Rik,8,120204434,120228230,lincRNA,-1,23796,chr8_120204434_120228230
Gins2,8,120578633,120589304,protein_coding,-1,10671,chr8_120578633_120589304
1190005I06Rik,8,120608602,120647632,protein_coding,-1,39030,chr8_120608602_120647632
Gm27021,8,120608786,120668079,protein_coding,-1,59293,chr8_120608786_120668079
Emc8,8,120653914,120668573,protein_coding,-1,14659,chr8_120653914_120668573
Mthfsd,8,121091628,121108392,protein_coding,-1,16764,chr8_121091628_121108392
5033426O07Rik,8,121198714,121203602,lincRNA,-1,4888,chr8_121198714_121203602
Gm26815,8,121256747,121356836,lincRNA,-1,100089,chr8_121256747_121356836
1700018B08Rik,8,121530780,121544320,protein_coding,-1,13540,chr8_121530780_121544320
Fbxo31,8,121549440,121578806,protein_coding,-1,29366,chr8_121549440_121578806
Zcchc14,8,121598703,121652901,protein_coding,-1,54198,chr8_121598703_121652901
Gm45833,8,121666814,121674088,lincRNA,-1,7274,chr8_121666814_121674088
Klhdc4,8,121796313,121829569,protein_coding,-1,33256,chr8_121796313_121829569
Slc7a5,8,121881150,121907694,protein_coding,-1,26544,chr8_121881150_121907694
Car5a,8,121916126,121944904,protein_coding,-1,28778,chr8_121916126_121944904
Trhr2,8,122356967,122360746,protein_coding,-1,3779,chr8_122356967_122360746
Cyba,8,122424776,122432930,protein_coding,-1,8154,chr8_122424776_122432930
Mvd,8,122433601,122443422,protein_coding,-1,9821,chr8_122433601_122443422
Gm20735,8,122445268,122451322,lincRNA,-1,6054,chr8_122445268_122451322
Snai3,8,122454208,122460733,protein_coding,-1,6525,chr8_122454208_122460733
Rnf166,8,122466147,122476064,protein_coding,-1,9917,chr8_122466147_122476064
Piezo1,8,122481698,122551329,protein_coding,-1,69631,chr8_122481698_122551329
Aprt,8,122574635,122576909,protein_coding,-1,2274,chr8_122574635_122576909
Galns,8,122578242,122611463,protein_coding,-1,33221,chr8_122578242_122611463
Pabpn1l,8,122619471,122622739,protein_coding,-1,3268,chr8_122619471_122622739
Cbfa2t3,8,122625141,122699109,protein_coding,-1,73968,chr8_122625141_122699109
C230057M02Rik,8,122724948,122752325,lincRNA,-1,27377,chr8_122724948_122752325
Ankrd11,8,122883822,123042277,protein_coding,-1,158455,chr8_122883822_123042277
Sult5a1,8,123140192,123158315,protein_coding,-1,18123,chr8_123140192_123158315
Chmp1a,8,123204264,123212763,protein_coding,-1,8499,chr8_123204264_123212763
Spata2l,8,123229801,123236233,protein_coding,-1,6432,chr8_123229801_123236233
Vps9d1,8,123242356,123254348,protein_coding,-1,11992,chr8_123242356_123254348
Fanca,8,123268300,123318576,protein_coding,-1,50276,chr8_123268300_123318576
Dbndd1,8,123504718,123515463,protein_coding,-1,10745,chr8_123504718_123515463
Gm45781,8,123727772,123735142,lincRNA,-1,7370,chr8_123727772_123735142
4732419C18Rik,8,123744631,123754726,lincRNA,-1,10095,chr8_123744631_123754726
2810455O05Rik,8,123838553,123840785,lincRNA,-1,2232,chr8_123838553_123840785
Ccsap,8,123840831,123860209,protein_coding,-1,19378,chr8_123840831_123860209
Acta1,8,123891769,123894751,protein_coding,-1,2982,chr8_123891769_123894751
Nup133,8,123897123,123949265,protein_coding,-1,52142,chr8_123897123_123949265
Abcb10,8,123952459,123983122,protein_coding,-1,30663,chr8_123952459_123983122
Taf5l,8,123996318,124021397,protein_coding,-1,25079,chr8_123996318_124021397
Gm45732,8,124025072,124048412,antisense,-1,23340,chr8_124025072_124048412
1810008B01Rik,8,124305132,124306507,antisense,-1,1375,chr8_124305132_124306507
Gm15775,8,124324778,124331795,antisense,-1,7017,chr8_124324778_124331795
Pgbd5,8,124369049,124439658,protein_coding,-1,70609,chr8_124369049_124439658
Cog2,8,124520767,124552008,protein_coding,1,31241,chr8_124520767_124552008
Agt,8,124556534,124569706,protein_coding,-1,13172,chr8_124556534_124569706
Capn9,8,124576111,124618731,protein_coding,1,42620,chr8_124576111_124618731
2310022B05Rik,8,124635756,124663369,protein_coding,-1,27613,chr8_124635756_124663369
Ttc13,8,124671332,124721983,protein_coding,-1,50651,chr8_124671332_124721983
Arv1,8,124722139,124734123,protein_coding,1,11984,chr8_124722139_124734123
Fam89a,8,124740257,124751832,protein_coding,-1,11575,chr8_124740257_124751832
Trim67,8,124793092,124834713,protein_coding,1,41621,chr8_124793092_124834713
2810004N23Rik,8,124836945,124863120,protein_coding,-1,26175,chr8_124836945_124863120
Gnpat,8,124863033,124890057,protein_coding,1,27024,chr8_124863033_124890057
Exoc8,8,124893108,124897705,protein_coding,-1,4597,chr8_124893108_124897705
Sprtn,8,124897886,124906161,protein_coding,1,8275,chr8_124897886_124906161
Gm45709,8,124897894,124900130,antisense,-1,2236,chr8_124897894_124900130
Egln1,8,124908587,124949324,protein_coding,-1,40737,chr8_124908587_124949324
Tsnax,8,125012997,125034192,protein_coding,1,21195,chr8_125012997_125034192
Disc1,8,125054195,125261858,protein_coding,1,207663,chr8_125054195_125261858
Gm16237,8,125224400,125227323,antisense,-1,2923,chr8_125224400_125227323
Sipa1l2,8,125418063,125569808,protein_coding,-1,151745,chr8_125418063_125569808
4930567H12Rik,8,125584632,125625605,lincRNA,1,40973,chr8_125584632_125625605
Map10,8,125669818,125673359,protein_coding,1,3541,chr8_125669818_125673359
Ntpcr,8,125729963,125748235,protein_coding,1,18272,chr8_125729963_125748235
Pcnx2,8,125751508,125898317,protein_coding,-1,146809,chr8_125751508_125898317
A730098A19Rik,8,125897914,125908144,antisense,1,10230,chr8_125897914_125908144
Map3k21,8,125910450,125947440,protein_coding,1,36990,chr8_125910450_125947440
Kcnk1,8,125995170,126030685,protein_coding,1,35515,chr8_125995170_126030685
Gm45875,8,126029248,126046808,antisense,-1,17560,chr8_126029248_126046808
Slc35f3,8,126138995,126395978,protein_coding,1,256983,chr8_126138995_126395978
Coa6,8,126422515,126425433,protein_coding,1,2918,chr8_126422515_126425433
Tarbp1,8,126425329,126475065,protein_coding,-1,49736,chr8_126425329_126475065
Gm26759,8,126566970,126590988,antisense,1,24018,chr8_126566970_126590988
Irf2bp2,8,126588296,126593986,protein_coding,-1,5690,chr8_126588296_126593986
Gm45805,8,126755571,126758334,lincRNA,-1,2763,chr8_126755571_126758334
Gm31718,8,126812640,126908215,lincRNA,-1,95575,chr8_126812640_126908215
A630001O12Rik,8,126839233,126851473,lincRNA,1,12240,chr8_126839233_126851473
Tomm20,8,126930667,126945844,protein_coding,-1,15177,chr8_126930667_126945844
Rbm34,8,126947172,126971071,protein_coding,-1,23899,chr8_126947172_126971071
Pard3,8,127063893,127612286,protein_coding,1,548393,chr8_127063893_127612286
Nrp1,8,128358604,128503363,protein_coding,1,144759,chr8_128358604_128503363
Itgb1,8,128685654,128733200,protein_coding,1,47546,chr8_128685654_128733200
Ccdc7a,8,128734235,129065517,protein_coding,-1,331282,chr8_128734235_129065517
Ccdc7b,8,129067134,129183732,protein_coding,1,116598,chr8_129067134_129183732
Gm10999,8,129129097,129131661,protein_coding,-1,2564,chr8_129129097_129131661
2610044O15Rik8,8,129216354,129234406,protein_coding,-1,18052,chr8_129216354_129234406
Gm32856,8,129263641,129282844,lincRNA,1,19203,chr8_129263641_129282844
Gm2888,14,3030002,3038762,protein_coding,1,8760,chr14_3030002_3038762
Gm2897,14,3049285,3076840,protein_coding,1,27555,chr14_3049285_3076840
Gm10340,14,3133997,3141609,protein_coding,1,7612,chr14_3133997_3141609
D830030K20Rik,14,3208488,3234351,protein_coding,1,25863,chr14_3208488_3234351
1700110I01Rik,14,3262340,3305832,lincRNA,1,43492,chr14_3262340_3305832
Gm2956,14,3332627,3354799,protein_coding,1,22172,chr14_3332627_3354799
Gm3005,14,3428103,3594220,protein_coding,1,166117,chr14_3428103_3594220
Gm3002,14,3810074,3966518,protein_coding,1,156444,chr14_3810074_3966518
Gm5796,14,4023941,4041370,protein_coding,1,17429,chr14_4023941_4041370
Gm3115,14,4084120,4099306,protein_coding,1,15186,chr14_4084120_4099306
Gm8108,14,4110526,4132784,protein_coding,1,22258,chr14_4110526_4132784
Gm2974,14,4182576,4204895,protein_coding,1,22319,chr14_4182576_4204895
2610042L04Rik,14,4334763,4354688,protein_coding,1,19925,chr14_4334763_4354688
Gm3164,14,4415448,4443839,protein_coding,1,28391,chr14_4415448_4443839
Gm3173,14,4430992,4519452,protein_coding,1,88460,chr14_4430992_4519452
Gm3047,14,4555405,4562747,protein_coding,1,7342,chr14_4555405_4562747
Gm3252,14,4726775,4747493,protein_coding,1,20718,chr14_4726775_4747493
Gm3264,14,4855576,4875851,protein_coding,1,20275,chr14_4855576_4875851
Gm3278,14,4892416,4902431,protein_coding,1,10015,chr14_4892416_4902431
Gm8281,14,5071040,5093318,protein_coding,1,22278,chr14_5071040_5093318
Gm3500,14,5365794,5389049,protein_coding,-1,23255,chr14_5365794_5389049
Gm3194,14,5438065,5455467,protein_coding,-1,17402,chr14_5438065_5455467
Gm3488,14,5501674,5522927,protein_coding,1,21253,chr14_5501674_5522927
Gm3383,14,5607620,5807982,protein_coding,-1,200362,chr14_5607620_5807982
Gm8237,14,5857918,5880382,protein_coding,-1,22464,chr14_5857918_5880382
Gm3248,14,5939225,5961745,protein_coding,-1,22520,chr14_5939225_5961745
Gm3453,14,5970744,5979137,protein_coding,-1,8393,chr14_5970744_5979137
Gm8206,14,6016759,6093942,protein_coding,-1,77183,chr14_6016759_6093942
Gm3468,14,6087295,6108665,protein_coding,-1,21370,chr14_6087295_6108665
Gm3476,14,6105321,6125807,protein_coding,-1,20486,chr14_6105321_6125807
Gm3411,14,6259747,6287250,protein_coding,-1,27503,chr14_6259747_6287250
Gm3618,14,6306228,6352062,transcribed_unprocessed_pseudogene,-1,45834,chr14_6306228_6352062
Gm3629,14,6583959,6590613,protein_coding,-1,6654,chr14_6583959_6590613
Gm10251,14,6638420,6684170,protein_coding,-1,45750,chr14_6638420_6684170
Gm8050,14,6712183,6720251,protein_coding,-1,8068,chr14_6712183_6720251
Gm3636,14,6735685,6742332,protein_coding,-1,6647,chr14_6735685_6742332
Gm3667,14,6868502,6889962,protein_coding,-1,21460,chr14_6868502_6889962
Gm10406,14,7006115,7027449,protein_coding,-1,21334,chr14_7006115_7027449
Gm3685,14,7036535,7044970,protein_coding,-1,8435,chr14_7036535_7044970
Gm3696,14,7083208,7100621,protein_coding,-1,17413,chr14_7083208_7100621
Gm3512,14,7153511,7174533,protein_coding,-1,21022,chr14_7153511_7174533
Gm3739,14,7293648,7315049,protein_coding,-1,21401,chr14_7293648_7315049
Gm10339,14,7374667,7412375,lincRNA,-1,37708,chr14_7374667_7412375
4933406F09Rik,14,7412460,7508369,lincRNA,1,95909,chr14_7412460_7508369
Gm3755,14,7440924,7450917,protein_coding,-1,9993,chr14_7440924_7450917
Gm3752,14,7466362,7483762,protein_coding,-1,17400,chr14_7466362_7483762
Gm3558,14,7545151,7568566,protein_coding,-1,23415,chr14_7545151_7568566
Gm10338,14,7580617,7595592,protein_coding,-1,14975,chr14_7580617_7595592
Gm10128,14,7640895,7643972,protein_coding,-1,3077,chr14_7640895_7643972
Gm16741,14,7749945,7775528,lincRNA,1,25583,chr14_7749945_7775528
Flnb,14,7817957,7951588,protein_coding,1,133631,chr14_7817957_7951588
Gm45521,14,7957288,7960636,protein_coding,1,3348,chr14_7957288_7960636
Dnase1l3,14,7964533,7994573,protein_coding,-1,30040,chr14_7964533_7994573
Abhd6,14,8002902,8056763,protein_coding,1,53861,chr14_8002902_8056763
Rpp14,14,8080367,8091834,protein_coding,1,11467,chr14_8080367_8091834
Pxk,14,8098211,8165117,protein_coding,1,66906,chr14_8098211_8165117
Pdhb,14,8165996,8173025,protein_coding,-1,7029,chr14_8165996_8173025
Kctd6,14,8214140,8223563,protein_coding,1,9423,chr14_8214140_8223563
Acox2,14,8225511,8259353,protein_coding,-1,33842,chr14_8225511_8259353
Fam107a,14,8296274,8318023,protein_coding,-1,21749,chr14_8296274_8318023
Oit1,14,8348937,8378754,protein_coding,-1,29817,chr14_8348937_8378754
2610318M16Rik,14,8367440,8371010,antisense,1,3570,chr14_8367440_8371010
4930452B06Rik,14,8431192,8666240,protein_coding,-1,235048,chr14_8431192_8666240
4930455B14Rik,14,8666386,8673378,lincRNA,1,6992,chr14_8666386_8673378
Gm48370,14,9400624,9459180,lincRNA,1,58556,chr14_9400624_9459180
Gm48371,14,9443375,9469555,lincRNA,-1,26180,chr14_9443375_9469555
Fhit,14,9550092,11162035,protein_coding,-1,1611943,chr14_9550092_11162035
Gm48439,14,10178620,10186051,antisense,1,7431,chr14_10178620_10186051
Fhitos,14,10738535,10783076,antisense,1,44541,chr14_10738535_10783076
Gm3839,14,11280735,11356726,protein_coding,-1,75991,chr14_11280735_11356726
Gm48594,14,11460359,11502992,lincRNA,1,42633,chr14_11460359_11502992
Gm48595,14,11510535,11520770,lincRNA,-1,10235,chr14_11510535_11520770
Ptprg,14,11553532,12242041,protein_coding,1,688509,chr14_11553532_12242041
Gm3848,14,11965446,11981223,antisense,-1,15777,chr14_11965446_11981223
Gm49355,14,12283976,12324454,protein_coding,1,40478,chr14_12283976_12324454
D030051J21Rik,14,12321379,12324473,lincRNA,1,3094,chr14_12321379_12324473
Fezf2,14,12342094,12348189,protein_coding,-1,6095,chr14_12342094_12348189
Cadps,14,12372563,12823079,protein_coding,-1,450516,chr14_12372563_12823079
Gm48239,14,12374585,12384729,antisense,1,10144,chr14_12374585_12384729
Gm48526,14,13030370,13035765,lincRNA,1,5395,chr14_13030370_13035765
Synpr,14,13284780,13616340,protein_coding,1,331560,chr14_13284780_13616340
Sntn,14,13670876,13683148,protein_coding,1,12272,chr14_13670876_13683148
Gm281,14,13814618,13914478,protein_coding,-1,99860,chr14_13814618_13914478
Thoc7,14,13949012,13961852,protein_coding,-1,12840,chr14_13949012_13961852
Atxn7,14,13961440,14107302,protein_coding,1,145862,chr14_13961440_14107302
Psmd6,14,14112174,14120984,protein_coding,-1,8810,chr14_14112174_14120984
Olfr720,14,14171738,14186838,protein_coding,-1,15100,chr14_14171738_14186838
Gm48857,14,14292405,14294676,lincRNA,-1,2271,chr14_14292405_14294676
Olfr31,14,14322828,14331791,protein_coding,1,8963,chr14_14322828_14331791
Gm48860,14,14328004,14347264,antisense,-1,19260,chr14_14328004_14347264
Il3ra,14,14346275,14356011,protein_coding,1,9736,chr14_14346275_14356011
Slc4a7,14,14702279,14799940,protein_coding,1,97661,chr14_14702279_14799940
Nek10,14,14803415,15012059,protein_coding,1,208644,chr14_14803415_15012059
4921522A10Rik,14,15104124,15110333,lincRNA,-1,6209,chr14_15104124_15110333
Gm31577,14,15304420,15321874,lincRNA,-1,17454,chr14_15304420_15321874
Lrrc3b,14,15357515,15438987,protein_coding,-1,81472,chr14_15357515_15438987
Gm47782,14,15697956,15911315,lincRNA,-1,213359,chr14_15697956_15911315
Gm31804,14,15770099,15791784,lincRNA,1,21685,chr14_15770099_15791784
Gm47780,14,15876628,15879459,lincRNA,1,2831,chr14_15876628_15879459
1700062C10Rik,14,15999768,16037271,lincRNA,-1,37503,chr14_15999768_16037271
Oxsm,14,16238652,16249808,protein_coding,-1,11156,chr14_16238652_16249808
Gm47794,14,16243351,16245091,antisense,1,1740,chr14_16243351_16245091
Ngly1,14,16249280,16311926,protein_coding,1,62646,chr14_16249280_16311926
Gm48163,14,16336846,16366268,antisense,-1,29422,chr14_16336846_16366268
Top2b,14,16365179,16435462,protein_coding,1,70283,chr14_16365179_16435462
Rarb,14,16430839,16819156,protein_coding,-1,388317,chr14_16430839_16819156
Gm48162,14,16575601,16580459,antisense,1,4858,chr14_16575601_16580459
Thrb,14,17660261,18038090,protein_coding,1,377829,chr14_17660261_18038090
Gm48321,14,17931138,18021909,antisense,-1,90771,chr14_17931138_18021909
Nr1d2,14,18204054,18239127,protein_coding,-1,35073,chr14_18204054_18239127
Rpl15,14,18267823,18271391,protein_coding,-1,3568,chr14_18267823_18271391
Nkiras1,14,18271136,18284003,protein_coding,1,12867,chr14_18271136_18284003
Ube2e1,14,18282722,18331859,protein_coding,-1,49137,chr14_18282722_18331859
Ube2e2,14,18573575,18894267,protein_coding,-1,320692,chr14_18573575_18894267
Gm48099,14,19271274,19282822,lincRNA,1,11548,chr14_19271274_19282822
Gm21738,14,19415857,19418930,protein_coding,-1,3073,chr14_19415857_19418930
Gm48105,14,19504718,19529194,lincRNA,1,24476,chr14_19504718_19529194
Gm2244,14,19532896,19549963,protein_coding,-1,17067,chr14_19532896_19549963
Gm2237,14,19563800,19585135,protein_coding,-1,21335,chr14_19563800_19585135
Gm5458,14,19594139,19602581,protein_coding,-1,8442,chr14_19594139_19602581
Gm41102,14,19612403,19618889,lincRNA,-1,6486,chr14_19612403_19618889
4930469B13Rik,14,19615130,19628632,lincRNA,1,13502,chr14_19615130_19628632
Nid2,14,19751265,19811787,protein_coding,1,60522,chr14_19751265_19811787
Rtraf,14,19811351,19823824,protein_coding,-1,12473,chr14_19811351_19823824
D14Ertd670e,14,19838925,19844677,lincRNA,1,5752,chr14_19838925_19844677
Gm48283,14,19866980,19873455,lincRNA,1,6475,chr14_19866980_19873455
Gng2,14,19872559,19977627,protein_coding,-1,105068,chr14_19872559_19977627
Saysd1,14,20075636,20138534,protein_coding,-1,62898,chr14_20075636_20138534
Kcnk5,14,20140057,20181809,protein_coding,-1,41752,chr14_20140057_20181809
Gm48395,14,20215502,20221425,lincRNA,1,5923,chr14_20215502_20221425
Kcnk16,14,20261376,20269199,protein_coding,-1,7823,chr14_20261376_20269199
Nudt13,14,20294697,20317578,protein_coding,1,22881,chr14_20294697_20317578
Ecd,14,20319852,20348121,protein_coding,-1,28269,chr14_20319852_20348121
Fam149b,14,20348162,20383491,protein_coding,1,35329,chr14_20348162_20383491
Gm30054,14,20364567,20378876,antisense,-1,14309,chr14_20364567_20378876
Dnajc9,14,20384638,20388910,protein_coding,-1,4272,chr14_20384638_20388910
Mrps16,14,20389304,20393634,protein_coding,-1,4330,chr14_20389304_20393634
Cfap70,14,20394193,20452226,protein_coding,-1,58033,chr14_20394193_20452226
Anxa7,14,20455260,20480133,protein_coding,-1,24873,chr14_20455260_20480133
Mss51,14,20482867,20496901,protein_coding,-1,14034,chr14_20482867_20496901
Ppp3cb,14,20499364,20546573,protein_coding,-1,47209,chr14_20499364_20546573
1810062O18Rik,14,20546079,20570687,antisense,1,24608,chr14_20546079_20570687
Usp54,14,20548912,20641063,protein_coding,-1,92151,chr14_20548912_20641063
2810402E24Rik,14,20641009,20644048,antisense,1,3039,chr14_20641009_20644048
Myoz1,14,20649107,20656540,protein_coding,-1,7433,chr14_20649107_20656540
Synpo2l,14,20658946,20668354,protein_coding,-1,9408,chr14_20658946_20668354
Sec24c,14,20674308,20694852,protein_coding,1,20544,chr14_20674308_20694852
6230400D17Rik,14,20687236,20703028,antisense,-1,15792,chr14_20687236_20703028
Fut11,14,20694968,20701016,protein_coding,1,6048,chr14_20694968_20701016
Chchd1,14,20703006,20704425,protein_coding,1,1419,chr14_20703006_20704425
Zswim8,14,20707552,20723619,protein_coding,1,16067,chr14_20707552_20723619
Ndst2,14,20723730,20734562,protein_coding,-1,10832,chr14_20723730_20734562
Camk2g,14,20734875,20794088,protein_coding,-1,59213,chr14_20734875_20794088
Gm30108,14,20794239,20796560,lincRNA,1,2321,chr14_20794239_20796560
Plau,14,20836660,20843385,protein_coding,1,6725,chr14_20836660_20843385
Vcl,14,20929398,21033676,protein_coding,1,104278,chr14_20929398_21033676
Ap3m1,14,21031442,21052508,protein_coding,-1,21066,chr14_21031442_21052508
Adk,14,21052574,21448569,protein_coding,1,395995,chr14_21052574_21448569
Kat6b,14,21481434,21672478,protein_coding,1,191044,chr14_21481434_21672478
Dupd1,14,21676537,21714576,protein_coding,-1,38039,chr14_21676537_21714576
Dusp13,14,21733394,21751181,protein_coding,-1,17787,chr14_21733394_21751181
Gm15935,14,21741543,21746632,antisense,1,5089,chr14_21741543_21746632
Samd8,14,21750531,21798726,protein_coding,1,48195,chr14_21750531_21798726
Vdac2,14,21825238,21845879,protein_coding,1,20641,chr14_21825238_21845879
Comtd1,14,21845855,21848977,protein_coding,-1,3122,chr14_21845855_21848977
A430057M04Rik,14,21847578,21856931,antisense,1,9353,chr14_21847578_21856931
4931407E12Rik,14,21868630,21889766,lincRNA,-1,21136,chr14_21868630_21889766
Zfp503,14,21983959,21989601,protein_coding,-1,5642,chr14_21983959_21989601
Lrmda,14,22019712,23056085,protein_coding,1,1036373,chr14_22019712_23056085
Gm7480,14,22032086,22036103,antisense,-1,4017,chr14_22032086_22036103
4930405A10Rik,14,22507174,22542823,antisense,-1,35649,chr14_22507174_22542823
Gm10248,14,23038194,23094571,antisense,-1,56377,chr14_23038194_23094571
Kcnma1,14,23289431,24014491,protein_coding,-1,725060,chr14_23289431_24014491
Gm29626,14,23560248,23564589,antisense,1,4341,chr14_23560248_23564589
Dlg5,14,24133953,24245920,protein_coding,-1,111967,chr14_24133953_24245920
E330034G19Rik,14,24293214,24309966,protein_coding,1,16752,chr14_24293214_24309966
Gm47814,14,24438987,24446403,lincRNA,-1,7416,chr14_24438987_24446403
Polr3a,14,24448696,24487058,protein_coding,-1,38362,chr14_24448696_24487058
Rps24,14,24487125,24496959,protein_coding,1,9834,chr14_24487125_24496959
4930542C16Rik,14,24597266,24617467,lincRNA,-1,20201,chr14_24597266_24617467
4930428N03Rik,14,24617557,24788520,lincRNA;lncRNA,1,170963,chr14_24617557_24788520
Gm47906,14,24833635,24835089,lincRNA,1,1454,chr14_24833635_24835089
Gm38408,14,25066904,25074444,lincRNA,-1,7540,chr14_25066904_25074444
Gm32224,14,25127788,25135852,lincRNA,1,8064,chr14_25127788_25135852
4930572O13Rik,14,25139795,25143241,lincRNA,-1,3446,chr14_25139795_25143241
Zmiz1os1,14,25257523,25461128,antisense,-1,203605,chr14_25257523_25461128
Gm17747,14,25441641,25453229,lincRNA,1,11588,chr14_25441641_25453229
Zmiz1,14,25459185,25666743,protein_coding,1,207558,chr14_25459185_25666743
Ppif,14,25694154,25700468,protein_coding,1,6314,chr14_25694154_25700468
Ppifos,14,25696974,25701282,antisense,-1,4308,chr14_25696974_25701282
Zcchc24,14,25711642,25769039,protein_coding,-1,57397,chr14_25711642_25769039
Anxa11,14,25842156,25886804,protein_coding,1,44648,chr14_25842156_25886804
Anxa11os,14,25856777,25870266,antisense,-1,13489,chr14_25856777_25870266
Plac9a,14,25887506,25903100,protein_coding,-1,15594,chr14_25887506_25903100
Tmem254a,14,25923300,25927672,protein_coding,-1,4372,chr14_25923300_25927672
Duxbl1,14,25978577,25990088,protein_coding,1,11511,chr14_25978577_25990088
Tmem254c,14,26063919,26067355,protein_coding,-1,3436,chr14_26063919_26067355
Cphx3,14,26082297,26235744,protein_coding,1,153447,chr14_26082297_26235744
Duxbl3,14,26257962,26269436,protein_coding,1,11474,chr14_26257962_26269436
Gm34059,14,26315011,26324954,lincRNA,-1,9943,chr14_26315011_26324954
4933413J09Rik,14,26356574,26400456,lincRNA,1,43882,chr14_26356574_26400456
Slmap,14,26413168,26534931,protein_coding,-1,121763,chr14_26413168_26534931
Dennd6a,14,26573856,26634322,protein_coding,1,60466,chr14_26573856_26634322
Arf4os,CHR_MG3627_PATCH,26628407,26638183,antisense;lncRNA,-1,9776,chrCHR_MG3627_PATCH_26628407_26638183
Arf4,14,26638074,26665084,protein_coding,1,27010,chr14_26638074_26665084
Pde12,14,26659958,26669883,protein_coding,-1,9925,chr14_26659958_26669883
9930004E17Rik,CHR_MG3627_PATCH,26670010,26670507,antisense;lncRNA,1,497,chrCHR_MG3627_PATCH_26670010_26670507
Dnah12,14,26693274,26892505,protein_coding,1,199231,chr14_26693274_26892505
Asb14,14,26894557,26916060,protein_coding,1,21503,chr14_26894557_26916060
Appl1,14,26918988,26971232,protein_coding,-1,52244,chr14_26918988_26971232
Hesx1,14,26994416,27002329,protein_coding,1,7913,chr14_26994416_27002329
Il17rd,14,27038941,27107286,protein_coding,1,68345,chr14_27038941_27107286
Arhgef3,14,27114899,27403911,protein_coding,1,289012,chr14_27114899_27403911
Ccdc66,14,27481090,27508460,protein_coding,-1,27370,chr14_27481090_27508460
Erc2,14,27622428,28478537,protein_coding,1,856109,chr14_27622428_28478537
Gm45645,14,27838165,27876217,antisense,-1,38052,chr14_27838165_27876217
Wnt5a,14,28504750,28527448,protein_coding,1,22698,chr14_28504750_28527448
Gm2670,14,28508074,28511392,antisense,-1,3318,chr14_28508074_28511392
Gm35164,14,28649672,28699011,lincRNA,1,49339,chr14_28649672_28699011
Gm35217,14,28777427,28798421,lincRNA,-1,20994,chr14_28777427_28798421
Cacna2d3,14,28904943,29721864,protein_coding,-1,816921,chr14_28904943_29721864
Lrtm1,14,29018208,29033645,protein_coding,1,15437,chr14_29018208_29033645
Gm48004,14,29081302,29083805,antisense,1,2503,chr14_29081302_29083805
Gm48006,14,29235227,29257521,antisense,1,22294,chr14_29235227_29257521
Gm48003,14,29574697,29593304,antisense,1,18607,chr14_29574697_29593304
Gm48058,14,29732366,29733395,lincRNA,-1,1029,chr14_29732366_29733395
Gm41118,14,29735344,29745625,lincRNA,1,10281,chr14_29735344_29745625
Gm35281,14,29786828,29852408,lincRNA,-1,65580,chr14_29786828_29852408
Gm47414,14,29958071,29961381,lincRNA,-1,3310,chr14_29958071_29961381
Selenok,14,29968308,29975662,protein_coding,1,7354,chr14_29968308_29975662
Actr8,14,29978337,30006354,protein_coding,1,28017,chr14_29978337_30006354
Il17rb,14,29996135,30008896,protein_coding,-1,12761,chr14_29996135_30008896
Chdh,14,30009023,30040527,protein_coding,1,31504,chr14_30009023_30040527
Cacna1d,14,30039939,30491455,protein_coding,-1,451516,chr14_30039939_30491455
Dcp1a,14,30479535,30527063,protein_coding,1,47528,chr14_30479535_30527063
Tkt,14,30548359,30574720,protein_coding,1,26361,chr14_30548359_30574720
Prkcd,14,30595354,30626210,protein_coding,-1,30856,chr14_30595354_30626210
Rft1,14,30654360,30691317,protein_coding,1,36957,chr14_30654360_30691317
Sfmbt1,14,30714849,30822721,protein_coding,1,107872,chr14_30714849_30822721
1700087M22Rik,14,30770681,30778004,antisense,-1,7323,chr14_30770681_30778004
Mustn1,14,30879200,30881610,protein_coding,1,2410,chr14_30879200_30881610
Itih4,14,30886476,30902353,protein_coding,1,15877,chr14_30886476_30902353
Itih3,14,30908572,30923760,protein_coding,-1,15188,chr14_30908572_30923760
Itih1,14,30929180,30943289,protein_coding,-1,14109,chr14_30929180_30943289
Nek4,14,30951377,30988821,protein_coding,1,37444,chr14_30951377_30988821
Spcs1,14,30999826,31001672,protein_coding,-1,1846,chr14_30999826_31001672
Glt8d1,14,31001400,31011991,protein_coding,1,10591,chr14_31001400_31011991
Gnl3,14,31012433,31019152,protein_coding,-1,6719,chr14_31012433_31019152
Pbrm1,14,31019138,31121592,protein_coding,1,102454,chr14_31019138_31121592
Smim4,14,31088132,31128956,protein_coding,-1,40824,chr14_31088132_31128956
Nt5dc2,14,31131053,31139124,protein_coding,1,8071,chr14_31131053_31139124
Stab1,14,31139013,31168641,protein_coding,-1,29628,chr14_31139013_31168641
Nisch,14,31170930,31216946,protein_coding,-1,46016,chr14_31170930_31216946
Tnnc1,14,31208312,31211729,protein_coding,1,3417,chr14_31208312_31211729
Sema3g,14,31217860,31230352,protein_coding,1,12492,chr14_31217860_31230352
Phf7,14,31237689,31251317,protein_coding,-1,13628,chr14_31237689_31251317
Bap1,14,31251450,31259944,protein_coding,1,8494,chr14_31251450_31259944
Dnah1,14,31260375,31323896,protein_coding,-1,63521,chr14_31260375_31323896
Gm35823,14,31268757,31320941,antisense,1,52184,chr14_31268757_31320941
Gm49217,14,31323955,31336076,lincRNA,1,12121,chr14_31323955_31336076
Capn7,14,31336638,31371986,protein_coding,1,35348,chr14_31336638_31371986
Sh3bp5,14,31359880,31436078,protein_coding,-1,76198,chr14_31359880_31436078
Mettl6,14,31473578,31495040,protein_coding,-1,21462,chr14_31473578_31495040
Eaf1,14,31494399,31509858,protein_coding,1,15459,chr14_31494399_31509858
Colq,14,31523082,31591343,protein_coding,-1,68261,chr14_31523082_31591343
Gm49387,14,31552905,31640878,protein_coding,-1,87973,chr14_31552905_31640878
Hacl1,14,31598730,31641286,protein_coding,-1,42556,chr14_31598730_31641286
Btd,14,31641028,31668579,protein_coding,1,27551,chr14_31641028_31668579
Ankrd28,14,31698768,31830651,protein_coding,-1,131883,chr14_31698768_31830651
D830044D21Rik,14,31906528,31931716,lincRNA,1,25188,chr14_31906528_31931716
4930425P05Rik,14,32012141,32013002,lincRNA,-1,861,chr14_32012141_32013002
Galnt15,14,32028989,32062197,protein_coding,1,33208,chr14_32028989_32062197
Dph3,14,32080566,32085729,protein_coding,-1,5163,chr14_32080566_32085729
Oxnad1,14,32085374,32103202,protein_coding,1,17828,chr14_32085374_32103202
Msmb,14,32142023,32158370,protein_coding,1,16347,chr14_32142023_32158370
Ncoa4,14,32159865,32179855,protein_coding,1,19990,chr14_32159865_32179855
Timm23,14,32180162,32201898,protein_coding,-1,21736,chr14_32180162_32201898
Parg,14,32201949,32297550,protein_coding,1,95601,chr14_32201949_32297550
Gm17210,14,32292924,32294974,antisense,-1,2050,chr14_32292924_32294974
Gm46447,14,32301924,32308895,lincRNA,1,6971,chr14_32301924_32308895
Gm48914,14,32303662,32317985,lincRNA,-1,14323,chr14_32303662_32317985
Ogdhl,14,32322019,32348151,protein_coding,1,26132,chr14_32322019_32348151
Chat,14,32408203,32465989,protein_coding,-1,57786,chr14_32408203_32465989
Gm2990,14,32465042,32483548,antisense,1,18506,chr14_32465042_32483548
Ercc6,14,32513521,32580990,protein_coding,1,67469,chr14_32513521_32580990
Prrxl1,14,32599407,32649246,protein_coding,1,49839,chr14_32599407_32649246
3425401B19Rik,14,32659119,32685293,protein_coding,-1,26174,chr14_32659119_32685293
Fam170b,14,32833962,32836789,protein_coding,1,2827,chr14_32833962_32836789
Vstm4,14,32856756,32939491,protein_coding,1,82735,chr14_32856756_32939491
Wdfy4,14,32959547,33185508,protein_coding,-1,225961,chr14_32959547_33185508
Lrrc18,14,32991382,33015291,protein_coding,1,23909,chr14_32991382_33015291
Arhgap22,14,33214026,33369934,protein_coding,1,155908,chr14_33214026_33369934
Gm49030,14,33218044,33220931,antisense,-1,2887,chr14_33218044_33220931
Gm15512,14,33365951,33370143,antisense,-1,4192,chr14_33365951_33370143
Mapk8,14,33377898,33447158,protein_coding,-1,69260,chr14_33377898_33447158
Frmpd2,14,33471696,33575269,protein_coding,1,103573,chr14_33471696_33575269
Ptpn20,14,33589207,33640754,protein_coding,1,51547,chr14_33589207_33640754
Gdf10,14,33923587,33937983,protein_coding,1,14396,chr14_33923587_33937983
Zfp488,14,33967070,33978764,protein_coding,-1,11694,chr14_33967070_33978764
Gm30083,14,33988417,34015182,protein_coding,-1,26765,chr14_33988417_34015182
Gm5460,14,34016758,34048193,protein_coding,1,31435,chr14_34016758_34048193
A630023A22Rik,14,34051126,34102754,protein_coding,-1,51628,chr14_34051126_34102754
Antxrl,14,34052707,34076405,protein_coding,1,23698,chr14_34052707_34076405
Anxa8,14,34085981,34100571,protein_coding,1,14590,chr14_34085981_34100571
Gprin2,14,34185688,34201653,protein_coding,-1,15965,chr14_34185688_34201653
Syt15,14,34219595,34230420,protein_coding,1,10825,chr14_34219595_34230420
Gm49201,14,34230619,34231728,lincRNA,-1,1109,chr14_34230619_34231728
Glud1,14,34310727,34345265,protein_coding,1,34538,chr14_34310727_34345265
Sncg,14,34370274,34374789,protein_coding,-1,4515,chr14_34370274_34374789
Mmrn2,14,34375465,34404287,protein_coding,1,28822,chr14_34375465_34404287
Bmpr1a,14,34410734,34503341,protein_coding,-1,92607,chr14_34410734_34503341
Gm17110,14,34501715,34502684,antisense,1,969,chr14_34501715_34502684
9230112D13Rik,14,34511621,34522801,protein_coding,-1,11180,chr14_34511621_34522801
Ldb3,14,34526603,34588682,protein_coding,-1,62079,chr14_34526603_34588682
Opn4,14,34590618,34600142,protein_coding,-1,9524,chr14_34590618_34600142
Gm49012,14,34591092,34605700,antisense,1,14608,chr14_34591092_34605700
Gm49024,14,34661707,34662704,lincRNA,1,997,chr14_34661707_34662704
Gm49025,14,34668031,34668339,lincRNA,-1,308,chr14_34668031_34668339
Wapl,14,34673928,34747983,protein_coding,1,74055,chr14_34673928_34747983
A930038B10Rik,14,34759402,34770553,lincRNA,1,11151,chr14_34759402_34770553
Gm49032,14,34768956,34770055,lincRNA,-1,1099,chr14_34768956_34770055
Grid1,14,34820108,35583379,protein_coding,1,763271,chr14_34820108_35583379
4930596D02Rik,14,35809488,35811978,protein_coding,-1,2490,chr14_35809488_35811978
4930474N05Rik,14,36094917,36100114,protein_coding,1,5197,chr14_36094917_36100114
Ccser2,14,36874936,36968777,protein_coding,-1,93841,chr14_36874936_36968777
Rgr,14,37034909,37048964,protein_coding,-1,14055,chr14_37034909_37048964
Lrit1,14,37054830,37064946,protein_coding,1,10116,chr14_37054830_37064946
Lrit2,14,37067929,37073743,protein_coding,1,5814,chr14_37067929_37073743
Cdhr1,14,37077857,37098347,protein_coding,-1,20490,chr14_37077857_37098347
2610528A11Rik,14,37102140,37114022,protein_coding,-1,11882,chr14_37102140_37114022
Ghitm,14,37120092,37135272,protein_coding,-1,15180,chr14_37120092_37135272
Gm31393,14,37601107,37606788,lincRNA,-1,5681,chr14_37601107_37606788
Gm31456,14,38317904,38337126,lincRNA,1,19222,chr14_38317904_38337126
Nrg3,14,38368952,39473088,protein_coding,-1,1104136,chr14_38368952_39473088
Gm20641,14,38522049,38532311,antisense,1,10262,chr14_38522049_38532311
Nrg3os,14,38898302,38958794,antisense,1,60492,chr14_38898302_38958794
Gm20642,14,39220071,39250430,antisense,1,30359,chr14_39220071_39250430
1700109I08Rik,14,39655663,39685293,lincRNA,1,29630,chr14_39655663_39685293
Sh2d4b,14,40813789,40893266,protein_coding,-1,79477,chr14_40813789_40893266
Tspan14,14,40906445,40966807,protein_coding,-1,60362,chr14_40906445_40966807
Dydc2,14,41049117,41069208,protein_coding,-1,20091,chr14_41049117_41069208
Gm47547,14,41053653,41061614,antisense,1,7961,chr14_41053653_41061614
Dydc1,14,41072911,41092197,protein_coding,1,19286,chr14_41072911_41092197
Mat1a,14,41105035,41124412,protein_coding,1,19377,chr14_41105035_41124412
Mbl1,14,41151458,41159601,protein_coding,1,8143,chr14_41151458_41159601
Sftpd,14,41172214,41185149,protein_coding,-1,12935,chr14_41172214_41185149
Gm2832,14,41278805,41288815,protein_coding,1,10010,chr14_41278805_41288815
Gm7945,14,41381628,41386379,protein_coding,-1,4751,chr14_41381628_41386379
Gm3072,14,41619286,41624612,protein_coding,-1,5326,chr14_41619286_41624612
1700024B05Rik,14,41943995,42003821,protein_coding,1,59826,chr14_41943995_42003821
Gm17027,14,42157290,42162622,protein_coding,-1,5332,chr14_42157290_42162622
Gm7995,14,42310210,42325394,protein_coding,1,15184,chr14_42310210_42325394
Gm8005,14,42434156,42439673,protein_coding,-1,5517,chr14_42434156_42439673
Gm8024,14,42518878,42524282,protein_coding,-1,5404,chr14_42518878_42524282
Gm3633,14,42636467,42641917,protein_coding,-1,5450,chr14_42636467_42641917
Gm10378,14,42655938,42663605,protein_coding,1,7667,chr14_42655938_42663605
Gm21977,14,42847980,42853477,protein_coding,-1,5497,chr14_42847980_42853477
Gm8094,14,43071142,43076643,protein_coding,-1,5501,chr14_43071142_43076643
Gm8104,14,43100601,43115190,protein_coding,1,14589,chr14_43100601_43115190
Gm49135,14,43131404,43146687,lincRNA,1,15283,chr14_43131404_43146687
Gm7233,14,43179867,43187988,protein_coding,1,8121,chr14_43179867_43187988
Gm8126,14,43258649,43266799,protein_coding,1,8150,chr14_43258649_43266799
1700001F09Rik,14,43342383,43347811,protein_coding,-1,5428,chr14_43342383_43347811
Gm21154,14,43646251,43673065,lincRNA,1,26814,chr14_43646251_43673065
Gm7324,14,43697828,43715378,protein_coding,1,17550,chr14_43697828_43715378
Gm49083,14,43804696,43812383,lincRNA,-1,7687,chr14_43804696_43812383
Ear1,14,43818765,43875517,protein_coding,-1,56752,chr14_43818765_43875517
Gm8113,14,43925390,43933411,protein_coding,1,8021,chr14_43925390_43933411
Ang5,14,43957069,43963072,protein_coding,1,6003,chr14_43957069_43963072
4930503E14Rik,14,44163169,44213254,protein_coding,-1,50085,chr14_44163169_44213254
Gm8212,14,44197661,44203133,protein_coding,1,5472,chr14_44197661_44203133
Gm32857,14,44226217,44315511,lincRNA,-1,89294,chr14_44226217_44315511
Gm8220,14,44285580,44291068,protein_coding,1,5488,chr14_44285580_44291068
Gm8229,14,44365357,44370841,protein_coding,1,5484,chr14_44365357_44370841
Gm8232,14,44433635,44439086,protein_coding,1,5451,chr14_44433635_44439086
BC061237,14,44492463,44506345,protein_coding,1,13882,chr14_44492463_44506345
AC160336.1,14,44544055,44637201,lincRNA,-1,93146,chr14_44544055_44637201
Gm8257,14,44649204,44706456,protein_coding,-1,57252,chr14_44649204_44706456
Gm8267,14,44716838,44750340,protein_coding,-1,33502,chr14_44716838_44750340
Gm34060,14,44750440,44767598,lincRNA,1,17158,chr14_44750440_44767598
Gm49145,14,44821886,44834142,lincRNA,1,12256,chr14_44821886_44834142
Ptgdr,14,44851235,44859375,protein_coding,-1,8140,chr14_44851235_44859375
Gm17173,14,44972268,45006900,antisense,-1,34632,chr14_44972268_45006900
Ptger2,14,44988195,45003820,protein_coding,1,15625,chr14_44988195_45003820
Gm49180,14,45056497,45102094,lincRNA,-1,45597,chr14_45056497_45102094
Txndc16,14,45133465,45220328,protein_coding,-1,86863,chr14_45133465_45220328
Gpr137c,14,45219717,45282725,protein_coding,1,63008,chr14_45219717_45282725
Ero1l,14,45283087,45318771,protein_coding,-1,35684,chr14_45283087_45318771
Psmc6,14,45329788,45349705,protein_coding,1,19917,chr14_45329788_45349705
Styx,14,45351093,45422820,protein_coding,1,71727,chr14_45351093_45422820
Gnpnat1,14,45376334,45404913,protein_coding,-1,28579,chr14_45376334_45404913
Gm34250,14,45442754,45447073,lincRNA,-1,4319,chr14_45442754_45447073
Fermt2,14,45458795,45530118,protein_coding,-1,71323,chr14_45458795_45530118
Gm41144,14,45541173,45543567,lincRNA,-1,2394,chr14_45541173_45543567
Gm49123,14,45551838,45554402,lincRNA,-1,2564,chr14_45551838_45554402
Gm15601,14,45563834,45598512,antisense,1,34678,chr14_45563834_45598512
Ddhd1,14,45588467,45658143,protein_coding,-1,69676,chr14_45588467_45658143
A530076I17Rik,14,45660770,45668498,lincRNA,-1,7728,chr14_45660770_45668498
Gm15218,14,45754689,45993170,lincRNA,1,238481,chr14_45754689_45993170
Gm49192,14,45944000,45991037,lincRNA,-1,47037,chr14_45944000_45991037
Bmp4,14,46383520,46390669,protein_coding,-1,7149,chr14_46383520_46390669
Gm15222,14,46387519,46389282,antisense,1,1763,chr14_46387519_46389282
Gm15221,14,46436855,46454535,lincRNA,1,17680,chr14_46436855_46454535
Gm48912,14,46482225,46516442,lincRNA,-1,34217,chr14_46482225_46516442
E130120K24Rik,14,46556303,46568344,lincRNA,1,12041,chr14_46556303_46568344
Rubie,14,46568263,46598425,lincRNA,-1,30162,chr14_46568263_46598425
4933425B07Rik,14,46602806,46637423,lincRNA,-1,34617,chr14_46602806_46637423
D330046F09Rik,14,46645817,46673775,lincRNA,-1,27958,chr14_46645817_46673775
Gm48924,14,46743215,46746399,lincRNA,-1,3184,chr14_46743215_46746399
Cdkn3,14,46760541,46771669,protein_coding,1,11128,chr14_46760541_46771669
Cnih1,14,46775567,46788411,protein_coding,-1,12844,chr14_46775567_46788411
Gm48933,14,46787633,46788530,antisense,1,897,chr14_46787633_46788530
Gmfb,14,46808149,46822242,protein_coding,-1,14093,chr14_46808149_46822242
Cgrrf1,14,46832125,46854193,protein_coding,1,22068,chr14_46832125_46854193
Gm34934,14,46866576,46882757,lincRNA,-1,16181,chr14_46866576_46882757
Samd4,14,46882854,47105815,protein_coding,1,222961,chr14_46882854_47105815
2810457G06Rik,14,46883698,46885064,antisense,-1,1366,chr14_46883698_46885064
Gm10371,14,47097679,47116161,antisense,-1,18482,chr14_47097679_47116161
Gch1,14,47153895,47189413,protein_coding,-1,35518,chr14_47153895_47189413
Wdhd1,14,47240944,47276857,protein_coding,-1,35913,chr14_47240944_47276857
Socs4,14,47276931,47296102,protein_coding,1,19171,chr14_47276931_47296102
Mapk1ip1l,14,47298266,47323204,protein_coding,1,24938,chr14_47298266_47323204
Gm49189,14,47301982,47305485,antisense,-1,3503,chr14_47301982_47305485
Lgals3,14,47367751,47386160,protein_coding,1,18409,chr14_47367751_47386160
Dlgap5,14,47387779,47418407,protein_coding,-1,30628,chr14_47387779_47418407
Gm48975,14,47422417,47427570,lincRNA,1,5153,chr14_47422417_47427570
Fbxo34,14,47450421,47531962,protein_coding,1,81541,chr14_47450421_47531962
Gm35166,14,47502944,47508187,antisense,-1,5243,chr14_47502944_47508187
Atg14,14,47540893,47570649,protein_coding,-1,29756,chr14_47540893_47570649
Gm49004,14,47541980,47544217,antisense,1,2237,chr14_47541980_47544217
Ktn1,14,47648448,47739894,protein_coding,1,91446,chr14_47648448_47739894
Gm41148,14,47790968,47805349,lincRNA,-1,14381,chr14_47790968_47805349
Gm35360,14,47805235,47823104,lincRNA,1,17869,chr14_47805235_47823104
4930447J18Rik,14,47898851,47944189,lincRNA,1,45338,chr14_47898851_47944189
Gm49303,14,47960019,47973713,lincRNA,1,13694,chr14_47960019_47973713
Gm49306,14,48047011,48058470,lincRNA,1,11459,chr14_48047011_48058470
Peli2,14,48120823,48281575,protein_coding,1,160752,chr14_48120823_48281575
Tmem260,14,48446124,48524246,protein_coding,1,78122,chr14_48446124_48524246
4930572G02Rik,14,48537991,48571888,lincRNA,1,33897,chr14_48537991_48571888
Gm49120,14,48590599,48596402,lincRNA,1,5803,chr14_48590599_48596402
Gm49151,14,48643461,48649774,lincRNA,1,6313,chr14_48643461_48649774
Otx2os1,14,48668708,48870683,lincRNA,1,201975,chr14_48668708_48870683
Gm49156,14,48727414,48740809,lincRNA,-1,13395,chr14_48727414_48740809
Exoc5,14,49004090,49066653,protein_coding,-1,62563,chr14_49004090_49066653
Ap5m1,14,49066097,49094234,protein_coding,1,28137,chr14_49066097_49094234
Naa30,14,49172226,49191031,protein_coding,1,18805,chr14_49172226_49191031
Gm48935,14,49217779,49220047,lincRNA,1,2268,chr14_49217779_49220047
Slc35f4,14,49298519,49526046,protein_coding,-1,227527,chr14_49298519_49526046
Gm48940,14,49299836,49304512,antisense,1,4676,chr14_49299836_49304512
Gm36146,14,49722652,49744296,antisense,1,21644,chr14_49722652_49744296
Olfr722,14,49894258,49901999,protein_coding,-1,7741,chr14_49894258_49901999
Olfr726,14,50083570,50090953,protein_coding,-1,7383,chr14_50083570_50090953
Olfr727,14,50123186,50128746,protein_coding,1,5560,chr14_50123186_50128746
Olfr729,14,50144731,50152910,protein_coding,-1,8179,chr14_50144731_50152910
Olfr731,14,50233531,50241866,protein_coding,-1,8335,chr14_50233531_50241866
Olfr735,14,50342612,50348872,protein_coding,-1,6260,chr14_50342612_50348872
Olfr736,14,50381163,50394192,protein_coding,1,13029,chr14_50381163_50394192
Olfr738,14,50407568,50415438,protein_coding,1,7870,chr14_50407568_50415438
Olfr739,14,50418626,50427888,protein_coding,1,9262,chr14_50418626_50427888
Olfr740,14,50445545,50456933,protein_coding,1,11388,chr14_50445545_50456933
Olfr741,14,50472738,50488338,protein_coding,1,15600,chr14_50472738_50488338
Olfr742,14,50503600,50517145,protein_coding,1,13545,chr14_50503600_50517145
Olfr744,14,50614879,50619839,protein_coding,1,4960,chr14_50614879_50619839
Olfr746,14,50647083,50654183,protein_coding,1,7100,chr14_50647083_50654183
Olfr747,14,50680657,50693206,protein_coding,-1,12549,chr14_50680657_50693206
Olfr749,14,50736171,50745094,protein_coding,-1,8923,chr14_50736171_50745094
Ttc5,14,50765415,50785519,protein_coding,-1,20104,chr14_50765415_50785519
Ccnb1ip1,14,50789248,50807732,protein_coding,-1,18484,chr14_50789248_50807732
Parp2,14,50807841,50821301,protein_coding,1,13460,chr14_50807841_50821301
Tep1,14,50824059,50870560,protein_coding,-1,46501,chr14_50824059_50870560
Gm26782,14,50870324,50880603,antisense,1,10279,chr14_50870324_50880603
Klhl33,14,50888582,50897507,protein_coding,-1,8925,chr14_50888582_50897507
Osgep,14,50906478,50924893,protein_coding,-1,18415,chr14_50906478_50924893
Apex1,14,50924968,50927139,protein_coding,1,2171,chr14_50924968_50927139
Pnp,14,50931082,50965237,protein_coding,1,34155,chr14_50931082_50965237
Olfr750,14,51066301,51074435,protein_coding,-1,8134,chr14_51066301_51074435
Rnase4,14,51091077,51106151,protein_coding,1,15074,chr14_51091077_51106151
Rnase6,14,51123908,51132187,protein_coding,1,8279,chr14_51123908_51132187
Rnase1,14,51144998,51146785,protein_coding,-1,1787,chr14_51144998_51146785
Gm21718,14,51311497,51317768,lincRNA,1,6271,chr14_51311497_51317768
Gm7247,14,51361756,51569982,protein_coding,1,208226,chr14_51361756_51569982
Gm5622,14,51552790,51662953,protein_coding,1,110163,chr14_51552790_51662953
Gm17174,14,51587653,51592139,protein_coding,-1,4486,chr14_51587653_51592139
Gm17078,14,51606807,51611310,protein_coding,-1,4503,chr14_51606807_51611310
Gm4181,14,51630273,51635666,protein_coding,-1,5393,chr14_51630273_51635666
Gm5800,14,51711643,51717183,protein_coding,-1,5540,chr14_51711643_51717183
Ang4,14,51763878,51773590,protein_coding,-1,9712,chr14_51763878_51773590
AY358078,14,51800046,51826359,protein_coding,1,26313,chr14_51800046_51826359
Mettl17,14,51884842,51893039,protein_coding,1,8197,chr14_51884842_51893039
Slc39a2,14,51892889,51896745,protein_coding,1,3856,chr14_51892889_51896745
Ndrg2,14,51905271,51914158,protein_coding,-1,8887,chr14_51905271_51914158
Gm49076,14,51926264,51929660,lincRNA,-1,3396,chr14_51926264_51929660
Arhgef40,14,51984719,52006251,protein_coding,1,21532,chr14_51984719_52006251
Gm16617,14,51986425,51988827,antisense,-1,2402,chr14_51986425_51988827
Zfp219,14,52006077,52020733,protein_coding,-1,14656,chr14_52006077_52020733
Tmem253,14,52015658,52019794,protein_coding,1,4136,chr14_52015658_52019794
Gm49086,14,52020076,52021908,antisense,1,1832,chr14_52020076_52021908
Gm49256,14,52023284,52024108,lincRNA,1,824,chr14_52023284_52024108
Olfr221,14,52033962,52042459,protein_coding,-1,8497,chr14_52033962_52042459
Hnrnpc,14,52073377,52104028,protein_coding,-1,30651,chr14_52073377_52104028
Rpgrip1,14,52110704,52163546,protein_coding,1,52842,chr14_52110704_52163546
Supt16,14,52160414,52197416,protein_coding,-1,37002,chr14_52160414_52197416
Gm26590,14,52197502,52213852,antisense,1,16350,chr14_52197502_52213852
Chd8,14,52198151,52257780,protein_coding,-1,59629,chr14_52198151_52257780
Rab2b,14,52261759,52279545,protein_coding,-1,17786,chr14_52261759_52279545
Tox4,14,52279146,52296401,protein_coding,1,17255,chr14_52279146_52296401
Mettl3,14,52294841,52305128,protein_coding,-1,10287,chr14_52294841_52305128
Sall2,14,52311172,52328762,protein_coding,-1,17590,chr14_52311172_52328762
Olfr1513,14,52347495,52356408,protein_coding,-1,8913,chr14_52347495_52356408
Olfr1512,14,52371332,52379168,protein_coding,-1,7836,chr14_52371332_52379168
Olfr1511,14,52389794,52397379,protein_coding,-1,7585,chr14_52389794_52397379
Olfr1510,14,52409131,52414373,protein_coding,-1,5242,chr14_52409131_52414373
Olfr1509,14,52442990,52452574,protein_coding,1,9584,chr14_52442990_52452574
Olfr1508,14,52458829,52467495,protein_coding,-1,8666,chr14_52458829_52467495
Olfr1507,14,52488791,52495749,protein_coding,-1,6958,chr14_52488791_52495749
Trav9d-4,14,52983201,52983860,TR_V_gene,1,659,chr14_52983201_52983860
Gm30214,14,53032417,53039466,antisense,-1,7049,chr14_53032417_53039466
Trav9n-4,14,53294341,53295030,TR_V_gene,1,689,chr14_53294341_53295030
Gm43650,14,53336637,53343922,antisense,-1,7285,chr14_53336637_53343922
Trav13n-4,14,53362267,53364106,TR_V_gene,1,1839,chr14_53362267_53364106
Trav12-2,14,53616315,53616914,TR_V_gene,1,599,chr14_53616315_53616914
Trav9-4,14,53676141,53676630,TR_V_gene,1,489,chr14_53676141_53676630
Trav4-4-dv10,14,53683647,53684177,TR_V_gene,1,530,chr14_53683647_53684177
Gm43647,14,53918327,53961515,antisense,-1,43188,chr14_53918327_53961515
Trav22,14,53926978,53927595,TR_V_pseudogene,1,617,chr14_53926978_53927595
Trdv2-2,14,53960944,53961602,TR_V_gene,1,658,chr14_53960944_53961602
Gm30275,14,54067579,54125395,antisense,-1,57816,chr14_54067579_54125395
Gm43434,14,54128298,54146287,antisense,-1,17989,chr14_54128298_54146287
Trdc,14,54142851,54148868,TR_C_gene,1,6017,chr14_54142851_54148868
Trac,14,54220521,54224206,TR_C_gene,1,3685,chr14_54220521_54224206
Dad1,14,54235479,54254104,protein_coding,-1,18625,chr14_54235479_54254104
Abhd4,14,54254188,54270637,protein_coding,1,16449,chr14_54254188_54270637
Oxa1l,14,54360834,54369673,protein_coding,1,8839,chr14_54360834_54369673
Slc7a7,14,54369442,54417780,protein_coding,-1,48338,chr14_54369442_54417780
Mrpl52,14,54426909,54429756,protein_coding,1,2847,chr14_54426909_54429756
Mmp14,14,54431612,54445364,protein_coding,1,13752,chr14_54431612_54445364
Gm10366,14,54463042,54464742,antisense,-1,1700,chr14_54463042_54464742
Lrp10,14,54464137,54471497,protein_coding,1,7360,chr14_54464137_54471497
Rem2,14,54476100,54480431,protein_coding,1,4331,chr14_54476100_54480431
Prmt5,14,54507187,54517525,protein_coding,-1,10338,chr14_54507187_54517525
Haus4,14,54541785,54554616,protein_coding,-1,12831,chr14_54541785_54554616
Ajuba,14,54567472,54577558,protein_coding,-1,10086,chr14_54567472_54577558
4931414P19Rik,14,54583663,54605993,protein_coding,-1,22330,chr14_54583663_54605993
Psmb5,14,54614119,54618022,protein_coding,-1,3903,chr14_54614119_54618022
Psmb11,14,54621433,54629556,protein_coding,1,8123,chr14_54621433_54629556
Cdh24,14,54631231,54641364,protein_coding,-1,10133,chr14_54631231_54641364
Gm17606,14,54640952,54648293,protein_coding,1,7341,chr14_54640952_54648293
Acin1,14,54642161,54686931,protein_coding,-1,44770,chr14_54642161_54686931
4930579G18Rik,14,54650511,54654607,antisense,1,4096,chr14_54650511_54654607
1700123O20Rik,14,54686216,54690741,protein_coding,1,4525,chr14_54686216_54690741
Gm29776,14,54692598,54698833,protein_coding,-1,6235,chr14_54692598_54698833
Slc7a8,14,54722209,54781946,protein_coding,-1,59737,chr14_54722209_54781946
Rnf212b,14,54814141,54854108,protein_coding,1,39967,chr14_54814141_54854108
Homez,14,54852736,54870961,protein_coding,-1,18225,chr14_54852736_54870961
Ppp1r3e,14,54872669,54877550,protein_coding,-1,4881,chr14_54872669_54877550
Gm20521,14,54883441,54898137,protein_coding,1,14696,chr14_54883441_54898137
Pabpn1,14,54892500,54898169,protein_coding,1,5669,chr14_54892500_54898169
Slc22a17,14,54906304,54913132,protein_coding,-1,6828,chr14_54906304_54913132
Efs,14,54916535,54926126,protein_coding,-1,9591,chr14_54916535_54926126
Il25,14,54932695,54935837,protein_coding,1,3142,chr14_54932695_54935837
Cmtm5,14,54936261,54939274,protein_coding,1,3013,chr14_54936261_54939274
Gm49130,14,54940355,54942852,antisense,1,2497,chr14_54940355_54942852
Myh6,14,54941921,54966927,protein_coding,-1,25006,chr14_54941921_54966927
Mhrt,14,54968678,54974349,antisense,1,5671,chr14_54968678_54974349
Myh7,14,54970684,54994626,protein_coding,-1,23942,chr14_54970684_54994626
Gm17428,14,54976933,54977025,protein_coding,1,92,chr14_54976933_54977025
Gm31251,14,54979393,54991601,antisense,1,12208,chr14_54979393_54991601
Ngdn,14,55015454,55024137,protein_coding,1,8683,chr14_55015454_55024137
Zfhx2os,14,55053869,55075873,antisense,1,22004,chr14_55053869_55075873
Gm20687,14,55054945,55098986,antisense,1,44041,chr14_55054945_55098986
Zfhx2,14,55060262,55092324,protein_coding,-1,32062,chr14_55060262_55092324
Ap1g2,14,55098575,55106593,protein_coding,-1,8018,chr14_55098575_55106593
Jph4,14,55106826,55116935,protein_coding,-1,10109,chr14_55106826_55116935
Dhrs2,14,55222007,55241435,protein_coding,1,19428,chr14_55222007_55241435
Gm49022,14,55276834,55280687,lincRNA,-1,3853,chr14_55276834_55280687
Dhrs4,14,55478758,55490340,protein_coding,1,11582,chr14_55478758_55490340
Carmil3,14,55490651,55508272,protein_coding,1,17621,chr14_55490651_55508272
Cpne6,14,55510445,55517431,protein_coding,1,6986,chr14_55510445_55517431
Nrl,14,55518978,55524981,protein_coding,-1,6003,chr14_55518978_55524981
Gm10876,14,55528828,55542399,antisense,-1,13571,chr14_55528828_55542399
Pck2,14,55540266,55551242,protein_coding,1,10976,chr14_55540266_55551242
A730061H03Rik,14,55559097,55560408,bidirectional_promoter_lncRNA,-1,1311,chr14_55559097_55560408
Dcaf11,14,55560006,55570065,protein_coding,1,10059,chr14_55560006_55570065
Gm15932,14,55566159,55575991,antisense,-1,9832,chr14_55566159_55575991
Fitm1,14,55575617,55576954,protein_coding,1,1337,chr14_55575617_55576954
Psme1,14,55578123,55581529,protein_coding,1,3406,chr14_55578123_55581529
Emc9,14,55581516,55585302,protein_coding,-1,3786,chr14_55581516_55585302
Psme2,14,48960285,55591113,protein_coding,-1,6630828,chr14_48960285_55591113
Rnf31,14,55591708,55603693,protein_coding,1,11985,chr14_55591708_55603693
Irf9,14,55603571,55610030,protein_coding,1,6459,chr14_55603571_55610030
Rec8,14,55618037,55625395,protein_coding,1,7358,chr14_55618037_55625395
Ipo4,14,55625400,55635957,protein_coding,-1,10557,chr14_55625400_55635957
Gm49378,14,55629076,55637895,protein_coding,-1,8819,chr14_55629076_55637895
Tm9sf1,14,55635965,55643806,protein_coding,-1,7841,chr14_55635965_55643806
Tssk4,14,55650184,55652539,protein_coding,1,2355,chr14_55650184_55652539
Mdp1,14,55657879,55660508,protein_coding,-1,2629,chr14_55657879_55660508
Nedd8,14,55662263,55672124,protein_coding,-1,9861,chr14_55662263_55672124
Gmpr2,14,55671941,55679200,protein_coding,1,7259,chr14_55671941_55679200
Tinf2,14,55674689,55681820,protein_coding,-1,7131,chr14_55674689_55681820
Gm49067,14,55681918,55712282,antisense,1,30364,chr14_55681918_55712282
Tgm1,14,55700009,55713926,protein_coding,-1,13917,chr14_55700009_55713926
Rabggta,14,55715416,55722263,protein_coding,-1,6847,chr14_55715416_55722263
Dhrs1,14,55739020,55745690,protein_coding,-1,6670,chr14_55739020_55745690
Nop9,14,55745693,55755500,protein_coding,1,9807,chr14_55745693_55755500
Cideb,14,55754050,55758458,protein_coding,-1,4408,chr14_55754050_55758458
Ltb4r2,14,55761428,55765138,protein_coding,1,3710,chr14_55761428_55765138
Ltb4r1,14,55765962,55768494,protein_coding,1,2532,chr14_55765962_55768494
Adcy4,14,55769057,55784095,protein_coding,-1,15038,chr14_55769057_55784095
Ripk3,14,55784995,55788865,protein_coding,-1,3870,chr14_55784995_55788865
Nfatc4,14,55823144,55833943,protein_coding,1,10799,chr14_55823144_55833943
Nynrin,14,55854010,55874736,protein_coding,1,20726,chr14_55854010_55874736
Cbln3,14,55878913,55884392,protein_coding,-1,5479,chr14_55878913_55884392
Khnyn,14,55884947,55898775,protein_coding,1,13828,chr14_55884947_55898775
Sdr39u1,14,55897283,55900293,protein_coding,-1,3010,chr14_55897283_55900293
Cma2,14,55950980,55974031,protein_coding,1,23051,chr14_55950980_55974031
Gzmn,14,56165797,56174599,protein_coding,-1,8802,chr14_56165797_56174599
Gm4022,14,56173751,56207735,antisense,1,33984,chr14_56173751_56207735
Gzmc,14,56231441,56234656,protein_coding,-1,3215,chr14_56231441_56234656
Atp12a,14,56365068,56388550,protein_coding,1,23482,chr14_56365068_56388550
Gm10873,14,56376902,56391562,antisense,-1,14660,chr14_56376902_56391562
Rnf17,14,56402581,56525032,protein_coding,1,122451,chr14_56402581_56525032
Cenpj,14,56526761,56575425,protein_coding,-1,48664,chr14_56526761_56575425
Parp4,14,56575619,56659794,protein_coding,1,84175,chr14_56575619_56659794
Gm16573,14,56607261,56620513,antisense,-1,13252,chr14_56607261_56620513
Mphosph8,14,56668248,56697430,protein_coding,1,29182,chr14_56668248_56697430
Gm16973,14,56696280,56701268,lincRNA,-1,4988,chr14_56696280_56701268
Pspc1,14,56720710,56778316,protein_coding,-1,57606,chr14_56720710_56778316
Zmym5,14,56790585,56811716,protein_coding,-1,21131,chr14_56790585_56811716
Zmym2,14,56886653,56962701,protein_coding,1,76048,chr14_56886653_56962701
Gja3,14,57034460,57058100,protein_coding,-1,23640,chr14_57034460_57058100
Gjb2,14,57098600,57104702,protein_coding,-1,6102,chr14_57098600_57104702
Gm4491,14,57112506,57115883,protein_coding,-1,3377,chr14_57112506_57115883
Gjb6,14,57123303,57133611,protein_coding,-1,10308,chr14_57123303_57133611
Cryl1,14,57274993,57398529,protein_coding,-1,123536,chr14_57274993_57398529
Ift88,14,57424062,57517936,protein_coding,1,93874,chr14_57424062_57517936
Ift88os,14,57506744,57510835,antisense,-1,4091,chr14_57506744_57510835
Il17d,14,57524777,57543166,protein_coding,1,18389,chr14_57524777_57543166
Eef1akmt1,14,57549597,57571612,protein_coding,-1,22015,chr14_57549597_57571612
Xpo4,14,57577521,57665430,protein_coding,-1,87909,chr14_57577521_57665430
Gm49361,14,57642077,57746103,protein_coding,-1,104026,chr14_57642077_57746103
Lats2,14,57689662,57758388,protein_coding,-1,68726,chr14_57689662_57758388
Sap18,14,57798180,57806638,protein_coding,1,8458,chr14_57798180_57806638
Ska3,14,57806561,57826185,protein_coding,-1,19624,chr14_57806561_57826185
Mrpl57,14,57826234,57829296,protein_coding,1,3062,chr14_57826234_57829296
Zdhhc20,14,57832703,57890276,protein_coding,-1,57573,chr14_57832703_57890276
Micu2,14,57916261,57999262,protein_coding,-1,83001,chr14_57916261_57999262
Fgf9,14,58070547,58112720,protein_coding,1,42173,chr14_58070547_58112720
Gm33321,14,58300973,58363816,lincRNA,1,62843,chr14_58300973_58363816
Gm48447,14,58912104,58939867,lincRNA,1,27763,chr14_58912104_58939867
Gm41162,14,59046121,59067224,lincRNA,1,21103,chr14_59046121_59067224
Gm48453,14,59084136,59087118,lincRNA,-1,2982,chr14_59084136_59087118
1700129C05Rik,14,59133040,59142893,protein_coding,-1,9853,chr14_59133040_59142893
Gm5142,14,59158503,59178749,protein_coding,-1,20246,chr14_59158503_59178749
Rcbtb1,14,59201209,59237265,protein_coding,1,36056,chr14_59201209_59237265
Phf11a,14,59276913,59297522,protein_coding,-1,20609,chr14_59276913_59297522
Phf11b,14,59320964,59341351,protein_coding,-1,20387,chr14_59320964_59341351
Phf11d,14,59347407,59365470,protein_coding,-1,18063,chr14_59347407_59365470
Phf11c,14,59380833,59395381,protein_coding,-1,14548,chr14_59380833_59395381
Setdb2,14,59402009,59440884,protein_coding,-1,38875,chr14_59402009_59440884
Cab39l,14,59440972,59585764,protein_coding,1,144792,chr14_59440972_59585764
Cdadc1,14,59559388,59597959,protein_coding,-1,38571,chr14_59559388_59597959
Shisa2,14,59625308,59631660,protein_coding,1,6352,chr14_59625308_59631660
Atp8a2,14,59638540,60197179,protein_coding,-1,558639,chr14_59638540_60197179
4930563I02Rik,14,60087071,60096093,antisense,1,9022,chr14_60087071_60096093
Nupl1,14,60184612,60251431,protein_coding,-1,66819,chr14_60184612_60251431
Gm49336,14,60205282,60251507,protein_coding,-1,46225,chr14_60205282_60251507
Mtmr6,14,60265228,60302370,protein_coding,1,37142,chr14_60265228_60302370
Amer2,14,60373259,60388197,protein_coding,1,14938,chr14_60373259_60388197
Gm29266,14,60485208,60599031,lincRNA,1,113823,chr14_60485208_60599031
Spata13,14,60634001,60764556,protein_coding,1,130555,chr14_60634001_60764556
C1qtnf9,14,60768134,60780869,protein_coding,1,12735,chr14_60768134_60780869
Mipepos,14,60776329,60784581,antisense,-1,8252,chr14_60776329_60784581
Mipep,14,60784573,60905478,protein_coding,1,120905,chr14_60784573_60905478
Tnfrsf19,14,60963875,61046490,protein_coding,-1,82615,chr14_60963875_61046490
Sacs,14,61138457,61240695,protein_coding,1,102238,chr14_61138457_61240695
Sgcg,14,61219115,61258490,protein_coding,-1,39375,chr14_61219115_61258490
1700109G14Rik,14,61292980,61318146,antisense,-1,25166,chr14_61292980_61318146
Arl11,14,61309753,61311936,protein_coding,1,2183,chr14_61309753_61311936
Ebpl,14,61331742,61360439,protein_coding,-1,28697,chr14_61331742_61360439
Kpna3,14,61365211,61439874,protein_coding,-1,74663,chr14_61365211_61439874
4930556J02Rik,14,61492688,61527389,lincRNA,1,34701,chr14_61492688_61527389
Spryd7,14,61531993,61556886,protein_coding,-1,24893,chr14_61531993_61556886
Trim13,14,61598247,61605946,protein_coding,1,7699,chr14_61598247_61605946
Kcnrg,14,61607457,61612826,protein_coding,1,5369,chr14_61607457_61612826
Gm27010,14,61625926,61627337,lincRNA,-1,1411,chr14_61625926_61627337
Gm26916,14,61629484,61630414,lincRNA,1,930,chr14_61629484_61630414
Gm27017,14,61648950,61667312,lincRNA,1,18362,chr14_61648950_61667312
Gm35419,14,62113120,62171126,lincRNA,-1,58006,chr14_62113120_62171126
Dleu7,14,62276231,62293047,protein_coding,-1,16816,chr14_62276231_62293047
Rnaseh2b,14,62292589,62372992,protein_coding,1,80403,chr14_62292589_62372992
Gucy1b2,14,62392676,62456289,protein_coding,-1,63613,chr14_62392676_62456289
Gm4131,14,62463414,62566921,protein_coding,-1,103507,chr14_62463414_62566921
Fam124a,14,62555737,62608486,protein_coding,1,52749,chr14_62555737_62608486
Serpine3,14,62663667,62692243,protein_coding,1,28576,chr14_62663667_62692243
Ints6,14,62676330,62761169,protein_coding,-1,84839,chr14_62676330_62761169
Wdfy2,14,62837678,62961509,protein_coding,1,123831,chr14_62837678_62961509
Defb48,14,62977524,62984510,protein_coding,-1,6986,chr14_62977524_62984510
Defb47,14,62998077,63001160,protein_coding,1,3083,chr14_62998077_63001160
Defb43,14,63011771,63018088,protein_coding,1,6317,chr14_63011771_63018088
Defb30,14,63034087,63049960,protein_coding,-1,15873,chr14_63034087_63049960
Defb42,14,63046991,63058149,protein_coding,1,11158,chr14_63046991_63058149
Ctsb,14,63122462,63145923,protein_coding,1,23461,chr14_63122462_63145923
Fdft1,14,63145150,63179578,protein_coding,-1,34428,chr14_63145150_63179578
Neil2,14,63182443,63193856,protein_coding,-1,11413,chr14_63182443_63193856
Gata4,14,63198922,63271692,protein_coding,-1,72770,chr14_63198922_63271692
Gm49390,14,63317745,63336957,lincRNA,1,19212,chr14_63317745_63336957
Gm5463,14,63329220,63345635,lincRNA,1,16415,chr14_63329220_63345635
Blk,14,63372836,63417037,protein_coding,-1,44201,chr14_63372836_63417037
Fam167a,14,63436394,63465498,protein_coding,1,29104,chr14_63436394_63465498
Tdh,14,63492347,63509092,protein_coding,-1,16745,chr14_63492347_63509092
Gm17232,14,63493699,63499872,antisense,1,6173,chr14_63493699_63499872
Mtmr9,14,63519651,63543982,protein_coding,-1,24331,chr14_63519651_63543982
Gm15918,14,63602524,63607372,antisense,-1,4848,chr14_63602524_63607372
Xkr6,14,63606503,63820809,protein_coding,1,214306,chr14_63606503_63820809
Pinx1,14,63860364,63919859,protein_coding,1,59495,chr14_63860364_63919859
Sox7,14,63943673,63950732,protein_coding,1,7059,chr14_63943673_63950732
4930578I06Rik,14,63969339,63987790,protein_coding,-1,18451,chr14_63969339_63987790
Rp1l1,14,63992506,64035025,protein_coding,1,42519,chr14_63992506_64035025
Prss55,14,64075438,64090162,protein_coding,-1,14724,chr14_64075438_64090162
Prss51,14,64086234,64097678,protein_coding,1,11444,chr14_64086234_64097678
4930471C04Rik,14,64099295,64104235,lincRNA,-1,4940,chr14_64099295_64104235
Prss52,14,64104286,64113755,protein_coding,1,9469,chr14_64104286_64113755
Gm17116,14,64111200,64114641,antisense,-1,3441,chr14_64111200_64114641
9630015K15Rik,14,64116314,64127605,antisense,1,11291,chr14_64116314_64127605
Msra,14,64122625,64455903,protein_coding,-1,333278,chr14_64122625_64455903
Gm47202,14,64530952,64537538,lincRNA,-1,6586,chr14_64530952_64537538
Mir124a-1hg,14,64587331,64593961,lincRNA,1,6630,chr14_64587331_64593961
Kif13b,14,64647265,64809617,protein_coding,1,162352,chr14_64647265_64809617
Hmbox1,14,64811600,64949871,protein_coding,-1,138271,chr14_64811600_64949871
Ints9,14,64950045,65039835,protein_coding,1,89790,chr14_64950045_65039835
Extl3,14,65052060,65149855,protein_coding,-1,97795,chr14_65052060_65149855
Gm30008,14,65171115,65174959,lincRNA,-1,3844,chr14_65171115_65174959
Gm41177,14,65172355,65185432,lincRNA,1,13077,chr14_65172355_65185432
Fzd3,14,65192449,65262463,protein_coding,-1,70014,chr14_65192449_65262463
Fbxo16,14,65266618,65323973,protein_coding,1,57355,chr14_65266618_65323973
Gm48433,14,65326331,65337604,lincRNA,1,11273,chr14_65326331_65337604
Gm48449,14,65351442,65359410,antisense,-1,7968,chr14_65351442_65359410
Zfp395,14,65358389,65398930,protein_coding,1,40541,chr14_65358389_65398930
Pnoc,14,65400673,65425472,protein_coding,-1,24799,chr14_65400673_65425472
Elp3,14,65530449,65593075,protein_coding,-1,62626,chr14_65530449_65593075
Nuggc,14,65598546,65648531,protein_coding,1,49985,chr14_65598546_65648531
Scara5,14,65666403,65764826,protein_coding,1,98423,chr14_65666403_65764826
Pbk,14,65805837,65817822,protein_coding,1,11985,chr14_65805837_65817822
Esco2,14,65819038,65833994,protein_coding,-1,14956,chr14_65819038_65833994
Ccdc25,14,65837302,65866607,protein_coding,1,29305,chr14_65837302_65866607
Scara3,14,65919394,65953935,protein_coding,-1,34541,chr14_65919394_65953935
Clu,14,65968483,65981547,protein_coding,1,13064,chr14_65968483_65981547
Gulo,14,65986786,66009207,protein_coding,-1,22421,chr14_65986786_66009207
Adam2,14,66027329,66077733,protein_coding,-1,50404,chr14_66027329_66077733
Ephx2,14,66084374,66124500,protein_coding,-1,40126,chr14_66084374_66124500
Chrna2,14,66135039,66152948,protein_coding,1,17909,chr14_66135039_66152948
Ptk2b,14,66153257,66281052,protein_coding,-1,127795,chr14_66153257_66281052
Trim35,14,66297031,66311424,protein_coding,1,14393,chr14_66297031_66311424
Gm41183,14,66336715,66341229,lincRNA,-1,4514,chr14_66336715_66341229
Stmn4,14,66344296,66361680,protein_coding,1,17384,chr14_66344296_66361680
Adra1a,14,66635251,66771168,protein_coding,1,135917,chr14_66635251_66771168
Gm10032,14,66784480,66793758,lincRNA,1,9278,chr14_66784480_66793758
Dpysl2,14,66802864,66868688,protein_coding,-1,65824,chr14_66802864_66868688
Gm5464,14,66868850,66871723,lincRNA,1,2873,chr14_66868850_66871723
Pnma2,14,66911170,66921023,protein_coding,1,9853,chr14_66911170_66921023
Bnip3l,14,66985239,67008877,protein_coding,-1,23638,chr14_66985239_67008877
Ppp2r2a,14,67014056,67072444,protein_coding,-1,58388,chr14_67014056_67072444
Ebf2,14,67233292,67430918,protein_coding,1,197626,chr14_67233292_67430918
Gm6878,14,67304888,67314711,antisense,-1,9823,chr14_67304888_67314711
4930438E09Rik,14,67332042,67397742,antisense,-1,65700,chr14_67332042_67397742
Gm10860,14,67427668,67437171,antisense,-1,9503,chr14_67427668_67437171
Gm38409,14,67476873,67502079,lincRNA,1,25206,chr14_67476873_67502079
Cdca2,14,67676331,67715841,protein_coding,-1,39510,chr14_67676331_67715841
Kctd9,14,67715937,67742310,protein_coding,1,26373,chr14_67715937_67742310
Gnrh1,14,67745181,67749439,protein_coding,1,4258,chr14_67745181_67749439
Dock5,14,67752135,67933442,protein_coding,-1,181307,chr14_67752135_67933442
Gm31107,14,68044428,68051330,lincRNA,-1,6902,chr14_68044428_68051330
Nefm,14,68082590,68124846,protein_coding,-1,42256,chr14_68082590_68124846
Nefl,14,68083863,68089095,protein_coding,1,5232,chr14_68083863_68089095
Gm47212,14,68218253,68223811,lincRNA,1,5558,chr14_68218253_68223811
Gm31227,14,68461631,68496417,lincRNA,1,34786,chr14_68461631_68496417
Adam7,14,68497336,68533741,protein_coding,-1,36405,chr14_68497336_68533741
Adamdec1,14,68563380,68582095,protein_coding,-1,18715,chr14_68563380_68582095
Adam28,14,68606027,68655842,protein_coding,-1,49815,chr14_68606027_68655842
Gm41192,14,69019434,69029652,antisense,-1,10218,chr14_69019434_69029652
Stc1,14,69029238,69041804,protein_coding,1,12566,chr14_69029238_69041804
1700092C10Rik,14,69164797,69171857,antisense,-1,7060,chr14_69164797_69171857
Nkx2-6,14,69171802,69175518,protein_coding,1,3716,chr14_69171802_69175518
Nkx3-1,14,69190638,69194662,protein_coding,1,4024,chr14_69190638_69194662
Slc25a37,14,69241848,69285112,protein_coding,-1,43264,chr14_69241848_69285112
Gm27222,14,69259146,69262037,antisense,1,2891,chr14_69259146_69262037
Synb,14,69289344,69294299,protein_coding,-1,4955,chr14_69289344_69294299
Gm16677,14,69327999,69337165,lincRNA,-1,9166,chr14_69327999_69337165
Gm16867,14,69363504,69503362,protein_coding,-1,139858,chr14_69363504_69503362
Gm27177,14,69582164,69683286,antisense,-1,101122,chr14_69582164_69683286
Loxl2,14,69609068,69695834,protein_coding,1,86766,chr14_69609068_69695834
R3hcc1,14,69697307,69707584,protein_coding,-1,10277,chr14_69697307_69707584
Chmp7,14,69717000,69732541,protein_coding,-1,15541,chr14_69717000_69732541
Tnfrsf10b,14,69767472,69784411,protein_coding,1,16939,chr14_69767472_69784411
Rhobtb2,14,69784990,69805636,protein_coding,-1,20646,chr14_69784990_69805636
Pebp4,14,69840420,70059918,protein_coding,1,219498,chr14_69840420_70059918
Gm33524,14,70018231,70057367,antisense,-1,39136,chr14_70018231_70057367
Egr3,14,70077203,70082614,protein_coding,1,5411,chr14_70077203_70082614
Bin3,14,70100105,70138206,protein_coding,1,38101,chr14_70100105_70138206
Ccar2,14,70138164,70153811,protein_coding,-1,15647,chr14_70138164_70153811
9930012K11Rik,14,70154405,70159502,protein_coding,-1,5097,chr14_70154405_70159502
Pdlim2,14,70164218,70177681,protein_coding,-1,13463,chr14_70164218_70177681
Sorbs3,14,70180468,70211989,protein_coding,-1,31521,chr14_70180468_70211989
Ppp3cc,14,70217865,70289471,protein_coding,-1,71606,chr14_70217865_70289471
Slc39a14,14,70303469,70351425,protein_coding,-1,47956,chr14_70303469_70351425
Piwil2,14,70372477,70429383,protein_coding,-1,56906,chr14_70372477_70429383
Polr3d,14,70438757,70443447,protein_coding,-1,4690,chr14_70438757_70443447
Phyhip,14,70457476,70468832,protein_coding,1,11356,chr14_70457476_70468832
Bmp1,14,70474558,70520234,protein_coding,-1,45676,chr14_70474558_70520234
Sftpc,14,70520949,70524081,protein_coding,-1,3132,chr14_70520949_70524081
Lgi3,14,70530685,70538324,protein_coding,1,7639,chr14_70530685_70538324
Reep4,14,70545251,70548933,protein_coding,1,3682,chr14_70545251_70548933
Hr,14,70552212,70573548,protein_coding,1,21336,chr14_70552212_70573548
Nudt18,14,70577637,70582688,protein_coding,1,5051,chr14_70577637_70582688
Fam160b2,14,70583296,70599835,protein_coding,-1,16539,chr14_70583296_70599835
Dmtn,14,70601263,70636048,protein_coding,-1,34785,chr14_70601263_70636048
Fgf17,14,70636203,70642268,protein_coding,-1,6065,chr14_70636203_70642268
Npm2,14,70647302,70659244,protein_coding,-1,11942,chr14_70647302_70659244
Xpo7,14,70654246,70766628,protein_coding,-1,112382,chr14_70654246_70766628
Dok2,14,70766036,70778495,protein_coding,1,12459,chr14_70766036_70778495
2410012E07Rik,14,70852933,70873954,lincRNA,1,21021,chr14_70852933_70873954
Gfra2,14,70890120,70979838,protein_coding,1,89718,chr14_70890120_70979838
Gm49289,14,71087270,71147008,lincRNA,1,59738,chr14_71087270_71147008
Gm4251,14,71251273,71271051,lincRNA,1,19778,chr14_71251273_71271051
4930434J06Rik,14,71856702,71920439,lincRNA,1,63737,chr14_71856702_71920439
Gm9195,14,72426013,72491838,protein_coding,-1,65825,chr14_72426013_72491838
Fndc3a,14,72537946,72710003,protein_coding,-1,172057,chr14_72537946_72710003
Gm16549,14,72589752,72603367,antisense,1,13615,chr14_72589752_72603367
Gm41206,14,72789353,72860268,lincRNA,1,70915,chr14_72789353_72860268
Cysltr2,14,73025603,73049114,protein_coding,-1,23511,chr14_73025603_73049114
Rcbtb2,14,73123037,73207843,protein_coding,1,84806,chr14_73123037_73207843
Gm17233,14,73173820,73187321,antisense,-1,13501,chr14_73173820_73187321
Rb1,14,73183673,73325822,protein_coding,-1,142149,chr14_73183673_73325822
Lpar6,14,73237895,73243294,protein_coding,1,5399,chr14_73237895_73243294
Itm2b,14,73362226,73385289,protein_coding,-1,23063,chr14_73362226_73385289
Med4,14,73510025,73518849,protein_coding,1,8824,chr14_73510025_73518849
Nudt15,14,73518877,73548242,protein_coding,-1,29365,chr14_73518877_73548242
Sucla2,14,73525319,73596142,protein_coding,1,70823,chr14_73525319_73596142
Gm21750,14,73661225,73662721,protein_coding,1,1496,chr14_73661225_73662721
Gm49165,14,73712817,73732016,lincRNA,-1,19199,chr14_73712817_73732016
Gm49164,14,73728568,73956061,lincRNA,1,227493,chr14_73728568_73956061
Gm49171,14,73979158,74451303,lincRNA,-1,472145,chr14_73979158_74451303
4933402J15Rik,14,74355527,74369741,lincRNA,1,14214,chr14_74355527_74369741
Gm49175,14,74532174,74547547,lincRNA,-1,15373,chr14_74532174_74547547
Htr2a,14,74640840,74709494,protein_coding,1,68654,chr14_74640840_74709494
Esd,14,74732297,74750765,protein_coding,1,18468,chr14_74732297_74750765
Lrch1,14,74754675,74947876,protein_coding,-1,193201,chr14_74754675_74947876
Gm10847,14,74926445,74933133,antisense,1,6688,chr14_74926445_74933133
Gm4278,14,74975086,74987104,lincRNA,1,12018,chr14_74975086_74987104
Rubcnl,14,75016027,75052532,protein_coding,1,36505,chr14_75016027_75052532
Lrrc63,14,75084303,75130881,protein_coding,-1,46578,chr14_75084303_75130881
Lcp1,14,75131101,75230842,protein_coding,1,99741,chr14_75131101_75230842
Cpb2,14,75242287,75283555,protein_coding,1,41268,chr14_75242287_75283555
Zc3h13,14,75284373,75344426,protein_coding,1,60053,chr14_75284373_75344426
Gm49200,14,75358982,75400446,lincRNA,-1,41464,chr14_75358982_75400446
Siah3,14,75455982,75529708,protein_coding,1,73726,chr14_75455982_75529708
Erich6b,14,75642249,75696717,protein_coding,1,54468,chr14_75642249_75696717
Cog3,14,75702350,75754558,protein_coding,-1,52208,chr14_75702350_75754558
Slc25a30,14,75760117,75787037,protein_coding,-1,26920,chr14_75760117_75787037
Gm4285,14,75843379,75844964,antisense,-1,1585,chr14_75843379_75844964
Tpt1,14,75845093,75848525,protein_coding,1,3432,chr14_75845093_75848525
Gtf2f2,14,75896937,76010865,protein_coding,-1,113928,chr14_75896937_76010865
Kctd4,14,75955009,75966206,protein_coding,1,11197,chr14_75955009_75966206
Gpalpp1,14,76086236,76110760,protein_coding,-1,24524,chr14_76086236_76110760
Nufip1,14,76110891,76137379,protein_coding,1,26488,chr14_76110891_76137379
Tsc22d1,14,76414961,76507765,protein_coding,1,92804,chr14_76414961_76507765
E130202H07Rik,14,76526592,76530746,lincRNA,1,4154,chr14_76526592_76530746
Serp2,14,76532814,76556889,protein_coding,-1,24075,chr14_76532814_76556889
4930431P22Rik,14,76760131,76762217,lincRNA,1,2086,chr14_76760131_76762217
Gm30246,14,76780827,76784212,lincRNA,1,3385,chr14_76780827_76784212
Gm48968,14,76832821,76853299,lincRNA,1,20478,chr14_76832821_76853299
Gm48969,14,76861571,76875175,lincRNA,1,13604,chr14_76861571_76875175
Lacc1,14,77024200,77036904,protein_coding,-1,12704,chr14_77024200_77036904
Ccdc122,14,77036772,77112257,protein_coding,1,75485,chr14_77036772_77112257
Enox1,14,77156763,77721760,protein_coding,1,564997,chr14_77156763_77721760
Gm49002,14,77438586,77440976,antisense,-1,2390,chr14_77438586_77440976
Gm6994,14,77479483,77506868,antisense,-1,27385,chr14_77479483_77506868
Gm49003,14,77578544,77633860,antisense,-1,55316,chr14_77578544_77633860
Gm30467,14,77780974,77794221,lincRNA,1,13247,chr14_77780974_77794221
Gm1587,14,77793945,77798968,lincRNA,-1,5023,chr14_77793945_77798968
Dnajc15,14,77820681,77875125,protein_coding,-1,54444,chr14_77820681_77875125
Epsti1,14,77904239,78002657,protein_coding,1,98418,chr14_77904239_78002657
Gm48954,14,78019728,78048336,lincRNA,1,28608,chr14_78019728_78048336
Gm19301,14,78070717,78090786,lincRNA,1,20069,chr14_78070717_78090786
Fam216b,14,78081021,78089007,protein_coding,-1,7986,chr14_78081021_78089007
Tnfsf11,14,78277445,78308043,protein_coding,-1,30598,chr14_78277445_78308043
Akap11,14,78492246,78536808,protein_coding,-1,44562,chr14_78492246_78536808
Dgkh,14,78558750,78732776,protein_coding,-1,174026,chr14_78558750_78732776
Vwa8,14,78849052,79202310,protein_coding,1,353258,chr14_78849052_79202310
Gm49016,14,78945180,78947227,antisense,-1,2047,chr14_78945180_78947227
Gm49015,14,79146259,79151389,antisense,-1,5130,chr14_79146259_79151389
Gm4632,14,79178894,79199190,antisense,-1,20296,chr14_79178894_79199190
Zfp957,14,79212355,79247369,protein_coding,-1,35014,chr14_79212355_79247369
Rgcc,14,79288756,79301645,protein_coding,-1,12889,chr14_79288756_79301645
Naa16,14,79325269,79390778,protein_coding,-1,65509,chr14_79325269_79390778
Mtrf1,14,79397772,79423587,protein_coding,1,25815,chr14_79397772_79423587
Kbtbd7,14,79426511,79431036,protein_coding,1,4525,chr14_79426511_79431036
Kbtbd6,14,79451835,79454818,protein_coding,1,2983,chr14_79451835_79454818
Wbp4,14,79459937,79481520,protein_coding,-1,21583,chr14_79459937_79481520
Elf1,14,79481194,79582494,protein_coding,1,101300,chr14_79481194_79582494
Sugt1,14,79587691,79635196,protein_coding,1,47505,chr14_79587691_79635196
Cnmd,14,79637690,79662170,protein_coding,-1,24480,chr14_79637690_79662170
Gm49042,14,79695037,79702410,lincRNA,-1,7373,chr14_79695037_79702410
4930452G13Rik,14,79702920,79714464,lincRNA,1,11544,chr14_79702920_79714464
Pcdh8,14,79766775,79771312,protein_coding,-1,4537,chr14_79766775_79771312
Gm9748,14,79769908,79772743,antisense,1,2835,chr14_79769908_79772743
Gm6999,14,79836712,80006326,lincRNA,1,169614,chr14_79836712_80006326
Gm10845,14,79860521,79869176,lincRNA,-1,8655,chr14_79860521_79869176
Olfm4,14,79984081,80023139,protein_coding,1,39058,chr14_79984081_80023139
Gm49046,14,81100768,81123367,lincRNA,1,22599,chr14_81100768_81123367
Gm41219,14,81685810,81721128,lincRNA,1,35318,chr14_81685810_81721128
Gm49048,14,82140123,82142578,lincRNA,-1,2455,chr14_82140123_82142578
Gm49054,14,83932800,83939741,lincRNA,-1,6941,chr14_83932800_83939741
Gm32455,14,84046431,84075290,lincRNA,-1,28859,chr14_84046431_84075290
Pcdh17,14,84443563,84539002,protein_coding,1,95439,chr14_84443563_84539002
9630013A20Rik,14,84458639,84476424,antisense,-1,17785,chr14_84458639_84476424
Gm32729,14,86172923,86179581,lincRNA,1,6658,chr14_86172923_86179581
4930529K09Rik,14,86245970,86283688,lincRNA,1,37718,chr14_86245970_86283688
Gm32913,14,86396382,86409099,lincRNA,-1,12717,chr14_86396382_86409099
Diaph3,14,86655367,87141235,protein_coding,-1,485868,chr14_86655367_87141235
Tdrd3,14,87416639,87545504,protein_coding,1,128865,chr14_87416639_87545504
Gm33203,14,88264392,88337544,lincRNA,-1,73152,chr14_88264392_88337544
Pcdh20,14,88464743,88471396,protein_coding,-1,6653,chr14_88464743_88471396
Gm41225,14,88636033,88763761,lincRNA,1,127728,chr14_88636033_88763761
Gm48941,14,90064763,90085892,lincRNA,-1,21129,chr14_90064763_90085892
4930474H20Rik,14,90126891,90269760,lincRNA,1,142869,chr14_90126891_90269760
Gm33246,14,90668259,90691445,lincRNA,-1,23186,chr14_90668259_90691445
Gm48942,14,91638499,91647839,lincRNA,-1,9340,chr14_91638499_91647839
4930433E05Rik,14,92861256,92866566,lincRNA,-1,5310,chr14_92861256_92866566
Pcdh9,14,93013410,93890679,protein_coding,-1,877269,chr14_93013410_93890679
Gm33450,14,94715695,94735465,lincRNA,-1,19770,chr14_94715695_94735465
Klhl1,14,96102736,96519102,protein_coding,-1,416366,chr14_96102736_96519102
Gm49007,14,96924633,96992293,lincRNA,-1,67660,chr14_96924633_96992293
Gm33525,14,97042601,97052968,lincRNA,-1,10367,chr14_97042601_97052968
Dach1,14,97786853,98169765,protein_coding,-1,382912,chr14_97786853_98169765
Gm49018,14,98887974,98920945,lincRNA,-1,32971,chr14_98887974_98920945
Rpl36a-ps1,14,98993870,98994318,protein_coding,-1,448,chr14_98993870_98994318
Mzt1,14,99034544,99046134,protein_coding,-1,11590,chr14_99034544_99046134
Bora,14,99046222,99074540,protein_coding,1,28318,chr14_99046222_99074540
Dis3,14,99075206,99099770,protein_coding,-1,24564,chr14_99075206_99099770
Pibf1,14,99099424,99254493,protein_coding,1,155069,chr14_99099424_99254493
Klf5,14,99298691,99315036,protein_coding,1,16345,chr14_99298691_99315036
Gm41230,14,99522545,99576902,lincRNA,1,54357,chr14_99522545_99576902
Gm49225,14,99617527,99620016,lincRNA,-1,2489,chr14_99617527_99620016
Klf12,14,99870632,100284679,protein_coding,-1,414047,chr14_99870632_100284679
4930517O19Rik,14,100213142,100245339,antisense,1,32197,chr14_100213142_100245339
Gm41231,14,100286165,100292575,lincRNA,1,6410,chr14_100286165_100292575
6330576A10Rik,14,100459423,100479525,lincRNA,1,20102,chr14_100459423_100479525
Tbc1d4,14,101442360,101609191,protein_coding,-1,166831,chr14_101442360_101609191
Commd6,14,101632981,101640686,protein_coding,-1,7705,chr14_101632981_101640686
Uchl3,14,101653967,101696125,protein_coding,1,42158,chr14_101653967_101696125
Gm9922,14,101727601,101729815,bidirectional_promoter_lncRNA,-1,2214,chr14_101727601_101729815
Lmo7,14,101729957,101934710,protein_coding,1,204753,chr14_101729957_101934710
Gm49292,14,102437023,102464994,lincRNA,1,27971,chr14_102437023_102464994
Kctd12,14,102976581,102982637,protein_coding,-1,6056,chr14_102976581_102982637
4933432I03Rik,14,102987412,103033803,lincRNA,-1,46391,chr14_102987412_103033803
Acod1,14,103046977,103056573,protein_coding,1,9596,chr14_103046977_103056573
Cln5,14,103070216,103077628,protein_coding,1,7412,chr14_103070216_103077628
Fbxl3,14,103080239,103099566,protein_coding,-1,19327,chr14_103080239_103099566
Mycbp2,14,103113411,103346814,protein_coding,-1,233403,chr14_103113411_103346814
Gm34907,14,103463919,103512619,lincRNA,1,48700,chr14_103463919_103512619
Scel,14,103513342,103612797,protein_coding,1,99455,chr14_103513342_103612797
Slain1,14,103650228,103704907,protein_coding,1,54679,chr14_103650228_103704907
Slain1os,14,103692983,103699442,antisense,-1,6459,chr14_103692983_103699442
Ednrb,14,103814625,103844402,protein_coding,-1,29777,chr14_103814625_103844402
4930432J09Rik,14,103977628,104027142,lincRNA,-1,49514,chr14_103977628_104027142
D130079A08Rik,14,104288431,104459336,lincRNA,-1,170905,chr14_104288431_104459336
Pou4f1,14,104461676,104467999,protein_coding,-1,6323,chr14_104461676_104467999
Rnf219,14,104477536,104522645,protein_coding,-1,45109,chr14_104477536_104522645
D130009I18Rik,14,104612791,104966783,lincRNA,1,353992,chr14_104612791_104966783
Rbm26,14,105106751,105177327,protein_coding,-1,70576,chr14_105106751_105177327
Ndfip2,14,105258573,105309298,protein_coding,1,50725,chr14_105258573_105309298
5430440P10Rik,14,105427559,105437716,lincRNA,1,10157,chr14_105427559_105437716
Gm35909,14,105518096,105523485,lincRNA,1,5389,chr14_105518096_105523485
Gm10076,14,105681828,105682211,lincRNA,1,383,chr14_105681828_105682211
Gm48970,14,105853073,105862501,lincRNA,-1,9428,chr14_105853073_105862501
Spry2,14,105891947,105896819,protein_coding,-1,4872,chr14_105891947_105896819
Trim52,14,106106198,106135859,protein_coding,1,29661,chr14_106106198_106135859
Gm48972,14,106241684,106267934,lincRNA,-1,26250,chr14_106241684_106267934
Gm36107,14,106265292,106271248,lincRNA,1,5956,chr14_106265292_106271248
1700128A07Rik,14,106417187,106486520,lincRNA,-1,69333,chr14_106417187_106486520
Gm48977,14,107997070,108011384,lincRNA,-1,14314,chr14_107997070_108011384
Slitrk1,14,108908800,108914158,protein_coding,-1,5358,chr14_108908800_108914158
Slitrk6,14,110748580,110755149,protein_coding,-1,6569,chr14_110748580_110755149
Gm48992,14,111432212,111433312,lincRNA,-1,1100,chr14_111432212_111433312
Slitrk5,14,111675097,111683141,protein_coding,1,8044,chr14_111675097_111683141
Tpm3-rs7,14,113314608,113316754,protein_coding,1,2146,chr14_113314608_113316754
4930524C18Rik,14,114831965,114861327,lincRNA,1,29362,chr14_114831965_114861327
1700100I10Rik,14,114940227,114945948,lincRNA,-1,5721,chr14_114940227_114945948
Mir17hg,14,115042879,115046727,lincRNA,1,3848,chr14_115042879_115046727
Gpc5,14,115092215,116525179,protein_coding,1,1432964,chr14_115092215_116525179
Gpc6,14,116925315,117976544,protein_coding,1,1051229,chr14_116925315_117976544
Dct,14,118012790,118052244,protein_coding,-1,39454,chr14_118012790_118052244
4930435M08Rik,14,118044974,118046864,antisense,1,1890,chr14_118044974_118046864
Tgds,14,118111911,118132755,protein_coding,-1,20844,chr14_118111911_118132755
Gpr180,14,118137158,118163261,protein_coding,1,26103,chr14_118137158_118163261
4933431J24Rik,14,118209378,118213145,lincRNA,1,3767,chr14_118209378_118213145
Sox21,14,118233232,118237030,protein_coding,-1,3798,chr14_118233232_118237030
Gm4675,14,118236232,118261199,lincRNA,1,24967,chr14_118236232_118261199
Gm32093,14,118322977,118325899,lincRNA,1,2922,chr14_118322977_118325899
1700044C05Rik,14,118365878,118398170,lincRNA,1,32292,chr14_118365878_118398170
Abcc4,14,118482692,118706219,protein_coding,-1,223527,chr14_118482692_118706219
Gm27198,14,118727794,118735145,lincRNA,-1,7351,chr14_118727794_118735145
Cldn10,14,118787908,118875489,protein_coding,1,87581,chr14_118787908_118875489
Dzip1,14,118875520,118925460,protein_coding,-1,49940,chr14_118875520_118925460
Gm49179,14,118875882,118880860,antisense,1,4978,chr14_118875882_118880860
Dnajc3,14,118937976,118981697,protein_coding,1,43721,chr14_118937976_118981697
Uggt2,14,118985039,119099430,protein_coding,-1,114391,chr14_118985039_119099430
Hs6st3,14,119138341,119869815,protein_coding,1,731474,chr14_119138341_119869815
Oxgr1,14,120019585,120042435,protein_coding,-1,22850,chr14_120019585_120042435
Gm4681,14,120089943,120195452,lincRNA,-1,105509,chr14_120089943_120195452
Mbnl2,14,120275669,120431697,protein_coding,1,156028,chr14_120275669_120431697
Gm26679,14,120384859,120388985,antisense,-1,4126,chr14_120384859_120388985
Rap2a,14,120478444,120507194,protein_coding,1,28750,chr14_120478444_120507194
Gm49008,14,120632962,120660850,lincRNA,1,27888,chr14_120632962_120660850
Gm17613,14,120749185,120750062,lincRNA,1,877,chr14_120749185_120750062
Gm41253,14,120805143,120806284,lincRNA,-1,1141,chr14_120805143_120806284
Ipo5,14,120911224,120947999,protein_coding,1,36775,chr14_120911224_120947999
Farp1,14,121035200,121283744,protein_coding,1,248544,chr14_121035200_121283744
Stk24,14,121286343,121380011,protein_coding,-1,93668,chr14_121286343_121380011
Slc15a1,14,121459621,121505252,protein_coding,-1,45631,chr14_121459621_121505252
Gm49035,14,121507013,121519130,lincRNA,-1,12117,chr14_121507013_121519130
Dock9,14,121542046,121797837,protein_coding,-1,255791,chr14_121542046_121797837
1810041H14Rik,14,121876725,121879409,antisense,-1,2684,chr14_121876725_121879409
Ubac2,14,121878620,122021034,protein_coding,1,142414,chr14_121878620_122021034
Gpr18,14,121911253,121915781,protein_coding,-1,4528,chr14_121911253_121915781
Gpr183,14,121952551,121965195,protein_coding,-1,12644,chr14_121952551_121965195
Timm8a2,14,122034674,122038420,protein_coding,1,3746,chr14_122034674_122038420
Gm49236,14,122064351,122091226,lincRNA,-1,26875,chr14_122064351_122091226
A330035P11Rik,14,122103430,122106974,lincRNA,-1,3544,chr14_122103430_122106974
Tm9sf2,14,122107038,122159604,protein_coding,1,52566,chr14_122107038_122159604
Clybl,14,122181704,122402234,protein_coding,1,220530,chr14_122181704_122402234
1700108J01Rik,14,122229905,122233654,antisense,-1,3749,chr14_122229905_122233654
Gm5089,14,122365239,122451115,antisense;processed_transcript,-1,85876,chr14_122365239_122451115
Zic5,14,122456795,122465677,protein_coding,-1,8882,chr14_122456795_122465677
Zic2,14,122475435,122479852,protein_coding,1,4417,chr14_122475435_122479852
Gm10837,14,122490586,122492121,lincRNA,1,1535,chr14_122490586_122492121
Pcca,14,122534324,122891100,protein_coding,1,356776,chr14_122534324_122891100
Ggact,14,122816223,122913757,protein_coding,-1,97534,chr14_122816223_122913757
Tmtc4,14,122918971,122984035,protein_coding,-1,65064,chr14_122918971_122984035
4930594M22Rik,14,122913030,122956343,antisense;processed_transcript,1,43313,chr14_122913030_122956343
Nalcn,14,123276634,123627144,protein_coding,-1,350510,chr14_123276634_123627144
Itgbl1,14,123659971,123975618,protein_coding,1,315647,chr14_123659971_123975618
Fgf14,14,123977907,124677127,protein_coding,-1,699220,chr14_123977907_124677127
Gm28932,14,123979210,123980619,antisense,1,1409,chr14_123979210_123980619
1700024B18Rik,14,123987635,124015684,antisense,1,28049,chr14_123987635_124015684
4930404O17Rik,14,124730320,124742797,lincRNA,-1,12477,chr14_124730320_124742797
Gm10722,9,3000922,3002330,protein_coding,1,1408,chr9_3000922_3002330
Gm10718,9,3023547,3025218,protein_coding,1,1671,chr9_3023547_3025218
Gm10717,9,3025417,3033289,protein_coding,1,7872,chr9_3025417_3033289
Gm31138,9,3199894,3215230,lincRNA,1,15336,chr9_3199894_3215230
Alkbh8,9,3335140,3391154,protein_coding,1,56014,chr9_3335140_3391154
Cwf19l2,9,3403592,3479236,protein_coding,1,75644,chr9_3403592_3479236
Gucy1a2,9,3532778,3894736,protein_coding,1,361958,chr9_3532778_3894736
Aasdhppt,9,4294793,4309471,protein_coding,-1,14678,chr9_4294793_4309471
Kbtbd3,9,4309833,4331732,protein_coding,1,21899,chr9_4309833_4331732
Msantd4,9,4376562,4386870,protein_coding,1,10308,chr9_4376562_4386870
Gria4,9,4417896,4796234,protein_coding,-1,378338,chr9_4417896_4796234
Casp1,9,5298508,5307290,protein_coding,1,8782,chr9_5298508_5307290
Casp4,9,5308828,5336783,protein_coding,1,27955,chr9_5308828_5336783
Casp12,9,5345430,5373032,protein_coding,1,27602,chr9_5345430_5373032
Pdgfd,9,6168584,6378850,protein_coding,1,210266,chr9_6168584_6378850
Dync2h1,9,6928503,7184446,protein_coding,-1,255943,chr9_6928503_7184446
Dcun1d5,9,7184520,7208205,protein_coding,1,23685,chr9_7184520_7208205
Mmp13,9,7272514,7283331,protein_coding,1,10817,chr9_7272514_7283331
Mmp12,9,7344381,7369499,protein_coding,1,25118,chr9_7344381_7369499
Mmp1b,9,7368239,7388047,protein_coding,-1,19808,chr9_7368239_7388047
Mmp3,9,7445822,7455975,protein_coding,1,10153,chr9_7445822_7455975
Mmp10,9,7502352,7510240,protein_coding,1,7888,chr9_7502352_7510240
Mmp8,9,7558456,7568485,protein_coding,1,10029,chr9_7558456_7568485
Mmp27,9,7571396,7581885,protein_coding,1,10489,chr9_7571396_7581885
Mmp20,9,7628231,7674979,protein_coding,1,46748,chr9_7628231_7674979
AV064505,9,7669429,7695631,antisense,-1,26202,chr9_7669429_7695631
Tmem123,9,7764041,7794333,protein_coding,1,30292,chr9_7764041_7794333
Birc2,9,7818227,7837064,protein_coding,-1,18837,chr9_7818227_7837064
Birc3,9,7848699,7873186,protein_coding,-1,24487,chr9_7848699_7873186
Yap1,9,7931999,8004596,protein_coding,-1,72597,chr9_7931999_8004596
Cep126,9,8076461,8134294,protein_coding,-1,57833,chr9_8076461_8134294
Trpc6,9,8544142,8680741,protein_coding,1,136599,chr9_8544142_8680741
Gm32014,9,8644073,8740988,lincRNA,-1,96915,chr9_8644073_8740988
Pgr,9,8899833,8968611,protein_coding,1,68778,chr9_8899833_8968611
Arhgap42,9,8994329,9239101,protein_coding,-1,244772,chr9_8994329_9239101
Gm16833,9,9236288,9260883,antisense,1,24595,chr9_9236288_9260883
Gm46102,9,9355737,9583307,lincRNA,-1,227570,chr9_9355737_9583307
Gm47334,9,9564087,9583564,lincRNA,1,19477,chr9_9564087_9583564
Cntn5,9,9660891,10904775,protein_coding,-1,1243884,chr9_9660891_10904775
Gm32710,9,10904345,10907818,antisense,1,3473,chr9_10904345_10907818
Gm47001,9,11102513,11119398,lincRNA,1,16885,chr9_11102513_11119398
Gm47002,9,11148600,11167495,lincRNA,1,18895,chr9_11148600_11167495
Gm47034,9,11516862,11584845,lincRNA,-1,67983,chr9_11516862_11584845
4930568E12Rik,9,13091256,13105858,lincRNA,-1,14602,chr9_13091256_13105858
Gm47051,9,13106013,13136998,lincRNA,1,30985,chr9_13106013_13136998
Jrkl,9,13242607,13245829,protein_coding,-1,3222,chr9_13242607_13245829
Ccdc82,9,13246955,13292520,protein_coding,1,45565,chr9_13246955_13292520
Maml2,9,13297957,13709388,protein_coding,1,411431,chr9_13297957_13709388
Gm17571,9,13444034,13446753,protein_coding,-1,2719,chr9_13444034_13446753
Mtmr2,9,13748410,13806481,protein_coding,1,58071,chr9_13748410_13806481
Cep57,9,13807792,13827107,protein_coding,-1,19315,chr9_13807792_13827107
Fam76b,9,13827716,13854987,protein_coding,1,27271,chr9_13827716_13854987
Gm47535,9,13915801,13920119,lincRNA,-1,4318,chr9_13915801_13920119
Gm47557,9,13945281,13981814,lincRNA,1,36533,chr9_13945281_13981814
1700019J19Rik,9,14089620,14118301,lincRNA,1,28681,chr9_14089620_14118301
Gm47559,9,14107054,14108123,lincRNA,-1,1069,chr9_14107054_14108123
Gm47564,9,14204083,14218183,lincRNA,1,14100,chr9_14204083_14218183
Gm47565,9,14249625,14250939,lincRNA,-1,1314,chr9_14249625_14250939
Gm34069,9,14259041,14263803,lincRNA,-1,4762,chr9_14259041_14263803
Sesn3,9,14275067,14333101,protein_coding,1,58034,chr9_14275067_14333101
Gm47326,9,14335612,14343063,lincRNA,1,7451,chr9_14335612_14343063
Endod1,9,14353990,14381507,protein_coding,-1,27517,chr9_14353990_14381507
Gm47319,9,14385692,14389723,lincRNA,1,4031,chr9_14385692_14389723
Kdm4d,9,14462548,14500482,protein_coding,-1,37934,chr9_14462548_14500482
Cwc15,9,14500617,14510577,protein_coding,1,9960,chr9_14500617_14510577
Amotl1,9,14541966,14645056,protein_coding,-1,103090,chr9_14541966_14645056
Piwil4,9,14696230,14740740,protein_coding,-1,44510,chr9_14696230_14740740
Gm10706,9,14704642,14719058,antisense,1,14416,chr9_14704642_14719058
Fut4,9,14748320,14752393,protein_coding,-1,4073,chr9_14748320_14752393
1700012B09Rik,9,14756587,14771030,protein_coding,-1,14443,chr9_14756587_14771030
Ankrd49,9,14779618,14784856,protein_coding,-1,5238,chr9_14779618_14784856
Mre11a,9,14784654,14837123,protein_coding,1,52469,chr9_14784654_14837123
Gm16302,9,14845613,14847835,lincRNA,1,2222,chr9_14845613_14847835
Gpr83,9,14860210,14870789,protein_coding,1,10579,chr9_14860210_14870789
Izumo1r,9,14885814,14903949,protein_coding,-1,18135,chr9_14885814_14903949
Gm47214,9,14949463,14977583,lincRNA,1,28120,chr9_14949463_14977583
Panx1,9,15002128,15045478,protein_coding,-1,43350,chr9_15002128_15045478
Hephl1,9,15051841,15112108,protein_coding,-1,60267,chr9_15051841_15112108
Vstm5,9,15239045,15259416,protein_coding,1,20371,chr9_15239045_15259416
Med17,9,15260351,15279931,protein_coding,-1,19580,chr9_15260351_15279931
4931406C07Rik,9,15283337,15306448,protein_coding,-1,23111,chr9_15283337_15306448
Taf1d,9,15306214,15316991,protein_coding,1,10777,chr9_15306214_15316991
Cep295,9,15316915,15357788,protein_coding,-1,40873,chr9_15316915_15357788
Gm16568,9,15330573,15335345,antisense,1,4772,chr9_15330573_15335345
Gm34973,9,15381367,15387425,lincRNA,1,6058,chr9_15381367_15387425
Smco4,9,15493432,15545260,protein_coding,1,51828,chr9_15493432_15545260
Deup1,9,15559864,15627933,protein_coding,-1,68069,chr9_15559864_15627933
4930540M03Rik,9,15619857,15641224,antisense,1,21367,chr9_15619857_15641224
Slc36a4,9,15709738,15743361,protein_coding,1,33623,chr9_15709738_15743361
Mtnr1b,9,15824528,15874556,protein_coding,-1,50028,chr9_15824528_15874556
Fat3,9,15910189,16501285,protein_coding,-1,591096,chr9_15910189_16501285
Chordc1,9,18292125,18317442,protein_coding,1,25317,chr9_18292125_18317442
Naalad2,9,18321951,18402995,protein_coding,-1,81044,chr9_18321951_18402995
Ubtfl1,9,18404418,18413177,protein_coding,1,8759,chr9_18404418_18413177
Mbd3l2,9,18430654,18446316,protein_coding,1,15662,chr9_18430654_18446316
Zfp558,9,18455575,18478268,protein_coding,-1,22693,chr9_18455575_18478268
Mbd3l1,9,18478359,18485298,protein_coding,1,6939,chr9_18478359_18485298
Muc16,9,18495455,18674530,protein_coding,-1,179075,chr9_18495455_18674530
Olfr24,9,18751507,18763996,protein_coding,-1,12489,chr9_18751507_18763996
Olfr839-ps1,9,19168407,19177312,protein_coding,-1,8905,chr9_19168407_19177312
Olfr845,9,19336457,19341718,protein_coding,1,5261,chr9_19336457_19341718
Olfr847,9,19373668,19378669,protein_coding,-1,5001,chr9_19373668_19378669
Zfp317,9,19622102,19649731,protein_coding,1,27629,chr9_19622102_19649731
Olfr857,9,19709433,19714930,protein_coding,1,5497,chr9_19709433_19714930
Olfr58,9,19780283,19785333,protein_coding,1,5050,chr9_19780283_19785333
Olfr859,9,19804906,19817626,protein_coding,1,12720,chr9_19804906_19817626
Gm45699,9,19842073,19872536,antisense,1,30463,chr9_19842073_19872536
Olfr860,9,19845156,19849747,protein_coding,-1,4591,chr9_19845156_19849747
Olfr77,9,19916865,19929124,protein_coding,1,12259,chr9_19916865_19929124
Olfr867,9,20050955,20057562,protein_coding,-1,6607,chr9_20050955_20057562
Olfr869,9,20129009,20138763,protein_coding,1,9754,chr9_20129009_20138763
Olfr872,9,20237119,20261643,protein_coding,1,24524,chr9_20237119_20261643
Olfr39,9,20282351,20287578,protein_coding,1,5227,chr9_20282351_20287578
Olfr873,9,20298532,20303599,protein_coding,1,5067,chr9_20298532_20303599
Olfr18,9,20312152,20336094,protein_coding,-1,23942,chr9_20312152_20336094
Zfp560,9,20345136,20385177,protein_coding,-1,40041,chr9_20345136_20385177
Zfp26,9,20428449,20460162,protein_coding,-1,31713,chr9_20428449_20460162
Zfp426,9,20468549,20492746,protein_coding,-1,24197,chr9_20468549_20492746
Zfp266,9,20495068,20521417,protein_coding,-1,26349,chr9_20495068_20521417
Zfp846,9,20581291,20605409,protein_coding,1,24118,chr9_20581291_20605409
Fbxl12os,9,20607458,20617271,antisense,1,9813,chr9_20607458_20617271
Fbxl12,9,20618118,20644767,protein_coding,-1,26649,chr9_20618118_20644767
Ubl5,9,20642878,20647140,protein_coding,1,4262,chr9_20642878_20647140
Pin1,9,20652095,20666584,protein_coding,1,14489,chr9_20652095_20666584
Olfm2,9,20667690,20746349,protein_coding,-1,78659,chr9_20667690_20746349
Col5a3,9,20770050,20815067,protein_coding,-1,45017,chr9_20770050_20815067
Rdh8,9,20818503,20826117,protein_coding,1,7614,chr9_20818503_20826117
Angptl6,9,20873808,20879727,protein_coding,-1,5919,chr9_20873808_20879727
Ppan,9,20888175,20892178,protein_coding,1,4003,chr9_20888175_20892178
Eif3g,9,20894349,20898623,protein_coding,-1,4274,chr9_20894349_20898623
Dnmt1,9,20907209,20959888,protein_coding,-1,52679,chr9_20907209_20959888
S1pr2,9,20962361,20976781,protein_coding,-1,14420,chr9_20962361_20976781
Mrpl4,9,21002738,21008839,protein_coding,1,6101,chr9_21002738_21008839
Icam1,9,21015985,21028817,protein_coding,1,12832,chr9_21015985_21028817
Gm47079,9,21028307,21032357,antisense,-1,4050,chr9_21028307_21032357
Icam4,9,21029373,21030595,protein_coding,1,1222,chr9_21029373_21030595
Icam5,9,21032073,21039036,protein_coding,1,6963,chr9_21032073_21039036
Gm26592,9,21034290,21037782,antisense,-1,3492,chr9_21034290_21037782
Zglp1,9,21062393,21067093,protein_coding,-1,4700,chr9_21062393_21067093
Gm49373,9,21062400,21073096,protein_coding,-1,10696,chr9_21062400_21073096
Gm38431,9,21067514,21091997,protein_coding,-1,24483,chr9_21067514_21091997
Raver1,9,21074158,21092008,protein_coding,-1,17850,chr9_21074158_21092008
1700084C06Rik,9,21091755,21128393,antisense,1,36638,chr9_21091755_21128393
Tyk2,9,21104068,21131243,protein_coding,-1,27175,chr9_21104068_21131243
Cdc37,9,21133222,21149982,protein_coding,-1,16760,chr9_21133222_21149982
Pde4a,9,21165714,21213248,protein_coding,1,47534,chr9_21165714_21213248
Gm16754,9,21225371,21233046,antisense,1,7675,chr9_21225371_21233046
Keap1,9,21229730,21239361,protein_coding,-1,9631,chr9_21229730_21239361
S1pr5,9,21242912,21248443,protein_coding,-1,5531,chr9_21242912_21248443
Atg4d,9,21265293,21277772,protein_coding,1,12479,chr9_21265293_21277772
Kri1,9,21273457,21287969,protein_coding,-1,14512,chr9_21273457_21287969
Cdkn2d,9,21288410,21291407,protein_coding,-1,2997,chr9_21288410_21291407
Ap1m2,9,21294275,21312337,protein_coding,-1,18062,chr9_21294275_21312337
Gm39302,9,21318079,21320617,lincRNA,-1,2538,chr9_21318079_21320617
Slc44a2,9,21320698,21355028,protein_coding,1,34330,chr9_21320698_21355028
Gm36198,9,21367396,21369184,antisense,-1,1788,chr9_21367396_21369184
Ilf3,9,21367871,21405361,protein_coding,1,37490,chr9_21367871_21405361
Gm16853,9,21405242,21411720,antisense,-1,6478,chr9_21405242_21411720
Qtrt1,9,21411837,21420274,protein_coding,1,8437,chr9_21411837_21420274
Dnm2,9,21424908,21507759,protein_coding,1,82851,chr9_21424908_21507759
Tmed1,9,21507553,21510252,protein_coding,-1,2699,chr9_21507553_21510252
AB124611,9,21526176,21545333,protein_coding,1,19157,chr9_21526176_21545333
Carm1,9,21546894,21592623,protein_coding,1,45729,chr9_21546894_21592623
Yipf2,9,21588682,21592828,protein_coding,-1,4146,chr9_21588682_21592828
Timm29,9,21592722,21595970,protein_coding,1,3248,chr9_21592722_21595970
Smarca4,9,21616169,21704230,protein_coding,1,88061,chr9_21616169_21704230
Gm26511,9,21717616,21723450,lincRNA,-1,5834,chr9_21717616_21723450
Ldlr,9,21723483,21749919,protein_coding,1,26436,chr9_21723483_21749919
Spc24,9,21755442,21760303,protein_coding,-1,4861,chr9_21755442_21760303
Kank2,9,21766784,21798744,protein_coding,-1,31960,chr9_21766784_21798744
Dock6,9,21799860,21852635,protein_coding,-1,52775,chr9_21799860_21852635
Angptl8,9,21835510,21837347,protein_coding,1,1837,chr9_21835510_21837347
Rab3d,9,21907491,21918192,protein_coding,-1,10701,chr9_21907491_21918192
Tmem205,9,21921008,21927556,protein_coding,-1,6548,chr9_21921008_21927556
Ccdc159,9,21927471,21935872,protein_coding,1,8401,chr9_21927471_21935872
Plppr2,9,21937033,21948907,protein_coding,1,11874,chr9_21937033_21948907
Swsap1,9,21955755,21958264,protein_coding,1,2509,chr9_21955755_21958264
Epor,9,21958897,21963506,protein_coding,-1,4609,chr9_21958897_21963506
Rgl3,9,21968711,21989446,protein_coding,-1,20735,chr9_21968711_21989446
Ccdc151,9,21989871,22002634,protein_coding,-1,12763,chr9_21989871_22002634
Prkcsh,9,22002806,22014222,protein_coding,1,11416,chr9_22002806_22014222
Elavl3,9,22015005,22052023,protein_coding,-1,37018,chr9_22015005_22052023
Gm49318,9,22036380,22071259,protein_coding,-1,34879,chr9_22036380_22071259
Zfp653,9,22055411,22071376,protein_coding,-1,15965,chr9_22055411_22071376
Gm16845,9,22071002,22086122,antisense,1,15120,chr9_22071002_22086122
Ecsit,9,22072246,22085438,protein_coding,-1,13192,chr9_22072246_22085438
Cnn1,9,22099216,22109630,protein_coding,1,10414,chr9_22099216_22109630
Elof1,9,22112989,22117172,protein_coding,-1,4183,chr9_22112989_22117172
Acp5,9,22126727,22135711,protein_coding,-1,8984,chr9_22126727_22135711
Pigyl,9,22156846,22158358,protein_coding,1,1512,chr9_22156846_22158358
Zfp872,9,22188090,22202123,protein_coding,1,14033,chr9_22188090_22202123
1810064F22Rik,9,22196963,22213860,antisense,-1,16897,chr9_22196963_22213860
Zfp809,9,22225714,22243354,protein_coding,1,17640,chr9_22225714_22243354
Zfp599,9,22247430,22259895,protein_coding,-1,12465,chr9_22247430_22259895
Zfp810,9,22276748,22307648,protein_coding,-1,30900,chr9_22276748_22307648
Anln,9,22332012,22389188,protein_coding,-1,57176,chr9_22332012_22389188
Rp9,9,22411047,22469743,protein_coding,-1,58696,chr9_22411047_22469743
9530077C05Rik,9,22411513,22444681,protein_coding,1,33168,chr9_22411513_22444681
Gm17545,9,22454290,22462062,protein_coding,1,7772,chr9_22454290_22462062
Bbs9,9,22475715,22888280,protein_coding,1,412565,chr9_22475715_22888280
Bmper,9,23223076,23485200,protein_coding,1,262124,chr9_23223076_23485200
Gm47663,9,23917102,23940342,lincRNA,-1,23240,chr9_23917102_23940342
Npsr1,9,24097996,24316398,protein_coding,1,218402,chr9_24097996_24316398
Gm15600,9,24296139,24300257,antisense,-1,4118,chr9_24296139_24300257
Gm10701,9,24341657,24418709,antisense,1,77052,chr9_24341657_24418709
Dpy19l1,9,24411776,24503140,protein_coding,-1,91364,chr9_24411776_24503140
Dpy19l2,9,24557047,24696293,protein_coding,-1,139246,chr9_24557047_24696293
Tbx20,9,24718138,24774303,protein_coding,-1,56165,chr9_24718138_24774303
Gm29824,9,24776467,24806024,lincRNA,1,29557,chr9_24776467_24806024
E130101E03Rik,9,24974208,24998420,lincRNA,1,24212,chr9_24974208_24998420
Gm48256,9,25057050,25062599,lincRNA,1,5549,chr9_25057050_25062599
Herpud2,9,25108132,25151820,protein_coding,-1,43688,chr9_25108132_25151820
Gm29642,9,25152114,25175561,lincRNA,1,23447,chr9_25152114_25175561
Eepd1,9,25481547,25604110,protein_coding,1,122563,chr9_25481547_25604110
Gm48362,9,25855315,25859652,lincRNA,-1,4337,chr9_25855315_25859652
Gm39312,9,26028685,26033479,lincRNA,-1,4794,chr9_26028685_26033479
Gm30313,9,26519485,26549953,lincRNA,-1,30468,chr9_26519485_26549953
Gm48393,9,26719838,26731861,lincRNA,-1,12023,chr9_26719838_26731861
B3gat1,9,26733728,26763101,protein_coding,1,29373,chr9_26733728_26763101
Glb1l2,9,26763044,26806468,protein_coding,-1,43424,chr9_26763044_26806468
Glb1l3,9,26817953,26860890,protein_coding,-1,42937,chr9_26817953_26860890
Gm1110,9,26879567,26923111,protein_coding,-1,43544,chr9_26879567_26923111
Acad8,9,26974135,26999566,protein_coding,-1,25431,chr9_26974135_26999566
Thyn1,9,26999710,27007336,protein_coding,1,7626,chr9_26999710_27007336
Vps26b,9,27007771,27030065,protein_coding,-1,22294,chr9_27007771_27030065
Ncapd3,9,27030175,27095315,protein_coding,1,65140,chr9_27030175_27095315
Jam3,9,27097384,27155421,protein_coding,-1,58037,chr9_27097384_27155421
Gm48796,9,27098551,27102343,antisense,1,3792,chr9_27098551_27102343
Gm48801,9,27199590,27203298,lincRNA,-1,3708,chr9_27199590_27203298
Gm48803,9,27291197,27293344,lincRNA,-1,2147,chr9_27291197_27293344
Igsf9b,9,27299204,27357546,protein_coding,1,58342,chr9_27299204_27357546
Spata19,9,27396800,27401785,protein_coding,1,4985,chr9_27396800_27401785
Gm48902,9,27616185,27625898,lincRNA,1,9713,chr9_27616185_27625898
Opcml,9,27790775,28925410,protein_coding,1,1134635,chr9_27790775_28925410
Gm48091,9,28794296,28954347,antisense,-1,160051,chr9_28794296_28954347
Ntm,9,28994750,29963141,protein_coding,-1,968391,chr9_28994750_29963141
Gm15520,9,29059799,29070199,antisense,1,10400,chr9_29059799_29070199
Snx19,9,30427108,30466733,protein_coding,1,39625,chr9_30427108_30466733
Gm47716,9,30625808,30632587,lincRNA,-1,6779,chr9_30625808_30632587
Gm31013,9,30722035,30781479,lincRNA,-1,59444,chr9_30722035_30781479
Adamts15,9,30899155,30922452,protein_coding,-1,23297,chr9_30899155_30922452
Adamts8,9,30942562,30963838,protein_coding,1,21276,chr9_30942562_30963838
Gm29724,9,30954087,31031205,antisense,-1,77118,chr9_30954087_31031205
Zbtb44,9,31030644,31075885,protein_coding,1,45241,chr9_31030644_31075885
Gm17508,9,31080617,31082475,lincRNA,-1,1858,chr9_31080617_31082475
St14,9,31089402,31131853,protein_coding,-1,42451,chr9_31089402_31131853
Aplp2,9,31149557,31211815,protein_coding,-1,62258,chr9_31149557_31211815
Prdm10,9,31280538,31381723,protein_coding,1,101185,chr9_31280538_31381723
Nfrkb,9,31386192,31421333,protein_coding,1,35141,chr9_31386192_31421333
Tmem45b,9,31426196,31464462,protein_coding,-1,38266,chr9_31426196_31464462
Gm31408,9,31559609,31579634,lincRNA,1,20025,chr9_31559609_31579634
Barx2,9,31846044,31913462,protein_coding,-1,67418,chr9_31846044_31913462
Gm31497,9,31905993,31911198,antisense,1,5205,chr9_31905993_31911198
Gm47465,9,31947018,32005460,lincRNA,-1,58442,chr9_31947018_32005460
Arhgap32,9,32116136,32268446,protein_coding,1,152310,chr9_32116136_32268446
Kcnj5,9,32314707,32344350,protein_coding,-1,29643,chr9_32314707_32344350
Gm39317,9,32348682,32361738,lincRNA,1,13056,chr9_32348682_32361738
Kcnj1,9,32372493,32399197,protein_coding,1,26704,chr9_32372493_32399197
Fli1,9,32422204,32542861,protein_coding,-1,120657,chr9_32422204_32542861
Gm27201,9,32508413,32516958,antisense,1,8545,chr9_32508413_32516958
Gm47680,9,32613452,32629557,lincRNA,1,16105,chr9_32613452_32629557
Ets1,9,32636221,32757820,protein_coding,1,121599,chr9_32636221_32757820
Gm27240,9,32709652,32711171,antisense,-1,1519,chr9_32709652_32711171
Gm3331,9,32813734,32834104,lincRNA,1,20370,chr9_32813734_32834104
Gm27162,9,32904937,32928966,lincRNA,-1,24029,chr9_32904937_32928966
Gm27166,9,33031791,33090799,lincRNA,1,59008,chr9_33031791_33090799
Gm32171,9,33151292,33262516,lincRNA,1,111224,chr9_33151292_33262516
Gm47775,9,33296244,33308803,lincRNA,1,12559,chr9_33296244_33308803
Gm47777,9,33482183,33492014,lincRNA,-1,9831,chr9_33482183_33492014
Gm47785,9,33901917,33921449,lincRNA,1,19532,chr9_33901917_33921449
Gm27164,9,33942310,34007173,lincRNA,1,64863,chr9_33942310_34007173
7630403G23Rik,9,34042369,34059019,lincRNA,1,16650,chr9_34042369_34059019
Gm47858,9,34459181,34477056,lincRNA,1,17875,chr9_34459181_34477056
Kirrel3,9,34485894,35036716,protein_coding,1,550822,chr9_34485894_35036716
Kirrel3os,9,34918233,34929509,antisense,-1,11276,chr9_34918233_34929509
St3gal4,9,35046576,35119268,protein_coding,-1,72692,chr9_35046576_35119268
Dcps,9,35124408,35176061,protein_coding,-1,51653,chr9_35124408_35176061
Tirap,9,35184551,35200291,protein_coding,-1,15740,chr9_35184551_35200291
Gm39318,9,35188663,35193817,antisense,1,5154,chr9_35188663_35193817
Srpr,9,35200175,35247973,protein_coding,1,47798,chr9_35200175_35247973
Foxred1,9,35204206,35211055,protein_coding,-1,6849,chr9_35204206_35211055
Fam118b,9,35216965,35267805,protein_coding,-1,50840,chr9_35216965_35267805
Rpusd4,9,35267865,35277731,protein_coding,1,9866,chr9_35267865_35277731
4933422A05Rik,9,35281105,35285423,lincRNA,1,4318,chr9_35281105_35285423
Gm33838,9,35301722,35307599,lincRNA,-1,5877,chr9_35301722_35307599
Cdon,9,35421128,35507652,protein_coding,1,86524,chr9_35421128_35507652
Gm1113,9,35509222,35518269,protein_coding,-1,9047,chr9_35509222_35518269
Ddx25,9,35536647,35558528,protein_coding,-1,21881,chr9_35536647_35558528
Pus3,9,35558595,35567401,protein_coding,1,8806,chr9_35558595_35567401
Hyls1,9,35560820,35570398,protein_coding,-1,9578,chr9_35560820_35570398
Pate2,9,35570284,35690318,protein_coding,1,120034,chr9_35570284_35690318
Pate4,9,35607093,35611941,protein_coding,-1,4848,chr9_35607093_35611941
Pate1,9,35685079,35687390,protein_coding,-1,2311,chr9_35685079_35687390
Gm27235,9,35776524,35790101,protein_coding,-1,13577,chr9_35776524_35790101
Gm27187,9,35960687,36011558,lincRNA,-1,50871,chr9_35960687_36011558
Gm5916,9,36119934,36128779,protein_coding,-1,8845,chr9_36119934_36128779
Gm3434,9,36134246,36135630,lincRNA,-1,1384,chr9_36134246_36135630
Acrv1,9,36693220,36698843,protein_coding,1,5623,chr9_36693220_36698843
Chek1,9,36708482,36727065,protein_coding,-1,18583,chr9_36708482_36727065
Stt3a,9,36729344,36767679,protein_coding,-1,38335,chr9_36729344_36767679
Gm26787,9,36767887,36782677,antisense,1,14790,chr9_36767887_36782677
Ei24,9,36779159,36797393,protein_coding,-1,18234,chr9_36779159_36797393
Fez1,9,36821864,36878924,protein_coding,1,57060,chr9_36821864_36878924
Pknox2,9,36890982,37147407,protein_coding,-1,256425,chr9_36890982_37147407
Gm3896,9,37015758,37020671,antisense,1,4913,chr9_37015758_37020671
Gm48716,9,37118656,37120064,antisense,1,1408,chr9_37118656_37120064
Tmem218,9,37208223,37224700,protein_coding,1,16477,chr9_37208223_37224700
Slc37a2,9,37227585,37255738,protein_coding,-1,28153,chr9_37227585_37255738
Gm47633,9,37264093,37264659,lincRNA,-1,566,chr9_37264093_37264659
Ccdc15,9,37275835,37348432,protein_coding,-1,72597,chr9_37275835_37348432
Gm34885,9,37312136,37324436,antisense,1,12300,chr9_37312136_37324436
Hepacam,9,37367351,37386575,protein_coding,1,19224,chr9_37367351_37386575
Robo4,9,37401897,37415115,protein_coding,1,13218,chr9_37401897_37415115
Robo3,9,37415669,37433246,protein_coding,-1,17577,chr9_37415669_37433246
Msantd2,9,37489021,37524625,protein_coding,1,35604,chr9_37489021_37524625
Esam,9,37528078,37538319,protein_coding,1,10241,chr9_37528078_37538319
Vsig2,9,37539255,37544205,protein_coding,1,4950,chr9_37539255_37544205
Nrgn,9,37544492,37552904,protein_coding,-1,8412,chr9_37544492_37552904
Siae,9,37555698,37649655,protein_coding,1,93957,chr9_37555698_37649655
Spa17,9,37603290,37613722,protein_coding,-1,10432,chr9_37603290_37613722
Tbrg1,9,37648763,37657312,protein_coding,-1,8549,chr9_37648763_37657312
Panx3,9,37659902,37669235,protein_coding,-1,9333,chr9_37659902_37669235
Olfr160,9,37708964,37716250,protein_coding,-1,7286,chr9_37708964_37716250
Olfr875,9,37771857,37774459,protein_coding,1,2602,chr9_37771857_37774459
Olfr876,9,37803031,37808144,protein_coding,1,5113,chr9_37803031_37808144
Olfr877,9,37854269,37857320,protein_coding,1,3051,chr9_37854269_37857320
Olfr145,9,37896724,37903519,protein_coding,1,6795,chr9_37896724_37903519
Olfr878,9,37917840,37922474,protein_coding,1,4634,chr9_37917840_37922474
Olfr881,9,37991825,37996408,protein_coding,1,4583,chr9_37991825_37996408
Olfr889,9,38115198,38121245,protein_coding,1,6047,chr9_38115198_38121245
Olfr890,9,38142517,38148375,protein_coding,1,5858,chr9_38142517_38148375
Olfr893,9,38208365,38211598,protein_coding,1,3233,chr9_38208365_38211598
Olfr25,9,38329060,38335889,protein_coding,1,6829,chr9_38329060_38335889
Olfr898,9,38348411,38352919,protein_coding,1,4508,chr9_38348411_38352919
Olfr250,9,38366896,38371355,protein_coding,1,4459,chr9_38366896_38371355
Olfr251,9,38377086,38382474,protein_coding,1,5388,chr9_38377086_38382474
Olfr904,9,38463144,38468995,protein_coding,1,5851,chr9_38463144_38468995
Olfr905,9,38471107,38477013,protein_coding,1,5906,chr9_38471107_38477013
Olfr914,9,38605102,38610978,protein_coding,1,5876,chr9_38605102_38610978
Olfr916,9,38655052,38659875,protein_coding,-1,4823,chr9_38655052_38659875
Vwa5a,9,38718268,38743337,protein_coding,1,25069,chr9_38718268_38743337
Olfr920,9,38752299,38760117,protein_coding,1,7818,chr9_38752299_38760117
Olfr921,9,38773068,38779021,protein_coding,1,5953,chr9_38773068_38779021
Olfr924,9,38844449,38851495,protein_coding,1,7046,chr9_38844449_38851495
Olfr27,9,39128131,39145072,protein_coding,1,16941,chr9_39128131_39145072
Olfr943,9,39166304,39192350,protein_coding,1,26046,chr9_39166304_39192350
Olfr1537,9,39234412,39249994,protein_coding,-1,15582,chr9_39234412_39249994
Olfr945,9,39256869,39276818,protein_coding,-1,19949,chr9_39256869_39276818
Olfr44,9,39481786,39493995,protein_coding,-1,12209,chr9_39481786_39493995
Olfr959,9,39569383,39575569,protein_coding,-1,6186,chr9_39569383_39575569
AW551984,9,39587396,39604403,protein_coding,-1,17007,chr9_39587396_39604403
Olfr961,9,39645085,39649556,protein_coding,1,4471,chr9_39645085_39649556
Olfr149,9,39700518,39707117,protein_coding,-1,6599,chr9_39700518_39707117
Olfr967,9,39746249,39751493,protein_coding,1,5244,chr9_39746249_39751493
Olfr968,9,39768776,39783253,protein_coding,-1,14477,chr9_39768776_39783253
Olfr971,9,39836876,39841281,protein_coding,1,4405,chr9_39836876_39841281
Olfr972,9,39866422,39874651,protein_coding,1,8229,chr9_39866422_39874651
Olfr975,9,39948131,39952046,protein_coding,-1,3915,chr9_39948131_39952046
Olfr976,9,39954139,39961133,protein_coding,-1,6994,chr9_39954139_39961133
Olfr979,9,39998003,40003465,protein_coding,-1,5462,chr9_39998003_40003465
Olfr981,9,40021464,40030377,protein_coding,1,8913,chr9_40021464_40030377
Olfr983,9,40086908,40093595,protein_coding,-1,6687,chr9_40086908_40093595
Olfr984,9,40096515,40114206,protein_coding,-1,17691,chr9_40096515_40114206
Olfr985,9,40126308,40130184,protein_coding,-1,3876,chr9_40126308_40130184
Olfr986,9,40180920,40190134,protein_coding,1,9214,chr9_40180920_40190134
Zfp202,9,40192316,40213604,protein_coding,1,21288,chr9_40192316_40213604
Scn3b,9,40269217,40291618,protein_coding,1,22401,chr9_40269217_40291618
Gramd1b,9,40293233,40531383,protein_coding,-1,238150,chr9_40293233_40531383
1700110K17Rik,9,40323426,40343564,antisense,1,20138,chr9_40323426_40343564
Gm17540,9,40531155,40533620,lincRNA,1,2465,chr9_40531155_40533620
Gm35177,9,40547360,40561393,lincRNA,1,14033,chr9_40547360_40561393
Gm48277,9,40555086,40560929,lincRNA,-1,5843,chr9_40555086_40560929
Gm48284,9,40606416,40616386,lincRNA,-1,9970,chr9_40606416_40616386
Clmp,9,40685962,40785319,protein_coding,1,99357,chr9_40685962_40785319
Gm16095,9,40718906,40719986,antisense,-1,1080,chr9_40718906_40719986
Gm48293,9,40747281,40762673,antisense,-1,15392,chr9_40747281_40762673
Hspa8,9,40800984,40810087,protein_coding,1,9103,chr9_40800984_40810087
Bsx,9,40874127,40880057,protein_coding,1,5930,chr9_40874127_40880057
Jhy,9,40894849,40964118,protein_coding,-1,69269,chr9_40894849_40964118
Crtam,9,40969691,41004628,protein_coding,-1,34937,chr9_40969691_41004628
Ubash3b,9,41011098,41161697,protein_coding,-1,150599,chr9_41011098_41161697
Gm35657,9,41159424,41188862,lincRNA,1,29438,chr9_41159424_41188862
1700063D05Rik,9,41192446,41217990,lincRNA,1,25544,chr9_41192446_41217990
Gm48742,9,41405374,41532087,lincRNA,-1,126713,chr9_41405374_41532087
Gm48740,9,41551506,41559259,lincRNA,-1,7753,chr9_41551506_41559259
Gm48784,9,41659164,41675054,lincRNA,-1,15890,chr9_41659164_41675054
Gm35835,9,41680147,41737398,lincRNA,-1,57251,chr9_41680147_41737398
Gm40513,9,41886512,41890604,lincRNA,-1,4092,chr9_41886512_41890604
Sorl1,9,41964720,42124297,protein_coding,-1,159577,chr9_41964720_42124297
Gm16214,9,42022615,42034113,antisense,1,11498,chr9_42022615_42034113
Gm39321,9,42141993,42146506,lincRNA,1,4513,chr9_42141993_42146506
4930546K05Rik,9,42176592,42209231,lincRNA,-1,32639,chr9_42176592_42209231
Sc5d,9,42251595,42264256,protein_coding,-1,12661,chr9_42251595_42264256
Gm36435,9,42274764,42279878,lincRNA,-1,5114,chr9_42274764_42279878
Tecta,9,42329619,42399929,protein_coding,-1,70310,chr9_42329619_42399929
Gm47629,9,42385862,42390886,antisense,1,5024,chr9_42385862_42390886
Tbcel,9,42412316,42507809,protein_coding,-1,95493,chr9_42412316_42507809
Gm16322,9,42474555,42505662,antisense,1,31107,chr9_42474555_42505662
Grik4,9,42518135,42944493,protein_coding,-1,426358,chr9_42518135_42944493
Arhgef12,9,42963842,43107239,protein_coding,-1,143397,chr9_42963842_43107239
Pou2f3,9,43123939,43210369,protein_coding,-1,86430,chr9_43123939_43210369
Oaf,9,43221235,43239911,protein_coding,-1,18676,chr9_43221235_43239911
D630033O11Rik,9,43243599,43280076,lincRNA,1,36477,chr9_43243599_43280076
Trim29,9,43310848,43336115,protein_coding,1,25267,chr9_43310848_43336115
Gm36799,9,43356273,43379050,lincRNA,1,22777,chr9_43356273_43379050
Gm36855,9,43506551,43521004,lincRNA,-1,14453,chr9_43506551_43521004
Gm29961,9,43642082,43645157,lincRNA,-1,3075,chr9_43642082_43645157
Nectin1,9,43743984,43832658,protein_coding,1,88674,chr9_43743984_43832658
Gm30373,9,43924751,43970253,lincRNA,-1,45502,chr9_43924751_43970253
Gm10688,9,43978958,43979477,lincRNA,-1,519,chr9_43978958_43979477
Gm39323,9,44011735,44041059,lincRNA,-1,29324,chr9_44011735_44041059
Thy1,9,44043384,44048579,protein_coding,1,5195,chr9_44043384_44048579
Gm49380,9,44066327,44113500,protein_coding,-1,47173,chr9_44066327_44113500
Usp2,9,44067021,44095627,protein_coding,1,28606,chr9_44067021_44095627
Rnf26,9,44095631,44113517,protein_coding,-1,17886,chr9_44095631_44113517
Mfrp,9,44101729,44109187,protein_coding,1,7458,chr9_44101729_44109187
Gm26737,9,44112923,44121960,antisense,1,9037,chr9_44112923_44121960
Gm10687,9,44122186,44134485,antisense,-1,12299,chr9_44122186_44134485
Mcam,9,44134469,44142727,protein_coding,1,8258,chr9_44134469_44142727
Cbl,9,44142976,44234049,protein_coding,-1,91073,chr9_44142976_44234049
Ccdc153,9,44240676,44247306,protein_coding,1,6630,chr9_44240676_44247306
Pdzd3,9,44247307,44251471,protein_coding,-1,4164,chr9_44247307_44251471
Nlrx1,9,44252717,44268599,protein_coding,-1,15882,chr9_44252717_44268599
Abcg4,9,44273188,44288615,protein_coding,-1,15427,chr9_44273188_44288615
Gm48604,9,44290044,44292463,lincRNA,-1,2419,chr9_44290044_44292463
Hinfp,9,44292440,44305671,protein_coding,-1,13231,chr9_44292440_44305671
C2cd2l,9,44309237,44320285,protein_coding,-1,11048,chr9_44309237_44320285
Dpagt1,9,44326019,44333900,protein_coding,1,7881,chr9_44326019_44333900
Gm48853,9,44332684,44334386,antisense,-1,1702,chr9_44332684_44334386
Hmbs,9,44336339,44344228,protein_coding,-1,7889,chr9_44336339_44344228
Vps11,9,44347749,44361670,protein_coding,-1,13921,chr9_44347749_44361670
Hyou1,9,44379490,44392369,protein_coding,1,12879,chr9_44379490_44392369
Slc37a4,9,44396852,44402968,protein_coding,1,6116,chr9_44396852_44402968
Trappc4,9,44403698,44407600,protein_coding,-1,3902,chr9_44403698_44407600
Rps25,9,44407139,44410427,protein_coding,1,3288,chr9_44407139_44410427
Ccdc84,9,44410159,44418569,protein_coding,-1,8410,chr9_44410159_44418569
Gm47186,9,44419938,44423391,lincRNA,-1,3453,chr9_44419938_44423391
Foxr1,9,44433773,44441136,protein_coding,-1,7363,chr9_44433773_44441136
C030014I23Rik,9,44468344,44482180,lincRNA,1,13836,chr9_44468344_44482180
Gm47204,9,44477928,44479759,lincRNA,-1,1831,chr9_44477928_44479759
Bcl9l,9,44482825,44511896,protein_coding,1,29071,chr9_44482825_44511896
Cxcr5,9,44511787,44561877,protein_coding,-1,50090,chr9_44511787_44561877
Gm47230,9,44579608,44584652,lincRNA,1,5044,chr9_44579608_44584652
Gm47231,9,44596563,44598018,lincRNA,-1,1455,chr9_44596563_44598018
Gm47232,9,44598855,44599720,lincRNA,-1,865,chr9_44598855_44599720
Ddx6,9,44604892,44640731,protein_coding,1,35839,chr9_44604892_44640731
BC049987,9,44670453,44672238,lincRNA,-1,1785,chr9_44670453_44672238
Treh,9,44673233,44686305,protein_coding,1,13072,chr9_44673233_44686305
Phldb1,9,44686304,44735198,protein_coding,-1,48894,chr9_44686304_44735198
Arcn1,9,44741564,44767845,protein_coding,-1,26281,chr9_44741564_44767845
Ift46,9,44767908,44793447,protein_coding,1,25539,chr9_44767908_44793447
Tmem25,9,44793769,44799307,protein_coding,-1,5538,chr9_44793769_44799307
Gm48702,9,44799258,44802838,antisense,1,3580,chr9_44799258_44802838
Ttc36,9,44799397,44803072,protein_coding,-1,3675,chr9_44799397_44803072
Kmt2a,9,44803355,44881296,protein_coding,-1,77941,chr9_44803355_44881296
Atp5l,9,44912557,44920742,protein_coding,-1,8185,chr9_44912557_44920742
Gm30934,9,44920199,44921489,antisense,1,1290,chr9_44920199_44921489
Ube4a,9,44923127,44965600,protein_coding,-1,42473,chr9_44923127_44965600
Cd3g,9,44969572,44980431,protein_coding,-1,10859,chr9_44969572_44980431
Cd3d,9,44981786,44987339,protein_coding,1,5553,chr9_44981786_44987339
Cd3e,9,44998740,45009627,protein_coding,-1,10887,chr9_44998740_45009627
Gm48719,9,44999429,45002985,antisense,1,3556,chr9_44999429_45002985
Mpzl2,9,45039799,45054015,protein_coding,1,14216,chr9_45039799_45054015
Mpzl3,9,45055186,45077436,protein_coding,1,22250,chr9_45055186_45077436
Jaml,9,45079183,45108534,protein_coding,1,29351,chr9_45079183_45108534
Gm10684,9,45107176,45135606,lincRNA,-1,28430,chr9_45107176_45135606
Scn2b,9,45117782,45130070,protein_coding,1,12288,chr9_45117782_45130070
Scn4b,9,45138395,45154152,protein_coding,1,15757,chr9_45138395_45154152
Tmprss4,9,45172726,45204092,protein_coding,-1,31366,chr9_45172726_45204092
Gm17099,9,45172997,45175161,antisense,1,2164,chr9_45172997_45175161
BC049352,9,45182007,45250020,protein_coding,1,68013,chr9_45182007_45250020
Il10ra,9,45253837,45269149,protein_coding,-1,15312,chr9_45253837_45269149
Tmprss13,9,45319100,45347581,protein_coding,1,28481,chr9_45319100_45347581
Fxyd6,9,45370185,45396159,protein_coding,1,25974,chr9_45370185_45396159
Fxyd2,9,45399669,45410278,protein_coding,1,10609,chr9_45399669_45410278
4833428L15Rik,9,45416626,45431730,antisense,-1,15104,chr9_45416626_45431730
Dscaml1,9,45426628,45753712,protein_coding,1,327084,chr9_45426628_45753712
Cep164,9,45766946,45828691,protein_coding,-1,61745,chr9_45766946_45828691
Bace1,9,45838580,45864399,protein_coding,1,25819,chr9_45838580_45864399
Gm16536,9,45856769,45858357,antisense,-1,1588,chr9_45856769_45858357
Rnf214,9,45863425,45906911,protein_coding,-1,43486,chr9_45863425_45906911
Pcsk7,9,45906497,45929726,protein_coding,1,23229,chr9_45906497_45929726
Tagln,9,45929619,45936058,protein_coding,-1,6439,chr9_45929619_45936058
Gm48529,9,45930112,45933738,antisense,1,3626,chr9_45930112_45933738
Sidt2,9,45937857,45955258,protein_coding,-1,17401,chr9_45937857_45955258
A830035O19Rik,9,45954101,45955998,antisense,1,1897,chr9_45954101_45955998
Pafah1b2,9,45962859,46012690,protein_coding,-1,49831,chr9_45962859_46012690
Sik3,9,46012820,46224194,protein_coding,1,211374,chr9_46012820_46224194
Apoa1,9,46228580,46230466,protein_coding,1,1886,chr9_46228580_46230466
Apoc3,9,46232933,46235636,protein_coding,-1,2703,chr9_46232933_46235636
Zpr1,9,46273064,46282643,protein_coding,1,9579,chr9_46273064_46282643
Bud13,9,46283008,46299110,protein_coding,1,16102,chr9_46283008_46299110
4931429L15Rik,9,46303361,46319986,protein_coding,-1,16625,chr9_46303361_46319986
Gm39329,9,46319038,46331798,antisense,1,12760,chr9_46319038_46331798
Gm31374,9,46337931,46384755,lincRNA,1,46824,chr9_46337931_46384755
Gm47144,9,46486104,46505073,lincRNA,-1,18969,chr9_46486104_46505073
Gm31432,9,46532757,46543376,lincRNA,1,10619,chr9_46532757_46543376
Gm48945,9,46607255,46612726,lincRNA,1,5471,chr9_46607255_46612726
Gm31557,9,46666273,46674844,lincRNA,1,8571,chr9_46666273_46674844
Gm31614,9,46830339,46837616,lincRNA,1,7277,chr9_46830339_46837616
2900052N01Rik,9,46913493,46927366,lincRNA,1,13873,chr9_46913493_46927366
Gm47153,9,46960235,46979053,lincRNA,-1,18818,chr9_46960235_46979053
Gm4791,9,46998741,47003860,protein_coding,1,5119,chr9_46998741_47003860
Gm31698,9,47085947,47227095,lincRNA,-1,141148,chr9_47085947_47227095
Gm31816,9,47242326,47368649,lincRNA,-1,126323,chr9_47242326_47368649
Cadm1,9,47530173,47858115,protein_coding,1,327942,chr9_47530173_47858115
A730065G17Rik,9,48049516,48071634,lincRNA,1,22118,chr9_48049516_48071634
Gm40518,9,48132504,48158965,lincRNA,-1,26461,chr9_48132504_48158965
Nxpe4,9,48162023,48400025,protein_coding,1,238002,chr9_48162023_48400025
Nxpe2,9,48318006,48353454,protein_coding,-1,35448,chr9_48318006_48353454
Rexo2,9,48468512,48480623,protein_coding,-1,12111,chr9_48468512_48480623
Rbm7,9,48488701,48495299,protein_coding,-1,6598,chr9_48488701_48495299
Gm5617,9,48495442,48495972,protein_coding,1,530,chr9_48495442_48495972
Nnmt,9,48591877,48605153,protein_coding,-1,13276,chr9_48591877_48605153
Zbtb16,9,48654297,48836222,protein_coding,-1,181925,chr9_48654297_48836222
Gm32335,9,48896451,48905982,antisense,1,9531,chr9_48896451_48905982
Htr3a,9,48899213,48911099,protein_coding,-1,11886,chr9_48899213_48911099
Htr3b,9,48935008,48964990,protein_coding,-1,29982,chr9_48935008_48964990
Usp28,9,48985375,49042517,protein_coding,1,57142,chr9_48985375_49042517
1700042D02Rik,9,49051335,49055465,lincRNA,-1,4130,chr9_49051335_49055465
Zw10,9,49055613,49078775,protein_coding,1,23162,chr9_49055613_49078775
Tmprss5,9,49081260,49117587,protein_coding,1,36327,chr9_49081260_49117587
Gm4894,9,49250531,49280594,protein_coding,1,30063,chr9_49250531_49280594
Drd2,9,49340627,49408177,protein_coding,1,67550,chr9_49340627_49408177
Ankk1,9,49415194,49427021,protein_coding,-1,11827,chr9_49415194_49427021
Ttc12,9,49436963,49486225,protein_coding,-1,49262,chr9_49436963_49486225
Ncam1,9,49502136,49798925,protein_coding,-1,296789,chr9_49502136_49798925
Gm11149,9,49518288,49572591,antisense,1,54303,chr9_49518288_49572591
2310003N18Rik,9,50232523,50233182,lincRNA,-1,659,chr9_50232523_50233182
Rpl10-ps3,9,50344201,50344968,protein_coding,-1,767,chr9_50344201_50344968
Plet1os,9,50488795,50507823,antisense,-1,19028,chr9_50488795_50507823
Plet1,9,50494525,50505482,protein_coding,1,10957,chr9_50494525_50505482
Pts,9,50521617,50528724,protein_coding,-1,7107,chr9_50521617_50528724
Gm47077,9,50528767,50533752,antisense,1,4985,chr9_50528767_50533752
Bco2,9,50533087,50555181,protein_coding,-1,22094,chr9_50533087_50555181
Il18,9,50554827,50581840,protein_coding,1,27013,chr9_50554827_50581840
Tex12,9,50556819,50561325,protein_coding,-1,4506,chr9_50556819_50561325
Sdhd,9,50596357,50603812,protein_coding,-1,7455,chr9_50596357_50603812
Timm8b,9,50603910,50605320,protein_coding,1,1410,chr9_50603910_50605320
Pih1d2,9,50617321,50625000,protein_coding,1,7679,chr9_50617321_50625000
Dlat,9,50634633,50659780,protein_coding,-1,25147,chr9_50634633_50659780
Dixdc1,9,50662752,50739517,protein_coding,-1,76765,chr9_50662752_50739517
2310030G06Rik,9,50739691,50746536,protein_coding,-1,6845,chr9_50739691_50746536
Hspb2,9,50751078,50752354,protein_coding,-1,1276,chr9_50751078_50752354
Cryab,9,50751325,50756636,protein_coding,1,5311,chr9_50751325_50756636
1110032A03Rik,9,50762828,50775520,protein_coding,-1,12692,chr9_50762828_50775520
Fdxacb1,9,50768236,50773348,protein_coding,1,5112,chr9_50768236_50773348
Alg9,9,50775019,50843542,protein_coding,1,68523,chr9_50775019_50843542
Ppp2r1b,9,50845301,50894229,protein_coding,1,48928,chr9_50845301_50894229
Sik2,9,50892801,51009073,protein_coding,-1,116272,chr9_50892801_51009073
Layn,9,51054640,51077094,protein_coding,-1,22454,chr9_51054640_51077094
Btg4,9,51060901,51119875,protein_coding,1,58974,chr9_51060901_51119875
4833427G06Rik,9,51081115,51102078,protein_coding,-1,20963,chr9_51081115_51102078
Gm32742,9,51130307,51165517,protein_coding,-1,35210,chr9_51130307_51165517
Pou2af1,9,51213708,51240080,protein_coding,1,26372,chr9_51213708_51240080
Colca2,9,51270258,51279651,protein_coding,-1,9393,chr9_51270258_51279651
2010007H06Rik,9,51278513,51284210,antisense,1,5697,chr9_51278513_51284210
1810046K07Rik,9,51289686,51328924,protein_coding,-1,39238,chr9_51289686_51328924
Gm47854,9,51621425,51655127,lincRNA,-1,33702,chr9_51621425_51655127
Arhgap20,9,51765337,51853856,protein_coding,1,88519,chr9_51765337_51853856
Arhgap20os,9,51832814,51875886,antisense,-1,43072,chr9_51832814_51875886
Gm6980,9,51913477,51931661,lincRNA,-1,18184,chr9_51913477_51931661
4933407I05Rik,9,51914427,51927003,lincRNA,1,12576,chr9_51914427_51927003
Fdx1,9,51943306,51963556,protein_coding,-1,20250,chr9_51943306_51963556
Rdx,9,52047173,52100463,protein_coding,1,53290,chr9_52047173_52100463
Zc3h12c,9,52111344,52168572,protein_coding,-1,57228,chr9_52111344_52168572
Gm47957,9,52321896,52349311,lincRNA,-1,27415,chr9_52321896_52349311
Gm47960,9,52399274,52401968,lincRNA,-1,2694,chr9_52399274_52401968
AI593442,9,52673042,52679780,protein_coding,-1,6738,chr9_52673042_52679780
Gm1715,9,52679863,52798774,lincRNA,1,118911,chr9_52679863_52798774
Ddx10,9,53098635,53248053,protein_coding,-1,149418,chr9_53098635_53248053
4930510E17Rik,9,53264615,53280985,lincRNA,1,16370,chr9_53264615_53280985
Exph5,9,53301670,53377514,protein_coding,1,75844,chr9_53301670_53377514
4930550C14Rik,9,53402325,53434402,protein_coding,1,32077,chr9_53402325_53434402
Atm,9,53439149,53536740,protein_coding,-1,97591,chr9_53439149_53536740
Npat,9,53537047,53574342,protein_coding,1,37295,chr9_53537047_53574342
Acat1,9,53580522,53610382,protein_coding,-1,29860,chr9_53580522_53610382
Cul5,9,53614582,53670014,protein_coding,-1,55432,chr9_53614582_53670014
Gm16124,9,53667246,53681265,antisense,1,14019,chr9_53667246_53681265
Rab39,9,53684110,53706232,protein_coding,-1,22122,chr9_53684110_53706232
Slc35f2,9,53771538,53818154,protein_coding,1,46616,chr9_53771538_53818154
Sln,9,53850164,53854560,protein_coding,1,4396,chr9_53850164_53854560
Elmod1,9,53911457,53975301,protein_coding,-1,63844,chr9_53911457_53975301
Tnfaip8l3,9,54023405,54068388,protein_coding,-1,44983,chr9_54023405_54068388
Gm48346,9,54043312,54047798,lincRNA,1,4486,chr9_54043312_54047798
Cyp19a1,9,54165937,54268110,protein_coding,-1,102173,chr9_54165937_54268110
Gldnos,9,54268578,54301570,antisense,-1,32992,chr9_54268578_54301570
Gldn,9,54286486,54341786,protein_coding,1,55300,chr9_54286486_54341786
Dmxl2,9,54365158,54501626,protein_coding,-1,136468,chr9_54365158_54501626
Sh2d7,9,54534146,54545020,protein_coding,1,10874,chr9_54534146_54545020
Cib2,9,54544794,54560218,protein_coding,-1,15424,chr9_54544794_54560218
Idh3a,9,54586334,54604661,protein_coding,1,18327,chr9_54586334_54604661
Acsbg1,9,54604877,54661870,protein_coding,-1,56993,chr9_54604877_54661870
Dnaja4,9,54698873,54716315,protein_coding,1,17442,chr9_54698873_54716315
Wdr61,9,54714735,54734519,protein_coding,-1,19784,chr9_54714735_54734519
Crabp1,9,54764748,54773110,protein_coding,1,8362,chr9_54764748_54773110
Ireb2,9,54863789,54912530,protein_coding,1,48741,chr9_54863789_54912530
Hykk,9,54917283,54949924,protein_coding,1,32641,chr9_54917283_54949924
AY074887,9,54950230,54950998,protein_coding,-1,768,chr9_54950230_54950998
Psma4,9,54950790,54958030,protein_coding,1,7240,chr9_54950790_54958030
Chrna5,9,54980880,55007779,protein_coding,1,26899,chr9_54980880_55007779
Chrna3,9,55010111,55026562,protein_coding,-1,16451,chr9_55010111_55026562
Chrnb4,9,55028154,55048779,protein_coding,-1,20625,chr9_55028154_55048779
Gm47887,9,55064927,55067463,lincRNA,-1,2536,chr9_55064927_55067463
Ube2q2,9,55148854,55207529,protein_coding,1,58675,chr9_55148854_55207529
Fbxo22,9,55208925,55224433,protein_coding,1,15508,chr9_55208925_55224433
Nrg4,9,55220222,55326844,protein_coding,-1,106622,chr9_55220222_55326844
Tmem266,9,55326913,55438345,protein_coding,1,111432,chr9_55326913_55438345
Etfa,9,55454508,55512243,protein_coding,-1,57735,chr9_55454508_55512243
Isl2,9,55538672,55546180,protein_coding,1,7508,chr9_55538672_55546180
Scaper,9,55549879,55938119,protein_coding,-1,388240,chr9_55549879_55938119
4930563M21Rik,9,55962589,56010550,protein_coding,-1,47961,chr9_55962589_56010550
Rcn2,9,56041845,56061882,protein_coding,1,20037,chr9_56041845_56061882
Pstpip1,9,56089962,56128888,protein_coding,1,38926,chr9_56089962_56128888
Tspan3,9,56131725,56165477,protein_coding,-1,33752,chr9_56131725_56165477
Peak1,9,56201126,56418067,protein_coding,-1,216941,chr9_56201126_56418067
Peak1os,9,56257890,56267780,antisense,1,9890,chr9_56257890_56267780
Hmg20a,9,56418609,56496936,protein_coding,1,78327,chr9_56418609_56496936
Gm26868,9,56606693,56614473,lincRNA,1,7780,chr9_56606693_56614473
Lingo1,9,56618475,56796468,protein_coding,-1,177993,chr9_56618475_56796468
Gm47235,9,56798962,56801261,lincRNA,-1,2299,chr9_56798962_56801261
Odf3l1,9,56848659,56864679,protein_coding,-1,16020,chr9_56848659_56864679
Cspg4,9,56865033,56899870,protein_coding,1,34837,chr9_56865033_56899870
Gm47237,9,56903461,56904996,lincRNA,1,1535,chr9_56903461_56904996
Snx33,9,56917193,56928371,protein_coding,-1,11178,chr9_56917193_56928371
4930442G15Rik,9,56931631,56933545,lincRNA,1,1914,chr9_56931631_56933545
Imp3,9,56937475,56938398,protein_coding,1,923,chr9_56937475_56938398
Snupn,9,56950878,56983206,protein_coding,1,32328,chr9_56950878_56983206
Ptpn9,9,56994923,57062807,protein_coding,1,67884,chr9_56994923_57062807
Gm10658,9,57056630,57071966,antisense,-1,15336,chr9_57056630_57071966
Sin3a,9,57072040,57128366,protein_coding,1,56326,chr9_57072040_57128366
Man2c1os,9,57099950,57131290,antisense,-1,31340,chr9_57099950_57131290
Man2c1,9,57130690,57142722,protein_coding,1,12032,chr9_57130690_57142722
Neil1,9,57142800,57148305,protein_coding,-1,5505,chr9_57142800_57148305
Commd4,9,57155035,57158331,protein_coding,-1,3296,chr9_57155035_57158331
1700041C23Rik,9,57175275,57186108,lincRNA,1,10833,chr9_57175275_57186108
Trcg1,9,57236556,57249864,protein_coding,1,13308,chr9_57236556_57249864
1700017B05Rik,9,57253117,57262612,protein_coding,-1,9495,chr9_57253117_57262612
Ppcdc,9,57385095,57440124,protein_coding,-1,55029,chr9_57385095_57440124
Scamp5,9,57441327,57468060,protein_coding,-1,26733,chr9_57441327_57468060
Rpp25,9,57504026,57505448,protein_coding,1,1422,chr9_57504026_57505448
Cox5a,9,57521274,57532426,protein_coding,1,11152,chr9_57521274_57532426
Fam219b,9,57537528,57543184,protein_coding,1,5656,chr9_57537528_57543184
Mpi,9,57544256,57552763,protein_coding,-1,8507,chr9_57544256_57552763
Scamp2,9,57560943,57588795,protein_coding,1,27852,chr9_57560943_57588795
Ulk3,9,57589452,57596233,protein_coding,1,6781,chr9_57589452_57596233
Cplx3,9,57599992,57606281,protein_coding,-1,6289,chr9_57599992_57606281
Lman1l,9,57607085,57620774,protein_coding,-1,13689,chr9_57607085_57620774
Csk,9,57626646,57653631,protein_coding,-1,26985,chr9_57626646_57653631
Cyp1a1,9,57687928,57703824,protein_coding,1,15896,chr9_57687928_57703824
Edc3,9,57708540,57752499,protein_coding,1,43959,chr9_57708540_57752499
Clk3,9,57750624,57765860,protein_coding,-1,15236,chr9_57750624_57765860
Gm17231,9,57777865,57834295,antisense,1,56430,chr9_57777865_57834295
Arid3b,9,57790353,57836793,protein_coding,-1,46440,chr9_57790353_57836793
Ubl7,9,57910979,57929968,protein_coding,1,18989,chr9_57910979_57929968
Sema7a,9,57940112,57962865,protein_coding,1,22753,chr9_57940112_57962865
Gm17322,9,57998041,58007451,lincRNA,1,9410,chr9_57998041_58007451
Cyp11a1,9,58006411,58027023,protein_coding,1,20612,chr9_58006411_58027023
Ccdc33,9,58028677,58118823,protein_coding,-1,90146,chr9_58028677_58118823
Gm16130,9,58032274,58048997,antisense,1,16723,chr9_58032274_58048997
Stra6,9,58063788,58153996,protein_coding,1,90208,chr9_58063788_58153996
Islr,9,58156268,58204306,protein_coding,-1,48038,chr9_58156268_58204306
Islr2,9,58196297,58204319,protein_coding,-1,8022,chr9_58196297_58204319
Pml,9,58218076,58249786,protein_coding,-1,31710,chr9_58218076_58249786
Stoml1,9,58253164,58262520,protein_coding,1,9356,chr9_58253164_58262520
Loxl1,9,58287738,58313186,protein_coding,-1,25448,chr9_58287738_58313186
4930461G14Rik,9,58455122,58469635,lincRNA,1,14513,chr9_58455122_58469635
Cd276,9,58524298,58555437,protein_coding,-1,31139,chr9_58524298_58555437
Nptn,9,58582240,58657955,protein_coding,1,75715,chr9_58582240_58657955
Rec114,9,58652850,58743964,protein_coding,-1,91114,chr9_58652850_58743964
Hcn4,9,58823412,58863175,protein_coding,1,39763,chr9_58823412_58863175
Neo1,9,58874687,59036441,protein_coding,-1,161754,chr9_58874687_59036441
Gm47271,9,58979251,59033856,antisense,1,54605,chr9_58979251_59033856
Gm33053,9,59191410,59235071,lincRNA,-1,43661,chr9_59191410_59235071
Adpgk,9,59291558,59324052,protein_coding,1,32494,chr9_59291558_59324052
Bbs4,9,59321990,59353508,protein_coding,-1,31518,chr9_59321990_59353508
Arih1,9,59388258,59486618,protein_coding,-1,98360,chr9_59388258_59486618
Gm33180,9,59499361,59512865,lincRNA,-1,13504,chr9_59499361_59512865
Tmem202,9,59518685,59539847,protein_coding,-1,21162,chr9_59518685_59539847
Hexa,9,59539540,59565109,protein_coding,1,25569,chr9_59539540_59565109
Celf6,9,59577917,59607292,protein_coding,1,29375,chr9_59577917_59607292
Parp6,9,59617284,59650285,protein_coding,1,33001,chr9_59617284_59650285
Pkm,9,59656368,59679375,protein_coding,1,23007,chr9_59656368_59679375
Gramd2,9,59680144,59718874,protein_coding,1,38730,chr9_59680144_59718874
Senp8,9,59734259,59750710,protein_coding,-1,16451,chr9_59734259_59750710
Myo9a,9,59750896,59928866,protein_coding,1,177970,chr9_59750896_59928866
Gm20275,9,59826257,59941077,antisense,-1,114820,chr9_59826257_59941077
Nr2e3,9,59942771,59960659,protein_coding,-1,17888,chr9_59942771_59960659
Gm7616,9,59951285,59959044,antisense,1,7759,chr9_59951285_59959044
Gm15507,9,59957511,59961801,lincRNA,-1,4290,chr9_59957511_59961801
Thsd4,9,59966931,60522046,protein_coding,-1,555115,chr9_59966931_60522046
2010001M07Rik,9,60334142,60334968,antisense,1,826,chr9_60334142_60334968
9230112J17Rik,9,60523967,60545882,lincRNA,-1,21915,chr9_60523967_60545882
Gm49334,9,60527419,60546035,lincRNA,1,18616,chr9_60527419_60546035
Lrrc49,9,60568859,60688158,protein_coding,-1,119299,chr9_60568859_60688158
Larp6,9,60712989,60738801,protein_coding,1,25812,chr9_60712989_60738801
1700036A12Rik,9,60743120,60770276,lincRNA,1,27156,chr9_60743120_60770276
Uaca,9,60794542,60880370,protein_coding,1,85828,chr9_60794542_60880370
Gm9869,9,60821552,60838200,antisense,-1,16648,chr9_60821552_60838200
Gm47923,9,60919223,60949373,lincRNA,1,30150,chr9_60919223_60949373
Gm39348,9,61049009,61055819,lincRNA,-1,6810,chr9_61049009_61055819
Gm34004,9,61081951,61117839,lincRNA,1,35888,chr9_61081951_61117839
Gm33914,9,61102229,61127031,lincRNA,-1,24802,chr9_61102229_61127031
I730028E13Rik,9,61138515,61145259,lincRNA,1,6744,chr9_61138515_61145259
Gm34105,9,61206679,61212916,lincRNA,1,6237,chr9_61206679_61212916
B930092H01Rik,9,61259227,61293809,lincRNA,-1,34582,chr9_61259227_61293809
Gm10655,9,61370797,61372193,lincRNA,-1,1396,chr9_61370797_61372193
Tle3,9,61372366,61418497,protein_coding,1,46131,chr9_61372366_61418497
Gm34322,9,61442591,61455947,lincRNA,1,13356,chr9_61442591_61455947
Rplp1,9,61913284,61914542,protein_coding,-1,1258,chr9_61913284_61914542
Kif23,9,61915905,61946774,protein_coding,-1,30869,chr9_61915905_61946774
Paqr5,9,61953481,62026856,protein_coding,-1,73375,chr9_61953481_62026856
Glce,9,62057248,62122655,protein_coding,-1,65407,chr9_62057248_62122655
A730043L09Rik,9,62242596,62244100,lincRNA,-1,1504,chr9_62242596_62244100
Spesp1,9,62270729,62282208,protein_coding,-1,11479,chr9_62270729_62282208
Gm35288,9,62298502,62336649,lincRNA,1,38147,chr9_62298502_62336649
Anp32a,9,62341293,62378812,protein_coding,1,37519,chr9_62341293_62378812
Coro2b,9,62419492,62537044,protein_coding,-1,117552,chr9_62419492_62537044
Itga11,9,62677826,62783982,protein_coding,1,106156,chr9_62677826_62783982
Fem1b,9,62791821,62811934,protein_coding,-1,20113,chr9_62791821_62811934
Cln6,9,62838785,62852006,protein_coding,1,13221,chr9_62838785_62852006
Calml4,9,62858080,62875921,protein_coding,1,17841,chr9_62858080_62875921
Pias1,9,62878368,62987924,protein_coding,-1,109556,chr9_62878368_62987924
Gm48193,9,63080267,63082973,lincRNA,-1,2706,chr9_63080267_63082973
Skor1,9,63138170,63148961,protein_coding,-1,10791,chr9_63138170_63148961
Map2k5,9,63163768,63377902,protein_coding,-1,214134,chr9_63163768_63377902
2300009A05Rik,9,63394447,63399246,protein_coding,-1,4799,chr9_63394447_63399246
Iqch,9,63421455,63602493,protein_coding,-1,181038,chr9_63421455_63602493
Aagab,9,63602660,63644588,protein_coding,1,41928,chr9_63602660_63644588
Smad3,9,63646767,63757994,protein_coding,-1,111227,chr9_63646767_63757994
Gm36033,9,63926655,63937121,lincRNA,-1,10466,chr9_63926655_63937121
Smad6,9,63953076,64022059,protein_coding,-1,68983,chr9_63953076_64022059
Lctl,9,64117147,64138118,protein_coding,1,20971,chr9_64117147_64138118
Zwilch,9,64137144,64173104,protein_coding,-1,35960,chr9_64137144_64173104
Rpl4,9,64173375,64178666,protein_coding,1,5291,chr9_64173375_64178666
Snapc5,9,64179274,64183132,protein_coding,1,3858,chr9_64179274_64183132
Map2k1,9,64185770,64253631,protein_coding,-1,67861,chr9_64185770_64253631
Gm48855,9,64228339,64230795,lincRNA,1,2456,chr9_64228339_64230795
Uchl4,9,64235201,64236362,protein_coding,1,1161,chr9_64235201_64236362
Tipin,9,64281581,64305424,protein_coding,1,23843,chr9_64281581_64305424
Dis3l,9,64306756,64341288,protein_coding,-1,34532,chr9_64306756_64341288
Megf11,9,64385626,64709205,protein_coding,1,323579,chr9_64385626_64709205
Rab11a,9,64715299,64737758,protein_coding,-1,22459,chr9_64715299_64737758
Dennd4a,9,64811340,64919667,protein_coding,1,108327,chr9_64811340_64919667
Slc24a1,9,64922861,64951607,protein_coding,-1,28746,chr9_64922861_64951607
Ints14,9,64960905,64986978,protein_coding,1,26073,chr9_64960905_64986978
Hacd3,9,64986983,65021693,protein_coding,-1,34710,chr9_64986983_65021693
Dpp8,9,65032414,65082651,protein_coding,1,50237,chr9_65032414_65082651
Gm47350,9,65054882,65094355,antisense,-1,39473,chr9_65054882_65094355
Igdcc4,9,65101486,65137940,protein_coding,1,36454,chr9_65101486_65137940
Igdcc3,9,65141189,65185872,protein_coding,1,44683,chr9_65141189_65185872
Parp16,9,65195353,65239224,protein_coding,1,43871,chr9_65195353_65239224
Cilp,9,65265180,65280605,protein_coding,1,15425,chr9_65265180_65280605
Clpx,9,65294260,65330658,protein_coding,1,36398,chr9_65294260_65330658
Gm39363,9,65332520,65345607,lincRNA,1,13087,chr9_65332520_65345607
Pdcd7,9,65346104,65359643,protein_coding,1,13539,chr9_65346104_65359643
Ubap1l,9,65361041,65380377,protein_coding,1,19336,chr9_65361041_65380377
Kbtbd13,9,65388684,65391652,protein_coding,-1,2968,chr9_65388684_65391652
Rasl12,9,65398506,65414853,protein_coding,1,16347,chr9_65398506_65414853
Slc51b,9,65412714,65422955,protein_coding,-1,10241,chr9_65412714_65422955
Mtfmt,9,65435782,65453054,protein_coding,1,17272,chr9_65435782_65453054
Gm47270,9,65453615,65460399,lincRNA,1,6784,chr9_65453615_65460399
Spg21,9,65460947,65488470,protein_coding,1,27523,chr9_65460947_65488470
Ankdd1a,9,65488470,65520193,protein_coding,-1,31723,chr9_65488470_65520193
Plekho2,9,65552698,65580040,protein_coding,-1,27342,chr9_65552698_65580040
Pif1,9,65587160,65595967,protein_coding,1,8807,chr9_65587160_65595967
Rbpms2,9,65629648,65660528,protein_coding,1,30880,chr9_65629648_65660528
Oaz2,9,65668001,65690300,protein_coding,1,22299,chr9_65668001_65690300
Zfp609,9,65692391,65827564,protein_coding,-1,135173,chr9_65692391_65827564
Trip4,9,65828930,65908794,protein_coding,-1,79864,chr9_65828930_65908794
Pclaf,9,65890237,65903266,protein_coding,1,13029,chr9_65890237_65903266
Csnk1g1,9,65908924,66045015,protein_coding,1,136091,chr9_65908924_66045015
Ppib,9,66060222,66066623,protein_coding,1,6401,chr9_66060222_66066623
Snx22,9,66065176,66069719,protein_coding,-1,4543,chr9_66065176_66069719
Snx1,9,66088133,66126587,protein_coding,-1,38454,chr9_66088133_66126587
Dapk2,9,66158223,66272242,protein_coding,1,114019,chr9_66158223_66272242
Herc1,9,66350450,66508775,protein_coding,1,158325,chr9_66350450_66508775
Gm28379,9,66417746,66448496,antisense,-1,30750,chr9_66417746_66448496
Fbxl22,9,66508375,66514609,protein_coding,-1,6234,chr9_66508375_66514609
Usp3,9,66514637,66593142,protein_coding,-1,78505,chr9_66514637_66593142
Gm15563,9,66572001,66582059,antisense,1,10058,chr9_66572001_66582059
Car12,9,66713686,66766845,protein_coding,1,53159,chr9_66713686_66766845
Aph1b,9,66775202,66795490,protein_coding,-1,20288,chr9_66775202_66795490
BC050972,9,66798678,66804359,antisense,-1,5681,chr9_66798678_66804359
Aph1c,9,66814994,66834726,protein_coding,-1,19732,chr9_66814994_66834726
Gm17098,9,66834699,66835534,antisense,1,835,chr9_66834699_66835534
Rab8b,9,66843664,66919687,protein_coding,-1,76023,chr9_66843664_66919687
Rps27l,9,66946086,66949516,protein_coding,1,3430,chr9_66946086_66949516
Lactb,9,66955388,66975484,protein_coding,-1,20096,chr9_66955388_66975484
Tpm1,9,67022590,67049406,protein_coding,-1,26816,chr9_67022590_67049406
Gm10646,9,67102300,67109601,lincRNA,1,7301,chr9_67102300_67109601
Gm19299,9,67133560,67213918,lincRNA,1,80358,chr9_67133560_67213918
Tln2,9,67217087,67559703,protein_coding,-1,342616,chr9_67217087_67559703
Gm47047,9,67424503,67427491,antisense,1,2988,chr9_67424503_67427491
M5C1000I18Rik,9,67758712,67760230,lincRNA,-1,1518,chr9_67758712_67760230
C2cd4b,9,67759437,67760930,protein_coding,1,1493,chr9_67759437_67760930
C2cd4a,9,67830489,67832330,protein_coding,-1,1841,chr9_67830489_67832330
Vps13c,9,67840396,67995638,protein_coding,1,155242,chr9_67840396_67995638
Gm20745,9,68017964,68025714,lincRNA,-1,7750,chr9_68017964_68025714
4930502A04Rik,9,68470902,68520200,lincRNA,-1,49298,chr9_68470902_68520200
Rora,9,68653786,69388246,protein_coding,1,734460,chr9_68653786_69388246
Gm15511,9,69348889,69364247,antisense,-1,15358,chr9_69348889_69364247
Ice2,9,69397906,69433122,protein_coding,1,35216,chr9_69397906_69433122
Anxa2,9,69453620,69491795,protein_coding,1,38175,chr9_69453620_69491795
B230323A14Rik,9,69758740,69830845,antisense,1,72105,chr9_69758740_69830845
Gm28731,9,69988400,69989968,antisense,-1,1568,chr9_69988400_69989968
Bnip2,9,69989466,70008317,protein_coding,1,18851,chr9_69989466_70008317
Gtf2a2,9,70012550,70022866,protein_coding,1,10316,chr9_70012550_70022866
Gcnt3,9,70031496,70038088,protein_coding,-1,6592,chr9_70031496_70038088
Fam81a,9,70088511,70142560,protein_coding,-1,54049,chr9_70088511_70142560
Myo1e,9,70207350,70399766,protein_coding,1,192416,chr9_70207350_70399766
Ccnb2,9,70407692,70421547,protein_coding,-1,13855,chr9_70407692_70421547
Rnf111,9,70425424,70503725,protein_coding,-1,78301,chr9_70425424_70503725
Sltm,9,70542754,70592234,protein_coding,1,49480,chr9_70542754_70592234
Mindy2,9,70599014,70657174,protein_coding,-1,58160,chr9_70599014_70657174
Gm10642,9,70656251,70657862,antisense,1,1611,chr9_70656251_70657862
Adam10,9,70678997,70780229,protein_coding,1,101232,chr9_70678997_70780229
Lipc,9,70798128,70952226,protein_coding,-1,154098,chr9_70798128_70952226
Aqp9,9,71110659,71168682,protein_coding,-1,58023,chr9_71110659_71168682
Gm32511,9,71163794,71208124,antisense,1,44330,chr9_71163794_71208124
Aldh1a2,9,71215789,71296243,protein_coding,1,80454,chr9_71215789_71296243
Polr2m,9,71478437,71485935,protein_coding,-1,7498,chr9_71478437_71485935
Myzap,9,71504347,71592360,protein_coding,-1,88013,chr9_71504347_71592360
Cgnl1,9,71626509,71771602,protein_coding,-1,145093,chr9_71626509_71771602
Tcf12,9,71842688,72111871,protein_coding,-1,269183,chr9_71842688_72111871
Gm27159,9,72179183,72179758,lincRNA,-1,575,chr9_72179183_72179758
Gm27188,9,72207706,72230306,lincRNA,-1,22600,chr9_72207706_72230306
Gm27253,9,72268614,72274856,lincRNA,-1,6242,chr9_72268614_72274856
Zfp280d,9,72274860,72363777,protein_coding,1,88917,chr9_72274860_72363777
BC065403,9,72361735,72409945,antisense,-1,48210,chr9_72361735_72409945
Mns1,9,72438011,72462025,protein_coding,1,24014,chr9_72438011_72462025
Gm27231,9,72441079,72441779,antisense,-1,700,chr9_72441079_72441779
Tex9,9,72450394,72492212,protein_coding,-1,41818,chr9_72450394_72492212
4930509E16Rik,9,72518250,72531858,lincRNA,-1,13608,chr9_72518250_72531858
Rfx7,9,72532240,72622937,protein_coding,1,90697,chr9_72532240_72622937
Gm27241,9,72613790,72617053,antisense,-1,3263,chr9_72613790_72617053
Gm27232,9,72618693,72619520,antisense,-1,827,chr9_72618693_72619520
Nedd4,9,72662346,72749852,protein_coding,1,87506,chr9_72662346_72749852
Gm27204,9,72774063,72776225,lincRNA,-1,2162,chr9_72774063_72776225
Prtg,9,72806874,72917291,protein_coding,1,110417,chr9_72806874_72917291
Pygo1,9,72925645,72952181,protein_coding,1,26536,chr9_72925645_72952181
Gm44503,9,72958852,73016319,protein_coding,1,57467,chr9_72958852_73016319
Ccpg1os,9,72979722,72985382,protein_coding,-1,5660,chr9_72979722_72985382
Ccpg1,9,72985429,73016340,protein_coding,1,30911,chr9_72985429_73016340
Pigb,9,73007419,73040378,protein_coding,-1,32959,chr9_73007419_73040378
Rab27a,9,73044854,73097629,protein_coding,1,52775,chr9_73044854_73097629
Khdc3,9,73101836,73104438,protein_coding,1,2602,chr9_73101836_73104438
Gm20509,9,73102470,73117920,protein_coding,1,15450,chr9_73102470_73117920
Rsl24d1,9,73113426,73123333,protein_coding,1,9907,chr9_73113426_73123333
Gm27211,9,73192483,73268115,lincRNA,1,75632,chr9_73192483_73268115
Unc13c,9,73479422,73968966,protein_coding,-1,489544,chr9_73479422_73968966
Wdr72,9,74110356,74283308,protein_coding,1,172952,chr9_74110356_74283308
Gm20649,9,74848463,74891476,lincRNA,1,43013,chr9_74848463_74891476
Onecut1,9,74861921,74891781,protein_coding,1,29860,chr9_74861921_74891781
Fam214a,9,74952884,75032468,protein_coding,1,79584,chr9_74952884_75032468
Arpp19,9,75037614,75060313,protein_coding,1,22699,chr9_75037614_75060313
Myo5a,9,75071015,75223688,protein_coding,1,152673,chr9_75071015_75223688
Myo5c,9,75232020,75305451,protein_coding,1,73431,chr9_75232020_75305451
Gnb5,9,75306288,75345876,protein_coding,1,39588,chr9_75306288_75345876
Gm19531,9,75310335,75314871,antisense,-1,4536,chr9_75310335_75314871
Gm48677,9,75317072,75342842,antisense,-1,25770,chr9_75317072_75342842
Bcl2l10,9,75347758,75351649,protein_coding,1,3891,chr9_75347758_75351649
Mapk6,9,75369062,75410005,protein_coding,-1,40943,chr9_75369062_75410005
4933433G15Rik,9,75410184,75417709,lincRNA,1,7525,chr9_75410184_75417709
Leo1,9,75441524,75466432,protein_coding,1,24908,chr9_75441524_75466432
Tmod3,9,75497707,75559657,protein_coding,-1,61950,chr9_75497707_75559657
Tmod2,9,75565621,75611325,protein_coding,-1,45704,chr9_75565621_75611325
Lysmd2,9,75625741,75637771,protein_coding,1,12030,chr9_75625741_75637771
Scg3,9,75643189,75684056,protein_coding,-1,40867,chr9_75643189_75684056
Bmp5,9,75775364,75900310,protein_coding,1,124946,chr9_75775364_75900310
Gm26903,9,75897843,76015192,antisense,-1,117349,chr9_75897843_76015192
Hmgcll1,9,76014855,76136350,protein_coding,1,121495,chr9_76014855_76136350
Gfral,9,76164102,76213657,protein_coding,-1,49555,chr9_76164102_76213657
Hcrtr2,9,76225880,76323856,protein_coding,-1,97976,chr9_76225880_76323856
Gm27234,9,76319577,76320846,antisense,1,1269,chr9_76319577_76320846
Fam83b,9,76490054,76567116,protein_coding,-1,77062,chr9_76490054_76567116
Gm34158,9,76754767,76786516,lincRNA,1,31749,chr9_76754767_76786516
Gm47800,9,76804116,76823062,lincRNA,-1,18946,chr9_76804116_76823062
Tinag,9,76951693,77045794,protein_coding,-1,94101,chr9_76951693_77045794
Gm19541,9,77046682,77051953,lincRNA,1,5271,chr9_77046682_77051953
Mlip,9,77102081,77352969,protein_coding,-1,250888,chr9_77102081_77352969
5730403I07Rik,9,77366412,77399418,lincRNA,-1,33006,chr9_77366412_77399418
Lrrc1,9,77430823,77544870,protein_coding,-1,114047,chr9_77430823_77544870
Klhl31,9,77636500,77660127,protein_coding,1,23627,chr9_77636500_77660127
Gm47790,9,77692197,77730279,lincRNA,-1,38082,chr9_77692197_77730279
Gm47795,9,77730737,77733268,lincRNA,-1,2531,chr9_77730737_77733268
Gclc,9,77754535,77794485,protein_coding,1,39950,chr9_77754535_77794485
Gm34654,9,77807036,77809793,lincRNA,-1,2757,chr9_77807036_77809793
Gm47818,9,77836030,77848111,lincRNA,1,12081,chr9_77836030_77848111
Elovl5,9,77917364,77984519,protein_coding,1,67155,chr9_77917364_77984519
Gm34829,9,77992599,78002261,lincRNA,1,9662,chr9_77992599_78002261
Gcm1,9,78051924,78065624,protein_coding,1,13700,chr9_78051924_78065624
Fbxo9,9,78081499,78109065,protein_coding,-1,27566,chr9_78081499_78109065
C920006O11Rik,9,78175914,78178879,transcribed_unprocessed_pseudogene,1,2965,chr9_78175914_78178879
Gsta4,9,78182774,78209349,protein_coding,1,26575,chr9_78182774_78209349
Gm10639,9,78289923,78305525,protein_coding,1,15602,chr9_78289923_78305525
Gsta2,9,78331018,78355788,protein_coding,-1,24770,chr9_78331018_78355788
Dppa5a,9,78367052,78368177,protein_coding,-1,1125,chr9_78367052_78368177
Ooep,9,78376109,78378725,protein_coding,-1,2616,chr9_78376109_78378725
4930542C12Rik,9,78394956,78396158,antisense,-1,1202,chr9_78394956_78396158
Ddx43,9,78395777,78423587,protein_coding,1,27810,chr9_78395777_78423587
Gm17324,9,78447865,78448786,antisense,-1,921,chr9_78447865_78448786
Mto1,9,78448208,78475348,protein_coding,1,27140,chr9_78448208_78475348
Eef1a1,9,78478449,78489151,protein_coding,-1,10702,chr9_78478449_78489151
Slc17a5,9,78536488,78588041,protein_coding,-1,51553,chr9_78536488_78588041
Cd109,9,78615546,78716253,protein_coding,1,100707,chr9_78615546_78716253
Gm35024,9,79026940,79029752,lincRNA,-1,2812,chr9_79026940_79029752
Gm47499,9,79159621,79202007,lincRNA,-1,42386,chr9_79159621_79202007
Gm47501,9,79215121,79267651,lincRNA,-1,52530,chr9_79215121_79267651
Gm39377,9,79378119,79390855,lincRNA,-1,12736,chr9_79378119_79390855
Gm10635,9,79444037,79519302,lincRNA,-1,75265,chr9_79444037_79519302
Col12a1,9,79598991,79718831,protein_coding,-1,119840,chr9_79598991_79718831
4930562D21Rik,9,79688776,79690907,antisense,1,2131,chr9_79688776_79690907
Cox7a2,9,79755361,79759878,protein_coding,-1,4517,chr9_79755361_79759878
Tmem30a,9,79768943,79793507,protein_coding,-1,24564,chr9_79768943_79793507
4930429F24Rik,9,79793641,79803235,lincRNA,1,9594,chr9_79793641_79803235
Filip1,9,79805094,80012851,protein_coding,-1,207757,chr9_79805094_80012851
Senp6,9,80066903,80144953,protein_coding,1,78050,chr9_80066903_80144953
Gm17477,9,80118895,80121937,antisense,-1,3042,chr9_80118895_80121937
Myo6,9,80165031,80311729,protein_coding,1,146698,chr9_80165031_80311729
Gm27227,9,80263306,80265450,antisense,-1,2144,chr9_80263306_80265450
Impg1,9,80313330,80465481,protein_coding,-1,152151,chr9_80313330_80465481
Gm48387,9,80544763,80601097,lincRNA,-1,56334,chr9_80544763_80601097
Gm27224,9,80802651,80864861,lincRNA,1,62210,chr9_80802651_80864861
Gm26713,9,80955436,81203591,lincRNA,1,248155,chr9_80955436_81203591
Gm27226,9,81455397,81460966,lincRNA,1,5569,chr9_81455397_81460966
Htr1b,9,81628291,81633828,protein_coding,-1,5537,chr9_81628291_81633828
D430036J16Rik,9,81631551,81645156,antisense,1,13605,chr9_81631551_81645156
Gm26907,9,81776695,81858891,antisense,-1,82196,chr9_81776695_81858891
Mei4,9,81863670,82206007,protein_coding,1,342337,chr9_81863670_82206007
Gm35548,9,82249931,82260208,lincRNA,-1,10277,chr9_82249931_82260208
1700063H06Rik,9,82260293,82263485,lincRNA,1,3192,chr9_82260293_82263485
Irak1bp1,9,82829540,82847687,protein_coding,1,18147,chr9_82829540_82847687
Phip,9,82866159,82975516,protein_coding,-1,109357,chr9_82866159_82975516
Gm39383,9,83008603,83042603,lincRNA,1,34000,chr9_83008603_83042603
Gm38398,9,83098224,83106330,lincRNA,1,8106,chr9_83098224_83106330
Hmgn3,9,83109948,83146685,protein_coding,-1,36737,chr9_83109948_83146685
Gm27216,9,83240481,83254540,lincRNA,-1,14059,chr9_83240481_83254540
Gm46123,9,83346159,83353978,lincRNA,1,7819,chr9_83346159_83353978
Lca5,9,83390293,83441127,protein_coding,-1,50834,chr9_83390293_83441127
Gm2087,9,83431547,83454573,antisense,1,23026,chr9_83431547_83454573
Sh3bgrl2,9,83548327,83638801,protein_coding,1,90474,chr9_83548327_83638801
Gm39384,9,83571560,83573289,lincRNA,-1,1729,chr9_83571560_83573289
Gm36120,9,83678081,83687525,lincRNA,-1,9444,chr9_83678081_83687525
Gm2109,9,83691475,83693223,lincRNA,1,1748,chr9_83691475_83693223
Elovl4,9,83778692,83806277,protein_coding,-1,27585,chr9_83778692_83806277
Ttk,9,83834689,83872389,protein_coding,1,37700,chr9_83834689_83872389
Gm36278,9,83921709,83925022,lincRNA,-1,3313,chr9_83921709_83925022
Bckdhb,9,83925145,84124240,protein_coding,1,199095,chr9_83925145_84124240
Gm46124,9,84009139,84024817,antisense,-1,15678,chr9_84009139_84024817
Gm39388,9,84577960,84613684,lincRNA,1,35724,chr9_84577960_84613684
4930554C24Rik,9,84774398,84857691,lincRNA,1,83293,chr9_84774398_84857691
Gm48821,9,84892120,84924633,lincRNA,-1,32513,chr9_84892120_84924633
Gm48830,9,85221196,85234582,lincRNA,-1,13386,chr9_85221196_85234582
Gm48832,9,85332352,85348065,lincRNA,-1,15713,chr9_85332352_85348065
Gm48834,9,85519493,85553765,lincRNA,-1,34272,chr9_85519493_85553765
Ibtk,9,85687360,85749334,protein_coding,-1,61974,chr9_85687360_85749334
Tpbg,9,85842380,85847040,protein_coding,1,4660,chr9_85842380_85847040
Gm47604,9,85941038,85943200,lincRNA,-1,2162,chr9_85941038_85943200
Ube2cbp,9,86307306,86464950,protein_coding,-1,157644,chr9_86307306_86464950
Pgm3,9,86554377,86571842,protein_coding,-1,17465,chr9_86554377_86571842
Rwdd2a,9,86571991,86574899,protein_coding,1,2908,chr9_86571991_86574899
Me1,9,86581371,86695953,protein_coding,-1,114582,chr9_86581371_86695953
A330041J22Rik,9,86695460,86701253,antisense,1,5793,chr9_86695460_86701253
Prss35,9,86743649,86758443,protein_coding,1,14794,chr9_86743649_86758443
Snap91,9,86765923,86880654,protein_coding,-1,114731,chr9_86765923_86880654
Gm36539,9,86981991,87006163,lincRNA,-1,24172,chr9_86981991_87006163
Ripply2,9,87015537,87019917,protein_coding,1,4380,chr9_87015537_87019917
Cyb5r4,9,87022014,87077774,protein_coding,1,55760,chr9_87022014_87077774
Mrap2,9,87144306,87184045,protein_coding,1,39739,chr9_87144306_87184045
Cep162,9,87189577,87255536,protein_coding,-1,65959,chr9_87189577_87255536
Tbx18,9,87702800,87731260,protein_coding,-1,28460,chr9_87702800_87731260
Nt5e,9,88327197,88372092,protein_coding,1,44895,chr9_88327197_88372092
Snx14,9,88376747,88438958,protein_coding,-1,62211,chr9_88376747_88438958
Gm20537,9,88407432,88456616,protein_coding,-1,49184,chr9_88407432_88456616
Syncrip,9,88447009,88482574,protein_coding,-1,35565,chr9_88447009_88482574
Zfp949,9,88548020,88571061,protein_coding,1,23041,chr9_88548020_88571061
Trim43a,9,88580891,88588819,protein_coding,1,7928,chr9_88580891_88588819
9430037G07Rik,9,88595325,88599516,lincRNA,-1,4191,chr9_88595325_88599516
Mthfsl,9,88688602,88720296,protein_coding,-1,31694,chr9_88688602_88720296
Gm10634,9,88719629,88806264,antisense,1,86635,chr9_88719629_88806264
Bcl2a1d,9,88723285,88731914,protein_coding,-1,8629,chr9_88723285_88731914
Gm29562,9,88827522,88828425,lincRNA,1,903,chr9_88827522_88828425
Trim43c,9,88839164,88848190,protein_coding,1,9026,chr9_88839164_88848190
Gm26611,9,88859011,88883554,lincRNA,1,24543,chr9_88859011_88883554
Trim43b,9,89084624,89092835,protein_coding,-1,8211,chr9_89084624_89092835
4930579C12Rik,9,89113111,89177887,lincRNA,-1,64776,chr9_89113111_89177887
Gm29094,9,89199379,89215471,protein_coding,1,16092,chr9_89199379_89215471
Mthfs,9,89210676,89377713,protein_coding,1,167037,chr9_89210676_89377713
Gm47403,9,89550698,89560384,lincRNA,-1,9686,chr9_89550698_89560384
Gm47409,9,89638072,89646002,lincRNA,1,7930,chr9_89638072_89646002
Tmed3,9,89699206,89705068,protein_coding,-1,5862,chr9_89699206_89705068
Ankrd34c,9,89725245,89738475,protein_coding,-1,13230,chr9_89725245_89738475
4930524O08Rik,9,89826519,89864028,lincRNA,1,37509,chr9_89826519_89864028
Rasgrf1,9,89909908,90026977,protein_coding,1,117069,chr9_89909908_90026977
Ctsh,9,90054152,90076089,protein_coding,1,21937,chr9_90054152_90076089
Morf4l1,9,90091665,90114774,protein_coding,-1,23109,chr9_90091665_90114774
Adamts7,9,90163069,90208071,protein_coding,1,45002,chr9_90163069_90208071
Tbc1d2b,9,90202027,90270804,protein_coding,-1,68777,chr9_90202027_90270804
Gm30849,9,90303800,90318448,lincRNA,1,14648,chr9_90303800_90318448
Gm28652,9,91337601,91340878,lincRNA,1,3277,chr9_91337601_91340878
Zic1,9,91358058,91365810,protein_coding,-1,7752,chr9_91358058_91365810
Zic4,9,91362413,91389348,protein_coding,1,26935,chr9_91362413_91389348
Gm29478,9,91404474,91562818,lincRNA,1,158344,chr9_91404474_91562818
Gm31409,9,91922664,91961118,lincRNA,-1,38454,chr9_91922664_91961118
Plscr5,9,92192936,92209772,protein_coding,1,16836,chr9_92192936_92209772
Plscr1,9,92249750,92272278,protein_coding,1,22528,chr9_92249750_92272278
Plscr2,9,92275602,92297752,protein_coding,1,22150,chr9_92275602_92297752
1700057G04Rik,9,92309377,92357876,protein_coding,1,48499,chr9_92309377_92357876
Plscr4,9,92457373,92492456,protein_coding,1,35083,chr9_92457373_92492456
Plod2,9,92542223,92608428,protein_coding,1,66205,chr9_92542223_92608428
4933400C23Rik,9,92717456,92795711,lincRNA,1,78255,chr9_92717456_92795711
Gm28054,9,92895832,92915791,lincRNA,1,19959,chr9_92895832_92915791
1700034K08Rik,9,92979914,93005739,lincRNA,-1,25825,chr9_92979914_93005739
Gm29395,9,94667208,94668818,lincRNA,-1,1610,chr9_94667208_94668818
Slc9a9,9,94669909,95230445,protein_coding,1,560536,chr9_94669909_95230445
Gm16262,9,94695704,94702319,antisense,-1,6615,chr9_94695704_94702319
Chst2,9,95399292,95406722,protein_coding,-1,7430,chr9_95399292_95406722
U2surp,9,95456898,95511996,protein_coding,-1,55098,chr9_95456898_95511996
Gm28424,9,95512151,95513469,antisense,1,1318,chr9_95512151_95513469
Gm32281,9,95554497,95558913,lincRNA,1,4416,chr9_95554497_95558913
Paqr9,9,95559657,95568023,protein_coding,1,8366,chr9_95559657_95568023
Gm16126,9,95618911,95648471,antisense,-1,29560,chr9_95618911_95648471
Pcolce2,9,95637601,95698096,protein_coding,1,60495,chr9_95637601_95698096
Trpc1,9,95705082,95750375,protein_coding,-1,45293,chr9_95705082_95750375
Pls1,9,95752642,95845311,protein_coding,-1,92669,chr9_95752642_95845311
1700065D16Rik,9,95855418,95858322,antisense,-1,2904,chr9_95855418_95858322
Atr,9,95857597,95951781,protein_coding,1,94184,chr9_95857597_95951781
Gm16794,9,95942045,95959393,antisense,-1,17348,chr9_95942045_95959393
Xrn1,9,95954760,96057803,protein_coding,1,103043,chr9_95954760_96057803
C78334,9,96017934,96024740,antisense,-1,6806,chr9_96017934_96024740
Gm28085,9,96027101,96040673,antisense,-1,13572,chr9_96027101_96040673
Gk5,9,96119362,96184608,protein_coding,1,65246,chr9_96119362_96184608
Tfdp2,9,96196275,96323646,protein_coding,1,127371,chr9_96196275_96323646
Atp1b3,9,96332655,96364442,protein_coding,-1,31787,chr9_96332655_96364442
BC043934,9,96435783,96438138,lincRNA,-1,2355,chr9_96435783_96438138
Rnf7,9,96470937,96478675,protein_coding,-1,7738,chr9_96470937_96478675
Gm28729,9,96486001,96525264,protein_coding,-1,39263,chr9_96486001_96525264
Rasa2,9,96539300,96631617,protein_coding,-1,92317,chr9_96539300_96631617
Zbtb38,9,96682770,96752831,protein_coding,-1,70061,chr9_96682770_96752831
A930006L05Rik,9,96705828,96711449,antisense,1,5621,chr9_96705828_96711449
Pxylp1,9,96823336,96892669,protein_coding,-1,69333,chr9_96823336_96892669
Spsb4,9,96943482,97018843,protein_coding,-1,75361,chr9_96943482_97018843
Gm16010,9,97015966,97022043,antisense,1,6077,chr9_97015966_97022043
Gm19325,9,97047444,97067307,lincRNA,-1,19863,chr9_97047444_97067307
Slc25a36,9,97074961,97111157,protein_coding,-1,36196,chr9_97074961_97111157
Gm16185,9,97085326,97088610,antisense,1,3284,chr9_97085326_97088610
Trim42,9,97349562,97369958,protein_coding,-1,20396,chr9_97349562_97369958
Gm15891,9,97349616,97369945,antisense,1,20329,chr9_97349616_97369945
Clstn2,9,97444395,98033181,protein_coding,-1,588786,chr9_97444395_98033181
4921534H16Rik,9,98003420,98012175,antisense,1,8755,chr9_98003420_98012175
Nmnat3,9,98287435,98420438,protein_coding,1,133003,chr9_98287435_98420438
Rbp1,9,98422961,98446575,protein_coding,1,23614,chr9_98422961_98446575
Rbp2,9,98486115,98509781,protein_coding,1,23666,chr9_98486115_98509781
Copb2,9,98563721,98588382,protein_coding,1,24661,chr9_98563721_98588382
Mrps22,9,98588730,98601660,protein_coding,-1,12930,chr9_98588730_98601660
Gm37637,9,98590495,98591750,antisense,1,1255,chr9_98590495_98591750
E330023G01Rik,9,98748599,98820087,lincRNA,-1,71488,chr9_98748599_98820087
Foxl2,9,98955288,98958543,protein_coding,1,3255,chr9_98955288_98958543
Faim,9,98986373,99002021,protein_coding,1,15648,chr9_98986373_99002021
Gm1123,9,99006790,99035715,protein_coding,-1,28925,chr9_99006790_99035715
Pik3cb,9,99036654,99140621,protein_coding,-1,103967,chr9_99036654_99140621
Faiml,9,99229376,99237239,protein_coding,-1,7863,chr9_99229376_99237239
Cep70,9,99243367,99300404,protein_coding,1,57037,chr9_99243367_99300404
4930422M22Rik,9,99299007,99304675,antisense,-1,5668,chr9_99299007_99304675
Esyt3,9,99309963,99358557,protein_coding,-1,48594,chr9_99309963_99358557
Gm28087,9,99367033,99368490,lincRNA,1,1457,chr9_99367033_99368490
Mras,9,99385420,99437381,protein_coding,-1,51961,chr9_99385420_99437381
Nme9,9,99451475,99474751,protein_coding,1,23276,chr9_99451475_99474751
Armc8,9,99478372,99568899,protein_coding,-1,90527,chr9_99478372_99568899
Dbr1,9,99575799,99584501,protein_coding,1,8702,chr9_99575799_99584501
A4gnt,9,99612502,99622367,protein_coding,1,9865,chr9_99612502_99622367
Dzip1l,9,99629496,99669256,protein_coding,1,39760,chr9_99629496_99669256
Cldn18,9,99689461,99717267,protein_coding,-1,27806,chr9_99689461_99717267
Gm16004,9,99708399,99756043,antisense,1,47644,chr9_99708399_99756043
Gm47757,9,99848283,99858313,lincRNA,-1,10030,chr9_99848283_99858313
Sox14,9,99874106,99876170,protein_coding,-1,2064,chr9_99874106_99876170
4930519F24Rik,9,100022300,100034672,lincRNA,1,12372,chr9_100022300_100034672
Il20rb,9,100457719,100486788,protein_coding,-1,29069,chr9_100457719_100486788
Nck1,9,100492293,100546134,protein_coding,-1,53841,chr9_100492293_100546134
Slc35g2,9,100552188,100571090,protein_coding,-1,18902,chr9_100552188_100571090
Stag1,9,100597798,100959375,protein_coding,1,361577,chr9_100597798_100959375
Pccb,9,100982032,101034898,protein_coding,-1,52866,chr9_100982032_101034898
Msl2,9,101074101,101104800,protein_coding,1,30699,chr9_101074101_101104800
Ppp2r3a,9,101105084,101251795,protein_coding,-1,146711,chr9_101105084_101251795
Gm28979,9,101342194,101348017,lincRNA,1,5823,chr9_101342194_101348017
9630041A04Rik,9,101861841,101943228,protein_coding,1,81387,chr9_101861841_101943228
Ephb1,9,101922128,102354693,protein_coding,-1,432565,chr9_101922128_102354693
Ky,9,102505750,102546239,protein_coding,1,40489,chr9_102505750_102546239
Gm29387,9,102559300,102570708,lincRNA,1,11408,chr9_102559300_102570708
Cep63,9,102584588,102626534,protein_coding,-1,41946,chr9_102584588_102626534
Anapc13,9,102626296,102634425,protein_coding,1,8129,chr9_102626296_102634425
Amotl2,9,102716672,102733418,protein_coding,1,16746,chr9_102716672_102733418
Gm5627,9,102739648,102756685,lincRNA,1,17037,chr9_102739648_102756685
Gm47416,9,102771495,102790260,lincRNA,1,18765,chr9_102771495_102790260
Ryk,9,102834917,102908305,protein_coding,1,73388,chr9_102834917_102908305
Slco2a1,9,102988712,103096002,protein_coding,1,107290,chr9_102988712_103096002
Gm47468,9,103082741,103085537,antisense,-1,2796,chr9_103082741_103085537
Rab6b,9,103111787,103185276,protein_coding,1,73489,chr9_103111787_103185276
Srprb,9,103188032,103202137,protein_coding,-1,14105,chr9_103188032_103202137
1300017J02Rik,9,103250521,103305082,protein_coding,-1,54561,chr9_103250521_103305082
Topbp1,9,103305215,103350428,protein_coding,1,45213,chr9_103305215_103350428
Cdv3,9,103353094,103365840,protein_coding,-1,12746,chr9_103353094_103365840
Gm47328,9,103412358,103423200,lincRNA,-1,10842,chr9_103412358_103423200
5830418P13Rik,9,103423578,103461260,antisense,1,37682,chr9_103423578_103461260
Bfsp2,9,103424924,103480420,protein_coding,-1,55496,chr9_103424924_103480420
Gm16252,9,103472084,103493249,antisense,1,21165,chr9_103472084_103493249
Tmem108,9,103482947,103761837,protein_coding,-1,278890,chr9_103482947_103761837
Gm32743,9,103521787,103545977,antisense,1,24190,chr9_103521787_103545977
4932413F04Rik,9,103557090,103565891,antisense,1,8801,chr9_103557090_103565891
Gm29154,9,103888423,103960376,lincRNA,-1,71953,chr9_103888423_103960376
Gm33054,9,104001760,104002339,lincRNA,-1,579,chr9_104001760_104002339
Nphp3,9,104002544,104043818,protein_coding,1,41274,chr9_104002544_104043818
Gm28305,9,104040662,104075879,protein_coding,1,35217,chr9_104040662_104075879
Uba5,9,104046599,104063134,protein_coding,-1,16535,chr9_104046599_104063134
Acad11,9,104063377,104127725,protein_coding,1,64348,chr9_104063377_104127725
Ackr4,9,104084157,104126933,protein_coding,-1,42776,chr9_104084157_104126933
Dnajc13,9,104151282,104262930,protein_coding,-1,111648,chr9_104151282_104262930
Acpp,9,104288251,104337748,protein_coding,-1,49497,chr9_104288251_104337748
Gm28548,9,104361832,104385031,lincRNA,1,23199,chr9_104361832_104385031
Cpne4,9,104547286,105034544,protein_coding,1,487258,chr9_104547286_105034544
Mrpl3,9,105053239,105079888,protein_coding,1,26649,chr9_105053239_105079888
Gm47106,9,105064805,105088286,antisense,-1,23481,chr9_105064805_105088286
Nudt16,9,105128903,105131824,protein_coding,-1,2921,chr9_105128903_105131824
Nek11,9,105162156,105395524,protein_coding,-1,233368,chr9_105162156_105395524
Gm20643,9,105208196,105211863,antisense,1,3667,chr9_105208196_105211863
Gm15619,9,105333513,105348916,antisense,1,15403,chr9_105333513_105348916
Aste1,9,105395392,105412229,protein_coding,1,16837,chr9_105395392_105412229
Atp2c1,9,105403539,105527319,protein_coding,-1,123780,chr9_105403539_105527319
Gm19667,9,105470520,105480194,antisense,1,9674,chr9_105470520_105480194
Pik3r4,9,105642978,105687657,protein_coding,1,44679,chr9_105642978_105687657
Col6a6,9,105687809,105828160,protein_coding,-1,140351,chr9_105687809_105828160
Col6a5,9,105856078,105960643,protein_coding,-1,104565,chr9_105856078_105960643
Col6a4,9,105989454,106096783,protein_coding,-1,107329,chr9_105989454_106096783
Gm29208,9,106122079,106128095,lincRNA,-1,6016,chr9_106122079_106128095
D030055H07Rik,9,106148687,106160201,antisense,1,11514,chr9_106148687_106160201
Glyctk,9,106152857,106158138,protein_coding,-1,5281,chr9_106152857_106158138
Wdr82,9,106170928,106191139,protein_coding,1,20211,chr9_106170928_106191139
Ppm1m,9,106194947,106199746,protein_coding,-1,4799,chr9_106194947_106199746
Twf2,9,106203108,106215389,protein_coding,1,12281,chr9_106203108_106215389
Tlr9,9,106222598,106226883,protein_coding,1,4285,chr9_106222598_106226883
Alas1,9,106233455,106248654,protein_coding,-1,15199,chr9_106233455_106248654
4930500F10Rik,9,106247960,106249413,antisense,1,1453,chr9_106247960_106249413
Poc1a,9,106281061,106350521,protein_coding,1,69460,chr9_106281061_106350521
Gm29123,9,106309944,106335833,antisense,-1,25889,chr9_106309944_106335833
Dusp7,9,106368632,106375724,protein_coding,1,7092,chr9_106368632_106375724
Rpl29,9,106429454,106431568,protein_coding,1,2114,chr9_106429454_106431568
Acy1,9,106432981,106438319,protein_coding,-1,5338,chr9_106432981_106438319
Abhd14a,9,106440051,106447678,protein_coding,-1,7627,chr9_106440051_106447678
Abhd14b,9,106447459,106452923,protein_coding,1,5464,chr9_106447459_106452923
Gm28959,9,106452181,106452918,antisense,-1,737,chr9_106452181_106452918
Pcbp4,9,106453291,106464012,protein_coding,1,10721,chr9_106453291_106464012
Gpr62,9,106463962,106465938,protein_coding,-1,1976,chr9_106463962_106465938
Parp3,9,106470322,106476949,protein_coding,-1,6627,chr9_106470322_106476949
Rrp9,9,106475963,106485424,protein_coding,1,9461,chr9_106475963_106485424
Iqcf4,9,106568319,106570996,protein_coding,-1,2677,chr9_106568319_106570996
Gm28111,9,106640928,106643564,antisense,1,2636,chr9_106640928_106643564
Grm2,9,106643095,106656082,protein_coding,-1,12987,chr9_106643095_106656082
Tex264,9,106658746,106685927,protein_coding,-1,27181,chr9_106658746_106685927
Rad54l2,9,106688082,106789194,protein_coding,-1,101112,chr9_106688082_106789194
Dcaf1,9,106821874,106880992,protein_coding,1,59118,chr9_106821874_106880992
Manf,9,106838312,106891979,protein_coding,-1,53667,chr9_106838312_106891979
4930524O07Rik,9,106891547,106895182,antisense,1,3635,chr9_106891547_106895182
Dock3,9,106892825,107231909,protein_coding,-1,339084,chr9_106892825_107231909
1700039M15Rik,9,107241220,107243997,lincRNA,1,2777,chr9_107241220_107243997
Mapkapk3,9,107254927,107289877,protein_coding,-1,34950,chr9_107254927_107289877
Cish,9,107296026,107302784,protein_coding,1,6758,chr9_107296026_107302784
Gm17041,9,107300380,107301838,antisense,-1,1458,chr9_107300380_107301838
Hemk1,9,107327084,107338350,protein_coding,-1,11266,chr9_107327084_107338350
6430571L13Rik,9,107340602,107352422,protein_coding,1,11820,chr9_107340602_107352422
4930429P21Rik,9,107351276,107353986,lincRNA,-1,2710,chr9_107351276_107353986
Cacna2d2,9,107399612,107529343,protein_coding,1,129731,chr9_107399612_107529343
Gm17141,9,107423857,107430567,antisense,-1,6710,chr9_107423857_107430567
Gm17118,9,107443950,107445031,antisense,-1,1081,chr9_107443950_107445031
Tmem115,9,107533945,107538673,protein_coding,1,4728,chr9_107533945_107538673
Cyb561d2,9,107539007,107542193,protein_coding,-1,3186,chr9_107539007_107542193
Nprl2,9,107542226,107545706,protein_coding,1,3480,chr9_107542226_107545706
Zmynd10,9,107547298,107551319,protein_coding,1,4021,chr9_107547298_107551319
Gm34106,9,107547569,107550768,antisense,-1,3199,chr9_107547569_107550768
Rassf1,9,107551555,107562267,protein_coding,1,10712,chr9_107551555_107562267
Gm9917,9,107558809,107568415,antisense,-1,9606,chr9_107558809_107568415
Tusc2,9,107563255,107566112,protein_coding,1,2857,chr9_107563255_107566112
Hyal2,9,107567945,107572779,protein_coding,1,4834,chr9_107567945_107572779
Gm16343,9,107575820,107587425,antisense,-1,11605,chr9_107575820_107587425
Hyal3,9,107580818,107587359,protein_coding,1,6541,chr9_107580818_107587359
Ifrd2,9,107587642,107593385,protein_coding,1,5743,chr9_107587642_107593385
Lsmem2,9,107592630,107597075,protein_coding,-1,4445,chr9_107592630_107597075
Gm38150,9,107594440,107594891,lincRNA,1,451,chr9_107594440_107594891
Sema3b,9,107597674,107609229,protein_coding,-1,11555,chr9_107597674_107609229
Gnai2,9,107614125,107635367,protein_coding,-1,21242,chr9_107614125_107635367
Slc38a3,9,107650634,107669530,protein_coding,-1,18896,chr9_107650634_107669530
Gnat1,9,107674474,107679712,protein_coding,-1,5238,chr9_107674474_107679712
Sema3f,9,107681500,107710475,protein_coding,-1,28975,chr9_107681500_107710475
Rbm5,9,107740371,107770996,protein_coding,-1,30625,chr9_107740371_107770996
Gm37850,9,107762808,107763587,antisense,1,779,chr9_107762808_107763587
Rbm6,9,107773559,107873237,protein_coding,-1,99678,chr9_107773559_107873237
Mon1a,9,107888151,107903139,protein_coding,1,14988,chr9_107888151_107903139
Mst1r,9,107906873,107920383,protein_coding,1,13510,chr9_107906873_107920383
Gm37974,9,107935077,107936394,antisense,-1,1317,chr9_107935077_107936394
Camkv,9,107935674,107949691,protein_coding,1,14017,chr9_107935674_107949691
Traip,9,107950136,107972270,protein_coding,1,22134,chr9_107950136_107972270
Uba7,9,107975505,107984060,protein_coding,1,8555,chr9_107975505_107984060
Gm20661,9,107983058,107995007,protein_coding,1,11949,chr9_107983058_107995007
4921523L03Rik,9,107991684,107995656,antisense,-1,3972,chr9_107991684_107995656
Gm20662,9,107996349,108045270,protein_coding,1,48921,chr9_107996349_108045270
4930535L15Rik,9,107998116,108002404,antisense,-1,4288,chr9_107998116_108002404
Ip6k1,9,108002501,108048782,protein_coding,1,46281,chr9_108002501_108048782
Gm38134,9,108010976,108016608,antisense,-1,5632,chr9_108010976_108016608
Gmppb,9,108049242,108052801,protein_coding,1,3559,chr9_108049242_108052801
Rnf123,9,108051534,108083346,protein_coding,-1,31812,chr9_108051534_108083346
Amigo3,9,108053159,108055701,protein_coding,1,2542,chr9_108053159_108055701
Mst1,9,108080436,108085003,protein_coding,1,4567,chr9_108080436_108085003
Apeh,9,108085413,108094606,protein_coding,-1,9193,chr9_108085413_108094606
Bsn,9,108096022,108190384,protein_coding,-1,94362,chr9_108096022_108190384
Dag1,9,108204634,108263958,protein_coding,-1,59324,chr9_108204634_108263958
Nicn1,9,108290429,108296498,protein_coding,1,6069,chr9_108290429_108296498
Amt,9,108296853,108302302,protein_coding,1,5449,chr9_108296853_108302302
Tcta,9,108302958,108306160,protein_coding,-1,3202,chr9_108302958_108306160
Rhoa,9,108306129,108337934,protein_coding,1,31805,chr9_108306129_108337934
Gm37401,9,108337089,108338273,antisense,-1,1184,chr9_108337089_108338273
Gpx1,9,108338903,108340343,protein_coding,1,1440,chr9_108338903_108340343
Usp4,9,108347853,108392545,protein_coding,1,44692,chr9_108347853_108392545
1700102P08Rik,9,108392805,108410934,protein_coding,1,18129,chr9_108392805_108410934
Ccdc36,9,108403611,108428484,protein_coding,-1,24873,chr9_108403611_108428484
BC048562,9,108436482,108446086,protein_coding,1,9604,chr9_108436482_108446086
Klhdc8b,9,108447636,108461581,protein_coding,-1,13945,chr9_108447636_108461581
Ccdc71,9,108460527,108465938,protein_coding,1,5411,chr9_108460527_108465938
Lamb2,9,108479736,108490530,protein_coding,1,10794,chr9_108479736_108490530
Usp19,9,108490602,108502337,protein_coding,1,11735,chr9_108490602_108502337
Qars,9,108507706,108515941,protein_coding,1,8235,chr9_108507706_108515941
Qrich1,9,108516806,108560163,protein_coding,1,43357,chr9_108516806_108560163
Impdh2,9,108560286,108565584,protein_coding,1,5298,chr9_108560286_108565584
Ndufaf3,9,108565537,108567434,protein_coding,-1,1897,chr9_108565537_108567434
4833445I07Rik,9,108567533,108569174,lincRNA,1,1641,chr9_108567533_108569174
Dalrd3,9,108569886,108572774,protein_coding,1,2888,chr9_108569886_108572774
Wdr6,9,108572311,108578739,protein_coding,-1,6428,chr9_108572311_108578739
P4htm,9,108578862,108597667,protein_coding,-1,18805,chr9_108578862_108597667
Arih2,9,108602942,108649386,protein_coding,-1,46444,chr9_108602942_108649386
Slc25a20,9,108662088,108684641,protein_coding,1,22553,chr9_108662088_108684641
Prkar2a,9,108689314,108750436,protein_coding,1,61122,chr9_108689314_108750436
Ip6k2,9,108783796,108806337,protein_coding,1,22541,chr9_108783796_108806337
Nckipsd,9,108808368,108818844,protein_coding,1,10476,chr9_108808368_108818844
Celsr3,9,108826320,108852969,protein_coding,1,26649,chr9_108826320_108852969
Slc26a6,9,108853283,108913049,protein_coding,1,59766,chr9_108853283_108913049
Tmem89,9,108866488,108915563,protein_coding,1,49075,chr9_108866488_108915563
Uqcrc1,9,108888502,108949623,protein_coding,1,61121,chr9_108888502_108949623
Col7a1,9,108953586,108984875,protein_coding,1,31289,chr9_108953586_108984875
Ucn2,9,108986010,108987164,protein_coding,1,1154,chr9_108986010_108987164
Gm38004,9,108991214,108991570,lincRNA,-1,356,chr9_108991214_108991570
Pfkfb4,9,108991778,109032228,protein_coding,1,40450,chr9_108991778_109032228
Shisa5,9,109038565,109057777,protein_coding,1,19212,chr9_109038565_109057777
Atrip,9,109057933,109074124,protein_coding,-1,16191,chr9_109057933_109074124
Tma7,9,109074568,109082587,protein_coding,-1,8019,chr9_109074568_109082587
Ccdc51,9,109082493,109092489,protein_coding,1,9996,chr9_109082493_109092489
Gm7628,9,109093844,109097796,antisense,-1,3952,chr9_109093844_109097796
Plxnb1,9,109095389,109119917,protein_coding,1,24528,chr9_109095389_109119917
Fbxw21,9,109139447,109162041,protein_coding,-1,22594,chr9_109139447_109162041
Fbxw13,9,109179227,109195975,protein_coding,-1,16748,chr9_109179227_109195975
Fbxw14,9,109270790,109287676,protein_coding,-1,16886,chr9_109270790_109287676
Fbxw22,9,109378400,109404296,protein_coding,-1,25896,chr9_109378400_109404296
Fbxw16,9,109432316,109449140,protein_coding,-1,16824,chr9_109432316_109449140
Gm42493,9,109448645,109460105,antisense,1,11460,chr9_109448645_109460105
Fbxw19,9,109476654,109495875,protein_coding,-1,19221,chr9_109476654_109495875
Gm42756,9,109537100,109552780,antisense,1,15680,chr9_109537100_109552780
Fbxw15,9,109552602,109568262,protein_coding,-1,15660,chr9_109552602_109568262
Fbxw24,9,109601116,109626057,protein_coding,-1,24941,chr9_109601116_109626057
Fbxw25,9,109645122,109664652,protein_coding,-1,19530,chr9_109645122_109664652
Fbxw18,9,109676734,109702700,protein_coding,-1,25966,chr9_109676734_109702700
Fbxw26,9,109717566,109746089,protein_coding,-1,28523,chr9_109717566_109746089
Fbxw27,9,109766045,109790670,protein_coding,-1,24625,chr9_109766045_109790670
Spink8,9,109812280,109826633,protein_coding,1,14353,chr9_109812280_109826633
Nme6,9,109832749,109843116,protein_coding,1,10367,chr9_109832749_109843116
Camp,9,109847379,109849617,protein_coding,-1,2238,chr9_109847379_109849617
Cdc25a,9,109875579,109893895,protein_coding,1,18316,chr9_109875579_109893895
Map4,9,109931460,110083955,protein_coding,1,152495,chr9_109931460_110083955
Gm43732,9,109988967,109991834,antisense,-1,2867,chr9_109988967_109991834
Dhx30,9,110084320,110117830,protein_coding,-1,33510,chr9_110084320_110117830
Smarcc1,9,110117708,110240178,protein_coding,1,122470,chr9_110117708_110240178
Cspg5,9,110243783,110262576,protein_coding,1,18793,chr9_110243783_110262576
Gm42775,9,110288952,110293937,lincRNA,-1,4985,chr9_110288952_110293937
Elp6,9,110305173,110322102,protein_coding,1,16929,chr9_110305173_110322102
Scap,9,110333288,110384950,protein_coding,1,51662,chr9_110333288_110384950
Ptpn23,9,110385082,110408213,protein_coding,-1,23131,chr9_110385082_110408213
Ngp,9,110419747,110423012,protein_coding,1,3265,chr9_110419747_110423012
Klhl18,9,110425926,110476694,protein_coding,-1,50768,chr9_110425926_110476694
Kif9,9,110476958,110525179,protein_coding,1,48221,chr9_110476958_110525179
Setd2,9,110532597,110618633,protein_coding,1,86036,chr9_110532597_110618633
Nradd,9,110621135,110624452,protein_coding,-1,3317,chr9_110621135_110624452
Nbeal2,9,110624789,110654161,protein_coding,-1,29372,chr9_110624789_110654161
Ccdc12,9,110656503,110711606,protein_coding,1,55103,chr9_110656503_110711606
Gm35715,9,110669329,110674954,antisense,-1,5625,chr9_110669329_110674954
Pth1r,9,110722085,110747145,protein_coding,-1,25060,chr9_110722085_110747145
Myl3,9,110741861,110769798,protein_coding,1,27937,chr9_110741861_110769798
Prss44,9,110813994,110824523,protein_coding,1,10529,chr9_110813994_110824523
Prss43,9,110826690,110831839,protein_coding,1,5149,chr9_110826690_110831839
Prss45,9,110834588,110841313,protein_coding,1,6725,chr9_110834588_110841313
Prss46,9,110844506,110856522,protein_coding,1,12016,chr9_110844506_110856522
Prss50,9,110857967,110864629,protein_coding,1,6662,chr9_110857967_110864629
Tmie,9,110865711,110880113,protein_coding,-1,14402,chr9_110865711_110880113
Als2cl,9,110879870,110900530,protein_coding,1,20660,chr9_110879870_110900530
Fam240a,9,110914739,110916861,protein_coding,-1,2122,chr9_110914739_110916861
Tdgf1,9,110939603,110946158,protein_coding,-1,6555,chr9_110939603_110946158
Lrrc2,9,110951545,110984066,protein_coding,1,32521,chr9_110951545_110984066
Rtp3,9,110984935,110990583,protein_coding,-1,5648,chr9_110984935_110990583
Ltf,9,111019271,111042767,protein_coding,1,23496,chr9_111019271_111042767
Ccrl2,9,111054486,111057519,protein_coding,-1,3033,chr9_111054486_111057519
Lrrfip2,9,111117592,111225668,protein_coding,1,108076,chr9_111117592_111225668
Mlh1,9,111228228,111271791,protein_coding,-1,43563,chr9_111228228_111271791
Epm2aip1,9,111271929,111279093,protein_coding,1,7164,chr9_111271929_111279093
Trank1,9,111311739,111395775,protein_coding,1,84036,chr9_111311739_111395775
Dclk3,9,111439081,111489118,protein_coding,1,50037,chr9_111439081_111489118
Stac,9,111561437,111690348,protein_coding,-1,128911,chr9_111561437_111690348
4930545L08Rik,9,111912311,111918666,lincRNA,-1,6355,chr9_111912311_111918666
Arpp21,9,112065091,112235938,protein_coding,-1,170847,chr9_112065091_112235938
2310075C17Rik,9,112227579,112228242,lincRNA,1,663,chr9_112227579_112228242
2900079G21Rik,9,112234277,112348925,lincRNA,1,114648,chr9_112234277_112348925
4933411E02Rik,9,112390104,112461630,lincRNA,-1,71526,chr9_112390104_112461630
Gm36251,9,113070983,113123029,lincRNA,-1,52046,chr9_113070983_113123029
Gm4657,9,113174608,113189815,lincRNA,-1,15207,chr9_113174608_113189815
Gm36367,9,113287707,113311215,lincRNA,1,23508,chr9_113287707_113311215
Gm36485,9,113406169,113420060,lincRNA,-1,13891,chr9_113406169_113420060
Gm47875,9,113420111,113422536,lincRNA,1,2425,chr9_113420111_113422536
AU023762,9,113496746,113611783,lincRNA,-1,115037,chr9_113496746_113611783
Gm36745,9,113636528,113642054,lincRNA,-1,5526,chr9_113636528_113642054
Pdcd6ip,9,113651744,113708259,protein_coding,-1,56515,chr9_113651744_113708259
Clasp2,9,113741473,113919682,protein_coding,1,178209,chr9_113741473_113919682
Ubp1,9,113930934,113977202,protein_coding,1,46268,chr9_113930934_113977202
Fbxl2,9,113963637,114046191,protein_coding,-1,82554,chr9_113963637_114046191
Susd5,9,114057140,114098728,protein_coding,1,41588,chr9_114057140_114098728
Gm29825,9,114118088,114192640,lincRNA,1,74552,chr9_114118088_114192640
Crtap,9,114375134,114390675,protein_coding,-1,15541,chr9_114375134_114390675
Glb1,9,114401076,114474898,protein_coding,1,73822,chr9_114401076_114474898
Ccr4,9,114490316,114504916,protein_coding,-1,14600,chr9_114490316_114504916
Trim71,9,114507133,114564369,protein_coding,-1,57236,chr9_114507133_114564369
Cnot10,9,114585878,114640184,protein_coding,-1,54306,chr9_114585878_114640184
Dync1li1,9,114688790,114724302,protein_coding,1,35512,chr9_114688790_114724302
Cmtm6,9,114731116,114749344,protein_coding,1,18228,chr9_114731116_114749344
Cmtm7,9,114756836,114781856,protein_coding,-1,25020,chr9_114756836_114781856
Gm9888,9,114780100,114782257,antisense,1,2157,chr9_114780100_114782257
Cmtm8,9,114789345,114844156,protein_coding,-1,54811,chr9_114789345_114844156
Gpd1l,9,114899341,114933987,protein_coding,-1,34646,chr9_114899341_114933987
Osbpl10,9,114978569,115232225,protein_coding,1,253656,chr9_114978569_115232225
Rps27rt,9,114982366,114982739,protein_coding,-1,373,chr9_114982366_114982739
Gm4665,9,115180404,115186058,antisense,-1,5654,chr9_115180404_115186058
Gm26962,9,115195453,115196898,antisense,-1,1445,chr9_115195453_115196898
Stt3b,9,115242581,115310421,protein_coding,-1,67840,chr9_115242581_115310421
Gadl1,9,115909455,116076176,protein_coding,1,166721,chr9_115909455_116076176
Gm16142,9,115990956,116001788,antisense,-1,10832,chr9_115990956_116001788
Tgfbr2,9,116084293,116175360,protein_coding,-1,91067,chr9_116084293_116175360
Gm4668,9,116189180,116194886,lincRNA,1,5706,chr9_116189180_116194886
Gm31410,9,116218802,116249753,lincRNA,1,30951,chr9_116218802_116249753
Rbms3,9,116572746,117872681,protein_coding,-1,1299935,chr9_116572746_117872681
Gm26614,9,117873144,117881202,lincRNA,1,8058,chr9_117873144_117881202
Azi2,9,118040499,118069794,protein_coding,1,29295,chr9_118040499_118069794
Cmc1,9,118064522,118150177,protein_coding,-1,85655,chr9_118064522_118150177
Gm17399,9,118150231,118170376,lincRNA,1,20145,chr9_118150231_118170376
4933432G23Rik,9,118429836,118437048,lincRNA,1,7212,chr9_118429836_118437048
Eomes,9,118478212,118486132,protein_coding,1,7920,chr9_118478212_118486132
Gm33460,9,118485559,118489099,antisense,-1,3540,chr9_118485559_118489099
Golga4,9,118506267,118582519,protein_coding,1,76252,chr9_118506267_118582519
Gm45897,9,118584853,118590195,lincRNA,-1,5342,chr9_118584853_118590195
Itga9,9,118606690,118901003,protein_coding,1,294313,chr9_118606690_118901003
Gm2415,9,118890075,118926455,antisense,-1,36380,chr9_118890075_118926455
Gm16295,9,118924873,118925777,lincRNA,1,904,chr9_118924873_118925777
Ctdspl,9,118926453,119043998,protein_coding,1,117545,chr9_118926453_119043998
Vill,9,119052778,119071525,protein_coding,1,18747,chr9_119052778_119071525
Plcd1,9,119071527,119093502,protein_coding,-1,21975,chr9_119071527_119093502
Dlec1,9,119102478,119148246,protein_coding,1,45768,chr9_119102478_119148246
Acaa1b,9,119148023,119157093,protein_coding,-1,9070,chr9_119148023_119157093
Gm47289,9,119159161,119161669,lincRNA,1,2508,chr9_119159161_119161669
Slc22a14,9,119169455,119365553,protein_coding,-1,196098,chr9_119169455_119365553
Acaa1a,9,119339676,119350299,protein_coding,1,10623,chr9_119339676_119350299
Xylb,9,119357381,119393797,protein_coding,1,36416,chr9_119357381_119393797
Acvr2b,9,119402118,119434995,protein_coding,1,32877,chr9_119402118_119434995
Gm47320,9,119405108,119409016,antisense,-1,3908,chr9_119405108_119409016
4930516B21Rik,9,119440278,119444830,lincRNA,-1,4552,chr9_119440278_119444830
Exog,9,119444943,119465517,protein_coding,1,20574,chr9_119444943_119465517
Scn5a,9,119483408,119579016,protein_coding,-1,95608,chr9_119483408_119579016
Scn10a,9,119608456,119719322,protein_coding,-1,110866,chr9_119608456_119719322
Scn11a,9,119753759,119825456,protein_coding,-1,71697,chr9_119753759_119825456
Wdr48,9,119894878,119926587,protein_coding,1,31709,chr9_119894878_119926587
Cx3cr1,9,119901616,120069879,protein_coding,-1,168263,chr9_119901616_120069879
Ttc21a,9,119937606,119967793,protein_coding,1,30187,chr9_119937606_119967793
1700019L13Rik,9,119983146,119988092,antisense,1,4946,chr9_119983146_119988092
Gm47043,9,120004037,120005106,lincRNA,1,1069,chr9_120004037_120005106
Gm33858,9,120068996,120070622,antisense,1,1626,chr9_120068996_120070622
Slc25a38,9,120110374,120124504,protein_coding,1,14130,chr9_120110374_120124504
Rpsa,9,120127689,120132369,protein_coding,1,4680,chr9_120127689_120132369
Gm5922,9,120133463,120136329,lincRNA,-1,2866,chr9_120133463_120136329
Mobp,9,120149707,120181484,protein_coding,1,31777,chr9_120149707_120181484
Gm38642,9,120179038,120280327,lincRNA;processed_transcript,1,101289,chr9_120179038_120280327
Myrip,9,120301513,120474841,protein_coding,1,173328,chr9_120301513_120474841
D830035M03Rik,9,120490532,120492547,antisense,-1,2015,chr9_120490532_120492547
Eif1b,9,120492232,120495330,protein_coding,1,3098,chr9_120492232_120495330
Entpd3,9,120539818,120568327,protein_coding,1,28509,chr9_120539818_120568327
Rpl14,9,120571444,120574654,protein_coding,1,3210,chr9_120571444_120574654
5830454E08Rik,9,120577331,120578074,lincRNA,1,743,chr9_120577331_120578074
Gm39456,9,120611654,120620299,lincRNA,-1,8645,chr9_120611654_120620299
Gm47064,9,120743590,120751143,lincRNA,-1,7553,chr9_120743590_120751143
Gm39459,9,120834363,120844936,lincRNA,1,10573,chr9_120834363_120844936
Gm47068,9,120843445,120846181,lincRNA,-1,2736,chr9_120843445_120846181
Gm19385,9,120861615,120866756,lincRNA,-1,5141,chr9_120861615_120866756
Gm34425,9,120869160,120873860,lincRNA,1,4700,chr9_120869160_120873860
Gm47070,9,120869984,120871030,lincRNA,-1,1046,chr9_120869984_120871030
4930593C16Rik,9,120924452,120930804,antisense,-1,6352,chr9_120924452_120930804
Ctnnb1,9,120929216,120960507,protein_coding,1,31291,chr9_120929216_120960507
Ulk4,9,120955351,121277197,protein_coding,-1,321846,chr9_120955351_121277197
Trak1,9,121297502,121474918,protein_coding,1,177416,chr9_121297502_121474918
Cck,9,121489824,121495694,protein_coding,-1,5870,chr9_121489824_121495694
Gm47095,9,121515665,121536151,lincRNA,-1,20486,chr9_121515665_121536151
Gm38661,9,121523575,121530805,lincRNA,1,7230,chr9_121523575_121530805
Lyzl4,9,121577843,121642096,protein_coding,-1,64253,chr9_121577843_121642096
Lyzl4os,9,121586997,121614255,antisense,1,27258,chr9_121586997_121614255
Vipr1,9,121642716,121672954,protein_coding,1,30238,chr9_121642716_121672954
Sec22c,9,121680045,121705490,protein_coding,-1,25445,chr9_121680045_121705490
Ss18l2,9,121710329,121713388,protein_coding,1,3059,chr9_121710329_121713388
Nktr,9,121719169,121756843,protein_coding,1,37674,chr9_121719169_121756843
E530011L22Rik,9,121754662,121759943,antisense,-1,5281,chr9_121754662_121759943
Zfp651,9,121759330,121771742,protein_coding,1,12412,chr9_121759330_121771742
Klhl40,9,121777607,121783818,protein_coding,1,6211,chr9_121777607_121783818
Hhatl,9,121784016,121792507,protein_coding,-1,8491,chr9_121784016_121792507
Ccdc13,9,121797627,121839461,protein_coding,-1,41834,chr9_121797627_121839461
Gm17163,9,121820289,121831193,antisense,1,10904,chr9_121820289_121831193
Higd1a,9,121848563,121858362,protein_coding,-1,9799,chr9_121848563_121858362
Gm47112,9,121857680,121859209,antisense,1,1529,chr9_121857680_121859209
Gm47113,9,121869496,121879936,lincRNA,1,10440,chr9_121869496_121879936
Ackr2,9,121898355,121911074,protein_coding,1,12719,chr9_121898355_121911074
1700048O20Rik,9,121937223,121947016,lincRNA,1,9793,chr9_121937223_121947016
Gm49343,9,121937973,121965089,processed_transcript,1,27116,chr9_121937973_121965089
Pomgnt2,9,121981606,121997110,protein_coding,-1,15504,chr9_121981606_121997110
Gm39463,9,121996118,122012455,antisense,1,16337,chr9_121996118_122012455
Gm47117,9,122008354,122012140,lincRNA,-1,3786,chr9_122008354_122012140
Gm39465,9,122019528,122051463,lincRNA,-1,31935,chr9_122019528_122051463
Gm39464,9,122047088,122052647,lincRNA,1,5559,chr9_122047088_122052647
Snrk,9,122117266,122169702,protein_coding,1,52436,chr9_122117266_122169702
Ano10,9,122175874,122294423,protein_coding,-1,118549,chr9_122175874_122294423
Gm26797,9,122295869,122310928,lincRNA,-1,15059,chr9_122295869_122310928
Abhd5,9,122351608,122381524,protein_coding,1,29916,chr9_122351608_122381524
A730085K08Rik,9,122380575,122398801,antisense,-1,18226,chr9_122380575_122398801
Gm47128,9,122422136,122423376,lincRNA,1,1240,chr9_122422136_122423376
Gm47133,9,122531746,122535020,lincRNA,-1,3274,chr9_122531746_122535020
9530059O14Rik,9,122572499,122679596,lincRNA,1,107097,chr9_122572499_122679596
Gm47134,9,122640169,122647830,lincRNA,-1,7661,chr9_122640169_122647830
Gm35501,9,122686799,122693642,lincRNA,1,6843,chr9_122686799_122693642
Gm47136,9,122687068,122714333,lincRNA,-1,27265,chr9_122687068_122714333
Topaz1,9,122747346,122802135,protein_coding,1,54789,chr9_122747346_122802135
Tcaim,9,122805539,122836334,protein_coding,1,30795,chr9_122805539_122836334
Gm35549,9,122822776,122844035,protein_coding,-1,21259,chr9_122822776_122844035
Zfp445,9,122844529,122866006,protein_coding,-1,21477,chr9_122844529_122866006
Zkscan7,9,122885685,122914154,protein_coding;transcribed_unprocessed_pseudogene,1,28469,chr9_122885685_122914154
Zfp105,9,122923072,122931028,protein_coding,1,7956,chr9_122923072_122931028
1110059G10Rik,9,122945089,122951000,protein_coding,-1,5911,chr9_122945089_122951000
Kif15,9,122951046,123018733,protein_coding,1,67687,chr9_122951046_123018733
Gm9856,9,123018995,123021572,antisense,-1,2577,chr9_123018995_123021572
Tmem42,9,123021326,123023705,protein_coding,1,2379,chr9_123021326_123023705
Tgm4,9,123034726,123067561,protein_coding,1,32835,chr9_123034726_123067561
Zdhhc3,9,123066160,123113205,protein_coding,-1,47045,chr9_123066160_123113205
Exosc7,9,123113215,123136129,protein_coding,1,22914,chr9_123113215_123136129
Clec3b,9,123150946,123157432,protein_coding,1,6486,chr9_123150946_123157432
Cdcp1,9,123170824,123216038,protein_coding,-1,45214,chr9_123170824_123216038
Tmem158,9,123259053,123260764,protein_coding,-1,1711,chr9_123259053_123260764
Gm47162,9,123307084,123307983,lincRNA,1,899,chr9_123307084_123307983
Lars2,9,123366927,123462666,protein_coding,1,95739,chr9_123366927_123462666
Limd1,9,123478706,123521552,protein_coding,1,42846,chr9_123478706_123521552
Sacm1l,9,123529759,123592600,protein_coding,1,62841,chr9_123529759_123592600
Slc6a20b,9,123590800,123632565,protein_coding,-1,41765,chr9_123590800_123632565
Slc6a20a,9,123634770,123678885,protein_coding,-1,44115,chr9_123634770_123678885
Gm17120,9,123635388,123637325,antisense,1,1937,chr9_123635388_123637325
Ccr9,9,123678439,123784330,protein_coding,1,105891,chr9_123678439_123784330
Lztfl1,9,123694416,123717697,protein_coding,-1,23281,chr9_123694416_123717697
Fyco1,9,123789500,123851899,protein_coding,-1,62399,chr9_123789500_123851899
Cxcr6,9,123806475,123811760,protein_coding,1,5285,chr9_123806475_123811760
Xcr1,9,123852315,123862029,protein_coding,-1,9714,chr9_123852315_123862029
Ccr1,9,123962124,123968692,protein_coding,-1,6568,chr9_123962124_123968692
Ccr3,9,124021972,124031689,protein_coding,1,9717,chr9_124021972_124031689
Ccr2,9,124101950,124113557,protein_coding,1,11607,chr9_124101950_124113557
Ccr5,9,124121543,124147699,protein_coding,1,26156,chr9_124121543_124147699
Gm39469,9,124270358,124282139,lincRNA;lncRNA,-1,11781,chr9_124270358_124282139
2010315B03Rik,9,124291804,124312696,protein_coding,-1,20892,chr9_124291804_124312696
Gm47181,9,124344398,124347514,lincRNA;lncRNA,-1,3116,chr9_124344398_124347514
Ppp2r3d,9,124422622,124476898,protein_coding,-1,54276,chr9_124422622_124476898
Sfi1,11,3131850,3193463,protein_coding,-1,61613,chr11_3131850_3193463
Gm11399,11,3142048,3143363,antisense,1,1315,chr11_3142048_3143363
Drg1,11,3187360,3266415,protein_coding,-1,79055,chr11_3187360_3266415
Eif4enif1,11,3202392,3244588,protein_coding,1,42196,chr11_3202392_3244588
Patz1,11,3288874,3309083,protein_coding,1,20209,chr11_3288874_3309083
Pik3ip1,11,3330401,3342971,protein_coding,1,12570,chr11_3330401_3342971
Limk2,11,3344256,3409189,protein_coding,-1,64933,chr11_3344256_3409189
Rnf185,11,3415982,3452363,protein_coding,-1,36381,chr11_3415982_3452363
Pla2g3,11,3488284,3499350,protein_coding,1,11066,chr11_3488284_3499350
Inpp5j,11,3494375,3504821,protein_coding,-1,10446,chr11_3494375_3504821
Selenom,11,3514684,3517351,protein_coding,1,2667,chr11_3514684_3517351
Smtn,11,3517523,3540612,protein_coding,-1,23089,chr11_3517523_3540612
Tug1,11,3639785,3649673,protein_coding,-1,9888,chr11_3639785_3649673
Morc2a,11,3649191,3690477,protein_coding,1,41286,chr11_3649191_3690477
Osbp2,11,3703731,3863903,protein_coding,-1,160172,chr11_3703731_3863903
4921536K21Rik,11,3886088,3895098,protein_coding,-1,9010,chr11_3886088_3895098
Dusp18,11,3895240,3901296,protein_coding,1,6056,chr11_3895240_3901296
Slc35e4,11,3907021,3914664,protein_coding,-1,7643,chr11_3907021_3914664
Tcn2,11,3917192,3932159,protein_coding,-1,14967,chr11_3917192_3932159
4930556J24Rik,11,3937541,3976778,protein_coding,-1,39237,chr11_3937541_3976778
Pes1,11,3963975,3980004,protein_coding,1,16029,chr11_3963975_3980004
Gal3st1,11,3983636,3999326,protein_coding,1,15690,chr11_3983636_3999326
Sec14l4,11,4031462,4048024,protein_coding,1,16562,chr11_4031462_4048024
Sec14l3,11,4064841,4077736,protein_coding,1,12895,chr11_4064841_4077736
Mtfp1,11,4091480,4095445,protein_coding,-1,3965,chr11_4091480_4095445
Sec14l2,11,4097039,4123415,protein_coding,-1,26376,chr11_4097039_4123415
Rnf215,11,4135202,4141172,protein_coding,1,5970,chr11_4135202_4141172
Ccdc157,11,4141123,4160293,protein_coding,-1,19170,chr11_4141123_4160293
Sf3a1,11,4160350,4182541,protein_coding,1,22191,chr11_4160350_4182541
Tbc1d10a,11,4186789,4215505,protein_coding,1,28716,chr11_4186789_4215505
Osm,11,4236420,4241026,protein_coding,1,4606,chr11_4236420_4241026
Hormad2,11,4345814,4441105,protein_coding,-1,95291,chr11_4345814_4441105
Mtmr3,11,4480868,4594863,protein_coding,-1,113995,chr11_4480868_4594863
Gm11032,11,4620067,4621698,protein_coding,1,1631,chr11_4620067_4621698
Gm11961,11,4620275,4630011,antisense,-1,9736,chr11_4620275_4630011
Ascc2,11,4637747,4685699,protein_coding,1,47952,chr11_4637747_4685699
Uqcr10,11,4701973,4704342,protein_coding,-1,2369,chr11_4701973_4704342
Zmat5,11,4704678,4737669,protein_coding,1,32991,chr11_4704678_4737669
Cabp7,11,4736892,4746778,protein_coding,-1,9886,chr11_4736892_4746778
Nf2,11,4765845,4849536,protein_coding,-1,83691,chr11_4765845_4849536
Nipsnap1,11,4873951,4894200,protein_coding,1,20249,chr11_4873951_4894200
Thoc5,11,4895320,4928867,protein_coding,1,33547,chr11_4895320_4928867
Nefh,11,4938754,4948064,protein_coding,-1,9310,chr11_4938754_4948064
Ap1b1,11,4986824,5042791,protein_coding,1,55967,chr11_4986824_5042791
Gas2l1,11,5054132,5065327,protein_coding,-1,11195,chr11_5054132_5065327
Rasl10a,11,5058128,5060385,protein_coding,1,2257,chr11_5058128_5060385
Ewsr1,11,5069689,5099266,protein_coding,-1,29577,chr11_5069689_5099266
Rhbdd3,11,5098926,5106093,protein_coding,1,7167,chr11_5098926_5106093
Emid1,11,5106265,5152257,protein_coding,-1,45992,chr11_5106265_5152257
Kremen1,11,5191552,5261558,protein_coding,-1,70006,chr11_5191552_5261558
Znrf3,11,5276324,5444847,protein_coding,-1,168523,chr11_5276324_5444847
Gm11963,11,5498840,5505699,antisense,1,6859,chr11_5498840_5505699
Xbp1,11,5520659,5525893,protein_coding,1,5234,chr11_5520659_5525893
Ccdc117,11,5528887,5542187,protein_coding,-1,13300,chr11_5528887_5542187
Ankrd36,11,5569684,5689337,protein_coding,1,119653,chr11_5569684_5689337
Mrps24,11,5703983,5715680,protein_coding,-1,11697,chr11_5703983_5715680
Urgcp,11,5713417,5762376,protein_coding,-1,48959,chr11_5713417_5762376
Dbnl,11,5788488,5800962,protein_coding,1,12474,chr11_5788488_5800962
Pgam2,11,5801640,5803733,protein_coding,-1,2093,chr11_5801640_5803733
Polm,11,5827860,5838016,protein_coding,-1,10156,chr11_5827860_5838016
Aebp1,11,5861947,5872088,protein_coding,1,10141,chr11_5861947_5872088
Pold2,11,5872180,5878292,protein_coding,-1,6112,chr11_5872180_5878292
Gck,11,5900820,5950081,protein_coding,-1,49261,chr11_5900820_5950081
Gm11967,11,5915315,5916731,antisense,1,1416,chr11_5915315_5916731
Ykt6,11,5955693,5967780,protein_coding,1,12087,chr11_5955693_5967780
Camk2b,11,5969644,6066362,protein_coding,-1,96718,chr11_5969644_6066362
Nudcd3,11,6105691,6200415,protein_coding,-1,94724,chr11_6105691_6200415
A730071L15Rik,11,6200029,6201643,protein_coding,1,1614,chr11_6200029_6201643
Npc1l1,11,6211013,6230143,protein_coding,-1,19130,chr11_6211013_6230143
Ddx56,11,6258919,6267772,protein_coding,-1,8853,chr11_6258919_6267772
Tmed4,11,6270369,6274870,protein_coding,-1,4501,chr11_6270369_6274870
Ogdh,11,6291633,6356642,protein_coding,1,65009,chr11_6291633_6356642
Zmiz2,11,6389074,6406158,protein_coding,1,17084,chr11_6389074_6406158
Ppia,11,6415443,6419817,protein_coding,1,4374,chr11_6415443_6419817
Purb,11,6467599,6475917,protein_coding,-1,8318,chr11_6467599_6475917
Gm11973,11,6475425,6493535,antisense,1,18110,chr11_6475425_6493535
Myo1g,11,6506548,6520965,protein_coding,-1,14417,chr11_6506548_6520965
Ccm2,11,6546887,6596744,protein_coding,1,49857,chr11_6546887_6596744
Nacad,11,6597823,6606053,protein_coding,-1,8230,chr11_6597823_6606053
Tbrg4,11,6615598,6626067,protein_coding,-1,10469,chr11_6615598_6626067
Wap,11,6635482,6638637,protein_coding,-1,3155,chr11_6635482_6638637
Ramp3,11,6658521,6677475,protein_coding,1,18954,chr11_6658521_6677475
Gm11983,11,6835626,6837654,protein_coding,-1,2028,chr11_6835626_6837654
Adcy1,11,7063489,7178506,protein_coding,1,115017,chr11_7063489_7178506
Igfbp1,11,7197782,7202546,protein_coding,1,4764,chr11_7197782_7202546
Igfbp3,11,7206086,7213923,protein_coding,-1,7837,chr11_7206086_7213923
Gm11986,11,7270351,7290374,lincRNA,-1,20023,chr11_7270351_7290374
Tns3,11,8431652,8664681,protein_coding,-1,233029,chr11_8431652_8664681
Pkd1l1,11,8826708,8973266,protein_coding,-1,146558,chr11_8826708_8973266
Hus1,11,8993137,9011191,protein_coding,-1,18054,chr11_8993137_9011191
Sun3,11,9016054,9048991,protein_coding,-1,32937,chr11_9016054_9048991
Gm11992,11,9048594,9069356,protein_coding,1,20762,chr11_9048594_9069356
Upp1,11,9118103,9136170,protein_coding,1,18067,chr11_9118103_9136170
Abca13,11,9191942,9684259,protein_coding,1,492317,chr11_9191942_9684259
Vwc2,11,11114223,11268931,protein_coding,1,154708,chr11_11114223_11268931
Zpbp,11,11279626,11462408,protein_coding,-1,182782,chr11_11279626_11462408
Spata48,11,11462094,11515192,protein_coding,1,53098,chr11_11462094_11515192
Gm11998,11,11557421,11579460,antisense,1,22039,chr11_11557421_11579460
4930512M02Rik,11,11589223,11627835,protein_coding,-1,38612,chr11_11589223_11627835
Ikzf1,11,11685003,11772926,protein_coding,1,87923,chr11_11685003_11772926
Fignl1,11,11787431,11808962,protein_coding,-1,21531,chr11_11787431_11808962
Ddc,11,11814101,11898144,protein_coding,-1,84043,chr11_11814101_11898144
1700042O10Rik,11,11868123,11885321,antisense,1,17198,chr11_11868123_11885321
Grb10,11,11930508,12038683,protein_coding,-1,108175,chr11_11930508_12038683
Cobl,11,12236608,12464960,protein_coding,-1,228352,chr11_12236608_12464960
Gm12002,11,12314514,12351028,antisense,1,36514,chr11_12314514_12351028
4930554G24Rik,11,14072103,14179041,lincRNA,-1,106938,chr11_14072103_14179041
1700046C09Rik,11,14560355,14599225,lincRNA,-1,38870,chr11_14560355_14599225
Vstm2a,11,16257724,16427310,protein_coding,1,169586,chr11_16257724_16427310
Sec61g,11,16500530,16508484,protein_coding,-1,7954,chr11_16500530_16508484
Egfr,11,16752203,16918158,protein_coding,1,165955,chr11_16752203_16918158
Egfros,11,16815431,16830702,antisense,-1,15271,chr11_16815431_16830702
Fbxo48,11,16951375,16954772,protein_coding,1,3397,chr11_16951375_16954772
Plek,11,16971206,17052381,protein_coding,-1,81175,chr11_16971206_17052381
Cnrip1,11,17051586,17079371,protein_coding,1,27785,chr11_17051586_17079371
Ppp3r1,11,17159263,17200375,protein_coding,1,41112,chr11_17159263_17200375
Wdr92,11,17182107,17233796,protein_coding,1,51689,chr11_17182107_17233796
Pno1,11,17203198,17211568,protein_coding,-1,8370,chr11_17203198_17211568
C1d,11,17257579,17269176,protein_coding,1,11597,chr11_17257579_17269176
Etaa1,11,17938756,17953875,protein_coding,-1,15119,chr11_17938756_17953875
Etaa1os,11,17953970,17959578,antisense,1,5608,chr11_17953970_17959578
Gm12018,11,18095986,18103384,lincRNA,1,7398,chr11_18095986_18103384
Gm12022,11,18467479,18493255,lincRNA,-1,25776,chr11_18467479_18493255
Gm12023,11,18595248,18710222,lincRNA,-1,114974,chr11_18595248_18710222
Meis1,11,18879817,19018985,protein_coding,-1,139168,chr11_18879817_19018985
Gm16140,11,19009128,19011183,antisense,1,2055,chr11_19009128_19011183
Gm16141,11,19013817,19015154,antisense,1,1337,chr11_19013817_19015154
4933406G16Rik,11,19065276,19075740,lincRNA,1,10464,chr11_19065276_19075740
Gm12027,11,19626761,19628061,lincRNA,-1,1300,chr11_19626761_19628061
Spred2,11,19924375,20024026,protein_coding,1,99651,chr11_19924375_20024026
Actr2,11,20062304,20112913,protein_coding,-1,50609,chr11_20062304_20112913
Gm12031,11,20145567,20146344,lincRNA,-1,777,chr11_20145567_20146344
Rab1a,11,20201432,20226856,protein_coding,1,25424,chr11_20201432_20226856
Cep68,11,20227037,20249429,protein_coding,-1,22392,chr11_20227037_20249429
Slc1a4,11,20302180,20332713,protein_coding,-1,30533,chr11_20302180_20332713
Sertad2,11,20543253,20653021,protein_coding,1,109768,chr11_20543253_20653021
Aftph,11,20685084,20741589,protein_coding,-1,56505,chr11_20685084_20741589
Lgalsl,11,20823576,20831056,protein_coding,-1,7480,chr11_20823576_20831056
Gm12037,11,20831481,20831919,lincRNA,-1,438,chr11_20831481_20831919
Peli1,11,21091291,21150323,protein_coding,1,59032,chr11_21091291_21150323
Vps54,11,21239281,21321136,protein_coding,1,81855,chr11_21239281_21321136
Ugp2,11,21321138,21371201,protein_coding,-1,50063,chr11_21321138_21371201
4932414J04Rik,11,21494730,21511178,lincRNA,-1,16448,chr11_21494730_21511178
Mdh1,11,21556692,21572367,protein_coding,-1,15675,chr11_21556692_21572367
Wdpcp,11,21572235,21898989,protein_coding,1,326754,chr11_21572235_21898989
Otx1,11,21994764,22002897,protein_coding,-1,8133,chr11_21994764_22002897
Ehbp1,11,22005828,22342292,protein_coding,-1,336464,chr11_22005828_22342292
Gm12050,11,22438821,22439775,lincRNA,-1,954,chr11_22438821_22439775
Gm12051,11,22483608,22491363,lincRNA,1,7755,chr11_22483608_22491363
Tmem17,11,22512088,22519234,protein_coding,1,7146,chr11_22512088_22519234
Gm12052,11,22617408,22618487,lincRNA,1,1079,chr11_22617408_22618487
Gm12055,11,22729897,22732986,lincRNA,-1,3089,chr11_22729897_22732986
B3gnt2,11,22759738,22860961,protein_coding,-1,101223,chr11_22759738_22860961
Commd1,11,22896136,22982382,protein_coding,-1,86246,chr11_22896136_22982382
Zrsr1,11,22972005,22976496,protein_coding,1,4491,chr11_22972005_22976496
Cct4,11,22990519,23003780,protein_coding,1,13261,chr11_22990519_23003780
Fam161a,11,23007531,23030788,protein_coding,1,23257,chr11_23007531_23030788
1700061J23Rik,11,23152140,23166375,lincRNA,1,14235,chr11_23152140_23166375
Xpo1,11,23256041,23298249,protein_coding,1,42208,chr11_23256041_23298249
Usp34,11,23306895,23490560,protein_coding,1,183665,chr11_23306895_23490560
Ahsa2,11,23487882,23498030,protein_coding,-1,10148,chr11_23487882_23498030
1700093K21Rik,11,23516203,23521155,protein_coding,-1,4952,chr11_23516203_23521155
0610010F05Rik,11,23564961,23633639,protein_coding,-1,68678,chr11_23564961_23633639
Pex13,11,23646479,23665959,protein_coding,-1,19480,chr11_23646479_23665959
Pus10,11,23665674,23732876,protein_coding,1,67202,chr11_23665674_23732876
Rel,11,23736847,23770970,protein_coding,-1,34123,chr11_23736847_23770970
Papolg,11,23862646,23895253,protein_coding,-1,32607,chr11_23862646_23895253
Gm12061,11,23894560,23895488,antisense,1,928,chr11_23894560_23895488
A830031A19Rik,11,24048955,24075054,protein_coding,-1,26099,chr11_24048955_24075054
Gm12063,11,24076559,24077367,lincRNA,1,808,chr11_24076559_24077367
Bcl11a,11,24078056,24174123,protein_coding,1,96067,chr11_24078056_24174123
Gm12064,11,24099688,24115405,antisense,-1,15717,chr11_24099688_24115405
4930538E20Rik,11,24160528,24172824,antisense,-1,12296,chr11_24160528_24172824
Gm12065,11,24198737,24202624,lincRNA,-1,3887,chr11_24198737_24202624
Gm12066,11,24201418,24217601,lincRNA,1,16183,chr11_24201418_24217601
Gm12068,11,24426246,24722646,lincRNA,1,296400,chr11_24426246_24722646
Gm10466,11,24721006,24730722,lincRNA,-1,9716,chr11_24721006_24730722
Gm12665,11,24903983,24926058,lincRNA,-1,22075,chr11_24903983_24926058
4933427E13Rik,11,25232626,25367137,lincRNA,1,134511,chr11_25232626_25367137
5730522E02Rik,11,25602763,26210763,protein_coding,-1,608000,chr11_25602763_26210763
Fancl,11,26386135,26471876,protein_coding,1,85741,chr11_26386135_26471876
Vrk2,11,26471322,26593999,protein_coding,-1,122677,chr11_26471322_26593999
Gm6685,11,28339128,28339814,processed_pseudogene,-1,686,chr11_28339128_28339814
Gm12081,11,28360362,28364339,antisense,1,3977,chr11_28360362_28364339
Ccdc85a,11,28385685,28584324,protein_coding,-1,198639,chr11_28385685_28584324
2810471M01Rik,11,28681564,28693276,lincRNA,1,11712,chr11_28681564_28693276
Efemp1,11,28853204,28926743,protein_coding,1,73539,chr11_28853204_28926743
Pnpt1,11,29130744,29161828,protein_coding,1,31084,chr11_29130744_29161828
Ppp4r3b,11,29172890,29220797,protein_coding,1,47907,chr11_29172890_29220797
Cfap36,11,29221532,29247409,protein_coding,-1,25877,chr11_29221532_29247409
Ccdc88a,11,29373658,29510808,protein_coding,1,137150,chr11_29373658_29510808
Prorsd1,11,29511757,29515033,protein_coding,-1,3276,chr11_29511757_29515033
Gm12089,11,29515086,29517355,antisense,1,2269,chr11_29515086_29517355
Mtif2,11,29526408,29545279,protein_coding,1,18871,chr11_29526408_29545279
Rps27a,11,29545846,29548109,protein_coding,-1,2263,chr11_29545846_29548109
Clhc1,11,29547950,29578367,protein_coding,1,30417,chr11_29547950_29578367
Gm12088,11,29595787,29597700,lincRNA,1,1913,chr11_29595787_29597700
Gm12092,11,29612324,29645509,lincRNA,-1,33185,chr11_29612324_29645509
Rtn4,11,29692947,29744331,protein_coding,1,51384,chr11_29692947_29744331
Eml6,11,29743048,30026033,protein_coding,-1,282985,chr11_29743048_30026033
Sptbn1,11,30099395,30268175,protein_coding,-1,168780,chr11_30099395_30268175
Gm29237,11,30106394,30108120,antisense,1,1726,chr11_30106394_30108120
4930505A04Rik,11,30426006,30471827,protein_coding,-1,45821,chr11_30426006_30471827
Acyp2,11,30505991,30649587,protein_coding,-1,143596,chr11_30505991_30649587
Psme4,11,30771726,30880361,protein_coding,1,108635,chr11_30771726_30880361
Gpr75,11,30885358,30893729,protein_coding,1,8371,chr11_30885358_30893729
Asb3,11,30885416,31102704,protein_coding,1,217288,chr11_30885416_31102704
Erlec1,11,30930774,30954335,protein_coding,-1,23561,chr11_30930774_30954335
Chac2,11,30976707,30986350,protein_coding,-1,9643,chr11_30976707_30986350
Stc2,11,31357307,31370074,protein_coding,-1,12767,chr11_31357307_31370074
Bod1,11,31665181,31671885,protein_coding,-1,6704,chr11_31665181_31671885
D630024D03Rik,11,31790113,31824524,lincRNA,-1,34411,chr11_31790113_31824524
Gm12107,11,31832660,31838214,lincRNA,1,5554,chr11_31832660_31838214
Cpeb4,11,31872211,31935634,protein_coding,1,63423,chr11_31872211_31935634
4930524B15Rik,11,31965592,31979651,protein_coding,1,14059,chr11_31965592_31979651
Nsg2,11,32000463,32059202,protein_coding,1,58739,chr11_32000463_32059202
Gm12108,11,32095261,32101228,lincRNA,-1,5967,chr11_32095261_32101228
Il9r,11,32187541,32200279,protein_coding,-1,12738,chr11_32187541_32200279
Snrnp25,11,32205415,32208984,protein_coding,1,3569,chr11_32205415_32208984
Rhbdf1,11,32209585,32222300,protein_coding,-1,12715,chr11_32209585_32222300
Nprl3,11,32225628,32267707,protein_coding,-1,42079,chr11_32225628_32267707
Mpg,11,32226505,32232700,protein_coding,1,6195,chr11_32226505_32232700
Hba-x,11,32276400,32278116,protein_coding,1,1716,chr11_32276400_32278116
Hba-a1,11,32283511,32284465,protein_coding,1,954,chr11_32283511_32284465
Hbq1b,11,32286965,32287784,protein_coding,1,819,chr11_32286965_32287784
Hba-a2,11,32296489,32297298,protein_coding,1,809,chr11_32296489_32297298
Hbq1a,11,32300069,32300873,protein_coding,1,804,chr11_32300069_32300873
Sh3pxd2b,11,32347820,32428173,protein_coding,1,80353,chr11_32347820_32428173
Ubtd2,11,32455370,32516687,protein_coding,1,61317,chr11_32455370_32516687
Efcab9,11,32522751,32532081,protein_coding,-1,9330,chr11_32522751_32532081
Stk10,11,32533305,32624587,protein_coding,1,91282,chr11_32533305_32624587
Fbxw11,11,32642724,32746816,protein_coding,1,104092,chr11_32642724_32746816
Smim23,11,32818529,32824605,protein_coding,-1,6076,chr11_32818529_32824605
Gm12111,11,32903137,32926160,lincRNA,-1,23023,chr11_32903137_32926160
Gm12114,11,33068551,33080521,lincRNA,1,11970,chr11_33068551_33080521
Fgf18,11,33117430,33147400,protein_coding,-1,29970,chr11_33117430_33147400
Npm1,11,33152287,33163206,protein_coding,-1,10919,chr11_33152287_33163206
Gm12116,11,33204055,33221477,lincRNA,1,17422,chr11_33204055_33221477
Ranbp17,11,33211795,33513746,protein_coding,-1,301951,chr11_33211795_33513746
Gabrp,11,33550781,33578959,protein_coding,-1,28178,chr11_33550781_33578959
D130052B06Rik,11,33599302,33625618,lincRNA,1,26316,chr11_33599302_33625618
Kcnip1,11,33629339,33993152,protein_coding,-1,363813,chr11_33629339_33993152
Gm12119,11,33695894,33697908,antisense,1,2014,chr11_33695894_33697908
Gm12120,11,33705550,33711435,antisense,1,5885,chr11_33705550_33711435
Kcnmb1,11,33963013,33973641,protein_coding,1,10628,chr11_33963013_33973641
4930469K13Rik,11,33973961,34098554,protein_coding,-1,124593,chr11_33973961_34098554
Lcp2,11,34046920,34092295,protein_coding,1,45375,chr11_34046920_34092295
Dock2,11,34226815,34783892,protein_coding,-1,557077,chr11_34226815_34783892
Spdl1,11,34809190,34833641,protein_coding,-1,24451,chr11_34809190_34833641
Slit3,11,35121224,35708507,protein_coding,1,587283,chr11_35121224_35708507
Pank3,11,35769484,35791285,protein_coding,1,21801,chr11_35769484_35791285
Fbll1,11,35797382,35798884,protein_coding,-1,1502,chr11_35797382_35798884
Rars,11,35808381,35834506,protein_coding,-1,26125,chr11_35808381_35834506
Wwc1,11,35838400,35980527,protein_coding,-1,142127,chr11_35838400_35980527
Tenm2,11,36006656,37235964,protein_coding,-1,1229308,chr11_36006656_37235964
Gm12126,11,36080664,36083854,antisense,1,3190,chr11_36080664_36083854
Gm12127,11,36278041,36279987,antisense,1,1946,chr11_36278041_36279987
Gm12128,11,37658989,37673166,lincRNA,1,14177,chr11_37658989_37673166
Gm12130,11,38493330,38520013,lincRNA,-1,26683,chr11_38493330_38520013
Gm12132,11,40008194,40337831,lincRNA,1,329637,chr11_40008194_40337831
3110004A20Rik,11,40474718,40475677,lincRNA,-1,959,chr11_40474718_40475677
Mat2b,11,40679314,40695203,protein_coding,-1,15889,chr11_40679314_40695203
Hmmr,11,40701395,40733422,protein_coding,-1,32027,chr11_40701395_40733422
Nudcd2,11,40733667,40740046,protein_coding,1,6379,chr11_40733667_40740046
Ccng1,11,40748552,40755311,protein_coding,-1,6759,chr11_40748552_40755311
Platr13,11,41218837,41221096,lincRNA,1,2259,chr11_41218837_41221096
Gabrg2,11,41910203,42000857,protein_coding,-1,90654,chr11_41910203_42000857
Gabra1,11,42130939,42182930,protein_coding,-1,51991,chr11_42130939_42182930
Gabra6,11,42306437,42321072,protein_coding,-1,14635,chr11_42306437_42321072
Gabrb2,11,42419757,42629028,protein_coding,1,209271,chr11_42419757_42629028
Gm12145,11,43106140,43116294,lincRNA,-1,10154,chr11_43106140_43116294
Atp10b,11,43149877,43262285,protein_coding,1,112408,chr11_43149877_43262285
Gm12146,11,43197424,43259784,antisense,-1,62360,chr11_43197424_43259784
Gm12147,11,43259791,43311088,antisense,-1,51297,chr11_43259791_43311088
Gm12148,11,43385482,43387183,lincRNA,1,1701,chr11_43385482_43387183
Pttg1,11,43420250,43426251,protein_coding,-1,6001,chr11_43420250_43426251
Slu7,11,43433744,43447981,protein_coding,1,14237,chr11_43433744_43447981
C1qtnf2,11,43474276,43491525,protein_coding,1,17249,chr11_43474276_43491525
Ccnjl,11,43528784,43586997,protein_coding,1,58213,chr11_43528784_43586997
Gm12150,11,43579602,43581116,antisense,-1,1514,chr11_43579602_43581116
4933415A04Rik,11,43587040,43589048,lincRNA,1,2008,chr11_43587040_43589048
Fabp6,11,43596049,43601540,protein_coding,-1,5491,chr11_43596049_43601540
Pwwp2a,11,43681998,43721491,protein_coding,1,39493,chr11_43681998_43721491
Ttc1,11,43729512,43748008,protein_coding,-1,18496,chr11_43729512_43748008
Adra1b,11,43774606,43901210,protein_coding,-1,126604,chr11_43774606_43901210
Gm12153,11,43959089,44134987,lincRNA,1,175898,chr11_43959089_44134987
Gm12154,11,44265563,44267209,lincRNA,-1,1646,chr11_44265563_44267209
Il12b,11,44400063,44414033,protein_coding,1,13970,chr11_44400063_44414033
Ublcp1,11,44454571,44470498,protein_coding,-1,15927,chr11_44454571_44470498
Rnf145,11,44518964,44565520,protein_coding,1,46556,chr11_44518964_44565520
4930597A21Rik,11,44586317,44591229,lincRNA,1,4912,chr11_44586317_44591229
Ebf1,11,44617317,45008091,protein_coding,1,390774,chr11_44617317_45008091
Gm12158,11,44659522,44662676,antisense,-1,3154,chr11_44659522_44662676
Gm12159,11,45102866,45116928,lincRNA,-1,14062,chr11_45102866_45116928
Gm12160,11,45160943,45213656,lincRNA,1,52713,chr11_45160943_45213656
Gm12162,11,45409042,45468504,lincRNA,-1,59462,chr11_45409042_45468504
Clint1,11,45851964,45910625,protein_coding,1,58661,chr11_45851964_45910625
Lsm11,11,45928269,45944935,protein_coding,-1,16666,chr11_45928269_45944935
Thg1l,11,45946843,45955494,protein_coding,-1,8651,chr11_45946843_45955494
Sox30,11,45980310,46017994,protein_coding,1,37684,chr11_45980310_46017994
Gm12166,11,46051354,46052321,protein_coding,-1,967,chr11_46051354_46052321
Adam19,11,46055992,46147343,protein_coding,1,91351,chr11_46055992_46147343
Gm16033,11,46143783,46147116,antisense,-1,3333,chr11_46143783_46147116
Nipal4,11,46148155,46166508,protein_coding,-1,18353,chr11_46148155_46166508
Cyfip2,11,46193850,46312859,protein_coding,-1,119009,chr11_46193850_46312859
Fndc9,11,46235531,46239872,protein_coding,1,4341,chr11_46235531_46239872
Itk,11,46325150,46389515,protein_coding,-1,64365,chr11_46325150_46389515
Gm12167,11,46342287,46345020,antisense,1,2733,chr11_46342287_46345020
Fam71b,11,46396559,46407982,protein_coding,1,11423,chr11_46396559_46407982
Med7,11,46436925,46442721,protein_coding,1,5796,chr11_46436925_46442721
Havcr2,11,46454935,46481255,protein_coding,1,26320,chr11_46454935_46481255
Gm12169,11,46524212,46538156,protein_coding,1,13944,chr11_46524212_46538156
Gm12171,11,46544209,46557067,lincRNA,1,12858,chr11_46544209_46557067
BC053393,11,46571536,46589232,protein_coding,1,17696,chr11_46571536_46589232
Dppa1,11,46607772,46629261,protein_coding,-1,21489,chr11_46607772_46629261
Gm4926,11,46636516,46645006,lincRNA,-1,8490,chr11_46636516_46645006
Timd2,11,46668960,46707061,protein_coding,-1,38101,chr11_46668960_46707061
Havcr1,11,46735080,46779578,protein_coding,1,44498,chr11_46735080_46779578
Timd4,11,46810800,46844332,protein_coding,1,33532,chr11_46810800_46844332
Sgcd,11,46896253,47988969,protein_coding,-1,1092716,chr11_46896253_47988969
Rack1,11,48800332,48806434,protein_coding,1,6102,chr11_48800332_48806434
Trim41,11,48806404,48817353,protein_coding,-1,10949,chr11_48806404_48817353
Gm12184,11,48825346,48826655,protein_coding,-1,1309,chr11_48825346_48826655
Trim7,11,48826140,48852209,protein_coding,1,26069,chr11_48826140_48852209
Gm16170,11,48843648,48853493,antisense,-1,9845,chr11_48843648_48853493
Irgm1,11,48861968,48871683,protein_coding,-1,9715,chr11_48861968_48871683
Gm5431,11,48887422,48902214,protein_coding,-1,14792,chr11_48887422_48902214
Gm12185,11,48904656,48992226,protein_coding,-1,87570,chr11_48904656_48992226
Olfr56,11,48978889,49135387,protein_coding,1,156498,chr11_48978889_49135387
9930111J21Rik2,11,49015874,49051242,protein_coding,-1,35368,chr11_49015874_49051242
Olfr1395,11,49142274,49150453,protein_coding,1,8179,chr11_49142274_49150453
Olfr1394,11,49154377,49162854,protein_coding,1,8477,chr11_49154377_49162854
Btnl9,11,49165585,49187159,protein_coding,-1,21574,chr11_49165585_49187159
Zfp62,11,49203292,49218816,protein_coding,1,15524,chr11_49203292_49218816
Mgat1,11,49244191,49263030,protein_coding,1,18839,chr11_49244191_49263030
Olfr1393,11,49278304,49282769,protein_coding,1,4465,chr11_49278304_49282769
Olfr1392,11,49285282,49295891,protein_coding,1,10609,chr11_49285282_49295891
Olfr10,11,49304741,49320021,protein_coding,1,15280,chr11_49304741_49320021
Olfr1391,11,49322742,49329810,protein_coding,1,7068,chr11_49322742_49329810
Olfr1390,11,49335188,49342247,protein_coding,1,7059,chr11_49335188_49342247
Olfr1389,11,49423067,49432968,protein_coding,1,9901,chr11_49423067_49432968
Olfr1388,11,49436624,49446103,protein_coding,1,9479,chr11_49436624_49446103
Olfr1385,11,49489070,49497496,protein_coding,1,8426,chr11_49489070_49497496
Olfr1384,11,49506724,49517345,protein_coding,1,10621,chr11_49506724_49517345
Olfr1383,11,49519648,49527199,protein_coding,1,7551,chr11_49519648_49527199
Olfr1382,11,49528247,49538691,protein_coding,1,10444,chr11_49528247_49538691
Olfr1381,11,49543449,49556127,protein_coding,1,12678,chr11_49543449_49556127
Olfr1380,11,49556878,49565859,protein_coding,1,8981,chr11_49556878_49565859
Flt4,11,49609263,49652739,protein_coding,1,43476,chr11_49609263_49652739
Scgb3a1,11,49663610,49665118,protein_coding,1,1508,chr11_49663610_49665118
Cnot6,11,49671503,49712723,protein_coding,-1,41220,chr11_49671503_49712723
Gfpt2,11,49794178,49838613,protein_coding,1,44435,chr11_49794178_49838613
Mapk9,11,49846751,49886421,protein_coding,1,39670,chr11_49846751_49886421
Rasgef1c,11,49901835,49980994,protein_coding,1,79159,chr11_49901835_49980994
Rnf130,11,50025346,50125719,protein_coding,1,100373,chr11_50025346_50125719
Tbc1d9b,11,50131396,50172785,protein_coding,1,41389,chr11_50131396_50172785
Gm12195,11,50134082,50135004,antisense,-1,922,chr11_50134082_50135004
Mrnip,11,50174444,50200115,protein_coding,1,25671,chr11_50174444_50200115
Sqstm1,11,50199366,50210827,protein_coding,-1,11461,chr11_50199366_50210827
Mgat4b,11,50210890,50235103,protein_coding,1,24213,chr11_50210890_50235103
Ltc4s,11,50236461,50238616,protein_coding,-1,2155,chr11_50236461_50238616
Gm26542,11,50236953,50288839,antisense,1,51886,chr11_50236953_50288839
Maml1,11,50255634,50292311,protein_coding,-1,36677,chr11_50255634_50292311
Canx,11,50293961,50325673,protein_coding,-1,31712,chr11_50293961_50325673
Cby3,11,50354462,50359699,protein_coding,1,5237,chr11_50354462_50359699
Hnrnph1,11,50376990,50386528,protein_coding,1,9538,chr11_50376990_50386528
Rufy1,11,50389286,50431125,protein_coding,-1,41839,chr11_50389286_50431125
Adamts2,11,50602084,50807573,protein_coding,1,205489,chr11_50602084_50807573
Gm12200,11,50720082,50725544,antisense,-1,5462,chr11_50720082_50725544
Zfp354c,11,50811086,50827724,protein_coding,-1,16638,chr11_50811086_50827724
Zfp879,11,50832031,50841552,protein_coding,-1,9521,chr11_50832031_50841552
Grm6,11,50850685,50866208,protein_coding,1,15523,chr11_50850685_50866208
Zfp454,11,50872720,50887651,protein_coding,-1,14931,chr11_50872720_50887651
Zfp2,11,50898712,50916165,protein_coding,-1,17453,chr11_50898712_50916165
Zfp354b,11,50921823,50931633,protein_coding,-1,9810,chr11_50921823_50931633
Olfr51,11,51003596,51009676,protein_coding,1,6080,chr11_51003596_51009676
Olfr54,11,51014236,51031578,protein_coding,1,17342,chr11_51014236_51031578
Zfp354a,11,51059257,51072799,protein_coding,1,13542,chr11_51059257_51072799
9230009I02Rik,11,51085087,51091833,lincRNA,1,6746,chr11_51085087_51091833
Platr20,11,51189833,51220418,lincRNA,-1,30585,chr11_51189833_51220418
Gm12569,11,51220473,51235053,protein_coding,1,14580,chr11_51220473_51235053
BC049762,11,51253651,51263046,protein_coding,-1,9395,chr11_51253651_51263046
Clk4,11,51261730,51281766,protein_coding,1,20036,chr11_51261730_51281766
Col23a1,11,51289920,51583918,protein_coding,1,293998,chr11_51289920_51583918
Phykpl,11,51584757,51604489,protein_coding,1,19732,chr11_51584757_51604489
Hnrnpab,11,51600100,51606847,protein_coding,-1,6747,chr11_51600100_51606847
Nhp2,11,51619735,51623714,protein_coding,1,3979,chr11_51619735_51623714
Rmnd5b,11,51623671,51635896,protein_coding,-1,12225,chr11_51623671_51635896
N4bp3,11,51643063,51650842,protein_coding,-1,7779,chr11_51643063_51650842
D930048N14Rik,11,51650954,51657681,protein_coding,1,6727,chr11_51650954_51657681
0610009B22Rik,11,51685386,51688874,protein_coding,-1,3488,chr11_51685386_51688874
Sec24a,11,51692264,51763634,protein_coding,-1,71370,chr11_51692264_51763634
Sar1b,11,51763687,51791925,protein_coding,1,28238,chr11_51763687_51791925
Jade2,11,51813455,51857653,protein_coding,-1,44198,chr11_51813455_51857653
Gm39822,11,51898966,51909624,lincRNA,1,10658,chr11_51898966_51909624
Cdkn2aipnl,11,51967661,51977334,protein_coding,1,9673,chr11_51967661_51977334
Gm12204,11,52000853,52001911,antisense,1,1058,chr11_52000853_52001911
Cdkl3,11,52004221,52089784,protein_coding,1,85563,chr11_52004221_52089784
Ppp2ca,11,52098681,52127778,protein_coding,1,29097,chr11_52098681_52127778
Skp1a,11,52231995,52246858,protein_coding,1,14863,chr11_52231995_52246858
Tcf7,11,52252371,52283331,protein_coding,-1,30960,chr11_52252371_52283331
A630014C17Rik,11,52276055,52286179,antisense,1,10124,chr11_52276055_52286179
Vdac1,11,52360860,52389397,protein_coding,1,28537,chr11_52360860_52389397
9530068E07Rik,11,52396428,52408728,protein_coding,1,12300,chr11_52396428_52408728
Fstl4,11,52764634,53188538,protein_coding,1,423904,chr11_52764634_53188538
Gm11186,11,53111451,53120056,antisense,-1,8605,chr11_53111451_53120056
Hspa4,11,53259814,53300457,protein_coding,-1,40643,chr11_53259814_53300457
Zcchc10,11,53324679,53333301,protein_coding,1,8622,chr11_53324679_53333301
Aff4,11,53350833,53421830,protein_coding,1,70997,chr11_53350833_53421830
Leap2,11,53422181,53423170,protein_coding,-1,989,chr11_53422181_53423170
Uqcrq,11,53427922,53430831,protein_coding,-1,2909,chr11_53427922_53430831
Gdf9,11,53431023,53437904,protein_coding,1,6881,chr11_53431023_53437904
Gm10447,11,53454804,53457110,bidirectional_promoter_lncRNA,-1,2306,chr11_53454804_53457110
Shroom1,11,53457205,53467766,protein_coding,1,10561,chr11_53457205_53467766
Gm12212,11,53462379,53463613,antisense,-1,1234,chr11_53462379_53463613
Sowaha,11,53476573,53480274,protein_coding,-1,3701,chr11_53476573_53480274
Kif3a,11,53567379,53601967,protein_coding,1,34588,chr11_53567379_53601967
Il4,11,53602982,53618669,protein_coding,-1,15687,chr11_53602982_53618669
Il13,11,53631324,53634702,protein_coding,-1,3378,chr11_53631324_53634702
Rad50,11,53649519,53707319,protein_coding,-1,57800,chr11_53649519_53707319
Il5,11,53720794,53725106,protein_coding,1,4312,chr11_53720794_53725106
Gm12214,11,53723953,53724618,antisense,-1,665,chr11_53723953_53724618
Irf1,11,53770014,53778374,protein_coding,1,8360,chr11_53770014_53778374
Gm12216,11,53783418,53859256,protein_coding,-1,75838,chr11_53783418_53859256
Slc22a5,11,53864542,53891660,protein_coding,-1,27118,chr11_53864542_53891660
Slc22a21,11,53949965,53980332,protein_coding,-1,30367,chr11_53949965_53980332
Slc22a4,11,53983123,54028090,protein_coding,-1,44967,chr11_53983123_54028090
Pdlim4,11,54054928,54069014,protein_coding,-1,14086,chr11_54054928_54069014
P4ha2,11,54100095,54131665,protein_coding,1,31570,chr11_54100095_54131665
4933405E24Rik,11,54177772,54213285,lincRNA,-1,35513,chr11_54177772_54213285
Csf2,11,54247271,54249667,protein_coding,-1,2396,chr11_54247271_54249667
Gm12223,11,54247600,54254495,antisense,1,6895,chr11_54247600_54254495
Acsl6,11,54303798,54364756,protein_coding,1,60958,chr11_54303798_54364756
Gm12224,11,54340369,54353479,antisense,-1,13110,chr11_54340369_54353479
Meikin,11,54370652,54426790,protein_coding,1,56138,chr11_54370652_54426790
Fnip1,11,54438199,54518235,protein_coding,1,80036,chr11_54438199_54518235
Rapgef6,11,54522847,54699285,protein_coding,1,176438,chr11_54522847_54699285
Cdc42se2,11,54717456,54787675,protein_coding,-1,70219,chr11_54717456_54787675
Gm12227,11,54728677,54734323,antisense,1,5646,chr11_54728677_54734323
Lyrm7os,11,54819919,54824967,antisense,1,5048,chr11_54819919_54824967
Lyrm7,11,54826866,54860916,protein_coding,-1,34050,chr11_54826866_54860916
Hint1,11,54866383,54870501,protein_coding,1,4118,chr11_54866383_54870501
Gpx3,11,54902453,54910377,protein_coding,1,7924,chr11_54902453_54910377
Tnip1,11,54910785,54962917,protein_coding,-1,52132,chr11_54910785_54962917
Anxa6,11,54979108,55033445,protein_coding,-1,54337,chr11_54979108_55033445
Ccdc69,11,55049731,55078131,protein_coding,-1,28400,chr11_55049731_55078131
Gm2a,11,55098115,55113029,protein_coding,1,14914,chr11_55098115_55113029
Slc36a3,11,55124815,55151708,protein_coding,-1,26893,chr11_55124815_55151708
Slc36a3os,11,55137044,55140193,antisense,1,3149,chr11_55137044_55140193
Slc36a2,11,55158470,55185077,protein_coding,-1,26607,chr11_55158470_55185077
Slc36a1os,11,55191719,55197864,antisense,-1,6145,chr11_55191719_55197864
Slc36a1,11,55204350,55236330,protein_coding,1,31980,chr11_55204350_55236330
Fat2,11,55250609,55336564,protein_coding,-1,85955,chr11_55250609_55336564
Sparc,11,55394500,55423183,protein_coding,-1,28683,chr11_55394500_55423183
Atox1,11,55446641,55461239,protein_coding,-1,14598,chr11_55446641_55461239
G3bp1,11,55469685,55504838,protein_coding,1,35153,chr11_55469685_55504838
Glra1,11,55514238,55608198,protein_coding,-1,93960,chr11_55514238_55608198
Gm12236,11,55514846,55527715,antisense,1,12869,chr11_55514846_55527715
Gm12239,11,55772088,56070848,antisense,1,298760,chr11_55772088_56070848
Nmur2,11,56024987,56041010,protein_coding,-1,16023,chr11_56024987_56041010
Gria1,11,57011387,57330244,protein_coding,1,318857,chr11_57011387_57330244
Fam114a2,11,57482993,57518617,protein_coding,-1,35624,chr11_57482993_57518617
Mfap3,11,57518664,57533815,protein_coding,1,15151,chr11_57518664_57533815
Gm12243,11,57572512,57574595,lincRNA,1,2083,chr11_57572512_57574595
4933424L21Rik,11,57623698,57649494,antisense,-1,25796,chr11_57623698_57649494
Galnt10,11,57645442,57787514,protein_coding,1,142072,chr11_57645442_57787514
4933426K07Rik,11,57655415,57657826,antisense,-1,2411,chr11_57655415_57657826
Sap30l,11,57801637,57810217,protein_coding,1,8580,chr11_57801637_57810217
Larp1,11,58009064,58062034,protein_coding,1,52970,chr11_58009064_58062034
Gm12248,11,58063552,58093134,protein_coding,-1,29582,chr11_58063552_58093134
Cnot8,11,58104153,58118594,protein_coding,1,14441,chr11_58104153_58118594
Gemin5,11,58120002,58168539,protein_coding,-1,48537,chr11_58120002_58168539
Gm12246,11,58126068,58128512,antisense,1,2444,chr11_58126068_58128512
Mrpl22,11,58171661,58179565,protein_coding,1,7904,chr11_58171661_58179565
Irgm2,11,58199618,58222782,protein_coding,1,23164,chr11_58199618_58222782
4930438A08Rik,11,58274799,58294289,protein_coding,1,19490,chr11_58274799_58294289
Zfp692,11,58307069,58314627,protein_coding,1,7558,chr11_58307069_58314627
Zfp672,11,58315114,58330339,protein_coding,-1,15225,chr11_58315114_58330339
Sh3bp5l,11,58330724,58347728,protein_coding,1,17004,chr11_58330724_58347728
Lypd8,11,58379043,58390728,protein_coding,1,11685,chr11_58379043_58390728
Gm12253,11,58432559,58441622,protein_coding,1,9063,chr11_58432559_58441622
Olfr30,11,58454105,58462270,protein_coding,-1,8165,chr11_58454105_58462270
Olfr330,11,58527186,58534836,protein_coding,-1,7650,chr11_58527186_58534836
Olfr328,11,58550854,58555636,protein_coding,-1,4782,chr11_58550854_58555636
Olfr224,11,58565856,58570553,protein_coding,-1,4697,chr11_58565856_58570553
Olfr324,11,58595114,58600783,protein_coding,1,5669,chr11_58595114_58600783
2210407C18Rik,11,58608204,58616075,protein_coding,-1,7871,chr11_58608204_58616075
Olfr323,11,58624159,58630501,protein_coding,-1,6342,chr11_58624159_58630501
Trim58,11,58640465,58652404,protein_coding,1,11939,chr11_58640465_58652404
Olfr322,11,58658782,58669528,protein_coding,1,10746,chr11_58658782_58669528
Olfr320,11,58681099,58686233,protein_coding,1,5134,chr11_58681099_58686233
Olfr319,11,58699162,58703472,protein_coding,1,4310,chr11_58699162_58703472
Olfr318,11,58717197,58724014,protein_coding,-1,6817,chr11_58717197_58724014
Olfr317,11,58731018,58739212,protein_coding,-1,8194,chr11_58731018_58739212
Olfr316,11,58752734,58759671,protein_coding,1,6937,chr11_58752734_58759671
Olfr315,11,58773188,58780251,protein_coding,1,7063,chr11_58773188_58780251
Fam183b,11,58792797,58801960,protein_coding,-1,9163,chr11_58792797_58801960
Olfr312,11,58829237,58834780,protein_coding,1,5543,chr11_58829237_58834780
Olfr311,11,58839251,58844111,protein_coding,1,4860,chr11_58839251_58844111
Gm12258,11,58847158,58861956,protein_coding,1,14798,chr11_58847158_58861956
Gm12259,11,58865965,58867154,lincRNA,1,1189,chr11_58865965_58867154
2810021J22Rik,11,58867216,58883288,protein_coding,1,16072,chr11_58867216_58883288
Zfp39,11,58888153,58904225,protein_coding,-1,16072,chr11_58888153_58904225
Gm12256,11,58889710,58891548,antisense,1,1838,chr11_58889710_58891548
Gm12257,11,58904402,58906170,antisense,1,1768,chr11_58904402_58906170
Rnf187,11,58932288,58938916,protein_coding,-1,6628,chr11_58932288_58938916
Trim17,11,58954685,58973098,protein_coding,1,18413,chr11_58954685_58973098
Trim11,11,58978093,58991458,protein_coding,1,13365,chr11_58978093_58991458
Obscn,11,58994256,59139170,protein_coding,-1,144914,chr11_58994256_59139170
Gm10435,11,59002910,59007293,antisense,1,4383,chr11_59002910_59007293
Iba57,11,59155369,59163739,protein_coding,-1,8370,chr11_59155369_59163739
Gjc2,11,59175568,59183213,protein_coding,-1,7645,chr11_59175568_59183213
Guk1,11,59183875,59192212,protein_coding,-1,8337,chr11_59183875_59192212
Mrpl55,11,59202486,59206134,protein_coding,1,3648,chr11_59202486_59206134
2310033P09Rik,11,59208321,59210738,protein_coding,1,2417,chr11_59208321_59210738
Arf1,11,59211412,59228270,protein_coding,-1,16858,chr11_59211412_59228270
Wnt3a,11,59248033,59290752,protein_coding,-1,42719,chr11_59248033_59290752
Wnt9a,11,59306928,59333552,protein_coding,1,26624,chr11_59306928_59333552
Prss38,11,59372669,59375657,protein_coding,-1,2988,chr11_59372669_59375657
Gm15755,11,59375461,59379905,antisense,1,4444,chr11_59375461_59379905
Snap47,11,59407134,59451186,protein_coding,-1,44052,chr11_59407134_59451186
Jmjd4,11,59450045,59458567,protein_coding,1,8522,chr11_59450045_59458567
Zfp867,11,59461197,59472474,protein_coding,-1,11277,chr11_59461197_59472474
Zkscan17,11,59485520,59526751,protein_coding,-1,41231,chr11_59485520_59526751
Nlrp3,11,59541568,59566956,protein_coding,1,25388,chr11_59541568_59566956
Olfr222,11,59570255,59576235,protein_coding,-1,5980,chr11_59570255_59576235
Mprip,11,59661305,59780860,protein_coding,1,119555,chr11_59661305_59780860
Gm12264,11,59775286,59780321,antisense,-1,5035,chr11_59775286_59780321
Pld6,11,59783897,59787645,protein_coding,-1,3748,chr11_59783897_59787645
Flcn,11,59791408,59810016,protein_coding,-1,18608,chr11_59791408_59810016
Gm16062,11,59810080,59818491,antisense,1,8411,chr11_59810080_59818491
Cops3,11,59817795,59839838,protein_coding,-1,22043,chr11_59817795_59839838
Nt5m,11,59839447,59880968,protein_coding,1,41521,chr11_59839447_59880968
Gm12714,11,59898374,59907319,lincRNA,1,8945,chr11_59898374_59907319
Med9os,11,59946889,59948142,antisense,-1,1253,chr11_59946889_59948142
Med9,11,59948206,59962205,protein_coding,1,13999,chr11_59948206_59962205
Rasd1,11,59963181,59964944,protein_coding,-1,1763,chr11_59963181_59964944
Pemt,11,59970614,60046489,protein_coding,-1,75875,chr11_59970614_60046489
Rai1,11,60105013,60199197,protein_coding,1,94184,chr11_60105013_60199197
4930412M03Rik,11,60112219,60115230,lincRNA,-1,3011,chr11_60112219_60115230
Srebf1,11,60199089,60222581,protein_coding,-1,23492,chr11_60199089_60222581
Tom1l2,11,60226714,60352905,protein_coding,-1,126191,chr11_60226714_60352905
Gm12265,11,60240810,60241930,antisense,1,1120,chr11_60240810_60241930
Drc3,11,60353329,60394341,protein_coding,1,41012,chr11_60353329_60394341
Atpaf2,11,60400626,60418457,protein_coding,-1,17831,chr11_60400626_60418457
Gid4,11,60417145,60450927,protein_coding,1,33782,chr11_60417145_60450927
Drg2,11,60454591,60468754,protein_coding,1,14163,chr11_60454591_60468754
Myo15,11,60469339,60528369,protein_coding,1,59030,chr11_60469339_60528369
Alkbh5,11,60536381,60558512,protein_coding,1,22131,chr11_60536381_60558512
Llgl1,11,60699723,60714186,protein_coding,1,14463,chr11_60699723_60714186
Flii,11,60714123,60727263,protein_coding,-1,13140,chr11_60714123_60727263
Mief2,11,60728398,60732951,protein_coding,1,4553,chr11_60728398_60732951
Top3a,11,60740058,60777365,protein_coding,-1,37307,chr11_60740058_60777365
Smcr8,11,60777524,60788287,protein_coding,1,10763,chr11_60777524_60788287
Shmt1,11,60788104,60811718,protein_coding,-1,23614,chr11_60788104_60811718
Dhrs7b,11,60830631,60860195,protein_coding,1,29564,chr11_60830631_60860195
Tmem11,11,60864452,60879272,protein_coding,-1,14820,chr11_60864452_60879272
Natd1,11,60902246,60914750,protein_coding,-1,12504,chr11_60902246_60914750
Map2k3os,11,60920917,60931867,antisense,-1,10950,chr11_60920917_60931867
Map2k3,11,60932033,60952811,protein_coding,1,20778,chr11_60932033_60952811
Kcnj12,11,61022564,61071131,protein_coding,1,48567,chr11_61022564_61071131
Tnfrsf13b,11,61126755,61149372,protein_coding,1,22617,chr11_61126755_61149372
Usp22,11,61151785,61175055,protein_coding,-1,23270,chr11_61151785_61175055
Aldh3a1,11,61207537,61218421,protein_coding,1,10884,chr11_61207537_61218421
Aldh3a2,11,61223417,61267464,protein_coding,-1,44047,chr11_61223417_61267464
Slc47a2,11,61301631,61342860,protein_coding,-1,41229,chr11_61301631_61342860
Slc47a1,11,61343401,61378345,protein_coding,-1,34944,chr11_61343401_61378345
Gm45605,11,61408018,61412286,lincRNA,1,4268,chr11_61408018_61412286
Rnf112,11,61448442,61454131,protein_coding,-1,5689,chr11_61448442_61454131
Mfap4,11,61485431,61488900,protein_coding,1,3469,chr11_61485431_61488900
Mapk7,11,61488812,61494406,protein_coding,-1,5594,chr11_61488812_61494406
B9d1os,11,61504386,61505059,antisense,-1,673,chr11_61504386_61505059
B9d1,11,61505144,61512931,protein_coding,1,7787,chr11_61505144_61512931
Epn2,11,61517249,61579687,protein_coding,-1,62438,chr11_61517249_61579687
Gm12272,11,61527755,61528577,antisense,1,822,chr11_61527755_61528577
Grap,11,61653265,61672784,protein_coding,1,19519,chr11_61653265_61672784
Slc5a10,11,61672781,61720826,protein_coding,-1,48045,chr11_61672781_61720826
Fam83g,11,61684091,61709951,protein_coding,1,25860,chr11_61684091_61709951
Prpsap2,11,61729650,61762088,protein_coding,-1,32438,chr11_61729650_61762088
Ulk2,11,61775649,61855073,protein_coding,-1,79424,chr11_61775649_61855073
A530017D24Rik,11,61864568,61868058,lincRNA,-1,3490,chr11_61864568_61868058
Gm26964,11,61865475,61867639,lincRNA,1,2164,chr11_61865475_61867639
Akap10,11,61871307,61930252,protein_coding,-1,58945,chr11_61871307_61930252
Gm12273,11,61950915,61952736,lincRNA,1,1821,chr11_61950915_61952736
Specc1,11,61956763,62223013,protein_coding,1,266250,chr11_61956763_62223013
Adora2b,11,62248984,62266453,protein_coding,1,17469,chr11_62248984_62266453
Zswim7,11,62267224,62281375,protein_coding,-1,14151,chr11_62267224_62281375
Ttc19,11,62281473,62328451,protein_coding,1,46978,chr11_62281473_62328451
Ncor1,11,62316426,62458541,protein_coding,-1,142115,chr11_62316426_62458541
Pigl,11,62458460,62514417,protein_coding,1,55957,chr11_62458460_62514417
Gm12949,11,62522741,62523542,antisense,1,801,chr11_62522741_62523542
Cenpv,11,62524946,62539261,protein_coding,-1,14315,chr11_62524946_62539261
Gm12279,11,62550047,62551041,antisense,-1,994,chr11_62550047_62551041
Ubb,11,62551171,62553213,protein_coding,1,2042,chr11_62551171_62553213
Trpv2,11,62574486,62600515,protein_coding,1,26029,chr11_62574486_62600515
Lrrc75a,11,62604884,62648523,protein_coding,-1,43639,chr11_62604884_62648523
Lrrc75aos2,11,62605766,62607748,antisense,1,1982,chr11_62605766_62607748
Lrrc75aos1,11,62634704,62638788,antisense,1,4084,chr11_62634704_62638788
Mmgt2,11,62648664,62666354,protein_coding,1,17690,chr11_62648664_62666354
Zfp287,11,62700356,62731905,protein_coding,-1,31549,chr11_62700356_62731905
Gm27194,11,62749852,62752787,lincRNA,1,2935,chr11_62749852_62752787
Zfp286,11,62752577,62789462,protein_coding,-1,36885,chr11_62752577_62789462
Gm10428,11,62753100,62753498,protein_coding,1,398,chr11_62753100_62753498
Zfp286os,11,62761236,62765554,antisense,1,4318,chr11_62761236_62765554
Trim16,11,62820231,62850808,protein_coding,1,30577,chr11_62820231_62850808
Fbxw10,11,62847069,62877465,protein_coding,1,30396,chr11_62847069_62877465
Tvp23b,11,62879455,62916780,protein_coding,1,37325,chr11_62879455_62916780
Tvp23bos,11,62919079,62921592,antisense,-1,2513,chr11_62919079_62921592
Cdrt4,11,62951193,62993095,protein_coding,1,41902,chr11_62951193_62993095
Cdrt4os1,11,62990453,63004134,antisense,-1,13681,chr11_62990453_63004134
Tekt3,11,63061654,63094964,protein_coding,1,33310,chr11_63061654_63094964
Pmp22,11,63128982,63159547,protein_coding,1,30565,chr11_63128982_63159547
B430319H21Rik,11,63173914,63188454,lincRNA,1,14540,chr11_63173914_63188454
Hs3st3b1,11,63885792,63922290,protein_coding,-1,36498,chr11_63885792_63922290
Cox10,11,63962627,64079468,protein_coding,-1,116841,chr11_63962627_64079468
9630013K17Rik,11,63964226,63968040,antisense,1,3814,chr11_63964226_63968040
Gm12289,11,64012615,64015224,antisense,1,2609,chr11_64012615_64015224
2810001G20Rik,11,64079484,64083259,antisense,1,3775,chr11_64079484_64083259
Gm12290,11,64164573,64182171,lincRNA,1,17598,chr11_64164573_64182171
Hs3st3a1,11,64435332,64522841,protein_coding,1,87509,chr11_64435332_64522841
Elac2,11,64979038,65002069,protein_coding,1,23031,chr11_64979038_65002069
Arhgap44,11,65002039,65162961,protein_coding,-1,160922,chr11_65002039_65162961
Myocd,11,65176561,65269989,protein_coding,-1,93428,chr11_65176561_65269989
Gm12295,11,65277654,65365798,lincRNA,-1,88144,chr11_65277654_65365798
Map2k4,11,65688243,65788297,protein_coding,-1,100054,chr11_65688243_65788297
Zkscan6,11,65807175,65829239,protein_coding,1,22064,chr11_65807175_65829239
Dnah9,11,65831282,66168551,protein_coding,-1,337269,chr11_65831282_66168551
Shisa6,11,66211725,66525964,protein_coding,-1,314239,chr11_66211725_66525964
Gm12298,11,66905721,66947086,antisense,-1,41365,chr11_66905721_66947086
Pirt,11,66911981,66929876,protein_coding,1,17895,chr11_66911981_66929876
Tmem220,11,67025154,67035312,protein_coding,1,10158,chr11_67025154_67035312
Adprm,11,67037905,67052594,protein_coding,-1,14689,chr11_67037905_67052594
Sco1,11,67052670,67067070,protein_coding,1,14400,chr11_67052670_67067070
Myh3,11,67078300,67102291,protein_coding,1,23991,chr11_67078300_67102291
2310065F04Rik,11,67112461,67120080,lincRNA,-1,7619,chr11_67112461_67120080
Myh2,11,67171027,67197517,protein_coding,1,26490,chr11_67171027_67197517
9430073C21Rik,11,67195680,67199234,antisense,-1,3554,chr11_67195680_67199234
Myh1,11,67200052,67224575,protein_coding,1,24523,chr11_67200052_67224575
Myhas,11,67211256,67237573,antisense,-1,26317,chr11_67211256_67237573
Myh4,11,67238029,67260446,protein_coding,1,22417,chr11_67238029_67260446
Myh8,11,67277124,67308634,protein_coding,1,31510,chr11_67277124_67308634
Myh13,11,67321658,67371586,protein_coding,1,49928,chr11_67321658_67371586
Gas7,11,67455091,67688990,protein_coding,1,233899,chr11_67455091_67688990
Gm12301,11,67571622,67577466,antisense,-1,5844,chr11_67571622_67577466
Glp2r,11,67661502,67771153,protein_coding,-1,109651,chr11_67661502_67771153
Rcvrn,11,67695326,67703333,protein_coding,1,8007,chr11_67695326_67703333
Gsg1l2,11,67774608,67789898,protein_coding,1,15290,chr11_67774608_67789898
Dhrs7c,11,67798187,67816002,protein_coding,1,17815,chr11_67798187_67816002
Usp43,11,67854523,67922153,protein_coding,-1,67630,chr11_67854523_67922153
Cfap52,11,67924806,67965651,protein_coding,-1,40845,chr11_67924806_67965651
Stx8,11,67966193,68207148,protein_coding,1,240955,chr11_67966193_68207148
C78197,11,68192193,68196153,antisense,-1,3960,chr11_68192193_68196153
Ntn1,11,68209364,68400823,protein_coding,-1,191459,chr11_68209364_68400823
Pik3r5,11,68432121,68497849,protein_coding,1,65728,chr11_68432121_68497849
Pik3r6,11,68503019,68552698,protein_coding,1,49679,chr11_68503019_68552698
Mfsd6l,11,68556186,68558245,protein_coding,1,2059,chr11_68556186_68558245
Ccdc42os,11,68583264,68586957,antisense,-1,3693,chr11_68583264_68586957
Ccdc42,11,68587021,68597966,protein_coding,1,10945,chr11_68587021_68597966
Myh10,11,68691559,68816632,protein_coding,1,125073,chr11_68691559_68816632
Ndel1,11,68821434,68871858,protein_coding,-1,50424,chr11_68821434_68871858
Rpl26,11,68901583,68906989,protein_coding,1,5406,chr11_68901583_68906989
Odf4,11,68921835,68927081,protein_coding,-1,5246,chr11_68921835_68927081
Arhgef15,11,68943155,68957480,protein_coding,-1,14325,chr11_68943155_68957480
Slc25a35,11,68968131,68974365,protein_coding,1,6234,chr11_68968131_68974365
Rangrf,11,68972484,68975185,protein_coding,-1,2701,chr11_68972484_68975185
Pfas,11,68985697,69008460,protein_coding,-1,22763,chr11_68985697_69008460
Ctc1,11,69015911,69036473,protein_coding,1,20562,chr11_69015911_69036473
Aurkb,11,69045647,69051664,protein_coding,1,6017,chr11_69045647_69051664
9330160F10Rik,11,69057718,69060483,antisense,-1,2765,chr11_69057718_69060483
Borcs6,11,69059717,69061578,protein_coding,1,1861,chr11_69059717_69061578
Tmem107,11,69070806,69073293,protein_coding,1,2487,chr11_69070806_69073293
Vamp2,11,69088490,69092384,protein_coding,1,3894,chr11_69088490_69092384
Per1,11,69095217,69109960,protein_coding,1,14743,chr11_69095217_69109960
9130213A22Rik,11,69120054,69122589,antisense,-1,2535,chr11_69120054_69122589
Hes7,11,69120404,69124055,protein_coding,1,3651,chr11_69120404_69124055
Aloxe3,11,69125896,69149115,protein_coding,1,23219,chr11_69125896_69149115
Alox12b,11,69156989,69169792,protein_coding,1,12803,chr11_69156989_69169792
Alox8,11,69183932,69197843,protein_coding,-1,13911,chr11_69183932_69197843
Gucy2e,11,69218117,69237036,protein_coding,-1,18919,chr11_69218117_69237036
Cntrob,11,69299487,69323775,protein_coding,-1,24288,chr11_69299487_69323775
Trappc1,11,69323980,69325793,protein_coding,1,1813,chr11_69323980_69325793
Kcnab3,11,69326258,69333042,protein_coding,1,6784,chr11_69326258_69333042
Kcnab3os,11,69329825,69332122,antisense,-1,2297,chr11_69329825_69332122
Chd3,11,69343273,69369406,protein_coding,-1,26133,chr11_69343273_69369406
Cyb5d1,11,69391925,69395631,protein_coding,-1,3706,chr11_69391925_69395631
Naa38,11,69395487,69396680,protein_coding,1,1193,chr11_69395487_69396680
Tmem88,11,69396519,69398234,protein_coding,-1,1715,chr11_69396519_69398234
Kdm6b,11,69398508,69413675,protein_coding,-1,15167,chr11_69398508_69413675
Kdm6bos,11,69401513,69402700,antisense,1,1187,chr11_69401513_69402700
Dnah2,11,69420809,69549110,protein_coding,-1,128301,chr11_69420809_69549110
Dnah2os,11,69448548,69453676,antisense,1,5128,chr11_69448548_69453676
Efnb3,11,69554092,69560205,protein_coding,-1,6113,chr11_69554092_69560205
Wrap53,11,69561758,69580255,protein_coding,-1,18497,chr11_69561758_69580255
Trp53,11,69580359,69591873,protein_coding,1,11514,chr11_69580359_69591873
Atp1b2,11,69599736,69605942,protein_coding,-1,6206,chr11_69599736_69605942
Sat2,11,69622024,69623870,protein_coding,1,1846,chr11_69622024_69623870
Fxr2,11,69632990,69653297,protein_coding,1,20307,chr11_69632990_69653297
Sox15,11,69655314,69656727,protein_coding,1,1413,chr11_69655314_69656727
Mpdu1,11,69656697,69662642,protein_coding,-1,5945,chr11_69656697_69662642
Cd68,11,69664213,69666153,protein_coding,-1,1940,chr11_69664213_69666153
Eif4a1,11,69666936,69672423,protein_coding,-1,5487,chr11_69666936_69672423
Senp3,11,69673115,69682084,protein_coding,-1,8969,chr11_69673115_69682084
Tnfsf13os,11,69682138,69691141,antisense,1,9003,chr11_69682138_69691141
Tnfsfm13,11,69682577,69696098,protein_coding,-1,13521,chr11_69682577_69696098
Polr2a,11,69733997,69758637,protein_coding,-1,24640,chr11_69733997_69758637
Slc35g3,11,69759890,69761968,protein_coding,-1,2078,chr11_69759890_69761968
Zbtb4,11,69765912,69784023,protein_coding,1,18111,chr11_69765912_69784023
Chrnb1,11,69784036,69795943,protein_coding,-1,11907,chr11_69784036_69795943
Fgf11,11,69796068,69801857,protein_coding,-1,5789,chr11_69796068_69801857
Tmem102,11,69803603,69805624,protein_coding,-1,2021,chr11_69803603_69805624
Spem1,11,69820876,69822180,protein_coding,-1,1304,chr11_69820876_69822180
Nlgn2,11,69823122,69837784,protein_coding,-1,14662,chr11_69823122_69837784
Tmem256,11,69838514,69839618,protein_coding,1,1104,chr11_69838514_69839618
Plscr3,11,69846376,69852058,protein_coding,1,5682,chr11_69846376_69852058
Tnk1,11,69851005,69858730,protein_coding,-1,7725,chr11_69851005_69858730
Kctd11,11,69878261,69881406,protein_coding,-1,3145,chr11_69878261_69881406
Acap1,11,69881567,69895539,protein_coding,-1,13972,chr11_69881567_69895539
2810408A11Rik,11,69897352,69900987,protein_coding,-1,3635,chr11_69897352_69900987
Neurl4,11,69901072,69913820,protein_coding,1,12748,chr11_69901072_69913820
Gps2,11,69913888,69916591,protein_coding,1,2703,chr11_69913888_69916591
Eif5a,11,69916714,69921958,protein_coding,-1,5244,chr11_69916714_69921958
Ybx2,11,69935796,69941605,protein_coding,1,5809,chr11_69935796_69941605
Cldn7,11,69964779,69967885,protein_coding,1,3106,chr11_69964779_69967885
Elp5,11,69968222,69982517,protein_coding,-1,14295,chr11_69968222_69982517
Ctdnep1,11,69981156,69990601,protein_coding,1,9445,chr11_69981156_69990601
Gabarap,11,69991143,69994951,protein_coding,1,3808,chr11_69991143_69994951
Phf23,11,69995777,70000009,protein_coding,1,4232,chr11_69995777_70000009
Dvl2,11,70000595,70012301,protein_coding,1,11706,chr11_70000595_70012301
Acadvl,11,70010183,70015411,protein_coding,-1,5228,chr11_70010183_70015411
Dlg4,11,70016942,70047522,protein_coding,1,30580,chr11_70016942_70047522
Asgr1,11,70054085,70057894,protein_coding,1,3809,chr11_70054085_70057894
Mgl2,11,70130329,70137550,protein_coding,1,7221,chr11_70130329_70137550
Clec10a,11,70156197,70170834,protein_coding,1,14637,chr11_70156197_70170834
Slc16a11,11,70212752,70216417,protein_coding,1,3665,chr11_70212752_70216417
Slc16a13,11,70216789,70221064,protein_coding,-1,4275,chr11_70216789_70221064
Bcl6b,11,70224128,70229798,protein_coding,-1,5670,chr11_70224128_70229798
Gm21988,11,70235206,70239830,protein_coding,-1,4624,chr11_70235206_70239830
Rnasek,11,70238124,70239842,protein_coding,-1,1718,chr11_70238124_70239842
Alox12,11,70241457,70255353,protein_coding,-1,13896,chr11_70241457_70255353
Alox12e,11,70315610,70322628,protein_coding,-1,7018,chr11_70315610_70322628
Alox15,11,70344152,70352031,protein_coding,-1,7879,chr11_70344152_70352031
Pelp1,11,70392883,70410031,protein_coding,-1,17148,chr11_70392883_70410031
Arrb2,11,70432635,70440828,protein_coding,1,8193,chr11_70432635_70440828
Med11,11,70451919,70453727,protein_coding,1,1808,chr11_70451919_70453727
Cxcl16,11,70453983,70459984,protein_coding,-1,6001,chr11_70453983_70459984
Zmynd15,11,70459433,70466202,protein_coding,1,6769,chr11_70459433_70466202
Tm4sf5,11,70505244,70511178,protein_coding,1,5934,chr11_70505244_70511178
Vmo1,11,70513516,70514616,protein_coding,-1,1100,chr11_70513516_70514616
Gltpd2,11,70519196,70520736,protein_coding,1,1540,chr11_70519196_70520736
Psmb6,11,70525367,70527858,protein_coding,1,2491,chr11_70525367_70527858
Pld2,11,70540064,70558110,protein_coding,1,18046,chr11_70540064_70558110
Mink1,11,70562881,70614483,protein_coding,1,51602,chr11_70562881_70614483
Gm12316,11,70611212,70613211,antisense,-1,1999,chr11_70611212_70613211
Chrne,11,70614883,70619216,protein_coding,-1,4333,chr11_70614883_70619216
Gm12315,11,70623027,70625561,lincRNA,-1,2534,chr11_70623027_70625561
Gp1ba,11,70639122,70642036,protein_coding,1,2914,chr11_70639122_70642036
Slc25a11,11,70644196,70647479,protein_coding,-1,3283,chr11_70644196_70647479
Rnf167,11,70647235,70651421,protein_coding,1,4186,chr11_70647235_70651421
Pfn1,11,70651850,70654644,protein_coding,-1,2794,chr11_70651850_70654644
Gm12319,11,70654741,70656493,lincRNA,-1,1752,chr11_70654741_70656493
Eno3,11,70657202,70662513,protein_coding,1,5311,chr11_70657202_70662513
Spag7,11,70663771,70669416,protein_coding,-1,5645,chr11_70663771_70669416
Camta2,11,70669463,70688105,protein_coding,-1,18642,chr11_70669463_70688105
Inca1,11,70688361,70700155,protein_coding,-1,11794,chr11_70688361_70700155
Kif1c,11,70700548,70731964,protein_coding,1,31416,chr11_70700548_70731964
Gm12320,11,70748705,70755151,lincRNA,-1,6446,chr11_70748705_70755151
Zfp3,11,70764209,70772928,protein_coding,1,8719,chr11_70764209_70772928
Scimp,11,70790932,70812586,protein_coding,-1,21654,chr11_70790932_70812586
Rabep1,11,70844778,70943105,protein_coding,1,98327,chr11_70844778_70943105
Nup88,11,70943058,70969973,protein_coding,-1,26915,chr11_70943058_70969973
Rpain,11,70970213,70977833,protein_coding,1,7620,chr11_70970213_70977833
C1qbp,11,70977836,70983026,protein_coding,-1,5190,chr11_70977836_70983026
Dhx33,11,70984091,71004437,protein_coding,-1,20346,chr11_70984091_71004437
Derl2,11,71007164,71019841,protein_coding,-1,12677,chr11_71007164_71019841
Mis12,11,71019611,71027371,protein_coding,1,7760,chr11_71019611_71027371
6330403K07Rik,11,71031941,71033513,protein_coding,-1,1572,chr11_71031941_71033513
Nlrp1a,11,71092236,71144704,protein_coding,-1,52468,chr11_71092236_71144704
Nlrp1b,11,71153102,71242913,protein_coding,-1,89811,chr11_71153102_71242913
Gm16013,11,71429828,71436180,lincRNA,-1,6352,chr11_71429828_71436180
9230020A06Rik,11,71512377,71573183,lincRNA,1,60806,chr11_71512377_71573183
Gm33351,11,71553408,71574595,lincRNA,-1,21187,chr11_71553408_71574595
Gm12324,11,71647076,71658477,lincRNA,-1,11401,chr11_71647076_71658477
Gm12326,11,71739397,71740466,lincRNA,-1,1069,chr11_71739397_71740466
Wscd1,11,71749920,71789647,protein_coding,1,39727,chr11_71749920_71789647
4930401O10Rik,11,71928471,71940122,lincRNA,-1,11651,chr11_71928471_71940122
Aipl1,11,72027963,72037509,protein_coding,-1,9546,chr11_72027963_72037509
Pimreg,11,72042032,72047370,protein_coding,1,5338,chr11_72042032_72047370
Pitpnm3,11,72047528,72135778,protein_coding,-1,88250,chr11_72047528_72135778
4933427D14Rik,11,72153929,72207459,protein_coding,-1,53530,chr11_72153929_72207459
Txndc17,11,72207547,72210015,protein_coding,1,2468,chr11_72207547_72210015
Med31,11,72211724,72215592,protein_coding,-1,3868,chr11_72211724_72215592
Slc13a5,11,72241989,72267222,protein_coding,-1,25233,chr11_72241989_72267222
Xaf1,11,72301629,72313733,protein_coding,1,12104,chr11_72301629_72313733
Fbxo39,11,72314444,72319416,protein_coding,1,4972,chr11_72314444_72319416
Tekt1,11,72344722,72362442,protein_coding,-1,17720,chr11_72344722_72362442
Smtnl2,11,72389164,72411713,protein_coding,-1,22549,chr11_72389164_72411713
Mybbp1a,11,72441355,72451768,protein_coding,1,10413,chr11_72441355_72451768
Spns2,11,72451638,72489904,protein_coding,-1,38266,chr11_72451638_72489904
Spns3,11,72494919,72550506,protein_coding,-1,55587,chr11_72494919_72550506
Ube2g1,11,72607283,72686481,protein_coding,1,79198,chr11_72607283_72686481
Ankfy1,11,72690006,72772146,protein_coding,1,82140,chr11_72690006_72772146
Cyb5d2,11,72777232,72796142,protein_coding,-1,18910,chr11_72777232_72796142
Zzef1,11,72796226,72927120,protein_coding,1,130894,chr11_72796226_72927120
Atp2a3,11,72961169,72993044,protein_coding,1,31875,chr11_72961169_72993044
P2rx1,11,72999103,73015200,protein_coding,1,16097,chr11_72999103_73015200
4732414G09Rik,11,73015856,73018841,lincRNA,-1,2985,chr11_73015856_73018841
Camkk1,11,73019008,73042073,protein_coding,1,23065,chr11_73019008_73042073
Ncbp3,11,73047783,73089317,protein_coding,1,41534,chr11_73047783_73089317
Itgae,11,73090583,73147446,protein_coding,1,56863,chr11_73090583_73147446
Haspin,11,73135485,73138294,protein_coding,-1,2809,chr11_73135485_73138294
P2rx5,11,73160421,73172685,protein_coding,1,12264,chr11_73160421_73172685
Emc6,11,73175519,73177037,protein_coding,-1,1518,chr11_73175519_73177037
Tax1bp3,11,73177083,73183162,protein_coding,1,6079,chr11_73177083_73183162
Ctns,11,73183596,73199042,protein_coding,-1,15446,chr11_73183596_73199042
Shpk,11,73199460,73224511,protein_coding,1,25051,chr11_73199460_73224511
Trpv1,11,73234292,73261242,protein_coding,1,26950,chr11_73234292_73261242
Trpv3,11,73267388,73300363,protein_coding,1,32975,chr11_73267388_73300363
Aspa,11,73304992,73329596,protein_coding,-1,24604,chr11_73304992_73329596
Gm49340,11,73329741,73355913,protein_coding,1,26172,chr11_73329741_73355913
Olfr1,11,73393010,73399614,protein_coding,-1,6604,chr11_73393010_73399614
Olfr381,11,73484274,73491603,protein_coding,-1,7329,chr11_73484274_73491603
Olfr384,11,73598594,73605092,protein_coding,1,6498,chr11_73598594_73605092
Zfp735,11,73688778,73713798,protein_coding,1,25020,chr11_73688778_73713798
Olfr390,11,73782964,73790446,protein_coding,1,7482,chr11_73782964_73790446
Olfr393,11,73844413,73851454,protein_coding,-1,7041,chr11_73844413_73851454
Olfr394,11,73883337,73890771,protein_coding,-1,7434,chr11_73883337_73890771
Olfr23,11,73936677,73942658,protein_coding,1,5981,chr11_73936677_73942658
Olfr398,11,73979967,73990407,protein_coding,-1,10440,chr11_73979967_73990407
Zfp616,11,74069955,74087292,protein_coding,1,17337,chr11_74069955_74087292
Olfr401,11,74113712,74122941,protein_coding,1,9229,chr11_74113712_74122941
Olfr403,11,74186249,74198612,protein_coding,1,12363,chr11_74186249_74198612
Olfr406,11,74259808,74271625,protein_coding,1,11817,chr11_74259808_74271625
Olfr410,11,74330281,74338031,protein_coding,-1,7750,chr11_74330281_74338031
Olfr411,11,74345129,74352650,protein_coding,-1,7521,chr11_74345129_74352650
Olfr412,11,74362069,74366218,protein_coding,1,4149,chr11_74362069_74366218
Rap1gap2,11,74383356,74610915,protein_coding,-1,227559,chr11_74383356_74610915
Ccdc92b,11,74619605,74641516,protein_coding,1,21911,chr11_74619605_74641516
Cluh,11,74649495,74670847,protein_coding,1,21352,chr11_74649495_74670847
Pafah1b1,11,74673949,74724670,protein_coding,-1,50721,chr11_74673949_74724670
Mettl16,11,74770830,74828525,protein_coding,1,57695,chr11_74770830_74828525
Mnt,11,74830920,74845725,protein_coding,1,14805,chr11_74830920_74845725
Sgsm2,11,74849261,74897060,protein_coding,-1,47799,chr11_74849261_74897060
Tsr1,11,74898071,74909342,protein_coding,1,11271,chr11_74898071_74909342
Srr,11,74906359,74925948,protein_coding,-1,19589,chr11_74906359_74925948
Smg6,11,74925823,75164448,protein_coding,1,238625,chr11_74925823_75164448
Gm28180,11,74992773,74993494,antisense,-1,721,chr11_74992773_74993494
Gm12333,11,75036476,75039348,antisense,-1,2872,chr11_75036476_75039348
Hic1,11,75164565,75169519,protein_coding,-1,4954,chr11_75164565_75169519
Ovca2,11,75175942,75178835,protein_coding,-1,2893,chr11_75175942_75178835
Dph1,11,75177643,75191241,protein_coding,-1,13598,chr11_75177643_75191241
Rtn4rl1,11,75193783,75267769,protein_coding,1,73986,chr11_75193783_75267769
Rpa1,11,75298166,75348324,protein_coding,-1,50158,chr11_75298166_75348324
Smyd4,11,75348433,75405705,protein_coding,1,57272,chr11_75348433_75405705
Serpinf1,11,75409769,75422701,protein_coding,-1,12932,chr11_75409769_75422701
Serpinf2,11,75431732,75439591,protein_coding,-1,7859,chr11_75431732_75439591
Wdr81,11,75440944,75454717,protein_coding,-1,13773,chr11_75440944_75454717
Tlcd2,11,75461715,75470899,protein_coding,1,9184,chr11_75461715_75470899
Prpf8,11,75486816,75509449,protein_coding,1,22633,chr11_75486816_75509449
Rilp,11,75510094,75513168,protein_coding,1,3074,chr11_75510094_75513168
Scarf1,11,75513540,75526582,protein_coding,1,13042,chr11_75513540_75526582
Gm45606,11,75530277,75533071,antisense,-1,2794,chr11_75530277_75533071
Slc43a2,11,75531694,75577575,protein_coding,1,45881,chr11_75531694_75577575
Pitpna,11,75588097,75628804,protein_coding,1,40707,chr11_75588097_75628804
Inpp5k,11,75630988,75648871,protein_coding,1,17883,chr11_75630988_75648871
Myo1c,11,75650504,75673910,protein_coding,1,23406,chr11_75650504_75673910
Crk,11,75679259,75706908,protein_coding,1,27649,chr11_75679259_75706908
Ywhae,11,75732869,75765845,protein_coding,1,32976,chr11_75732869_75765845
Doc2b,11,75768966,75796049,protein_coding,-1,27083,chr11_75768966_75796049
Rph3al,11,75830999,75938429,protein_coding,-1,107430,chr11_75830999_75938429
Gm16075,11,75860969,75861494,antisense,1,525,chr11_75860969_75861494
1700016K19Rik,11,75999912,76003569,protein_coding,1,3657,chr11_75999912_76003569
Rflnb,11,76019194,76027782,protein_coding,-1,8588,chr11_76019194_76027782
Vps53,11,76046226,76179647,protein_coding,-1,133421,chr11_76046226_76179647
Glod4,11,76120987,76243725,protein_coding,-1,122738,chr11_76120987_76243725
Fam57a,11,76179671,76214827,protein_coding,1,35156,chr11_76179671_76214827
Dbil5,11,76217608,76218666,protein_coding,1,1058,chr11_76217608_76218666
Mrm3,11,76243715,76250619,protein_coding,1,6904,chr11_76243715_76250619
Nxn,11,76257198,76399140,protein_coding,-1,141942,chr11_76257198_76399140
Timm22,11,76406952,76416292,protein_coding,1,9340,chr11_76406952_76416292
Abr,11,76416734,76623558,protein_coding,-1,206824,chr11_76416734_76623558
Bhlha9,11,76672470,76673676,protein_coding,1,1206,chr11_76672470_76673676
Gosr1,11,76726602,76763579,protein_coding,-1,36977,chr11_76726602_76763579
Cpd,11,76778424,76847018,protein_coding,-1,68594,chr11_76778424_76847018
Tmigd1,11,76902159,76916587,protein_coding,1,14428,chr11_76902159_76916587
Blmh,11,76924809,76987379,protein_coding,1,62570,chr11_76924809_76987379
Slc6a4,11,76998603,77032340,protein_coding,1,33737,chr11_76998603_77032340
Nsrp1,11,77044292,77078435,protein_coding,-1,34143,chr11_77044292_77078435
Efcab5,11,77089915,77188968,protein_coding,-1,99053,chr11_77089915_77188968
Gm45027,11,77200125,77200819,lincRNA,-1,694,chr11_77200125_77200819
Ssh2,11,77216287,77460220,protein_coding,1,243933,chr11_77216287_77460220
Coro6,11,77462411,77470484,protein_coding,1,8073,chr11_77462411_77470484
Ankrd13b,11,77470485,77489678,protein_coding,-1,19193,chr11_77470485_77489678
Git1,11,77493562,77507786,protein_coding,1,14224,chr11_77493562_77507786
Trp53i13,11,77508099,77515980,protein_coding,-1,7881,chr11_77508099_77515980
Abhd15,11,77515121,77538607,protein_coding,1,23486,chr11_77515121_77538607
Gm10392,11,77516660,77519198,antisense,-1,2538,chr11_77516660_77519198
Taok1,11,77529162,77607815,protein_coding,-1,78653,chr11_77529162_77607815
Nufip2,11,77686155,77741921,protein_coding,1,55766,chr11_77686155_77741921
Cryba1,11,77718615,77725283,protein_coding,-1,6668,chr11_77718615_77725283
Myo18a,11,77763246,77865980,protein_coding,1,102734,chr11_77763246_77865980
Gm10277,11,77785453,77787747,protein_coding,-1,2294,chr11_77785453_77787747
Pipox,11,77880615,77894096,protein_coding,-1,13481,chr11_77880615_77894096
Gm11190,11,77912127,77929288,lincRNA,-1,17161,chr11_77912127_77929288
Sez6,11,77930800,77979048,protein_coding,1,48248,chr11_77930800_77979048
Phf12,11,77982754,78030539,protein_coding,1,47785,chr11_77982754_78030539
Dhrs13os,11,78030012,78032665,antisense,-1,2653,chr11_78030012_78032665
Dhrs13,11,78032280,78037866,protein_coding,1,5586,chr11_78032280_78037866
Flot2,11,78037931,78060434,protein_coding,1,22503,chr11_78037931_78060434
Eral1,11,78073376,78080383,protein_coding,-1,7007,chr11_78073376_78080383
Fam222b,11,78094660,78156700,protein_coding,1,62040,chr11_78094660_78156700
Traf4,11,78158499,78165589,protein_coding,-1,7090,chr11_78158499_78165589
Nek8,11,78166106,78176675,protein_coding,-1,10569,chr11_78166106_78176675
Tlcd1,11,78176711,78181909,protein_coding,1,5198,chr11_78176711_78181909
Rpl23a,11,78180932,78183584,protein_coding,-1,2652,chr11_78180932_78183584
Rab34,11,78188430,78192193,protein_coding,1,3763,chr11_78188430_78192193
Proca1,11,78193392,78205763,protein_coding,1,12371,chr11_78193392_78205763
Supt6,11,78206746,78245987,protein_coding,-1,39241,chr11_78206746_78245987
Sdf2,11,78245746,78255496,protein_coding,1,9750,chr11_78245746_78255496
2610507B11Rik,11,78261752,78290623,protein_coding,1,28871,chr11_78261752_78290623
Spag5,11,78301529,78322457,protein_coding,1,20928,chr11_78301529_78322457
Aldoc,11,78322968,78327781,protein_coding,1,4813,chr11_78322968_78327781
Pigs,11,78328415,78342782,protein_coding,1,14367,chr11_78328415_78342782
Unc119,11,78343482,78349164,protein_coding,1,5682,chr11_78343482_78349164
Foxn1,11,78357577,78386558,protein_coding,-1,28981,chr11_78357577_78386558
Slc13a2,11,78397087,78422217,protein_coding,-1,25130,chr11_78397087_78422217
Slc46a1,11,78465697,78472059,protein_coding,1,6362,chr11_78465697_78472059
Sarm1,11,78472330,78497754,protein_coding,-1,25424,chr11_78472330_78497754
Vtn,11,78499091,78502324,protein_coding,1,3233,chr11_78499091_78502324
Sebox,11,78503447,78505081,protein_coding,1,1634,chr11_78503447_78505081
Tmem199,11,78507055,78512172,protein_coding,-1,5117,chr11_78507055_78512172
Poldip2,11,78512193,78522736,protein_coding,1,10543,chr11_78512193_78522736
Tnfaip1,11,78522850,78536332,protein_coding,-1,13482,chr11_78522850_78536332
Ift20,11,78536361,78541737,protein_coding,1,5376,chr11_78536361_78541737
Tmem97,11,78541817,78550777,protein_coding,-1,8960,chr11_78541817_78550777
Nlk,11,78567168,78697373,protein_coding,-1,130205,chr11_78567168_78697373
Lyrm9,11,78826584,78846870,protein_coding,1,20286,chr11_78826584_78846870
Nos2,11,78920787,78960254,protein_coding,1,39467,chr11_78920787_78960254
Lgals9,11,78962974,78984946,protein_coding,-1,21972,chr11_78962974_78984946
Ksr1,11,79013440,79146407,protein_coding,-1,132967,chr11_79013440_79146407
Gm11201,11,79023597,79031057,antisense,1,7460,chr11_79023597_79031057
Wsb1,11,79239372,79254671,protein_coding,-1,15299,chr11_79239372_79254671
Gm44787,11,79258586,79273893,lincRNA,-1,15307,chr11_79258586_79273893
Nf1,11,79339693,79581612,protein_coding,1,241919,chr11_79339693_79581612
AU040972,11,79481719,79484031,antisense,-1,2312,chr11_79481719_79484031
Omg,11,79500982,79504084,protein_coding,-1,3102,chr11_79500982_79504084
Evi2,11,79513385,79530589,protein_coding,-1,17204,chr11_79513385_79530589
Evi2a,11,79526560,79530609,protein_coding,-1,4049,chr11_79526560_79530609
Rab11fip4,11,79591212,79698023,protein_coding,1,106811,chr11_79591212_79698023
Rab11fip4os1,11,79607079,79623163,antisense,-1,16084,chr11_79607079_79623163
Rab11fip4os2,11,79670372,79675128,antisense,-1,4756,chr11_79670372_79675128
9130204K15Rik,11,79781979,79872394,lincRNA,-1,90415,chr11_79781979_79872394
Utp6,11,79932321,79962390,protein_coding,-1,30069,chr11_79932321_79962390
Suz12,11,79993106,80034123,protein_coding,1,41017,chr11_79993106_80034123
Crlf3,11,80046493,80080991,protein_coding,-1,34498,chr11_80046493_80080991
Atad5,11,80089400,80135794,protein_coding,1,46394,chr11_80089400_80135794
Tefm,11,80136678,80142175,protein_coding,-1,5497,chr11_80136678_80142175
Adap2,11,80154105,80178958,protein_coding,1,24853,chr11_80154105_80178958
Adap2os,11,80158861,80177629,antisense,-1,18768,chr11_80158861_80177629
Rnf135,11,80183851,80199757,protein_coding,1,15906,chr11_80183851_80199757
Rhot1,11,80209019,80267907,protein_coding,1,58888,chr11_80209019_80267907
Rhbdl3,11,80300912,80355955,protein_coding,1,55043,chr11_80300912_80355955
5730455P16Rik,11,80360492,80378034,protein_coding,-1,17542,chr11_80360492_80378034
Zfp207,11,80383279,80405733,protein_coding,1,22454,chr11_80383279_80405733
Psmd11,11,80428615,80473248,protein_coding,1,44633,chr11_80428615_80473248
Cdk5r1,11,80477023,80481184,protein_coding,1,4161,chr11_80477023_80481184
Myo1d,11,80482126,80780025,protein_coding,-1,297899,chr11_80482126_80780025
Tmem98,11,80810175,80822033,protein_coding,1,11858,chr11_80810175_80822033
4930507D10Rik,11,80850381,80858300,antisense,-1,7919,chr11_80850381_80858300
Spaca3,11,80858365,80867814,protein_coding,1,9449,chr11_80858365_80867814
Asic2,11,80880169,81968457,protein_coding,-1,1088288,chr11_80880169_81968457
Gm11417,11,81072403,81083358,antisense,1,10955,chr11_81072403_81083358
4930527B05Rik,11,81385013,81402491,antisense,1,17478,chr11_81385013_81402491
Gm11418,11,81587361,81593478,antisense,1,6117,chr11_81587361_81593478
5530401A14Rik,11,81860673,81894582,protein_coding,1,33909,chr11_81860673_81894582
Gm31522,11,81983119,82019967,lincRNA,-1,36848,chr11_81983119_82019967
Gm11419,11,81985406,81988769,lincRNA,1,3363,chr11_81985406_81988769
Gm17268,11,82028224,82038562,protein_coding,-1,10338,chr11_82028224_82038562
Ccl2,11,82035571,82037453,protein_coding,1,1882,chr11_82035571_82037453
Ccl11,11,82057823,82062955,protein_coding,1,5132,chr11_82057823_82062955
Ccl12,11,82101845,82103400,protein_coding,1,1555,chr11_82101845_82103400
Ccl1,11,82176657,82305690,protein_coding,-1,129033,chr11_82176657_82305690
Gm38577,11,82382796,82387340,lincRNA,-1,4544,chr11_82382796_82387340
Tmem132e,11,82388900,82446332,protein_coding,1,57432,chr11_82388900_82446332
Cct6b,11,82719250,82764321,protein_coding,-1,45071,chr11_82719250_82764321
Zfp830,11,82764345,82765935,protein_coding,1,1590,chr11_82764345_82765935
Gm11423,11,82779601,82781042,antisense,-1,1441,chr11_82779601_82781042
Lig3,11,82781108,82804274,protein_coding,1,23166,chr11_82781108_82804274
Rffl,11,82802449,82871210,protein_coding,-1,68761,chr11_82802449_82871210
Rad51d,11,82876434,82890614,protein_coding,-1,14180,chr11_82876434_82890614
Fndc8,11,82892124,82900801,protein_coding,1,8677,chr11_82892124_82900801
Nle1,11,82900768,82908411,protein_coding,-1,7643,chr11_82900768_82908411
Unc45b,11,82910550,82943403,protein_coding,1,32853,chr11_82910550_82943403
Slfn5os,CHR_CAST_EI_MMCHR11_CTG5,82942303,82960972,antisense;lncRNA,-1,18669,chrCHR_CAST_EI_MMCHR11_CTG5_82942303_82960972
Slfn5,11,82951349,82964840,protein_coding,1,13491,chr11_82951349_82964840
Slfn9,11,82978390,82991830,protein_coding,-1,13440,chr11_82978390_82991830
Slfn8,11,83002158,83021265,protein_coding,-1,19107,chr11_83002158_83021265
Slfn2,11,83057196,83070678,protein_coding,1,13482,chr11_83057196_83070678
Gm20234,CHR_WSB_EIJ_MMCHR11_CTG3,83059796,83071246,antisense;lncRNA,-1,11450,chrCHR_WSB_EIJ_MMCHR11_CTG3_83059796_83071246
Slfn4,11,83175186,83190216,protein_coding,1,15030,chr11_83175186_83190216
Slfn3,11,83141602,83215154,protein_coding,1,73552,chr11_83141602_83215154
Slfn14,11,83233324,83286726,protein_coding,-1,53402,chr11_83233324_83286726
Pex12,11,83294642,83302586,protein_coding,-1,7944,chr11_83294642_83302586
Ap2b1,11,83299024,83405035,protein_coding,1,106011,chr11_83299024_83405035
Rasl10b,11,83409137,83421039,protein_coding,1,11902,chr11_83409137_83421039
Gas2l2,11,83421902,83429455,protein_coding,-1,7553,chr11_83421902_83429455
1700020L24Rik,11,83437677,83441233,protein_coding,1,3556,chr11_83437677_83441233
Mmp28,11,83440768,83463071,protein_coding,-1,22303,chr11_83440768_83463071
Taf15,11,83473086,83506743,protein_coding,1,33657,chr11_83473086_83506743
Heatr9,11,83511736,83522175,protein_coding,-1,10439,chr11_83511736_83522175
Ccl5,11,83525778,83530518,protein_coding,-1,4740,chr11_83525778_83530518
Ccl9,11,83572919,83578636,protein_coding,-1,5717,chr11_83572919_83578636
Ccl6,11,83587882,83593087,protein_coding,-1,5205,chr11_83587882_83593087
Ccl3,11,83647844,83649355,protein_coding,-1,1511,chr11_83647844_83649355
Ccl4,11,83662584,83664683,protein_coding,1,2099,chr11_83662584_83664683
Wfdc17,11,83703991,83706268,protein_coding,1,2277,chr11_83703991_83706268
Wfdc18,11,83709015,83711348,protein_coding,1,2333,chr11_83709015_83711348
Wfdc21,11,83746940,83752642,protein_coding,1,5702,chr11_83746940_83752642
Heatr6,11,83753696,83783754,protein_coding,1,30058,chr11_83753696_83783754
Gm12576,11,83817682,83849493,lincRNA,-1,31811,chr11_83817682_83849493
Hnf1b,11,83850063,83905819,protein_coding,1,55756,chr11_83850063_83905819
Ddx52,11,83942062,83963088,protein_coding,1,21026,chr11_83942062_83963088
Synrg,11,83964428,84044578,protein_coding,1,80150,chr11_83964428_84044578
Dusp14,11,84048041,84069261,protein_coding,-1,21220,chr11_84048041_84069261
Tada2a,11,84078920,84129600,protein_coding,-1,50680,chr11_84078920_84129600
Acaca,11,84129672,84401651,protein_coding,1,271979,chr11_84129672_84401651
Gm11437,11,84148351,84167476,protein_coding,-1,19125,chr11_84148351_84167476
Aatf,11,84422855,84513522,protein_coding,-1,90667,chr11_84422855_84513522
Lhx1,11,84518284,84525535,protein_coding,-1,7251,chr11_84518284_84525535
Lhx1os,11,84525660,84535831,lincRNA,1,10171,chr11_84525660_84535831
1700109G15Rik,11,84716976,84720432,lincRNA,-1,3456,chr11_84716976_84720432
Gm11431,11,84763855,84777829,lincRNA,-1,13974,chr11_84763855_84777829
Mrm1,11,84813061,84819515,protein_coding,-1,6454,chr11_84813061_84819515
Dhrs11,11,84820856,84828994,protein_coding,-1,8138,chr11_84820856_84828994
Ggnbp2,11,84832361,84870817,protein_coding,-1,38456,chr11_84832361_84870817
Pigw,11,84876315,84880285,protein_coding,-1,3970,chr11_84876315_84880285
Myo19,11,84880148,84911226,protein_coding,1,31078,chr11_84880148_84911226
Znhit3,11,84910950,84916366,protein_coding,-1,5416,chr11_84910950_84916366
Car4,11,84957786,84966044,protein_coding,1,8258,chr11_84957786_84966044
Usp32,11,84984442,85140161,protein_coding,-1,155719,chr11_84984442_85140161
1700125H20Rik,11,85170404,85181145,protein_coding,1,10741,chr11_85170404_85181145
Appbp2,11,85187262,85235130,protein_coding,-1,47868,chr11_85187262_85235130
Appbp2os,11,85234775,85238304,antisense,1,3529,chr11_85234775_85238304
Ppm1d,11,85311244,85347066,protein_coding,1,35822,chr11_85311244_85347066
Bcas3,11,85353167,85826058,protein_coding,1,472891,chr11_85353167_85826058
Bcas3os1,11,85702200,85719744,antisense,-1,17544,chr11_85702200_85719744
Bcas3os2,11,85766831,85775680,antisense,-1,8849,chr11_85766831_85775680
Tbx2,11,85832551,85841948,protein_coding,1,9397,chr11_85832551_85841948
Gm11444,11,85846790,85850333,protein_coding,-1,3543,chr11_85846790_85850333
Tbx4,11,85886422,85916097,protein_coding,1,29675,chr11_85886422_85916097
Brip1,11,86058138,86201193,protein_coding,-1,143055,chr11_86058138_86201193
Brip1os,11,86201370,86304443,antisense,1,103073,chr11_86201370_86304443
Ints2,11,86210681,86257575,protein_coding,-1,46894,chr11_86210681_86257575
Med13,11,86267033,86357602,protein_coding,-1,90569,chr11_86267033_86357602
Rnft1,11,86484657,86499025,protein_coding,1,14368,chr11_86484657_86499025
Rps6kb1,11,86498871,86544805,protein_coding,-1,45934,chr11_86498871_86544805
Tubd1,11,86544991,86567360,protein_coding,1,22369,chr11_86544991_86567360
Vmp1,11,86583865,86683836,protein_coding,-1,99971,chr11_86583865_86683836
Ptrh2,11,86683985,86692457,protein_coding,1,8472,chr11_86683985_86692457
Cltc,11,86694351,86757565,protein_coding,-1,63214,chr11_86694351_86757565
Dhx40,11,86768846,86807746,protein_coding,-1,38900,chr11_86768846_86807746
Ypel2,11,86936425,86993707,protein_coding,-1,57282,chr11_86936425_86993707
Gdpd1,11,87033867,87074062,protein_coding,-1,40195,chr11_87033867_87074062
Gm11479,11,87074257,87074958,lincRNA,-1,701,chr11_87074257_87074958
Smg8,11,87077732,87086774,protein_coding,-1,9042,chr11_87077732_87086774
Prr11,11,87089153,87108708,protein_coding,-1,19555,chr11_87089153_87108708
Ska2,11,87109234,87124635,protein_coding,1,15401,chr11_87109234_87124635
Gm11491,11,87121567,87126958,antisense,-1,5391,chr11_87121567_87126958
Trim37,11,87127077,87220683,protein_coding,1,93606,chr11_87127077_87220683
Ppm1e,11,87226906,87359023,protein_coding,-1,132117,chr11_87226906_87359023
Rad51c,11,87376645,87404954,protein_coding,-1,28309,chr11_87376645_87404954
Tex14,11,87405065,87555823,protein_coding,1,150758,chr11_87405065_87555823
Mtmr4,11,87592162,87616302,protein_coding,1,24140,chr11_87592162_87616302
Hsf5,11,87617164,87659542,protein_coding,1,42378,chr11_87617164_87659542
Rnf43,11,87662722,87735539,protein_coding,1,72817,chr11_87662722_87735539
Supt4a,11,87737552,87743623,protein_coding,1,6071,chr11_87737552_87743623
Mir142hg,11,87755577,87757270,lincRNA,1,1693,chr11_87755577_87757270
Tspoap1,11,87760541,87785928,protein_coding,1,25387,chr11_87760541_87785928
Mpo,11,87793581,87804413,protein_coding,1,10832,chr11_87793581_87804413
Gm11505,11,87795784,87801144,antisense,-1,5360,chr11_87795784_87801144
Lpo,11,87806428,87828289,protein_coding,-1,21861,chr11_87806428_87828289
Mks1,11,87853215,87863803,protein_coding,1,10588,chr11_87853215_87863803
Epx,11,87864000,87875536,protein_coding,-1,11536,chr11_87864000_87875536
Olfr462,11,87884979,87892268,protein_coding,-1,7289,chr11_87884979_87892268
Olfr463,11,87892618,87897387,protein_coding,-1,4769,chr11_87892618_87897387
Olfr464,11,87913268,87920967,protein_coding,-1,7699,chr11_87913268_87920967
Dynll2,11,87979525,87987533,protein_coding,-1,8008,chr11_87979525_87987533
Gm11508,CHR_MG3829_PATCH,88011991,88048006,antisense;lncRNA,-1,36015,chrCHR_MG3829_PATCH_88011991_88048006
Srsf1,11,88047373,88053755,protein_coding,1,6382,chr11_88047373_88053755
Gm15892,11,88059066,88067476,lincRNA;lncRNA,1,8410,chr11_88059066_88067476
Vezf1,11,88068279,88084729,protein_coding,1,16450,chr11_88068279_88084729
Cuedc1,11,88098058,88194140,protein_coding,1,96082,chr11_88098058_88194140
Mrps23,11,88204388,88211507,protein_coding,1,7119,chr11_88204388_88211507
Gm38534,11,88253368,88256990,lincRNA;lncRNA,1,3622,chr11_88253368_88256990
Msi2,11,88339382,88718513,protein_coding,-1,379131,chr11_88339382_88718513
Gm15893,11,88356291,88363947,antisense,1,7656,chr11_88356291_88363947
C030037D09Rik,11,88718645,88728893,lincRNA,1,10248,chr11_88718645_88728893
Gm11493,11,88741011,88743369,lincRNA,-1,2358,chr11_88741011_88743369
Akap1,11,88830792,88864586,protein_coding,-1,33794,chr11_88830792_88864586
4930556N13Rik,11,88851604,88881395,antisense,1,29791,chr11_88851604_88881395
Scpep1os,11,88905928,88936061,antisense,1,30133,chr11_88905928_88936061
Scpep1,11,88924020,88955465,protein_coding,-1,31445,chr11_88924020_88955465
Elobl,11,88964658,88966931,protein_coding,-1,2273,chr11_88964658_88966931
Coil,11,88970252,88991613,protein_coding,1,21361,chr11_88970252_88991613
Gm11496,11,88993040,88996544,lincRNA,-1,3504,chr11_88993040_88996544
Trim25,11,88999376,89020293,protein_coding,1,20917,chr11_88999376_89020293
Dgke,11,89035179,89066850,protein_coding,-1,31671,chr11_89035179_89066850
Dgkeos,11,89064729,89069098,antisense,1,4369,chr11_89064729_89069098
Gm525,11,89073841,89093040,protein_coding,1,19199,chr11_89073841_89093040
Nog,11,89300638,89302332,protein_coding,-1,1694,chr11_89300638_89302332
Gm2018,11,89302723,89309428,lincRNA,1,6705,chr11_89302723_89309428
Ankfn1,11,89390223,89841266,protein_coding,-1,451043,chr11_89390223_89841266
Pctp,11,89982665,90002894,protein_coding,-1,20229,chr11_89982665_90002894
Tmem100,11,90030348,90036508,protein_coding,1,6160,chr11_90030348_90036508
Gm11494,11,90134842,90143624,lincRNA,-1,8782,chr11_90134842_90143624
Gm45716,11,90187683,90251255,protein_coding,1,63572,chr11_90187683_90251255
Mmd,11,90249456,90278589,protein_coding,1,29133,chr11_90249456_90278589
Hlf,11,90336536,90390895,protein_coding,-1,54359,chr11_90336536_90390895
Stxbp4,11,90476492,90638084,protein_coding,-1,161592,chr11_90476492_90638084
Cox11,11,90638173,90644931,protein_coding,1,6758,chr11_90638173_90644931
Tom1l1,11,90643465,90688366,protein_coding,-1,44901,chr11_90643465_90688366
4930405D11Rik,11,90804692,90895149,lincRNA,1,90457,chr11_90804692_90895149
Car10,11,93098028,93601749,protein_coding,1,503721,chr11_93098028_93601749
Utp18,11,93859243,93885766,protein_coding,-1,26523,chr11_93859243_93885766
Mbtd1,11,93885852,93946985,protein_coding,1,61133,chr11_93885852_93946985
Nme2,11,93949814,93956259,protein_coding,-1,6445,chr11_93949814_93956259
Gm20390,11,93949819,93968293,protein_coding,-1,18474,chr11_93949819_93968293
Nme1,11,93956979,93968521,protein_coding,-1,11542,chr11_93956979_93968521
Spag9,11,93996091,94126085,protein_coding,1,129994,chr11_93996091_94126085
Tob1,11,94211454,94215495,protein_coding,1,4041,chr11_94211454_94215495
Wfikkn2,11,94235956,94246005,protein_coding,-1,10049,chr11_94235956_94246005
Gm21885,11,94281873,94286253,protein_coding,1,4380,chr11_94281873_94286253
Luc7l3,11,94287890,94321988,protein_coding,-1,34098,chr11_94287890_94321988
Ankrd40,11,94328001,94341841,protein_coding,1,13840,chr11_94328001_94341841
Abcc3,11,94343295,94392997,protein_coding,-1,49702,chr11_94343295_94392997
Cacna1g,11,94408391,94474198,protein_coding,-1,65807,chr11_94408391_94474198
Spata20,11,94478904,94486179,protein_coding,-1,7275,chr11_94478904_94486179
Epn3,11,94489599,94499974,protein_coding,-1,10375,chr11_94489599_94499974
Mycbpap,11,94501347,94521742,protein_coding,-1,20395,chr11_94501347_94521742
Rsad1,11,94539798,94549255,protein_coding,-1,9457,chr11_94539798_94549255
Acsf2,11,94557102,94601871,protein_coding,-1,44769,chr11_94557102_94601871
Chad,11,94565047,94569127,protein_coding,1,4080,chr11_94565047_94569127
Lrrc59,11,94629767,94645216,protein_coding,1,15449,chr11_94629767_94645216
Eme1,11,94644996,94653964,protein_coding,-1,8968,chr11_94644996_94653964
Mrpl27,11,94653767,94660089,protein_coding,1,6322,chr11_94653767_94660089
Xylt2,11,94663851,94677515,protein_coding,-1,13664,chr11_94663851_94677515
Gm11541,11,94694498,94704499,protein_coding,-1,10001,chr11_94694498_94704499
Cdc34b,11,94741782,94743033,protein_coding,1,1251,chr11_94741782_94743033
Col1a1,11,94936224,94953042,protein_coding,1,16818,chr11_94936224_94953042
Sgca,11,94962791,94976327,protein_coding,-1,13536,chr11_94962791_94976327
Ppp1r9b,11,94991035,95006899,protein_coding,1,15864,chr11_94991035_95006899
Samd14,11,95009879,95026087,protein_coding,1,16208,chr11_95009879_95026087
Pdk2,11,95026258,95041354,protein_coding,-1,15096,chr11_95026258_95041354
Gm11513,11,95032759,95038283,antisense,1,5524,chr11_95032759_95038283
Itga3,11,95044474,95076801,protein_coding,-1,32327,chr11_95044474_95076801
Dlx3,11,95120119,95125296,protein_coding,1,5177,chr11_95120119_95125296
Dlx4,11,95140447,95146263,protein_coding,-1,5816,chr11_95140447_95146263
Dlx4os,11,95145052,95159047,antisense,1,13995,chr11_95145052_95159047
Tac4,11,95261529,95269265,protein_coding,1,7736,chr11_95261529_95269265
Kat7,11,95274259,95310246,protein_coding,-1,35987,chr11_95274259_95310246
Gm11520,11,95310429,95324496,antisense,1,14067,chr11_95310429_95324496
Gm11521,11,95336011,95337408,antisense,-1,1397,chr11_95336011_95337408
Fam117a,11,95337018,95381872,protein_coding,1,44854,chr11_95337018_95381872
Gm29477,11,95375525,95384507,antisense,-1,8982,chr11_95375525_95384507
Slc35b1,11,95384692,95391776,protein_coding,1,7084,chr11_95384692_95391776
Spop,11,95414080,95493406,protein_coding,1,79326,chr11_95414080_95493406
Nxph3,11,95509845,95514570,protein_coding,-1,4725,chr11_95509845_95514570
Ngfr,11,95568818,95587735,protein_coding,-1,18917,chr11_95568818_95587735
Phb,11,95666957,95680773,protein_coding,1,13816,chr11_95666957_95680773
Gm9796,11,95696894,95699143,lincRNA,-1,2249,chr11_95696894_95699143
Zfp652os,11,95700106,95712754,antisense,-1,12648,chr11_95700106_95712754
Zfp652,11,95712673,95835115,protein_coding,1,122442,chr11_95712673_95835115
Abi3,11,95830074,95842476,protein_coding,-1,12402,chr11_95830074_95842476
Gngt2,11,95837216,95845734,protein_coding,1,8518,chr11_95837216_95845734
Gm11527,11,95858162,95859174,lincRNA,-1,1012,chr11_95858162_95859174
B4galnt2,11,95865943,95914891,protein_coding,-1,48948,chr11_95865943_95914891
Gm11534,11,95869154,95876380,antisense,1,7226,chr11_95869154_95876380
Igf2bp1,11,95957163,96005940,protein_coding,-1,48777,chr11_95957163_96005940
Gip,11,96024545,96030831,protein_coding,1,6286,chr11_96024545_96030831
Snf8,11,96034885,96047430,protein_coding,1,12545,chr11_96034885_96047430
Ube2z,11,96047432,96065388,protein_coding,-1,17956,chr11_96047432_96065388
Atp5g1,11,96068852,96075670,protein_coding,-1,6818,chr11_96068852_96075670
Calcoco2,11,96099326,96111964,protein_coding,-1,12638,chr11_96099326_96111964
Ttll6,11,96133786,96165451,protein_coding,1,31665,chr11_96133786_96165451
Gm53,11,96251105,96264868,lincRNA,1,13763,chr11_96251105_96264868
Hoxb7,11,96286623,96290162,protein_coding,1,3539,chr11_96286623_96290162
Hoxb5os,11,96291024,96306910,antisense,-1,15886,chr11_96291024_96306910
Hoxb6,11,96292476,96301569,protein_coding,1,9093,chr11_96292476_96301569
Hoxb4,11,96318267,96321638,protein_coding,1,3371,chr11_96318267_96321638
Hoxb3,11,96323326,96347930,protein_coding,1,24604,chr11_96323326_96347930
Gm11536,11,96336299,96342108,antisense,-1,5809,chr11_96336299_96342108
Hoxb1,11,96365752,96368256,protein_coding,1,2504,chr11_96365752_96368256
Skap1,11,96464593,96759130,protein_coding,1,294537,chr11_96464593_96759130
Gm11537,11,96766802,96768269,antisense,1,1467,chr11_96766802_96768269
Snx11,11,96767555,96777559,protein_coding,-1,10004,chr11_96767555_96777559
Cbx1,11,96789127,96808640,protein_coding,1,19513,chr11_96789127_96808640
Nfe2l1,11,96817414,96829968,protein_coding,-1,12554,chr11_96817414_96829968
Copz2,11,96849870,96861203,protein_coding,1,11333,chr11_96849870_96861203
Cdk5rap3,11,96907426,96916496,protein_coding,-1,9070,chr11_96907426_96916496
Gm11525,11,96918941,96922493,antisense,-1,3552,chr11_96918941_96922493
Prr15l,11,96928104,96937830,protein_coding,1,9726,chr11_96928104_96937830
Pnpo,11,96937825,96943986,protein_coding,-1,6161,chr11_96937825_96943986
Sp2,11,96953341,96982959,protein_coding,-1,29618,chr11_96953341_96982959
Sp6,11,97013394,97024734,protein_coding,1,11340,chr11_97013394_97024734
Scrn2,11,97029938,97033958,protein_coding,1,4020,chr11_97029938_97033958
Lrrc46,11,97034602,97041407,protein_coding,-1,6805,chr11_97034602_97041407
Mrpl10,11,97041560,97049213,protein_coding,1,7653,chr11_97041560_97049213
Osbpl7,11,97050628,97068904,protein_coding,1,18276,chr11_97050628_97068904
Tbx21,11,97098071,97115331,protein_coding,-1,17260,chr11_97098071_97115331
Tbkbp1,11,97136171,97151495,protein_coding,-1,15324,chr11_97136171_97151495
Kpnb1,11,97159714,97187881,protein_coding,-1,28167,chr11_97159714_97187881
Gm11583,11,97160990,97161675,antisense,1,685,chr11_97160990_97161675
Npepps,11,97205842,97280638,protein_coding,-1,74796,chr11_97205842_97280638
Gm11592,11,97280128,97282897,antisense,1,2769,chr11_97280128_97282897
Mrpl45,11,97315716,97329920,protein_coding,1,14204,chr11_97315716_97329920
Gpr179,11,97332109,97352077,protein_coding,-1,19968,chr11_97332109_97352077
Socs7,11,97362435,97398542,protein_coding,1,36107,chr11_97362435_97398542
Arhgap23,11,97415533,97502402,protein_coding,1,86869,chr11_97415533_97502402
4933428G20Rik,11,97490783,97500340,protein_coding,-1,9557,chr11_97490783_97500340
Srcin1,11,97509340,97576186,protein_coding,-1,66846,chr11_97509340_97576186
Epop,11,97627389,97629702,protein_coding,-1,2313,chr11_97627389_97629702
Mllt6,11,97663414,97685463,protein_coding,1,22049,chr11_97663414_97685463
Cisd3,11,97685826,97688621,protein_coding,1,2795,chr11_97685826_97688621
Pcgf2,11,97688823,97700497,protein_coding,-1,11674,chr11_97688823_97700497
Psmb3,11,97703399,97713500,protein_coding,1,10101,chr11_97703399_97713500
Pip4k2b,11,97715157,97744704,protein_coding,-1,29547,chr11_97715157_97744704
Gm11614,11,97723651,97725711,antisense,1,2060,chr11_97723651_97725711
Cwc25,11,97745481,97766556,protein_coding,-1,21075,chr11_97745481_97766556
1700001P01Rik,11,97771481,97775918,protein_coding,-1,4437,chr11_97771481_97775918
Rpl23,11,97777527,97782437,protein_coding,-1,4910,chr11_97777527_97782437
Lasp1,11,97799000,97838764,protein_coding,1,39764,chr11_97799000_97838764
B230217C12Rik,11,97840780,97844099,protein_coding,1,3319,chr11_97840780_97844099
Fbxo47,11,97853826,97884154,protein_coding,-1,30328,chr11_97853826_97884154
Gm11630,11,97884594,97893811,lincRNA,1,9217,chr11_97884594_97893811
Plxdc1,11,97923238,97986444,protein_coding,-1,63206,chr11_97923238_97986444
Arl5c,11,97989578,97996181,protein_coding,-1,6603,chr11_97989578_97996181
Cacnb1,11,98001508,98023034,protein_coding,-1,21526,chr11_98001508_98023034
Rpl19,11,98026710,98030492,protein_coding,1,3782,chr11_98026710_98030492
Stac2,11,98036623,98053462,protein_coding,-1,16839,chr11_98036623_98053462
Fbxl20,11,98082556,98150403,protein_coding,-1,67847,chr11_98082556_98150403
Med1,11,98152154,98193293,protein_coding,-1,41139,chr11_98152154_98193293
Cdk12,11,98203059,98278504,protein_coding,1,75445,chr11_98203059_98278504
Neurod2,11,98325415,98329648,protein_coding,-1,4233,chr11_98325415_98329648
Ppp1r1b,11,98348404,98357796,protein_coding,1,9392,chr11_98348404_98357796
Stard3,11,98358368,98381112,protein_coding,1,22744,chr11_98358368_98381112
Tcap,11,98383811,98384953,protein_coding,1,1142,chr11_98383811_98384953
Pnmt,11,98386450,98388181,protein_coding,1,1731,chr11_98386450_98388181
Pgap3,11,98388677,98400490,protein_coding,-1,11813,chr11_98388677_98400490
Erbb2,11,98412470,98437716,protein_coding,1,25246,chr11_98412470_98437716
Mien1,11,98437708,98438991,protein_coding,-1,1283,chr11_98437708_98438991
Grb7,11,98446394,98455373,protein_coding,1,8979,chr11_98446394_98455373
Ikzf3,11,98464902,98546031,protein_coding,-1,81129,chr11_98464902_98546031
Zpbp2,11,98551097,98558665,protein_coding,1,7568,chr11_98551097_98558665
Ormdl3,11,98581256,98587368,protein_coding,-1,6112,chr11_98581256_98587368
Gsdma3,11,98626360,98638226,protein_coding,1,11866,chr11_98626360_98638226
Gsdma2,11,98646759,98657964,protein_coding,1,11205,chr11_98646759_98657964
Gsdma,11,98664351,98677708,protein_coding,1,13357,chr11_98664351_98677708
Psmd3,11,98682554,98695979,protein_coding,1,13425,chr11_98682554_98695979
Csf3,11,98701263,98703629,protein_coding,1,2366,chr11_98701263_98703629
Med24,11,98704591,98729435,protein_coding,-1,24844,chr11_98704591_98729435
Thra,11,98740638,98769006,protein_coding,1,28368,chr11_98740638_98769006
Nr1d1,11,98767932,98775333,protein_coding,-1,7401,chr11_98767932_98775333
Msl1,11,98795516,98807859,protein_coding,1,12343,chr11_98795516_98807859
Gm12359,11,98797707,98810087,antisense,-1,12380,chr11_98797707_98810087
Casc3,11,98804905,98833814,protein_coding,1,28909,chr11_98804905_98833814
Rapgefl1,11,98836785,98853697,protein_coding,1,16912,chr11_98836785_98853697
Wipf2,11,98863638,98905040,protein_coding,1,41402,chr11_98863638_98905040
Cdc6,11,98907801,98923940,protein_coding,1,16139,chr11_98907801_98923940
Rara,11,98927818,98974942,protein_coding,1,47124,chr11_98927818_98974942
Gjd3,11,98982180,98983016,protein_coding,-1,836,chr11_98982180_98983016
Top2a,11,98992943,99024189,protein_coding,-1,31246,chr11_98992943_99024189
Igfbp4,11,99041244,99054392,protein_coding,1,13148,chr11_99041244_99054392
Tns4,11,99065678,99089306,protein_coding,-1,23628,chr11_99065678_99089306
Ccr7,11,99144196,99155077,protein_coding,-1,10881,chr11_99144196_99155077
Smarce1,11,99209047,99231017,protein_coding,-1,21970,chr11_99209047_99231017
Krt222,11,99232761,99244085,protein_coding,-1,11324,chr11_99232761_99244085
Krt24,11,99279959,99285262,protein_coding,-1,5303,chr11_99279959_99285262
Krt25,11,99315516,99322951,protein_coding,-1,7435,chr11_99315516_99322951
Krt26,11,99328550,99337966,protein_coding,-1,9416,chr11_99328550_99337966
Krt27,11,99345565,99351104,protein_coding,-1,5539,chr11_99345565_99351104
Krt28,11,99364872,99374903,protein_coding,-1,10031,chr11_99364872_99374903
Krt10,11,99385254,99389364,protein_coding,-1,4110,chr11_99385254_99389364
Gm11940,11,99387340,99387897,antisense,1,557,chr11_99387340_99387897
Krt12,11,99415666,99422259,protein_coding,-1,6593,chr11_99415666_99422259
A830036E02Rik,11,99416956,99425497,antisense,1,8541,chr11_99416956_99425497
Krt20,11,99428403,99438150,protein_coding,-1,9747,chr11_99428403_99438150
Krt23,11,99477974,99493137,protein_coding,-1,15163,chr11_99477974_99493137
Krt39,11,99514114,99521338,protein_coding,-1,7224,chr11_99514114_99521338
Krt40,11,99537485,99543158,protein_coding,-1,5673,chr11_99537485_99543158
Krtap16-1,11,99984710,99986597,protein_coding,-1,1887,chr11_99984710_99986597
Gm11571,11,100052286,100085983,antisense,1,33697,chr11_100052286_100085983
Krt15,11,100131758,100135928,protein_coding,-1,4170,chr11_100131758_100135928
Krt19,11,100140810,100148665,protein_coding,-1,7855,chr11_100140810_100148665
Krt9,11,100186781,100193246,protein_coding,-1,6465,chr11_100186781_100193246
Krt16,11,100246091,100248902,protein_coding,-1,2811,chr11_100246091_100248902
Krt17,11,100256217,100261029,protein_coding,-1,4812,chr11_100256217_100261029
Gm14206,11,100278706,100291286,antisense,-1,12580,chr11_100278706_100291286
Eif1,11,100319885,100322096,protein_coding,1,2211,chr11_100319885_100322096
Hap1,11,100347327,100356128,protein_coding,-1,8801,chr11_100347327_100356128
Jup,11,100368958,100397763,protein_coding,-1,28805,chr11_100368958_100397763
P3h4,11,100408456,100414836,protein_coding,-1,6380,chr11_100408456_100414836
Fkbp10,11,100415697,100424824,protein_coding,1,9127,chr11_100415697_100424824
Nt5c3b,11,100422321,100441808,protein_coding,-1,19487,chr11_100422321_100441808
Klhl10,11,100441917,100457022,protein_coding,1,15105,chr11_100441917_100457022
Klhl11,11,100462614,100472741,protein_coding,-1,10127,chr11_100462614_100472741
Acly,11,100476353,100528000,protein_coding,-1,51647,chr11_100476353_100528000
Ttc25,11,100545607,100572568,protein_coding,1,26961,chr11_100545607_100572568
Cnp,11,100574904,100591729,protein_coding,1,16825,chr11_100574904_100591729
Dnajc7,11,100582818,100620188,protein_coding,-1,37370,chr11_100582818_100620188
Nkiras2,11,100619244,100627607,protein_coding,1,8363,chr11_100619244_100627607
Zfp385c,11,100627543,100692455,protein_coding,-1,64912,chr11_100627543_100692455
Dhx58os,11,100687417,100697520,antisense,1,10103,chr11_100687417_100697520
Dhx58,11,100694884,100704271,protein_coding,-1,9387,chr11_100694884_100704271
Kat2a,11,100704746,100712465,protein_coding,-1,7719,chr11_100704746_100712465
Hspb9,11,100713850,100714575,protein_coding,1,725,chr11_100713850_100714575
Rab5c,11,100715009,100738215,protein_coding,-1,23206,chr11_100715009_100738215
Kcnh4,11,100740376,100759942,protein_coding,-1,19566,chr11_100740376_100759942
Hcrt,11,100761069,100762931,protein_coding,-1,1862,chr11_100761069_100762931
Ghdc,11,100766032,100770957,protein_coding,-1,4925,chr11_100766032_100770957
Stat5b,11,100780731,100850724,protein_coding,-1,69993,chr11_100780731_100850724
Stat5a,11,100859351,100885169,protein_coding,1,25818,chr11_100859351_100885169
Stat3,11,100885098,100939540,protein_coding,-1,54442,chr11_100885098_100939540
Cavin1,11,100956733,100970887,protein_coding,-1,14154,chr11_100956733_100970887
Atp6v0a1,11,101009452,101063719,protein_coding,1,54267,chr11_101009452_101063719
Naglu,11,101070012,101077672,protein_coding,1,7660,chr11_101070012_101077672
Hsd17b1,11,101078411,101080527,protein_coding,1,2116,chr11_101078411_101080527
Coasy,11,101082565,101086619,protein_coding,1,4054,chr11_101082565_101086619
Mlx,11,101087277,101092207,protein_coding,1,4930,chr11_101087277_101092207
Psmc3ip,11,101091823,101095436,protein_coding,-1,3613,chr11_101091823_101095436
Retreg3,11,101096322,101119893,protein_coding,-1,23571,chr11_101096322_101119893
Tubg1,11,101119938,101126419,protein_coding,1,6481,chr11_101119938_101126419
Tubg2,11,101155907,101161787,protein_coding,1,5880,chr11_101155907_101161787
Plekhh3,11,101162679,101171351,protein_coding,-1,8672,chr11_101162679_101171351
Cntnap1,11,101170523,101190724,protein_coding,1,20201,chr11_101170523_101190724
Ccr10,11,101172997,101175443,protein_coding,-1,2446,chr11_101172997_101175443
Ezh1,11,101191115,101226463,protein_coding,-1,35348,chr11_101191115_101226463
Ramp2,11,101246028,101259546,protein_coding,1,13518,chr11_101246028_101259546
Vps25,11,101253707,101259549,protein_coding,1,5842,chr11_101253707_101259549
Wnk4,11,101260567,101277409,protein_coding,1,16842,chr11_101260567_101277409
Gm11615,11,101264762,101266303,antisense,-1,1541,chr11_101264762_101266303
Coa3,11,101277968,101279114,protein_coding,-1,1146,chr11_101277968_101279114
Cntd1,11,101279012,101296317,protein_coding,1,17305,chr11_101279012_101296317
Becn1,11,101285952,101302286,protein_coding,-1,16334,chr11_101285952_101302286
Psme3,11,101316213,101323537,protein_coding,1,7324,chr11_101316213_101323537
Aoc2,11,101325063,101329702,protein_coding,1,4639,chr11_101325063_101329702
Aoc3,11,101330605,101341938,protein_coding,1,11333,chr11_101330605_101341938
Gm28156,11,101339660,101347939,antisense,-1,8279,chr11_101339660_101347939
G6pc,11,101367561,101377903,protein_coding,1,10342,chr11_101367561_101377903
Gm27029,11,101406664,101424796,protein_coding,-1,18132,chr11_101406664_101424796
Ptges3l,11,101418812,101425333,protein_coding,-1,6521,chr11_101418812_101425333
Rundc1,11,101425085,101435673,protein_coding,1,10588,chr11_101425085_101435673
Rpl27,11,101442298,101445529,protein_coding,1,3231,chr11_101442298_101445529
Ifi35,11,101448407,101458698,protein_coding,1,10291,chr11_101448407_101458698
Gm11626,11,101456576,101457390,antisense,-1,814,chr11_101456576_101457390
Vat1,11,101458745,101466230,protein_coding,-1,7485,chr11_101458745_101466230
Rnd2,11,101464999,101471853,protein_coding,1,6854,chr11_101464999_101471853
Brca1,11,101488764,101551955,protein_coding,-1,63191,chr11_101488764_101551955
Nbr1,11,101552149,101581951,protein_coding,1,29802,chr11_101552149_101581951
Tmem106a,11,101582242,101591788,protein_coding,1,9546,chr11_101582242_101591788
Gm11634,11,101593743,101599256,protein_coding,-1,5513,chr11_101593743_101599256
Gm11635,11,101610614,101615956,lincRNA,1,5342,chr11_101610614_101615956
Rdm1,11,101627195,101636100,protein_coding,1,8905,chr11_101627195_101636100
Arl4d,11,101665541,101667832,protein_coding,1,2291,chr11_101665541_101667832
Dhx8,11,101732919,101767358,protein_coding,1,34439,chr11_101732919_101767358
Etv4,11,101769742,101785371,protein_coding,-1,15629,chr11_101769742_101785371
Meox1,11,101877510,101894374,protein_coding,-1,16864,chr11_101877510_101894374
Gm11551,11,101886237,101891206,antisense,1,4969,chr11_101886237_101891206
4930417O22Rik,11,101952421,101960573,antisense,1,8152,chr11_101952421_101960573
Sost,11,101962458,101967015,protein_coding,-1,4557,chr11_101962458_101967015
Gm20659,11,101971143,101971859,antisense,1,716,chr11_101971143_101971859
Dusp3,11,101971143,101987013,protein_coding,-1,15870,chr11_101971143_101987013
Mpp3,11,101999652,102028461,protein_coding,-1,28809,chr11_101999652_102028461
E130111B04Rik,11,102030268,102035084,antisense,-1,4816,chr11_102030268_102035084
Cd300lg,11,102041509,102055620,protein_coding,1,14111,chr11_102041509_102055620
Mpp2,11,102057015,102088515,protein_coding,-1,31500,chr11_102057015_102088515
Ppy,11,102099930,102101319,protein_coding,-1,1389,chr11_102099930_102101319
Nags,11,102145513,102149477,protein_coding,1,3964,chr11_102145513_102149477
Tmem101,11,102152546,102156404,protein_coding,-1,3858,chr11_102152546_102156404
Lsm12,11,102162497,102185296,protein_coding,-1,22799,chr11_102162497_102185296
G6pc3,11,102189620,102194081,protein_coding,1,4461,chr11_102189620_102194081
Hdac5,11,102194432,102230166,protein_coding,-1,35734,chr11_102194432_102230166
Asb16,11,102268743,102279462,protein_coding,1,10719,chr11_102268743_102279462
Tmub2,11,102284931,102289237,protein_coding,1,4306,chr11_102284931_102289237
Atxn7l3,11,102289300,102296631,protein_coding,-1,7331,chr11_102289300_102296631
Ubtf,11,102304560,102319742,protein_coding,-1,15182,chr11_102304560_102319742
Slc4a1,11,102348824,102366203,protein_coding,-1,17379,chr11_102348824_102366203
Rundc3a,11,102393403,102402555,protein_coding,1,9152,chr11_102393403_102402555
Slc25a39,11,102402985,102407946,protein_coding,-1,4961,chr11_102402985_102407946
Grn,11,102430315,102437048,protein_coding,1,6733,chr11_102430315_102437048
Fam171a2,11,102436981,102447682,protein_coding,-1,10701,chr11_102436981_102447682
Itga2b,11,102453297,102470122,protein_coding,-1,16825,chr11_102453297_102470122
Gpatch8,11,102475915,102556392,protein_coding,-1,80477,chr11_102475915_102556392
Gm11627,11,102576398,102579461,protein_coding,-1,3063,chr11_102576398_102579461
Fzd2,11,102604396,102608058,protein_coding,1,3662,chr11_102604396_102608058
2810433D01Rik,11,102619796,102624416,lincRNA,-1,4620,chr11_102619796_102624416
Meioc,11,102663716,102682237,protein_coding,1,18521,chr11_102663716_102682237
Ccdc43,11,102684686,102697782,protein_coding,-1,13096,chr11_102684686_102697782
Adam11,11,102761439,102780262,protein_coding,1,18823,chr11_102761439_102780262
Gjc1,11,102799579,102819700,protein_coding,-1,20121,chr11_102799579_102819700
Higd1b,11,102835849,102838040,protein_coding,1,2191,chr11_102835849_102838040
Eftud2,11,102838473,102880985,protein_coding,-1,42512,chr11_102838473_102880985
Gfap,11,102887336,102900912,protein_coding,-1,13576,chr11_102887336_102900912
Kif18b,11,102905529,102925124,protein_coding,-1,19595,chr11_102905529_102925124
C1ql1,11,102939264,102946688,protein_coding,-1,7424,chr11_102939264_102946688
2410004I01Rik,11,102958300,102964387,lincRNA,-1,6087,chr11_102958300_102964387
Dcakd,11,102994047,103028333,protein_coding,-1,34286,chr11_102994047_103028333
Plcd3,11,103070304,103101658,protein_coding,-1,31354,chr11_103070304_103101658
Acbd4,11,103101682,103112200,protein_coding,1,10518,chr11_103101682_103112200
Hexim1,11,103116231,103119725,protein_coding,1,3494,chr11_103116231_103119725
Hexim2,11,103132429,103139876,protein_coding,1,7447,chr11_103132429_103139876
Fmnl1,11,103171107,103198901,protein_coding,1,27794,chr11_103171107_103198901
Gm20511,11,103190710,103192896,antisense,-1,2186,chr11_103190710_103192896
Spata32,11,103208127,103218432,protein_coding,-1,10305,chr11_103208127_103218432
Map3k14,11,103219762,103267472,protein_coding,-1,47710,chr11_103219762_103267472
Arhgap27,11,103331497,103363692,protein_coding,-1,32195,chr11_103331497_103363692
Arhgap27os3,11,103344753,103350124,antisense,1,5371,chr11_103344753_103350124
Arhgap27os2,11,103355701,103361092,antisense,1,5391,chr11_103355701_103361092
Arhgap27os1,11,103363213,103364651,antisense,1,1438,chr11_103363213_103364651
Plekhm1,11,103364275,103412687,protein_coding,-1,48412,chr11_103364275_103412687
Gm39397,11,103421736,103422062,lincRNA,1,326,chr11_103421736_103422062
Lrrc37a,11,103450709,103504597,protein_coding,-1,53888,chr11_103450709_103504597
Gm884,11,103534577,103621140,protein_coding,-1,86563,chr11_103534577_103621140
Lyzl6,11,103631070,103638890,protein_coding,-1,7820,chr11_103631070_103638890
Rprml,11,103649570,103650579,protein_coding,1,1009,chr11_103649570_103650579
Gosr2,11,103676849,103697898,protein_coding,-1,21049,chr11_103676849_103697898
Wnt9b,11,103727364,103749821,protein_coding,-1,22457,chr11_103727364_103749821
Wnt3,11,103774150,103817957,protein_coding,1,43807,chr11_103774150_103817957
Nsf,11,103821782,103954056,protein_coding,-1,132274,chr11_103821782_103954056
Arf2,11,103966739,103985337,protein_coding,1,18598,chr11_103966739_103985337
Crhr1,11,104132855,104175523,protein_coding,1,42668,chr11_104132855_104175523
Sppl2c,11,104186327,104191163,protein_coding,1,4836,chr11_104186327_104191163
Mapt,11,104231390,104332090,protein_coding,1,100700,chr11_104231390_104332090
Gm11659,11,104250902,104259361,antisense,-1,8459,chr11_104250902_104259361
Kansl1,11,104333229,104468861,protein_coding,-1,135632,chr11_104333229_104468861
Cdc27,11,104502745,104550620,protein_coding,-1,47875,chr11_104502745_104550620
Myl4,11,104550663,104595753,protein_coding,1,45090,chr11_104550663_104595753
Gm11665,11,104556789,104557777,antisense,-1,988,chr11_104556789_104557777
Itgb3,11,104608000,104670476,protein_coding,1,62476,chr11_104608000_104670476
Gm11639,11,104685707,105117394,protein_coding,1,431687,chr11_104685707_105117394
Efcab3,11,105063592,105117537,protein_coding,1,53945,chr11_105063592_105117537
Mettl2,11,105126425,105140394,protein_coding,1,13969,chr11_105126425_105140394
1700052K11Rik,11,105177726,105181433,antisense,-1,3707,chr11_105177726_105181433
Tlk2,11,105178807,105283959,protein_coding,1,105152,chr11_105178807_105283959
Mrc2,11,105292643,105351139,protein_coding,1,58496,chr11_105292643_105351139
Gm11640,11,105434445,105435412,antisense,1,967,chr11_105434445_105435412
Tanc2,11,105589986,105929304,protein_coding,1,339318,chr11_105589986_105929304
Cyb561,11,105933702,105953336,protein_coding,-1,19634,chr11_105933702_105953336
Gm11651,11,105965608,105985694,antisense,-1,20086,chr11_105965608_105985694
Ace,11,105967945,105989964,protein_coding,1,22019,chr11_105967945_105989964
Ace3,11,105994675,106005443,protein_coding,1,10768,chr11_105994675_106005443
Kcnh6,11,106008124,106034549,protein_coding,1,26425,chr11_106008124_106034549
Dcaf7,11,106036872,106059324,protein_coding,1,22452,chr11_106036872_106059324
Gm11646,11,106051151,106051852,antisense,-1,701,chr11_106051151_106051852
Taco1os,11,106065077,106066305,antisense,-1,1228,chr11_106065077_106066305
Taco1,11,106066061,106073612,protein_coding,1,7551,chr11_106066061_106073612
Map3k3,11,106084613,106155446,protein_coding,1,70833,chr11_106084613_106155446
Gm11672,11,106126336,106127351,antisense,-1,1015,chr11_106126336_106127351
Limd2,11,106156256,106160860,protein_coding,-1,4604,chr11_106156256_106160860
Strada,11,106163330,106202168,protein_coding,-1,38838,chr11_106163330_106202168
Ccdc47,11,106197408,106216344,protein_coding,-1,18936,chr11_106197408_106216344
Ddx42,11,106216926,106249139,protein_coding,1,32213,chr11_106216926_106249139
Ftsj3,11,106249142,106256079,protein_coding,-1,6937,chr11_106249142_106256079
Psmc5,11,106256154,106263120,protein_coding,1,6966,chr11_106256154_106263120
Smarcd2,11,106263179,106272972,protein_coding,-1,9793,chr11_106263179_106272972
Tcam1,11,106276672,106288745,protein_coding,1,12073,chr11_106276672_106288745
Cd79b,11,106311341,106314762,protein_coding,-1,3421,chr11_106311341_106314762
Scn4a,11,106318592,106353288,protein_coding,-1,34696,chr11_106318592_106353288
Prr29,11,106365472,106377558,protein_coding,1,12086,chr11_106365472_106377558
Icam2,11,106377656,106388075,protein_coding,-1,10419,chr11_106377656_106388075
Ern1,11,106394650,106487852,protein_coding,-1,93202,chr11_106394650_106487852
Tex2,11,106502147,106613423,protein_coding,-1,111276,chr11_106502147_106613423
Pecam1,11,106654217,106750628,protein_coding,-1,96411,chr11_106654217_106750628
Milr1,11,106751226,106768794,protein_coding,1,17568,chr11_106751226_106768794
Polg2,11,106768253,106779537,protein_coding,-1,11284,chr11_106768253_106779537
Ddx5,11,106780355,106789185,protein_coding,-1,8830,chr11_106780355_106789185
Cep95,11,106789252,106819930,protein_coding,1,30678,chr11_106789252_106819930
Gm11706,11,106814670,106816008,antisense,-1,1338,chr11_106814670_106816008
Smurf2,11,106820066,106920715,protein_coding,-1,100649,chr11_106820066_106920715
Kpna2,11,106988629,106999541,protein_coding,-1,10912,chr11_106988629_106999541
1810010H24Rik,11,107025681,107030443,protein_coding,1,4762,chr11_107025681_107030443
Bptf,11,107033081,107132127,protein_coding,-1,99046,chr11_107033081_107132127
Gm11715,11,107157408,107167150,antisense,1,9742,chr11_107157408_107167150
Nol11,11,107166663,107189381,protein_coding,-1,22718,chr11_107166663_107189381
Pitpnc1,11,107207892,107470699,protein_coding,-1,262807,chr11_107207892_107470699
Gm11716,11,107338050,107344804,antisense,1,6754,chr11_107338050_107344804
Gm11712,11,107386983,107388971,antisense,1,1988,chr11_107386983_107388971
Gm11713,11,107410390,107413549,antisense,1,3159,chr11_107410390_107413549
Psmd12,11,107479484,107504362,protein_coding,1,24878,chr11_107479484_107504362
C330019F10Rik,11,107511403,107527220,lincRNA,-1,15817,chr11_107511403_107527220
Helz,11,107547930,107693826,protein_coding,1,145896,chr11_107547930_107693826
Cacng1,11,107703218,107716522,protein_coding,-1,13304,chr11_107703218_107716522
Cacng4,11,107732357,107794557,protein_coding,-1,62200,chr11_107732357_107794557
Cacng5,11,107874605,107915055,protein_coding,-1,40450,chr11_107874605_107915055
Prkca,11,107933387,108343928,protein_coding,-1,410541,chr11_107933387_108343928
Gm11655,11,108181850,108194126,antisense,1,12276,chr11_108181850_108194126
Apoh,11,108343354,108414396,protein_coding,1,71042,chr11_108343354_108414396
Cep112,11,108425192,108860615,protein_coding,1,435423,chr11_108425192_108860615
Cep112os1,11,108529097,108533664,antisense,-1,4567,chr11_108529097_108533664
Axin2,11,108920349,108950783,protein_coding,1,30434,chr11_108920349_108950783
Gm11670,11,108939310,108942015,antisense,-1,2705,chr11_108939310_108942015
E030025P04Rik,11,109139291,109144369,protein_coding,-1,5078,chr11_109139291_109144369
Rgs9,11,109225355,109298129,protein_coding,-1,72774,chr11_109225355_109298129
1700096J18Rik,11,109346839,109353651,lincRNA,1,6812,chr11_109346839_109353651
Gm11696,11,109352835,109363654,antisense,-1,10819,chr11_109352835_109363654
Gna13,11,109362831,109401369,protein_coding,1,38538,chr11_109362831_109401369
9930022D16Rik,11,109413917,109420405,protein_coding,1,6488,chr11_109413917_109420405
Amz2,11,109425946,109452813,protein_coding,1,26867,chr11_109425946_109452813
Gm15642,11,109437172,109438145,antisense,-1,973,chr11_109437172_109438145
Slc16a6,11,109450855,109473598,protein_coding,-1,22743,chr11_109450855_109473598
Arsg,11,109473374,109573330,protein_coding,1,99956,chr11_109473374_109573330
Wipi1,11,109573331,109611967,protein_coding,-1,38636,chr11_109573331_109611967
Gm11685,11,109616320,109641789,lincRNA,1,25469,chr11_109616320_109641789
Prkar1a,11,109649405,109669656,protein_coding,1,20251,chr11_109649405_109669656
Fam20a,11,109669749,109722279,protein_coding,-1,52530,chr11_109669749_109722279
Gm11684,11,109768486,109770599,antisense,1,2113,chr11_109768486_109770599
1700012B07Rik,11,109787651,109828046,protein_coding,-1,40395,chr11_109787651_109828046
Gm11683,11,109797183,109802796,antisense,1,5613,chr11_109797183_109802796
Abca8b,11,109932190,109995845,protein_coding,-1,63655,chr11_109932190_109995845
Gm11697,11,109936316,109938135,antisense,1,1819,chr11_109936316_109938135
Abca8a,11,110025634,110095978,protein_coding,-1,70344,chr11_110025634_110095978
Abca9,11,110100749,110168196,protein_coding,-1,67447,chr11_110100749_110168196
Abca6,11,110176820,110251776,protein_coding,-1,74956,chr11_110176820_110251776
Abca5,11,110269369,110337716,protein_coding,-1,68347,chr11_110269369_110337716
Map2k6,11,110399122,110525522,protein_coding,1,126400,chr11_110399122_110525522
Gm11682,11,110544507,110546399,lincRNA,1,1892,chr11_110544507_110546399
Kcnj16,11,110968033,111027968,protein_coding,1,59935,chr11_110968033_111027968
Kcnj2,11,111066164,111076821,protein_coding,1,10657,chr11_111066164_111076821
Gm11674,11,111796347,111800876,lincRNA,-1,4529,chr11_111796347_111800876
Gm11680,11,112107438,112132196,lincRNA,1,24758,chr11_112107438_112132196
Sox9,11,112782224,112787760,protein_coding,1,5536,chr11_112782224_112787760
Gm11681,11,112792731,112799008,lincRNA,-1,6277,chr11_112792731_112799008
4933434M16Rik,11,112825154,112832469,lincRNA,1,7315,chr11_112825154_112832469
2610035D17Rik,11,113043895,113201838,lincRNA,-1,157943,chr11_113043895_113201838
4732490B19Rik,11,113203315,113209669,lincRNA,-1,6354,chr11_113203315_113209669
Slc39a11,11,113244853,113650079,protein_coding,-1,405226,chr11_113244853_113650079
Sstr2,11,113619342,113626028,protein_coding,1,6686,chr11_113619342_113626028
Cog1,11,113649169,113667054,protein_coding,1,17885,chr11_113649169_113667054
Fam104a,11,113661319,113684155,protein_coding,-1,22836,chr11_113661319_113684155
D11Wsu47e,11,113684412,113694647,protein_coding,1,10235,chr11_113684412_113694647
Cpsf4l,11,113698172,113710017,protein_coding,-1,11845,chr11_113698172_113710017
Cdc42ep4,11,113726850,113751881,protein_coding,-1,25031,chr11_113726850_113751881
Sdk2,11,113776374,114067046,protein_coding,-1,290672,chr11_113776374_114067046
1700025D23Rik,11,114091406,114095336,lincRNA,1,3930,chr11_114091406_114095336
Gm11690,11,114219239,114238502,lincRNA,-1,19263,chr11_114219239_114238502
4932435O22Rik,11,114413401,114448860,lincRNA,-1,35459,chr11_114413401_114448860
Rpl38,11,114668524,114672331,protein_coding,1,3807,chr11_114668524_114672331
Ttyh2,11,114675431,114720977,protein_coding,1,45546,chr11_114675431_114720977
Dnaic2,11,114727408,114757889,protein_coding,1,30481,chr11_114727408_114757889
Kif19a,11,114765388,114790739,protein_coding,1,25351,chr11_114765388_114790739
Btbd17,11,114791217,114795945,protein_coding,-1,4728,chr11_114791217_114795945
Gpr142,11,114798924,114806745,protein_coding,1,7821,chr11_114798924_114806745
Gprc5c,11,114851152,114872617,protein_coding,1,21465,chr11_114851152_114872617
Cd300a,11,114890041,114904654,protein_coding,1,14613,chr11_114890041_114904654
Cd300lb,11,114922781,114934386,protein_coding,-1,11605,chr11_114922781_114934386
Cd300c,11,114956116,114969157,protein_coding,-1,13041,chr11_114956116_114969157
Cd300c2,11,114996721,115001880,protein_coding,-1,5159,chr11_114996721_115001880
Cd300ld2,11,115010335,115016193,protein_coding,-1,5858,chr11_115010335_115016193
Cd300e,11,115051917,115062177,protein_coding,-1,10260,chr11_115051917_115062177
Rab37,11,115091431,115162236,protein_coding,1,70805,chr11_115091431_115162236
Cd300lf,11,115116214,115133992,protein_coding,-1,17778,chr11_115116214_115133992
Slc9a3r1,11,115163341,115181181,protein_coding,1,17840,chr11_115163341_115181181
Nat9,11,115182832,115187859,protein_coding,-1,5027,chr11_115182832_115187859
Tmem104,11,115187487,115247023,protein_coding,1,59536,chr11_115187487_115247023
Grin2c,11,115249169,115267243,protein_coding,-1,18074,chr11_115249169_115267243
Fdxr,11,115268024,115277050,protein_coding,-1,9026,chr11_115268024_115277050
Fads6,11,115279622,115297663,protein_coding,-1,18041,chr11_115279622_115297663
Otop2,11,115307163,115332303,protein_coding,1,25140,chr11_115307163_115332303
Ush1g,11,115315192,115322041,protein_coding,-1,6849,chr11_115315192_115322041
Otop3,11,115334731,115346927,protein_coding,1,12196,chr11_115334731_115346927
Hid1,11,115347707,115367756,protein_coding,-1,20049,chr11_115347707_115367756
Cdr2l,11,115381916,115396132,protein_coding,1,14216,chr11_115381916_115396132
Mrpl58,11,115403752,115412674,protein_coding,1,8922,chr11_115403752_115412674
Ict1os,11,115406586,115408314,antisense,-1,1728,chr11_115406586_115408314
Atp5h,11,115415689,115419962,protein_coding,-1,4273,chr11_115415689_115419962
Kctd2,11,115420128,115431274,protein_coding,1,11146,chr11_115420128_115431274
Trim80,11,115440545,115448270,protein_coding,1,7725,chr11_115440545_115448270
Gm11695,11,115462045,115463454,antisense,-1,1409,chr11_115462045_115463454
Slc16a5,11,115462474,115474398,protein_coding,1,11924,chr11_115462474_115474398
Armc7,11,115475667,115490467,protein_coding,1,14800,chr11_115475667_115490467
Nt5c,11,115490420,115491862,protein_coding,-1,1442,chr11_115490420_115491862
Jpt1,11,115497353,115514387,protein_coding,-1,17034,chr11_115497353_115514387
Sumo2,11,115523102,115536276,protein_coding,-1,13174,chr11_115523102_115536276
Nup85,11,115564434,115583985,protein_coding,1,19551,chr11_115564434_115583985
Gga3,11,115584255,115604051,protein_coding,-1,19796,chr11_115584255_115604051
Mrps7,11,115603925,115608036,protein_coding,1,4111,chr11_115603925_115608036
Mif4gd,11,115607918,115612969,protein_coding,-1,5051,chr11_115607918_115612969
Slc25a19,11,115614178,115628295,protein_coding,-1,14117,chr11_115614178_115628295
Grb2,11,115644045,115708597,protein_coding,-1,64552,chr11_115644045_115708597
Tmem94,11,115765433,115799366,protein_coding,1,33933,chr11_115765433_115799366
Caskin2,11,115799183,115813639,protein_coding,-1,14456,chr11_115799183_115813639
Tsen54,11,115814724,115823094,protein_coding,1,8370,chr11_115814724_115823094
Llgl2,11,115824049,115855780,protein_coding,1,31731,chr11_115824049_115855780
Myo15b,11,115858406,115892603,protein_coding,1,34197,chr11_115858406_115892603
Recql5,11,115892595,115933477,protein_coding,-1,40882,chr11_115892595_115933477
Smim5,11,115899966,115906269,protein_coding,1,6303,chr11_115899966_115906269
Smim6,11,115912017,115913920,protein_coding,1,1903,chr11_115912017_115913920
Recql5os1,11,115925027,115926143,antisense,1,1116,chr11_115925027_115926143
Sap30bp,11,115933282,115966725,protein_coding,1,33443,chr11_115933282_115966725
Sap30bpos,11,115946450,115952105,antisense,-1,5655,chr11_115946450_115952105
Itgb4,11,115974709,116008412,protein_coding,1,33703,chr11_115974709_116008412
Galk1,11,116008457,116012719,protein_coding,-1,4262,chr11_116008457_116012719
H3f3b,11,116021912,116027962,protein_coding,-1,6050,chr11_116021912_116027962
Unk,11,116030322,116061214,protein_coding,1,30892,chr11_116030322_116061214
Unc13d,11,116062095,116077961,protein_coding,-1,15866,chr11_116062095_116077961
Wbp2,11,116078573,116086995,protein_coding,-1,8422,chr11_116078573_116086995
Trim47,11,116105752,116127210,protein_coding,-1,21458,chr11_116105752_116127210
Trim65,11,116121846,116131128,protein_coding,-1,9282,chr11_116121846_116131128
Mrpl38,11,116131817,116138868,protein_coding,-1,7051,chr11_116131817_116138868
Fbf1,11,116142285,116168166,protein_coding,-1,25881,chr11_116142285_116168166
Acox1,11,116171888,116199045,protein_coding,-1,27157,chr11_116171888_116199045
Ten1,11,116198855,116215318,protein_coding,1,16463,chr11_116198855_116215318
Evpl,11,116220559,116238077,protein_coding,-1,17518,chr11_116220559_116238077
Srp68,11,116245166,116274217,protein_coding,-1,29051,chr11_116245166_116274217
Galr2,11,116280939,116283938,protein_coding,1,2999,chr11_116280939_116283938
Exoc7,11,116288001,116307233,protein_coding,-1,19232,chr11_116288001_116307233
Foxj1,11,116330704,116335399,protein_coding,-1,4695,chr11_116330704_116335399
Rnf157,11,116336353,116413032,protein_coding,-1,76679,chr11_116336353_116413032
Ubald2,11,116434094,116439077,protein_coding,1,4983,chr11_116434094_116439077
Qrich2,11,116441325,116466241,protein_coding,-1,24916,chr11_116441325_116466241
Gm11739,11,116466319,116474274,antisense,1,7955,chr11_116466319_116474274
Prpsap1,11,116470845,116494202,protein_coding,-1,23357,chr11_116470845_116494202
Gm29292,11,116529215,116533077,antisense,-1,3862,chr11_116529215_116533077
Sphk1,11,116530925,116536675,protein_coding,1,5750,chr11_116530925_116536675
Ube2o,11,116537740,116581447,protein_coding,-1,43707,chr11_116537740_116581447
Aanat,11,116586432,116597680,protein_coding,1,11248,chr11_116586432_116597680
Rhbdf2,11,116598165,116627019,protein_coding,-1,28854,chr11_116598165_116627019
Cygb,11,116645595,116654313,protein_coding,-1,8718,chr11_116645595_116654313
Prcd,11,116653534,116668389,protein_coding,1,14855,chr11_116653534_116668389
St6galnac2,11,116675303,116694868,protein_coding,-1,19565,chr11_116675303_116694868
BC018473,11,116752167,116759373,antisense,1,7206,chr11_116752167_116759373
St6galnac1,11,116765025,116775507,protein_coding,-1,10482,chr11_116765025_116775507
Mxra7,11,116803062,116828046,protein_coding,-1,24984,chr11_116803062_116828046
Jmjd6,11,116837432,116843449,protein_coding,-1,6017,chr11_116837432_116843449
Mettl23,11,116843278,116854263,protein_coding,1,10985,chr11_116843278_116854263
Srsf2,11,116849901,116853094,protein_coding,-1,3193,chr11_116849901_116853094
Mfsd11,11,116852440,116875635,protein_coding,1,23195,chr11_116852440_116875635
Mgat5b,11,116918863,116986948,protein_coding,1,68085,chr11_116918863_116986948
Gm11728,11,117035078,117040193,lincRNA,-1,5115,chr11_117035078_117040193
Gm11731,11,117058425,117060268,lincRNA,1,1843,chr11_117058425_117060268
Snhg20,11,117076008,117078955,lincRNA,1,2947,chr11_117076008_117078955
Gm11730,11,117094948,117097067,antisense,-1,2119,chr11_117094948_117097067
Sec14l1,11,117115168,117159268,protein_coding,1,44100,chr11_117115168_117159268
Gm16045,11,117257649,117263437,antisense,-1,5788,chr11_117257649_117263437
Gm11729,11,117414389,117415368,lincRNA,1,979,chr11_117414389_117415368
Gm34418,11,117479875,117482597,lincRNA,-1,2722,chr11_117479875_117482597
Gm11733,11,117484368,117489014,protein_coding,1,4646,chr11_117484368_117489014
Gm11734,11,117523603,117532205,lincRNA,1,8602,chr11_117523603_117532205
Tnrc6c,11,117654289,117763439,protein_coding,1,109150,chr11_117654289_117763439
Tmc6,11,117765988,117782198,protein_coding,-1,16210,chr11_117765988_117782198
Tmc8,11,117782076,117793110,protein_coding,1,11034,chr11_117782076_117793110
Gm11724,11,117789897,117791313,antisense,-1,1416,chr11_117789897_117791313
6030468B19Rik,11,117797660,117807301,protein_coding,1,9641,chr11_117797660_117807301
Gm20708,11,117809668,117839904,protein_coding,1,30236,chr11_117809668_117839904
Tk1,11,117815526,117826092,protein_coding,-1,10566,chr11_117815526_117826092
Afmid,11,117825924,117839908,protein_coding,1,13984,chr11_117825924_117839908
Birc5,11,117849251,117855743,protein_coding,1,6492,chr11_117849251_117855743
Tmem235,11,117860752,117865543,protein_coding,1,4791,chr11_117860752_117865543
Tha1,11,117867952,117873481,protein_coding,-1,5529,chr11_117867952_117873481
Gm11725,11,117871250,117887416,antisense,1,16166,chr11_117871250_117887416
Socs3,11,117966079,117970047,protein_coding,-1,3968,chr11_117966079_117970047
Pgs1,11,117986292,118024011,protein_coding,1,37719,chr11_117986292_118024011
Dnah17,11,118021723,118130634,protein_coding,-1,108911,chr11_118021723_118130634
Gm11738,11,118114855,118118279,antisense,1,3424,chr11_118114855_118118279
Cyth1,11,118132019,118248592,protein_coding,-1,116573,chr11_118132019_118248592
Usp36,11,118259651,118290244,protein_coding,-1,30593,chr11_118259651_118290244
Timp2,11,118301069,118355740,protein_coding,-1,54671,chr11_118301069_118355740
Lgals3bp,11,118392751,118402092,protein_coding,-1,9341,chr11_118392751_118402092
Cant1,11,118406289,118419086,protein_coding,-1,12797,chr11_118406289_118419086
C1qtnf1,11,118428203,118449963,protein_coding,1,21760,chr11_118428203_118449963
Gm11747,11,118444200,118454995,antisense,-1,10795,chr11_118444200_118454995
Engase,11,118476829,118489209,protein_coding,1,12380,chr11_118476829_118489209
Rbfox3,11,118489762,118911597,protein_coding,-1,421835,chr11_118489762_118911597
Gm11750,11,118791372,118793828,lincRNA,1,2456,chr11_118791372_118793828
Enpp7,11,118988188,118993221,protein_coding,1,5033,chr11_118988188_118993221
Cbx2,11,119022962,119031270,protein_coding,1,8308,chr11_119022962_119031270
Cbx8,11,119036305,119040969,protein_coding,-1,4664,chr11_119036305_119040969
Cbx4,11,119077573,119086221,protein_coding,-1,8648,chr11_119077573_119086221
Gm11754,11,119106328,119111425,lincRNA,-1,5097,chr11_119106328_119111425
Gm11755,11,119123011,119138421,lincRNA,-1,15410,chr11_119123011_119138421
Tbc1d16,11,119143045,119228499,protein_coding,-1,85454,chr11_119143045_119228499
Gm11752,11,119220160,119222473,lincRNA,1,2313,chr11_119220160_119222473
Ccdc40,11,119228572,119265238,protein_coding,1,36666,chr11_119228572_119265238
Gaa,11,119267887,119285454,protein_coding,1,17567,chr11_119267887_119285454
Eif4a3,11,119288363,119300089,protein_coding,-1,11726,chr11_119288363_119300089
Card14,11,119307768,119345375,protein_coding,1,37607,chr11_119307768_119345375
Sgsh,11,119343425,119355536,protein_coding,-1,12111,chr11_119343425_119355536
Slc26a11,11,119355557,119381079,protein_coding,1,25522,chr11_119355557_119381079
Rnf213,11,119393100,119487418,protein_coding,1,94318,chr11_119393100_119487418
Endov,11,119491347,119511437,protein_coding,1,20090,chr11_119491347_119511437
Nptx1,11,119538719,119547753,protein_coding,-1,9034,chr11_119538719_119547753
Rptor,11,119602905,119899576,protein_coding,1,296671,chr11_119602905_119899576
Rptoros,11,119820812,119834365,antisense,-1,13553,chr11_119820812_119834365
Chmp6,11,119913441,119919548,protein_coding,1,6107,chr11_119913441_119919548
Gm11767,11,119935803,119942698,antisense,-1,6895,chr11_119935803_119942698
Gm11766,11,119938511,119942074,lincRNA,1,3563,chr11_119938511_119942074
Baiap2,11,119942763,120006782,protein_coding,1,64019,chr11_119942763_120006782
Aatk,11,120007313,120047167,protein_coding,-1,39854,chr11_120007313_120047167
Cep131,11,120064430,120086827,protein_coding,-1,22397,chr11_120064430_120086827
Tepsin,11,120090531,120098731,protein_coding,-1,8200,chr11_120090531_120098731
Ndufaf8,11,120098928,120100705,protein_coding,1,1777,chr11_120098928_120100705
Slc38a10,11,120103960,120151346,protein_coding,-1,47386,chr11_120103960_120151346
Gm11770,11,120215082,120216993,antisense,-1,1911,chr11_120215082_120216993
Bahcc1,11,120232947,120292296,protein_coding,1,59349,chr11_120232947_120292296
Gm11772,11,120235234,120236122,antisense,-1,888,chr11_120235234_120236122
Actg1,11,120345690,120348542,protein_coding,-1,2852,chr11_120345690_120348542
Fscn2,11,120361534,120368168,protein_coding,1,6634,chr11_120361534_120368168
Faap100,11,120369055,120378764,protein_coding,-1,9709,chr11_120369055_120378764
Nploc4,11,120380370,120437708,protein_coding,-1,57338,chr11_120380370_120437708
Pde6g,11,120447605,120453500,protein_coding,-1,5895,chr11_120447605_120453500
Oxld1,11,120456606,120458068,protein_coding,-1,1462,chr11_120456606_120458068
Ccdc137,11,120458115,120464358,protein_coding,1,6243,chr11_120458115_120464358
Arl16,11,120464866,120467607,protein_coding,-1,2741,chr11_120464866_120467607
Hgs,11,120467635,120483979,protein_coding,1,16344,chr11_120467635_120483979
Mrpl12,11,120484613,120489065,protein_coding,1,4452,chr11_120484613_120489065
Slc25a10,11,120491840,120499187,protein_coding,1,7347,chr11_120491840_120499187
Gcgr,11,120530699,120538986,protein_coding,1,8287,chr11_120530699_120538986
Mcrip1,11,120542888,120549727,protein_coding,-1,6839,chr11_120542888_120549727
P4hb,11,120560298,120573253,protein_coding,-1,12955,chr11_120560298_120573253
Arhgdia,11,120578104,120581624,protein_coding,-1,3520,chr11_120578104_120581624
Alyref,11,120592121,120598365,protein_coding,-1,6244,chr11_120592121_120598365
Anapc11,11,120598421,120608198,protein_coding,1,9777,chr11_120598421_120608198
Npb,11,120608477,120609093,protein_coding,1,616,chr11_120608477_120609093
Pcyt2,11,120610087,120617936,protein_coding,-1,7849,chr11_120610087_120617936
Sirt7,11,120618372,120625240,protein_coding,-1,6868,chr11_120618372_120625240
Mafg,11,120625117,120633600,protein_coding,-1,8483,chr11_120625117_120633600
Pycr1,11,120635712,120643769,protein_coding,-1,8057,chr11_120635712_120643769
Myadml2,11,120646031,120648158,protein_coding,-1,2127,chr11_120646031_120648158
Myadml2os,11,120647670,120657061,antisense,1,9391,chr11_120647670_120657061
Notum,11,120653788,120661175,protein_coding,-1,7387,chr11_120653788_120661175
Notumos,11,120659157,120661815,antisense,1,2658,chr11_120659157_120661815
Aspscr1,11,120672973,120709447,protein_coding,1,36474,chr11_120672973_120709447
Gm17178,11,120689146,120709447,antisense,-1,20301,chr11_120689146_120709447
Cenpx,11,120710942,120713738,protein_coding,-1,2796,chr11_120710942_120713738
Lrrc45,11,120713925,120721128,protein_coding,1,7203,chr11_120713925_120721128
Rac3,11,120721470,120723969,protein_coding,1,2499,chr11_120721470_120723969
Dcxr,11,120725399,120727281,protein_coding,-1,1882,chr11_120725399_120727281
Cbr2,11,120729489,120732114,protein_coding,-1,2625,chr11_120729489_120732114
Hmga1b,11,120762794,120764419,protein_coding,1,1625,chr11_120762794_120764419
Rfng,11,120780746,120784207,protein_coding,-1,3461,chr11_120780746_120784207
Gps1,11,120784272,120789102,protein_coding,1,4830,chr11_120784272_120789102
Dus1l,11,120789201,120796403,protein_coding,-1,7202,chr11_120789201_120796403
Fasn,11,120805846,120824547,protein_coding,-1,18701,chr11_120805846_120824547
Ccdc57,11,120826529,120932872,protein_coding,-1,106343,chr11_120826529_120932872
Gm11773,11,120831029,120834244,antisense,1,3215,chr11_120831029_120834244
Slc16a3,11,120948480,120960868,protein_coding,1,12388,chr11_120948480_120960868
Csnk1d,11,120958990,120991330,protein_coding,-1,32340,chr11_120958990_120991330
Gm28192,11,120963844,120964764,antisense,1,920,chr11_120963844_120964764
Gm11775,11,121029402,121052357,antisense,1,22955,chr11_121029402_121052357
Cd7,11,121036747,121039418,protein_coding,-1,2671,chr11_121036747_121039418
Sectm1b,11,121053458,121063569,protein_coding,-1,10111,chr11_121053458_121063569
Sectm1a,11,121067407,121081220,protein_coding,-1,13813,chr11_121067407_121081220
Uts2r,11,121160271,121161973,protein_coding,1,1702,chr11_121160271_121161973
Ogfod3,11,121177591,121204711,protein_coding,-1,27120,chr11_121177591_121204711
Hexdc,11,121204433,121222655,protein_coding,1,18222,chr11_121204433_121222655
Narf,11,121237253,121255856,protein_coding,1,18603,chr11_121237253_121255856
Foxk2,11,121259990,121309896,protein_coding,1,49906,chr11_121259990_121309896
Wdr45b,11,121327224,121354445,protein_coding,-1,27221,chr11_121327224_121354445
Rab40b,11,121356125,121388251,protein_coding,-1,32126,chr11_121356125_121388251
Fn3krp,11,121421401,121431288,protein_coding,1,9887,chr11_121421401_121431288
Fn3k,11,121434913,121450491,protein_coding,1,15578,chr11_121434913_121450491
Tbcd,11,121451949,121617164,protein_coding,1,165215,chr11_121451949_121617164
Zfp750,11,121510978,121519333,protein_coding,-1,8355,chr11_121510978_121519333
B3gntl1,11,121616197,121673153,protein_coding,-1,56956,chr11_121616197_121673153
Metrnl,11,121701544,121716306,protein_coding,1,14762,chr11_121701544_121716306
Ptchd3,11,121830247,121843423,protein_coding,1,13176,chr11_121830247_121843423
Gm12590,11,121882333,121883863,lincRNA,-1,1530,chr11_121882333_121883863
Gm46400,13,3116916,3119562,lincRNA,-1,2646,chr13_3116916_3119562
Gm40653,13,3273235,3282998,lincRNA,1,9763,chr13_3273235_3282998
Gm48530,13,3325296,3358455,lincRNA,-1,33159,chr13_3325296_3358455
2810429I04Rik,13,3478230,3501393,lincRNA,1,23163,chr13_3478230_3501393
Gdi2,13,3538063,3567871,protein_coding,1,29808,chr13_3538063_3567871
Asb13,13,3634032,3653822,protein_coding,1,19790,chr13_3634032_3653822
Gm47695,13,3759825,3781203,lincRNA,1,21378,chr13_3759825_3781203
Gm35190,13,3762282,3766722,lincRNA,-1,4440,chr13_3762282_3766722
Net1,13,3882018,3918220,protein_coding,-1,36202,chr13_3882018_3918220
Tubal3,13,3918274,3935277,protein_coding,1,17003,chr13_3918274_3935277
Akr1c14,13,4049011,4090688,protein_coding,1,41677,chr13_4049011_4090688
Gm47904,13,4091286,4092636,lincRNA,1,1350,chr13_4091286_4092636
Akr1c18,13,4132615,4150654,protein_coding,-1,18039,chr13_4132615_4150654
Gm47925,13,4166503,4172845,lincRNA,1,6342,chr13_4166503_4172845
Akr1c6,13,4434306,4457877,protein_coding,1,23571,chr13_4434306_4457877
Akr1c20,13,4486849,4523345,protein_coding,-1,36496,chr13_4486849_4523345
Akr1c21,13,4574075,4586541,protein_coding,1,12466,chr13_4574075_4586541
Akr1e1,13,4590750,4609174,protein_coding,-1,18424,chr13_4590750_4609174
Gm40658,13,4643907,4749064,lincRNA,1,105157,chr13_4643907_4749064
Gm5444,13,4771651,4836485,lincRNA,1,64834,chr13_4771651_4836485
Gm47450,13,4915714,4943052,lincRNA,-1,27338,chr13_4915714_4943052
1700016G22Rik,13,5855508,5858092,lincRNA,-1,2584,chr13_5855508_5858092
Klf6,13,5861482,5870394,protein_coding,1,8912,chr13_5861482_5870394
Gm47507,13,5887109,5928045,lincRNA,1,40936,chr13_5887109_5928045
Gm46401,13,5915793,6014285,lincRNA,1,98492,chr13_5915793_6014285
Gm47549,13,6269108,6277026,lincRNA,1,7918,chr13_6269108_6277026
Gm35615,13,6280378,6294714,lincRNA,-1,14336,chr13_6280378_6294714
Gm28465,13,6395716,6398740,lincRNA,1,3024,chr13_6395716_6398740
Pitrm1,13,6548149,6580515,protein_coding,1,32366,chr13_6548149_6580515
Pfkp,13,6579768,6648777,protein_coding,-1,69009,chr13_6579768_6648777
Gm40662,13,6995654,7076316,lincRNA,-1,80662,chr13_6995654_7076316
Gm36074,13,7446509,7465343,lincRNA,1,18834,chr13_7446509_7465343
Adarb2,13,8202866,8768747,protein_coding,1,565881,chr13_8202866_8768747
Wdr37,13,8802968,8871909,protein_coding,-1,68941,chr13_8802968_8871909
Idi1,13,8885501,8892451,protein_coding,1,6950,chr13_8885501_8892451
Gm9745,13,8941575,8948231,protein_coding,-1,6656,chr13_8941575_8948231
Idi2,13,8952863,8960945,protein_coding,1,8082,chr13_8952863_8960945
Gtpbp4,13,8966331,8996083,protein_coding,-1,29752,chr13_8966331_8996083
Gm36264,13,9001432,9076451,lincRNA,-1,75019,chr13_9001432_9076451
Larp4b,13,9093881,9174451,protein_coding,1,80570,chr13_9093881_9174451
Gm48825,13,9268684,9274143,lincRNA,1,5459,chr13_9268684_9274143
Dip2c,13,9276528,9668928,protein_coding,1,392400,chr13_9276528_9668928
Gm36423,13,9684226,9689544,antisense,1,5318,chr13_9684226_9689544
Zmynd11,13,9684833,9765330,protein_coding,-1,80497,chr13_9684833_9765330
Gm47802,13,9733897,9738234,antisense,1,4337,chr13_9733897_9738234
Chrm3,13,9875486,10360847,protein_coding,-1,485361,chr13_9875486_10360847
Gm26861,13,10357595,10797502,antisense,1,439907,chr13_10357595_10797502
Gm36525,13,10539738,10557707,lincRNA,-1,17969,chr13_10539738_10557707
Gm47408,13,10700161,10830778,lincRNA,1,130617,chr13_10700161_10830778
Gm47486,13,10974423,10979945,lincRNA,1,5522,chr13_10974423_10979945
Ryr2,13,11553102,12106945,protein_coding,-1,553843,chr13_11553102_12106945
Mtr,13,12182712,12258113,protein_coding,-1,75401,chr13_12182712_12258113
Actn2,13,12269426,12340760,protein_coding,-1,71334,chr13_12269426_12340760
Heatr1,13,12395027,12440289,protein_coding,1,45262,chr13_12395027_12440289
Lgals8,13,12439415,12464944,protein_coding,-1,25529,chr13_12439415_12464944
Edaradd,13,12472632,12520438,protein_coding,-1,47806,chr13_12472632_12520438
Gm30239,13,12540143,12562716,lincRNA,1,22573,chr13_12540143_12562716
Ero1lb,13,12565874,12611396,protein_coding,1,45522,chr13_12565874_12611396
Gm48544,13,13034858,13038936,lincRNA,1,4078,chr13_13034858_13038936
Gpr137b,13,13357620,13394014,protein_coding,-1,36394,chr13_13357620_13394014
Nid1,13,13437551,13512269,protein_coding,1,74718,chr13_13437551_13512269
Gm48682,13,13474343,13482405,antisense,-1,8062,chr13_13474343_13482405
Lyst,13,13590397,13778803,protein_coding,1,188406,chr13_13590397_13778803
Gng4,13,13784059,13827896,protein_coding,1,43837,chr13_13784059_13827896
Gm47882,13,13862534,13893979,lincRNA,1,31445,chr13_13862534_13893979
B3galnt2,13,13954469,13999103,protein_coding,1,44634,chr13_13954469_13999103
Tbce,13,13997949,14039638,protein_coding,-1,41689,chr13_13997949_14039638
Ggps1,13,14050659,14063488,protein_coding,-1,12829,chr13_14050659_14063488
Arid4b,13,14063232,14199603,protein_coding,1,136371,chr13_14063232_14199603
Hecw1,13,14226438,14523228,protein_coding,-1,296790,chr13_14226438_14523228
Gm30893,13,14521486,14525016,antisense,1,3530,chr13_14521486_14525016
Mrpl32,13,14608184,14613165,protein_coding,-1,4981,chr13_14608184_14613165
Psma2,13,14613240,14674236,protein_coding,1,60996,chr13_14613240_14674236
Gm20043,13,15375624,15413100,lincRNA,1,37476,chr13_15375624_15413100
Gli3,13,15463235,15730026,protein_coding,1,266791,chr13_15463235_15730026
4933412O06Rik,13,15781664,15802630,lincRNA,-1,20966,chr13_15781664_15802630
A530046M15Rik,13,15807243,15827537,lincRNA,1,20294,chr13_15807243_15827537
Gm31450,13,15931682,15934681,lincRNA,1,2999,chr13_15931682_15934681
Inhba,13,16011851,16031621,protein_coding,1,19770,chr13_16011851_16031621
Gm48444,13,16025382,16032275,antisense,-1,6893,chr13_16025382_16032275
Gm48492,13,16368944,16373180,lincRNA,-1,4236,chr13_16368944_16373180
Sugct,13,16857472,17695553,protein_coding,-1,838081,chr13_16857472_17695553
Gm48503,13,16937609,16947045,antisense,1,9436,chr13_16937609_16947045
Mplkip,13,17695192,17699748,protein_coding,1,4556,chr13_17695192_17699748
Cdk13,13,17710315,17805097,protein_coding,-1,94782,chr13_17710315_17805097
Rala,13,17880571,17944239,protein_coding,-1,63668,chr13_17880571_17944239
Gm48754,13,17932386,17938434,antisense,1,6048,chr13_17932386_17938434
Yae1d1,13,17981330,17993349,protein_coding,-1,12019,chr13_17981330_17993349
Gm48799,13,18002310,18008344,lincRNA,-1,6034,chr13_18002310_18008344
4930448F12Rik,13,18084947,18100202,lincRNA,-1,15255,chr13_18084947_18100202
Pou6f2,13,18121098,18397686,protein_coding,-1,276588,chr13_18121098_18397686
Gm48829,13,18640257,18645349,lincRNA,-1,5092,chr13_18640257_18645349
Vps41,13,18717286,18866811,protein_coding,1,149525,chr13_18717286_18866811
Amph,13,18948205,19150921,protein_coding,1,202716,chr13_18948205_19150921
Gm47658,13,18971702,18974997,antisense,-1,3295,chr13_18971702_18974997
Gm47661,13,19029940,19057896,antisense,-1,27956,chr13_19029940_19057896
Gm31887,13,19162036,19193558,antisense,-1,31522,chr13_19162036_19193558
Stard3nl,13,19357676,19395795,protein_coding,-1,38119,chr13_19357676_19395795
9330199G10Rik,13,19462847,19504367,lincRNA,-1,41520,chr13_19462847_19504367
Epdr1,13,19591706,19619927,protein_coding,-1,28221,chr13_19591706_19619927
Sfrp4,13,19623104,19632994,protein_coding,1,9890,chr13_19623104_19632994
Nme8,13,19645078,19697794,protein_coding,-1,52716,chr13_19645078_19697794
Gpr141,13,19749682,19824257,protein_coding,-1,74575,chr13_19749682_19824257
Elmo1,13,20090596,20608353,protein_coding,1,517757,chr13_20090596_20608353
Gm32036,13,20445286,20473490,antisense,-1,28204,chr13_20445286_20473490
Aoah,13,20794113,21036617,protein_coding,1,242504,chr13_20794113_21036617
Olfr1369-ps1,13,21111483,21119095,protein_coding,1,7612,chr13_21111483_21119095
Gm47806,13,21177187,21187556,antisense,-1,10369,chr13_21177187_21187556
Trim27,13,21179445,21194724,protein_coding,1,15279,chr13_21179445_21194724
Gpx5,13,21286429,21292731,protein_coding,-1,6302,chr13_21286429_21292731
Zscan12,13,21362820,21372289,protein_coding,1,9469,chr13_21362820_21372289
Zkscan3,13,21387003,21402755,protein_coding,-1,15752,chr13_21387003_21402755
Pgbd1,13,21421275,21441058,protein_coding,-1,19783,chr13_21421275_21441058
Zscan26,13,21442180,21453730,protein_coding,-1,11550,chr13_21442180_21453730
Nkapl,13,21467047,21468509,protein_coding,-1,1462,chr13_21467047_21468509
Zkscan4,13,21478907,21485507,protein_coding,1,6600,chr13_21478907_21485507
AK157302,13,21495223,21497146,protein_coding,1,1923,chr13_21495223_21497146
Zkscan8,13,21513222,21531120,protein_coding,-1,17898,chr13_21513222_21531120
Olfr1366,13,21535113,21542808,protein_coding,-1,7695,chr13_21535113_21542808
Olfr1535,13,21553894,21559893,protein_coding,-1,5999,chr13_21553894_21559893
Olfr1364,13,21571813,21581759,protein_coding,-1,9946,chr13_21571813_21581759
Olfr1361,13,21656880,21663386,protein_coding,-1,6506,chr13_21656880_21663386
Gm11274,13,21769125,21770476,lincRNA,1,1351,chr13_21769125_21770476
Hist1h2an,13,21786826,21787218,protein_coding,-1,392,chr13_21786826_21787218
Hist1h2bp,13,21787461,21789213,protein_coding,1,1752,chr13_21787461_21789213
Hist1h4m,13,21811746,21812147,protein_coding,1,401,chr13_21811746_21812147
Hist1h4n,13,21831767,21832196,protein_coding,-1,429,chr13_21831767_21832196
Hist1h2ap,13,21833026,21833507,protein_coding,-1,481,chr13_21833026_21833507
Hist1h2br,13,21833743,21837530,protein_coding,1,3787,chr13_21833743_21837530
Zfp184,13,21945094,21960779,protein_coding,1,15685,chr13_21945094_21960779
Pom121l2,13,21981194,21988734,protein_coding,1,7540,chr13_21981194_21988734
Prss16,13,22002173,22009742,protein_coding,-1,7569,chr13_22002173_22009742
Gm11290,13,22014468,22020738,lincRNA,1,6270,chr13_22014468_22020738
Vmn1r188,13,22084440,22095916,protein_coding,1,11476,chr13_22084440_22095916
Vmn1r189,13,22099762,22105824,protein_coding,-1,6062,chr13_22099762_22105824
Vmn1r195,13,22270522,22281230,protein_coding,1,10708,chr13_22270522_22281230
Vmn1r197,13,22324589,22332866,protein_coding,1,8277,chr13_22324589_22332866
Vmn1r198,13,22350364,22360301,protein_coding,1,9937,chr13_22350364_22360301
Vmn1r201,13,22471923,22478701,protein_coding,1,6778,chr13_22471923_22478701
Vmn1r202,13,22497750,22505381,protein_coding,-1,7631,chr13_22497750_22505381
Vmn1r203,13,22518114,22531992,protein_coding,1,13878,chr13_22518114_22531992
Vmn1r206,13,22617456,22624251,protein_coding,-1,6795,chr13_22617456_22624251
Gm11309,13,22691299,22714987,antisense,1,23688,chr13_22691299_22714987
Vmn1r208,13,22771474,22777400,protein_coding,-1,5926,chr13_22771474_22777400
Vmn1r209,13,22800629,22809682,protein_coding,-1,9053,chr13_22800629_22809682
Vmn1r210,13,22825875,22831348,protein_coding,-1,5473,chr13_22825875_22831348
Vmn1r213,13,23007656,23014482,protein_coding,1,6826,chr13_23007656_23014482
Vmn1r214,13,23030418,23037957,protein_coding,1,7539,chr13_23030418_23037957
Vmn1r215,13,23068025,23078006,protein_coding,1,9981,chr13_23068025_23078006
Vmn1r216,13,23096976,23108732,protein_coding,1,11756,chr13_23096976_23108732
Vmn1r217,13,23105100,23118226,protein_coding,-1,13126,chr13_23105100_23118226
Vmn1r218,13,23133155,23146112,protein_coding,1,12957,chr13_23133155_23146112
Vmn1r220,13,23178514,23187975,protein_coding,-1,9461,chr13_23178514_23187975
4930557F10Rik,13,23276204,23313400,lincRNA,-1,37196,chr13_23276204_23313400
4933404K08Rik,13,23278350,23282267,lincRNA,1,3917,chr13_23278350_23282267
4930586N03Rik,13,23313525,23385799,antisense,1,72274,chr13_23313525_23385799
Zfp322a,13,23353103,23369208,protein_coding,-1,16105,chr13_23353103_23369208
Abt1,13,23418361,23423866,protein_coding,-1,5505,chr13_23418361_23423866
C230035I16Rik,13,23427975,23431022,lincRNA,-1,3047,chr13_23427975_23431022
Gm46404,13,23441822,23445935,lincRNA,-1,4113,chr13_23441822_23445935
Btn1a1,13,23456992,23465901,protein_coding,-1,8909,chr13_23456992_23465901
Btn2a2,13,23477676,23488857,protein_coding,-1,11181,chr13_23477676_23488857
Gm11335,13,23527011,23530943,lincRNA,-1,3932,chr13_23527011_23530943
Hfe,13,23702034,23710854,protein_coding,-1,8820,chr13_23702034_23710854
4930558J22Rik,13,23755822,23757620,antisense,-1,1798,chr13_23755822_23757620
Trim38,13,23769913,23791528,protein_coding,1,21615,chr13_23769913_23791528
Gm11337,13,23794768,23804599,antisense,-1,9831,chr13_23794768_23804599
Slc17a2,13,23806993,23825180,protein_coding,1,18187,chr13_23806993_23825180
Slc17a3,13,23839434,23860716,protein_coding,1,21282,chr13_23839434_23860716
Slc17a1,13,23867750,23895730,protein_coding,1,27980,chr13_23867750_23895730
Slc17a4,13,23895890,23915009,protein_coding,-1,19119,chr13_23895890_23915009
Scgn,13,23953456,23991214,protein_coding,-1,37758,chr13_23953456_23991214
Gm11339,13,23956809,23966175,antisense,1,9366,chr13_23956809_23966175
Carmil1,13,24012344,24280795,protein_coding,-1,268451,chr13_24012344_24280795
Cmah,13,24327404,24477377,protein_coding,1,149973,chr13_24327404_24477377
Gm11342,13,24335937,24414803,antisense,-1,78866,chr13_24335937_24414803
Ripor2,13,24501525,24733816,protein_coding,1,232291,chr13_24501525_24733816
Gmnn,13,24751845,24761923,protein_coding,-1,10078,chr13_24751845_24761923
BC005537,13,24801657,24816197,protein_coding,1,14540,chr13_24801657_24816197
Acot13,13,24817948,24831540,protein_coding,-1,13592,chr13_24817948_24831540
Tdp2,13,24831679,24842153,protein_coding,1,10474,chr13_24831679_24842153
D130043K22Rik,13,24845135,24901270,protein_coding,1,56135,chr13_24845135_24901270
4932702P03Rik,13,24905593,24914272,antisense,1,8679,chr13_24905593_24914272
Aldh5a1,13,24907579,24937661,protein_coding,-1,30082,chr13_24907579_24937661
Gpld1,13,24943152,24992501,protein_coding,1,49349,chr13_24943152_24992501
Mrs2,13,24987483,25020379,protein_coding,-1,32896,chr13_24987483_25020379
Dcdc2a,13,25056004,25210706,protein_coding,1,154702,chr13_25056004_25210706
Nrsn1,13,25252040,25270502,protein_coding,-1,18462,chr13_25252040_25270502
Gm11351,13,25921033,25986293,lincRNA,-1,65260,chr13_25921033_25986293
1700092E19Rik,13,26283150,26312406,lincRNA,-1,29256,chr13_26283150_26312406
Gm47888,13,26968491,27058022,antisense,-1,89531,chr13_26968491_27058022
Prl3d1,13,27094190,27100258,protein_coding,1,6068,chr13_27094190_27100258
Prl3d3,13,27156790,27162593,protein_coding,1,5803,chr13_27156790_27162593
Prl3c1,13,27196659,27203749,protein_coding,1,7090,chr13_27196659_27203749
Prl3b1,13,27241847,27249683,protein_coding,1,7836,chr13_27241847_27249683
Prl3a1,13,27259436,27276667,protein_coding,1,17231,chr13_27259436_27276667
4930511O05Rik,13,27292616,27306032,lincRNA,1,13416,chr13_27292616_27306032
Prl8a2,13,27345673,27354216,protein_coding,1,8543,chr13_27345673_27354216
Prl8a8,13,27506968,27513217,protein_coding,-1,6249,chr13_27506968_27513217
Prl8a9,13,27557995,27564606,protein_coding,-1,6611,chr13_27557995_27564606
Prl8a1,13,27573922,27582171,protein_coding,-1,8249,chr13_27573922_27582171
Prl7a1,13,27633366,27642493,protein_coding,-1,9127,chr13_27633366_27642493
Prl7c1,13,27773495,27780804,protein_coding,-1,7309,chr13_27773495_27780804
Prl5a1,13,28142484,28151611,protein_coding,1,9127,chr13_28142484_28151611
Gm40841,13,28394453,28420066,lincRNA,-1,25613,chr13_28394453_28420066
Gm34639,13,28889458,28898676,lincRNA,-1,9218,chr13_28889458_28898676
Sox4,13,28948919,28953713,protein_coding,-1,4794,chr13_28948919_28953713
A330102I10Rik,13,29014399,29040336,lincRNA,1,25937,chr13_29014399_29040336
Cdkal1,13,29191746,29855674,protein_coding,-1,663928,chr13_29191746_29855674
E2f3,13,29906575,29986063,protein_coding,-1,79488,chr13_29906575_29986063
Gm11365,13,29940283,29942261,antisense,1,1978,chr13_29940283_29942261
Gm11368,13,30058677,30062971,lincRNA,1,4294,chr13_30058677_30062971
Mboat1,13,30136489,30246717,protein_coding,1,110228,chr13_30136489_30246717
Agtr1a,13,30336441,30382867,protein_coding,1,46426,chr13_30336441_30382867
Uqcrfs1,13,30540308,30545362,protein_coding,-1,5054,chr13_30540308_30545362
4930519D14Rik,13,30615043,30624259,lincRNA,1,9216,chr13_30615043_30624259
Dusp22,13,30659999,30711231,protein_coding,1,51232,chr13_30659999_30711231
Irf4,13,30749226,30766976,protein_coding,1,17750,chr13_30749226_30766976
Gm29675,13,30784433,30795226,lincRNA,-1,10793,chr13_30784433_30795226
Exoc2,13,30813919,30974093,protein_coding,-1,160174,chr13_30813919_30974093
4930401O12Rik,13,31213410,31241086,lincRNA,-1,27676,chr13_31213410_31241086
Gm11373,13,31325934,31330767,lincRNA,-1,4833,chr13_31325934_31330767
G630018N14Rik,13,31349901,31408922,lincRNA,-1,59021,chr13_31349901_31408922
Gm11376,13,31392578,31396579,lincRNA,1,4001,chr13_31392578_31396579
A530084C06Rik,13,31556134,31559333,protein_coding,-1,3199,chr13_31556134_31559333
Foxq1,13,31556134,31560976,protein_coding,1,4842,chr13_31556134_31560976
Gm11377,13,31564749,31573562,lincRNA,1,8813,chr13_31564749_31573562
1700018A04Rik,13,31565492,31625792,lincRNA,-1,60300,chr13_31565492_31625792
Foxf2,13,31625816,31631403,protein_coding,1,5587,chr13_31625816_31631403
Gm11379,13,31797539,31800789,antisense,1,3250,chr13_31797539_31800789
Foxc1,13,31806633,31812476,protein_coding,1,5843,chr13_31806633_31812476
Gmds,13,31819579,32338740,protein_coding,-1,519161,chr13_31819579_32338740
Gm35732,13,31971086,31972329,antisense,1,1243,chr13_31971086_31972329
Gm48073,13,32532919,32536415,lincRNA,-1,3496,chr13_32532919_32536415
Mylk4,13,32700827,32783954,protein_coding,-1,83127,chr13_32700827_32783954
Wrnip1,13,32802038,32822609,protein_coding,1,20571,chr13_32802038_32822609
D930007J09Rik,13,32800633,32803091,antisense,-1,2458,chr13_32800633_32803091
Serpinb1a,13,32842092,32851185,protein_coding,-1,9093,chr13_32842092_32851185
Serpinb1c,13,32881434,32898211,protein_coding,-1,16777,chr13_32881434_32898211
Serpinb6b,13,32965209,32979067,protein_coding,1,13858,chr13_32965209_32979067
Gm47662,13,32997062,33001750,lincRNA,1,4688,chr13_32997062_33001750
Serpinb9,13,33003250,33017957,protein_coding,1,14707,chr13_33003250_33017957
Serpinb1b,13,33078575,33094380,protein_coding,1,15805,chr13_33078575_33094380
Serpinb9e,13,33249612,33260850,protein_coding,1,11238,chr13_33249612_33260850
Serpinb9f,13,33324077,33335370,protein_coding,1,11293,chr13_33324077_33335370
Serpinb9g,13,33484790,33496004,protein_coding,1,11214,chr13_33484790_33496004
Serpinb6d,13,33661405,33671581,protein_coding,1,10176,chr13_33661405_33671581
Serpinb6e,13,33832345,33843408,protein_coding,-1,11063,chr13_33832345_33843408
Serpinb6c,13,33879816,33905708,protein_coding,-1,25892,chr13_33879816_33905708
Serpinb6a,13,33917918,34002794,protein_coding,-1,84876,chr13_33917918_34002794
1110046J04Rik,13,33935567,33960181,antisense,1,24614,chr13_33935567_33960181
Nqo2,13,33964687,33988443,protein_coding,1,23756,chr13_33964687_33988443
Ripk1,13,34002363,34037147,protein_coding,1,34784,chr13_34002363_34037147
Bphl,13,34037597,34074074,protein_coding,1,36477,chr13_34037597_34074074
Tubb2a,13,34074274,34078007,protein_coding,-1,3733,chr13_34074274_34078007
Gm47076,13,34119701,34122465,lincRNA,1,2764,chr13_34119701_34122465
Tubb2b,13,34126748,34130466,protein_coding,-1,3718,chr13_34126748_34130466
Gm36500,13,34133860,34137654,lincRNA,1,3794,chr13_34133860_34137654
Psmg4,13,34162964,34178173,protein_coding,1,15209,chr13_34162964_34178173
Slc22a23,13,34179158,34345182,protein_coding,-1,166024,chr13_34179158_34345182
Gm40909,13,34500728,34506511,lincRNA,-1,5783,chr13_34500728_34506511
Pxdc1,13,34627834,34653486,protein_coding,-1,25652,chr13_34627834_34653486
Gm15908,13,34652923,34666774,antisense,1,13851,chr13_34652923_34666774
Gm47152,13,34720682,34728661,lincRNA,1,7979,chr13_34720682_34728661
Fam50b,13,34734850,34747623,protein_coding,1,12773,chr13_34734850_34747623
Gm47157,13,34781585,34814544,lincRNA,-1,32959,chr13_34781585_34814544
Gm36839,13,34872512,34875432,lincRNA,-1,2920,chr13_34872512_34875432
Prpf4b,13,34875302,34906064,protein_coding,1,30762,chr13_34875302_34906064
Fam217a,13,34909960,34924310,protein_coding,-1,14350,chr13_34909960_34924310
4933417A18Rik,13,34924409,34955875,protein_coding,1,31466,chr13_34924409_34955875
Eci3,13,34946614,34963810,protein_coding,-1,17196,chr13_34946614_34963810
Gm16984,13,34963982,34990452,antisense,1,26470,chr13_34963982_34990452
Eci2,13,34977748,35027096,protein_coding,-1,49348,chr13_34977748_35027096
Gm48626,13,35027354,35031946,lincRNA,-1,4592,chr13_35027354_35031946
Gm40910,13,35052727,35083260,lincRNA,1,30533,chr13_35052727_35083260
1700019C18Rik,13,35184370,35212048,lincRNA,-1,27678,chr13_35184370_35212048
Gm48694,13,35242971,35256521,lincRNA,-1,13550,chr13_35242971_35256521
Gm48703,13,35395383,35455832,lincRNA,1,60449,chr13_35395383_35455832
Gm48707,13,35603030,35660777,lincRNA,-1,57747,chr13_35603030_35660777
Cdyl,13,35659833,35874063,protein_coding,1,214230,chr13_35659833_35874063
Gm48708,13,35773573,35776896,antisense,-1,3323,chr13_35773573_35776896
Rpp40,13,35893472,35906359,protein_coding,-1,12887,chr13_35893472_35906359
Gm48746,13,35905457,35921389,lincRNA,1,15932,chr13_35905457_35921389
Gm30127,13,35957545,35965008,antisense,-1,7463,chr13_35957545_35965008
Ppp1r3g,13,35958839,35970388,protein_coding,1,11549,chr13_35958839_35970388
Lyrm4,13,35978395,36117526,protein_coding,-1,139131,chr13_35978395_36117526
Gm48770,13,35995453,36014464,antisense,1,19011,chr13_35995453_36014464
Gm48765,13,36006725,36189723,antisense,-1,182998,chr13_36006725_36189723
Fars2,13,36117412,36726280,protein_coding,1,608868,chr13_36117412_36726280
Gm48767,13,36569764,36575934,antisense,-1,6170,chr13_36569764_36575934
Nrn1,13,36725361,36735131,protein_coding,-1,9770,chr13_36725361_36735131
Gm30177,13,36727258,36729259,antisense,1,2001,chr13_36727258_36729259
Gm49144,13,36836366,36885596,antisense,1,49230,chr13_36836366_36885596
Gm47675,13,36864016,36864625,lincRNA,-1,609,chr13_36864016_36864625
F13a1,13,36867178,37050244,protein_coding,-1,183066,chr13_36867178_37050244
Gm30489,13,36963239,36973329,antisense,1,10090,chr13_36963239_36973329
Gm30600,13,37237649,37244907,lincRNA,-1,7258,chr13_37237649_37244907
Gm47711,13,37326466,37327047,lincRNA,1,581,chr13_37326466_37327047
Ly86,13,37345208,37419036,protein_coding,1,73828,chr13_37345208_37419036
Gm4035,13,37421833,37435149,lincRNA,-1,13316,chr13_37421833_37435149
Gm29459,13,37449400,37451157,lincRNA,-1,1757,chr13_37449400_37451157
Gm29458,13,37452212,37453208,lincRNA,-1,996,chr13_37452212_37453208
Gm47731,13,37472038,37479213,lincRNA,1,7175,chr13_37472038_37479213
Gm47732,13,37482385,37483150,lincRNA,1,765,chr13_37482385_37483150
Gm47751,13,37561945,37564972,lincRNA,-1,3027,chr13_37561945_37564972
Gm47754,13,37581077,37589313,lincRNA,1,8236,chr13_37581077_37589313
Gm40915,13,37616964,37627603,lincRNA,-1,10639,chr13_37616964_37627603
AI463229,13,37657022,37667734,lincRNA,-1,10712,chr13_37657022_37667734
Gm40918,13,37692089,37717648,lincRNA,-1,25559,chr13_37692089_37717648
Gm31600,13,37761748,37768147,lincRNA,1,6399,chr13_37761748_37768147
Rreb1,13,37778400,37952005,protein_coding,1,173605,chr13_37778400_37952005
Gm46411,13,37793382,37799790,antisense,-1,6408,chr13_37793382_37799790
Ssr1,13,37966605,37994217,protein_coding,-1,27612,chr13_37966605_37994217
Cage1,13,38006052,38037069,protein_coding,-1,31017,chr13_38006052_38037069
Riok1,13,38036995,38061433,protein_coding,1,24438,chr13_38036995_38061433
Dsp,13,38151294,38198577,protein_coding,1,47283,chr13_38151294_38198577
Snrnp48,13,38204938,38227665,protein_coding,1,22727,chr13_38204938_38227665
Gm47990,13,38320526,38340721,lincRNA,1,20195,chr13_38320526_38340721
Bmp6,13,38345107,38500302,protein_coding,1,155195,chr13_38345107_38500302
4930579J19Rik,13,38454149,38461805,antisense,-1,7656,chr13_38454149_38461805
Txndc5,13,38500079,38528824,protein_coding,-1,28745,chr13_38500079_38528824
Gm31834,13,38527403,38532920,antisense,1,5517,chr13_38527403_38532920
Gm40922,13,38554865,38563819,lincRNA,1,8954,chr13_38554865_38563819
Bloc1s5,13,38592842,38635109,protein_coding,-1,42267,chr13_38592842_38635109
Gm47400,13,38634971,38637116,antisense,1,2145,chr13_38634971_38637116
Eef1e1,13,38644207,38659058,protein_coding,-1,14851,chr13_38644207_38659058
Gm46392,13,38710054,38908255,lincRNA,1,198201,chr13_38710054_38908255
Gm47509,13,38782161,38825755,lincRNA,-1,43594,chr13_38782161_38825755
Slc35b3,13,38932136,38960875,protein_coding,-1,28739,chr13_38932136_38960875
5033403F01Rik,13,38960619,38966605,antisense,1,5986,chr13_38960619_38966605
Gm47349,13,39467347,39470134,lincRNA,1,2787,chr13_39467347_39470134
Gm47352,13,39571583,39699499,lincRNA,1,127916,chr13_39571583_39699499
Gm32243,13,39617668,39647247,lincRNA,-1,29579,chr13_39617668_39647247
Gm40923,13,39771790,39791384,lincRNA,-1,19594,chr13_39771790_39791384
Ofcc1,13,40001882,40361450,protein_coding,-1,359568,chr13_40001882_40361450
Gm47039,13,40559320,40606479,lincRNA,-1,47159,chr13_40559320_40606479
Tfap2a,13,40715302,40738376,protein_coding,-1,23074,chr13_40715302_40738376
Gm47061,13,40723110,40725449,antisense,1,2339,chr13_40723110_40725449
Gm26688,13,40727808,40735162,antisense,1,7354,chr13_40727808_40735162
Gcnt2,13,40859754,40960892,protein_coding,1,101138,chr13_40859754_40960892
Gm31683,13,40907332,40917895,antisense,-1,10563,chr13_40907332_40917895
A730081D07Rik,13,40956414,41001151,antisense,-1,44737,chr13_40956414_41001151
Pak1ip1,13,41001023,41013015,protein_coding,1,11992,chr13_41001023_41013015
Tmem14c,13,41016292,41022586,protein_coding,1,6294,chr13_41016292_41022586
Mak,13,41025008,41079706,protein_coding,-1,54698,chr13_41025008_41079706
Gcm2,13,41101427,41111035,protein_coding,-1,9608,chr13_41101427_41111035
Sycp2l,13,41114307,41174351,protein_coding,1,60044,chr13_41114307_41174351
Gm48510,13,41176888,41179030,lincRNA,1,2142,chr13_41176888_41179030
Elovl2,13,41182381,41220405,protein_coding,-1,38024,chr13_41182381_41220405
Gm32063,13,41236345,41241478,lincRNA,1,5133,chr13_41236345_41241478
Smim13,13,41249844,41276577,protein_coding,1,26733,chr13_41249844_41276577
Nedd9,13,41309581,41487362,protein_coding,-1,177781,chr13_41309581_41487362
Gm26877,13,41359971,41370908,antisense,1,10937,chr13_41359971_41370908
Gm48571,13,41379956,41384725,antisense,1,4769,chr13_41379956_41384725
Gm32401,13,41487130,41544567,antisense,1,57437,chr13_41487130_41544567
Gm32184,13,41543005,41559913,lincRNA,-1,16908,chr13_41543005_41559913
Tmem170b,13,41605907,41641355,protein_coding,1,35448,chr13_41605907_41641355
Gm5082,13,41649443,41656777,lincRNA,1,7334,chr13_41649443_41656777
Adtrp,13,41763148,41847684,protein_coding,-1,84536,chr13_41763148_41847684
1700061E18Rik,13,41800783,41801795,antisense,1,1012,chr13_41800783_41801795
Gm28564,13,41843014,41849768,antisense,1,6754,chr13_41843014_41849768
Gm28707,13,42049334,42050287,lincRNA,1,953,chr13_42049334_42050287
Hivep1,13,42052021,42192537,protein_coding,1,140516,chr13_42052021_42192537
Edn1,13,42301476,42307990,protein_coding,1,6514,chr13_42301476_42307990
Gm47118,13,42302298,42304991,antisense,-1,2693,chr13_42302298_42304991
Phactr1,13,42680623,43138526,protein_coding,1,457903,chr13_42680623_43138526
Gm15810,13,42782692,42788258,antisense,-1,5566,chr13_42782692_42788258
Gm15813,13,43117673,43125717,antisense,-1,8044,chr13_43117673_43125717
Tbc1d7,13,43151740,43171501,protein_coding,-1,19761,chr13_43151740_43171501
Gfod1,13,43195245,43304172,protein_coding,-1,108927,chr13_43195245_43304172
Sirt5,13,43365496,43395203,protein_coding,1,29707,chr13_43365496_43395203
Nol7,13,43398390,43407097,protein_coding,1,8707,chr13_43398390_43407097
Ranbp9,13,43402675,43481282,protein_coding,-1,78607,chr13_43402675_43481282
Gm47683,13,43498897,43500167,lincRNA,-1,1270,chr13_43498897_43500167
Gm32939,13,43530220,43531781,lincRNA,1,1561,chr13_43530220_43531781
Mcur1,13,43538393,43560191,protein_coding,-1,21798,chr13_43538393_43560191
Rnf182,13,43615710,43670945,protein_coding,1,55235,chr13_43615710_43670945
Gm47728,13,43683120,43701064,lincRNA,1,17944,chr13_43683120_43701064
Gm20751,13,43716791,43719038,lincRNA,1,2247,chr13_43716791_43719038
Cd83,13,43784775,43803132,protein_coding,1,18357,chr13_43784775_43803132
Gm33195,13,43864669,43868589,lincRNA,1,3920,chr13_43864669_43868589
Gm2233,13,43948879,43952699,lincRNA,1,3820,chr13_43948879_43952699
Gm33489,13,44010592,44018522,lincRNA,-1,7930,chr13_44010592_44018522
Gm33630,13,44092028,44099960,lincRNA,-1,7932,chr13_44092028_44099960
Gm5083,13,44121167,44125179,lincRNA,1,4012,chr13_44121167_44125179
A330076C08Rik,13,44185760,44216487,lincRNA,-1,30727,chr13_44185760_44216487
Gm47781,13,44232398,44239606,lincRNA,1,7208,chr13_44232398_44239606
Gm29676,13,44249460,44280449,lincRNA,-1,30989,chr13_44249460_44280449
Gm33958,13,44363836,44391117,lincRNA,-1,27281,chr13_44363836_44391117
Gm27007,13,44400436,44455303,lincRNA,-1,54867,chr13_44400436_44455303
1700029N11Rik,13,44439712,44469030,lincRNA,1,29318,chr13_44439712_44469030
Gm34084,13,44472426,44504548,lincRNA,-1,32122,chr13_44472426_44504548
Gm34276,13,44537309,44568668,lincRNA,-1,31359,chr13_44537309_44568668
Gm47805,13,44622182,44625217,lincRNA,1,3035,chr13_44622182_44625217
Jarid2,13,44729474,44921643,protein_coding,1,192169,chr13_44729474_44921643
Dtnbp1,13,44922075,45002147,protein_coding,-1,80072,chr13_44922075_45002147
Gm40932,13,45099957,45117730,lincRNA,1,17773,chr13_45099957_45117730
Gm47448,13,45235635,45335588,lincRNA,1,99953,chr13_45235635_45335588
Gm34466,13,45246632,45267711,lincRNA,-1,21079,chr13_45246632_45267711
Mylip,13,45389742,45412022,protein_coding,1,22280,chr13_45389742_45412022
Gmpr,13,45507444,45553800,protein_coding,1,46356,chr13_45507444_45553800
Atxn1,13,45549755,45965008,protein_coding,-1,415253,chr13_45549755_45965008
Gm47460,13,45749572,45755206,antisense,1,5634,chr13_45749572_45755206
4930453C13Rik,13,45936040,45936904,antisense,1,864,chr13_45936040_45936904
5033430I15Rik,13,45965253,45966508,lincRNA,1,1255,chr13_45965253_45966508
Gm45949,13,46060597,46068765,lincRNA,1,8168,chr13_46060597_46068765
Gm10113,13,46175428,46191046,lincRNA,-1,15618,chr13_46175428_46191046
Stmnd1,13,46273721,46300115,protein_coding,1,26394,chr13_46273721_46300115
Rbm24,13,46418434,46431095,protein_coding,1,12661,chr13_46418434_46431095
Cap2,13,46501848,46650281,protein_coding,1,148433,chr13_46501848_46650281
Gm47523,13,46605327,46619780,antisense,-1,14453,chr13_46605327_46619780
Fam8a1,13,46669522,46678056,protein_coding,1,8534,chr13_46669522_46678056
Nup153,13,46679905,46727940,protein_coding,-1,48035,chr13_46679905_46727940
Kif13a,13,46749087,46929867,protein_coding,-1,180780,chr13_46749087_46929867
Gm48250,13,46881027,46884898,antisense,1,3871,chr13_46881027_46884898
Nhlrc1,13,47012557,47014850,protein_coding,-1,2293,chr13_47012557_47014850
Tpmt,13,47022482,47044737,protein_coding,-1,22255,chr13_47022482_47044737
Kdm1b,13,47043499,47085279,protein_coding,1,41780,chr13_47043499_47085279
Dek,13,47084775,47106201,protein_coding,-1,21426,chr13_47084775_47106201
Rnf144b,13,47122656,47247991,protein_coding,1,125335,chr13_47122656_47247991
A930002C04Rik,13,47143942,47148670,antisense,-1,4728,chr13_47143942_47148670
Gm35733,13,47361386,47439554,lincRNA,1,78168,chr13_47361386_47439554
G630093K05Rik,13,47910435,47934301,lincRNA,1,23866,chr13_47910435_47934301
4931429P17Rik,13,47960330,48018608,lincRNA,-1,58278,chr13_47960330_48018608
Gm36101,13,48031773,48042471,lincRNA,1,10698,chr13_48031773_48042471
A330033J07Rik,13,48044231,48262623,antisense,-1,218392,chr13_48044231_48262623
Id4,13,48261228,48266026,protein_coding,1,4798,chr13_48261228_48266026
A330048O09Rik,13,48272413,48273884,lincRNA,-1,1471,chr13_48272413_48273884
Gm48648,13,48359459,48408512,lincRNA,-1,49053,chr13_48359459_48408512
Zfp169,13,48487647,48513451,protein_coding,-1,25804,chr13_48487647_48513451
A830005F24Rik,13,48513570,48514859,protein_coding,1,1289,chr13_48513570_48514859
6720427I07Rik,13,48532905,48546500,lincRNA,-1,13595,chr13_48532905_48546500
Ptpdc1,13,48577872,48625664,protein_coding,-1,47792,chr13_48577872_48625664
Gm36550,13,48593501,48595843,antisense,1,2342,chr13_48593501_48595843
Phf2,13,48801750,48871119,protein_coding,-1,69369,chr13_48801750_48871119
Phf2os1,13,48871112,48875460,antisense,1,4348,chr13_48871112_48875460
Fam120a,13,48879219,48968017,protein_coding,-1,88798,chr13_48879219_48968017
Wnk2,13,49036303,49148014,protein_coding,-1,111711,chr13_49036303_49148014
Ninj1,13,49187485,49196244,protein_coding,1,8759,chr13_49187485_49196244
Card19,13,49202950,49216037,protein_coding,-1,13087,chr13_49202950_49216037
Susd3,13,49230690,49248706,protein_coding,-1,18016,chr13_49230690_49248706
Fgd3,13,49261554,49320311,protein_coding,-1,58757,chr13_49261554_49320311
Bicd2,13,49341585,49387026,protein_coding,1,45441,chr13_49341585_49387026
Ippk,13,49421249,49464573,protein_coding,1,43324,chr13_49421249_49464573
Cenpp,13,49464023,49652785,protein_coding,-1,188762,chr13_49464023_49652785
Tes3-ps,13,49493318,49496589,protein_coding,1,3271,chr13_49493318_49496589
Ecm2,13,49504810,49532789,protein_coding,1,27979,chr13_49504810_49532789
Aspn,13,49544443,49567565,protein_coding,1,23122,chr13_49544443_49567565
Omd,13,49582462,49592822,protein_coding,1,10360,chr13_49582462_49592822
Ogn,13,49608046,49624501,protein_coding,1,16455,chr13_49608046_49624501
Nol8,13,49653078,49679016,protein_coding,1,25938,chr13_49653078_49679016
Iars,13,49682100,49734267,protein_coding,1,52167,chr13_49682100_49734267
Gm30302,13,49784765,49799001,protein_coding,-1,14236,chr13_49784765_49799001
Gm48051,13,49970001,49974260,lincRNA,1,4259,chr13_49970001_49974260
Gm8739,13,50343583,50491741,antisense,-1,148158,chr13_50343583_50491741
Fbxw17,13,50417864,50433780,protein_coding,1,15916,chr13_50417864_50433780
Spin1,13,51100880,51152546,protein_coding,1,51666,chr13_51100880_51152546
Nxnl2,13,51171022,51175188,protein_coding,1,4166,chr13_51171022_51175188
Gm32834,13,51378136,51418686,lincRNA,-1,40550,chr13_51378136_51418686
S1pr3,13,51408639,51422797,protein_coding,1,14158,chr13_51408639_51422797
Shc3,13,51431041,51569487,protein_coding,-1,138446,chr13_51431041_51569487
Cks2,13,51645232,51650660,protein_coding,1,5428,chr13_51645232_51650660
Secisbp2,13,51651697,51684044,protein_coding,1,32347,chr13_51651697_51684044
Sema4d,13,51685529,51793747,protein_coding,-1,108218,chr13_51685529_51793747
Gadd45g,13,51846678,51848468,protein_coding,1,1790,chr13_51846678_51848468
Gm26651,13,51973214,51976583,lincRNA,1,3369,chr13_51973214_51976583
Gm48190,13,52087607,52096668,lincRNA,-1,9061,chr13_52087607_52096668
Diras2,13,52504380,52531279,protein_coding,-1,26899,chr13_52504380_52531279
Syk,13,52583173,52648792,protein_coding,1,65619,chr13_52583173_52648792
BB123696,13,52729615,52757205,lincRNA,-1,27590,chr13_52729615_52757205
Auh,13,52835119,52929681,protein_coding,-1,94562,chr13_52835119_52929681
Nfil3,13,52967209,52981073,protein_coding,-1,13864,chr13_52967209_52981073
Gm48336,13,53028918,53035090,lincRNA,1,6172,chr13_53028918_53035090
Ror2,13,53109312,53286124,protein_coding,-1,176812,chr13_53109312_53286124
Sptlc1,13,53332748,53377397,protein_coding,-1,44649,chr13_53332748_53377397
Gm2762,13,53393657,53455630,lincRNA,1,61973,chr13_53393657_53455630
Gm43262,13,53403950,53414830,lincRNA,-1,10880,chr13_53403950_53414830
Msx2,13,53466884,53473074,protein_coding,-1,6190,chr13_53466884_53473074
9530014B07Rik,13,53635894,53639193,lincRNA,-1,3299,chr13_53635894_53639193
Gm34278,13,53681609,53700417,lincRNA,-1,18808,chr13_53681609_53700417
Gm48548,13,53776627,53778973,lincRNA,1,2346,chr13_53776627_53778973
Gm34557,13,53921313,53934788,lincRNA,-1,13475,chr13_53921313_53934788
Gm48550,13,53968944,53976666,lincRNA,1,7722,chr13_53968944_53976666
Drd1,13,54051183,54055705,protein_coding,-1,4522,chr13_54051183_54055705
Sfxn1,13,54071869,54108342,protein_coding,1,36473,chr13_54071869_54108342
Hrh2,13,54192129,54236180,protein_coding,1,44051,chr13_54192129_54236180
Gm16578,13,54219453,54223023,antisense,-1,3570,chr13_54219453_54223023
Gm48623,13,54301959,54312797,lincRNA,1,10838,chr13_54301959_54312797
Gm48622,13,54309905,54327880,lincRNA,-1,17975,chr13_54309905_54327880
Cplx2,13,54371349,54383917,protein_coding,1,12568,chr13_54371349_54383917
Thoc3,13,54458837,54468849,protein_coding,-1,10012,chr13_54458837_54468849
Simc1,13,54503779,54551290,protein_coding,1,47511,chr13_54503779_54551290
4833439L19Rik,13,54551218,54565435,protein_coding,-1,14217,chr13_54551218_54565435
Arl10,13,54575015,54581128,protein_coding,1,6113,chr13_54575015_54581128
Nop16,13,54584185,54590090,protein_coding,-1,5905,chr13_54584185_54590090
Higd2a,13,54590207,54591158,protein_coding,1,951,chr13_54590207_54591158
Cltb,13,54592401,54611344,protein_coding,-1,18943,chr13_54592401_54611344
Faf2,13,54621784,54664063,protein_coding,1,42279,chr13_54621784_54664063
Rnf44,13,54679399,54693907,protein_coding,-1,14508,chr13_54679399_54693907
Cdhr2,13,54701461,54736662,protein_coding,1,35201,chr13_54701461_54736662
Gprin1,13,54736671,54749874,protein_coding,-1,13203,chr13_54736671_54749874
Sncb,13,54758860,54766595,protein_coding,-1,7735,chr13_54758860_54766595
Gm16249,13,54777514,54783091,antisense,-1,5577,chr13_54777514_54783091
Eif4e1b,13,54783998,54788459,protein_coding,1,4461,chr13_54783998_54788459
Tspan17,13,54789377,54796776,protein_coding,1,7399,chr13_54789377_54796776
Gm29431,13,54887470,54888013,lincRNA,1,543,chr13_54887470_54888013
5330429C05Rik,13,54913235,54914479,lincRNA,1,1244,chr13_54913235_54914479
4930526F13Rik,13,54926763,54930256,lincRNA,-1,3493,chr13_54926763_54930256
Unc5a,13,54949411,55006018,protein_coding,1,56607,chr13_54949411_55006018
Hk3,13,55005985,55021385,protein_coding,-1,15400,chr13_55005985_55021385
Uimc1,13,55027880,55100300,protein_coding,-1,72420,chr13_55027880_55100300
Zfp346,13,55105311,55134825,protein_coding,1,29514,chr13_55105311_55134825
Gm17617,13,55132962,55133548,protein_coding,-1,586,chr13_55132962_55133548
Fgfr4,13,55152640,55168759,protein_coding,1,16119,chr13_55152640_55168759
Nsd1,13,55209782,55318325,protein_coding,1,108543,chr13_55209782_55318325
Rab24,13,55319743,55321946,protein_coding,-1,2203,chr13_55319743_55321946
Prelid1,13,55320500,55325272,protein_coding,1,4772,chr13_55320500_55325272
Mxd3,13,55325168,55329823,protein_coding,-1,4655,chr13_55325168_55329823
Lman2,13,55343833,55362783,protein_coding,-1,18950,chr13_55343833_55362783
Rgs14,13,55369732,55384687,protein_coding,1,14955,chr13_55369732_55384687
Slc34a1,13,55398187,55415592,protein_coding,1,17405,chr13_55398187_55415592
Pfn3,13,55414688,55415232,protein_coding,-1,544,chr13_55414688_55415232
F12,13,55417958,55426793,protein_coding,-1,8835,chr13_55417958_55426793
Grk6,13,55445072,55460927,protein_coding,1,15855,chr13_55445072_55460927
Prr7,13,55464267,55473154,protein_coding,1,8887,chr13_55464267_55473154
Dbn1,13,55473429,55488111,protein_coding,-1,14682,chr13_55473429_55488111
Pdlim7,13,55495795,55513676,protein_coding,-1,17881,chr13_55495795_55513676
Dok3,13,55523231,55529296,protein_coding,-1,6065,chr13_55523231_55529296
Ddx41,13,55530410,55536658,protein_coding,-1,6248,chr13_55530410_55536658
Gm46416,13,55535995,55536624,antisense,1,629,chr13_55535995_55536624
Fam193b,13,55539316,55571120,protein_coding,-1,31804,chr13_55539316_55571120
Tmed9,13,55573732,55597697,protein_coding,1,23965,chr13_55573732_55597697
B4galt7,13,55599896,55610443,protein_coding,1,10547,chr13_55599896_55610443
Gm15911,13,55602182,55604783,antisense,-1,2601,chr13_55602182_55604783
Caml,13,55623005,55632411,protein_coding,1,9406,chr13_55623005_55632411
Ddx46,13,55635027,55681256,protein_coding,1,46229,chr13_55635027_55681256
B230219D22Rik,13,55693124,55703500,protein_coding,1,10376,chr13_55693124_55703500
Txndc15,13,55714650,55726227,protein_coding,1,11577,chr13_55714650_55726227
Pcbd2,13,55727368,55776830,protein_coding,1,49462,chr13_55727368_55776830
4930451E10Rik,13,55775136,55784505,antisense,-1,9369,chr13_55775136_55784505
Catsper3,13,55784568,55808998,protein_coding,1,24430,chr13_55784568_55808998
Pitx1,13,55825051,55836192,protein_coding,-1,11141,chr13_55825051_55836192
Gm47071,13,55826250,56084849,antisense,1,258599,chr13_55826250_56084849
Tifab,13,56173704,56178885,protein_coding,-1,5181,chr13_56173704_56178885
4930550C17Rik,13,56222224,56243940,lincRNA,-1,21716,chr13_56222224_56243940
Cxcl14,13,56288643,56296551,protein_coding,-1,7908,chr13_56288643_56296551
Gm3045,13,56426594,56433753,protein_coding,1,7159,chr13_56426594_56433753
Slc25a48,13,56438355,56474239,protein_coding,1,35884,chr13_56438355_56474239
Fbxl21,13,56522472,56537898,protein_coding,1,15426,chr13_56522472_56537898
Lect2,13,56542464,56548502,protein_coding,-1,6038,chr13_56542464_56548502
Tgfbi,13,56609523,56639562,protein_coding,1,30039,chr13_56609523_56639562
Smad5,13,56703010,56742377,protein_coding,1,39367,chr13_56703010_56742377
Gm45623,13,56752371,56753827,protein_coding,-1,1456,chr13_56752371_56753827
Trpc7,13,56773113,56895993,protein_coding,-1,122880,chr13_56773113_56895993
Spock1,13,57421195,57908332,protein_coding,-1,487137,chr13_57421195_57908332
Klhl3,13,58000228,58113592,protein_coding,-1,113364,chr13_58000228_58113592
Hnrnpa0,13,58125879,58128556,protein_coding,-1,2677,chr13_58125879_58128556
Idnk,13,58157649,58164693,protein_coding,1,7044,chr13_58157649_58164693
Ubqln1,13,58176156,58215653,protein_coding,-1,39497,chr13_58176156_58215653
Gm48441,13,58232143,58236750,antisense,1,4607,chr13_58232143_58236750
Gkap1,13,58233346,58275699,protein_coding,-1,42353,chr13_58233346_58275699
Gm26555,13,58281183,58299145,antisense,1,17962,chr13_58281183_58299145
Kif27,13,58287502,58359122,protein_coding,-1,71620,chr13_58287502_58359122
2210016F16Rik,13,58379817,58385225,protein_coding,-1,5408,chr13_58379817_58385225
Hnrnpk,13,58391142,58403343,protein_coding,-1,12201,chr13_58391142_58403343
Rmi1,13,58402248,58411148,protein_coding,1,8900,chr13_58402248_58411148
Gm47918,13,58443021,58444580,lincRNA,1,1559,chr13_58443021_58444580
Slc28a3,13,58545399,58610877,protein_coding,-1,65478,chr13_58545399_58610877
4930455J16Rik,13,58736408,58762360,lincRNA,-1,25952,chr13_58736408_58762360
Gm47947,13,58762385,58776543,lincRNA,1,14158,chr13_58762385_58776543
Gm40968,13,58775458,58797448,lincRNA,-1,21990,chr13_58775458_58797448
Ntrk2,13,58806569,59133970,protein_coding,1,327401,chr13_58806569_59133970
Gm47423,13,58824218,58826994,antisense,-1,2776,chr13_58824218_58826994
4930415C11Rik,13,59054896,59084093,antisense,-1,29197,chr13_59054896_59084093
Gm34354,13,59145873,59204327,lincRNA,1,58454,chr13_59145873_59204327
Gm47359,13,59170633,59182816,lincRNA,-1,12183,chr13_59170633_59182816
Gm34558,13,59211622,59217172,lincRNA,-1,5550,chr13_59211622_59217172
Gm34672,13,59235750,59255411,lincRNA,-1,19661,chr13_59235750_59255411
Gm47360,13,59294819,59330243,lincRNA,-1,35424,chr13_59294819_59330243
Gm34721,13,59405486,59409301,lincRNA,-1,3815,chr13_59405486_59409301
Gm34788,13,59411618,59419254,lincRNA,-1,7636,chr13_59411618_59419254
4930455M05Rik,13,59419108,59423161,lincRNA,1,4053,chr13_59419108_59423161
Agtpbp1,13,59445742,59585227,protein_coding,-1,139485,chr13_59445742_59585227
Naa35,13,59585259,59635922,protein_coding,1,50663,chr13_59585259_59635922
Golm1,13,59634626,59675811,protein_coding,-1,41185,chr13_59634626_59675811
Spata31d1a,13,59699806,59710330,protein_coding,-1,10524,chr13_59699806_59710330
Spata31d1b,13,59712284,59719295,protein_coding,1,7011,chr13_59712284_59719295
Spata31d1d,13,59725925,59731752,protein_coding,-1,5827,chr13_59725925_59731752
Gm46419,13,59726724,59750140,lincRNA,1,23416,chr13_59726724_59750140
1700014D04Rik,13,59740842,59746752,protein_coding,-1,5910,chr13_59740842_59746752
Isca1,13,59755409,59769810,protein_coding,-1,14401,chr13_59755409_59769810
Gm49354,13,59758935,59782245,protein_coding,-1,23310,chr13_59758935_59782245
Etohd2,13,59769497,59775407,antisense,1,5910,chr13_59769497_59775407
Gm34961,13,59823266,59833236,lincRNA,1,9970,chr13_59823266_59833236
Gm48384,13,59873642,59874964,lincRNA,1,1322,chr13_59873642_59874964
Gm19866,13,59901233,59915822,lincRNA,-1,14589,chr13_59901233_59915822
A530065N20Rik,13,60029711,60116669,lincRNA,1,86958,chr13_60029711_60116669
Gm48396,13,60053684,60057625,lincRNA,-1,3941,chr13_60053684_60057625
Gas1,13,60174405,60177365,protein_coding,-1,2960,chr13_60174405_60177365
Gm48488,13,60176682,60182862,lincRNA,1,6180,chr13_60176682_60182862
Gm5084,13,60205471,60216023,lincRNA,1,10552,chr13_60205471_60216023
Gm35333,13,60422756,60434731,lincRNA,-1,11975,chr13_60422756_60434731
Gm48500,13,60463586,60481298,lincRNA,-1,17712,chr13_60463586_60481298
A530001N23Rik,13,60483504,60488808,lincRNA,-1,5304,chr13_60483504_60488808
Dapk1,13,60601947,60763191,protein_coding,1,161244,chr13_60601947_60763191
Cts8,13,61246745,61255358,protein_coding,-1,8613,chr13_61246745_61255358
Gm49398,13,61247878,61288839,protein_coding,-1,40961,chr13_61247878_61288839
Gm49352,13,61538390,61568174,protein_coding,-1,29784,chr13_61538390_61568174
Gm49357,13,61655303,61743770,lincRNA,1,88467,chr13_61655303_61743770
Gm48228,13,62006640,62126102,lincRNA,-1,119462,chr13_62006640_62126102
Gm40977,13,62097748,62112047,lincRNA,1,14299,chr13_62097748_62112047
Zfp808,13,62129886,62236144,protein_coding,1,106258,chr13_62129886_62236144
Gm19792,13,62336463,62340727,lincRNA,-1,4264,chr13_62336463_62340727
Gm3604,13,62368328,62383177,protein_coding,-1,14849,chr13_62368328_62383177
Gm49359,13,62453016,62466832,protein_coding,-1,13816,chr13_62453016_62466832
Zfp935,13,62453715,62558511,protein_coding,-1,104796,chr13_62453715_62558511
Zfp934,13,62479827,62571199,protein_coding,-1,91372,chr13_62479827_62571199
6720489N17Rik,13,62603013,62624182,protein_coding,-1,21169,chr13_62603013_62624182
Platr25,13,62671784,62760709,protein_coding,-1,88925,chr13_62671784_62760709
Gm5141,13,62772200,62785808,protein_coding,-1,13608,chr13_62772200_62785808
Gm48795,13,62813969,62815523,lincRNA,-1,1554,chr13_62813969_62815523
Fbp2,13,62836877,62858422,protein_coding,-1,21545,chr13_62836877_62858422
Fbp1,13,62864753,62888282,protein_coding,-1,23529,chr13_62864753_62888282
Gm48812,13,62944561,62949442,lincRNA,-1,4881,chr13_62944561_62949442
Fancc,13,63285043,63497278,protein_coding,-1,212235,chr13_63285043_63497278
Gm16133,13,63329556,63339961,antisense,1,10405,chr13_63329556_63339961
Ptch1,13,63508328,63573598,protein_coding,-1,65270,chr13_63508328_63573598
Gm30655,13,63575051,63582562,lincRNA,1,7511,chr13_63575051_63582562
Gm30709,13,63621500,63627379,lincRNA,-1,5879,chr13_63621500_63627379
1700024I08Rik,13,63675756,63734298,lincRNA,-1,58542,chr13_63675756_63734298
Gm47390,13,63730149,63734599,lincRNA,1,4450,chr13_63730149_63734599
Gm47418,13,63794106,63795428,lincRNA,1,1322,chr13_63794106_63795428
Ercc6l2,13,63815240,63900302,protein_coding,1,85062,chr13_63815240_63900302
Hsd17b3,13,64058266,64089230,protein_coding,-1,30964,chr13_64058266_64089230
Slc35d2,13,64096308,64129368,protein_coding,-1,33060,chr13_64096308_64129368
Zfp367,13,64133018,64153202,protein_coding,-1,20184,chr13_64133018_64153202
Habp4,13,64161824,64186537,protein_coding,1,24713,chr13_64161824_64186537
Cdc14b,13,64189268,64275290,protein_coding,-1,86022,chr13_64189268_64275290
1810034E14Rik,13,64248700,64271852,antisense,1,23152,chr13_64248700_64271852
Gm47003,13,64291077,64298039,antisense,1,6962,chr13_64291077_64298039
Ctsl,13,64359337,64370890,protein_coding,-1,11553,chr13_64359337_64370890
Gm47123,13,64361052,64363022,antisense,1,1970,chr13_64361052_64363022
1700015C15Rik,13,64427780,64432402,antisense,-1,4622,chr13_64427780_64432402
Cdk20,13,64432314,64441773,protein_coding,1,9459,chr13_64432314_64441773
Gm31218,13,64449437,64508611,lincRNA,1,59174,chr13_64449437_64508611
Fam240b,13,64481246,64497792,protein_coding,-1,16546,chr13_64481246_64497792
Gm47193,13,64619550,64625002,lincRNA,1,5452,chr13_64619550_64625002
Gm47194,13,64674539,64685275,lincRNA,-1,10736,chr13_64674539_64685275
Cntnap3,13,64736182,64903955,protein_coding,-1,167773,chr13_64736182_64903955
Prss47,13,65044606,65052760,protein_coding,-1,8154,chr13_65044606_65052760
Mfsd14b,13,65064663,65112975,protein_coding,-1,48312,chr13_65064663_65112975
Olfr465-ps1,13,65138089,65146047,protein_coding,1,7958,chr13_65138089_65146047
Olfr466,13,65150240,65156152,protein_coding,1,5912,chr13_65150240_65156152
Nlrp4f,13,65177111,65205977,protein_coding,-1,28866,chr13_65177111_65205977
Gm47249,13,65212111,65214903,lincRNA,1,2792,chr13_65212111_65214903
Gm36445,13,65241753,65250154,lincRNA,1,8401,chr13_65241753_65250154
Gm47251,13,65252704,65253703,lincRNA,-1,999,chr13_65252704_65253703
Gm10775,13,65259539,65260826,protein_coding,1,1287,chr13_65259539_65260826
Zfp369,13,65278814,65304221,protein_coding,1,25407,chr13_65278814_65304221
Gm7762,13,65336222,65348597,lincRNA,-1,12375,chr13_65336222_65348597
Gm48166,13,65493490,65630774,lincRNA,1,137284,chr13_65493490_65630774
Gm48170,13,65615824,65620243,lincRNA,-1,4419,chr13_65615824_65620243
Gm40987,13,65976343,65982791,lincRNA,-1,6448,chr13_65976343_65982791
Gm26754,13,66244270,66451277,lincRNA,1,207007,chr13_66244270_66451277
2410141K09Rik,13,66418114,66441118,protein_coding,-1,23004,chr13_66418114_66441118
Gm40988,13,66680954,66708957,lincRNA,1,28003,chr13_66680954_66708957
Gm48412,13,66777441,66779142,lincRNA,1,1701,chr13_66777441_66779142
Uqcrb,13,66900617,66905378,protein_coding,-1,4761,chr13_66900617_66905378
Gm10767,13,66904914,66909236,protein_coding,1,4322,chr13_66904914_66909236
Mterf3,13,66906968,66933088,protein_coding,-1,26120,chr13_66906968_66933088
Ptdss1,13,66932830,66998401,protein_coding,1,65571,chr13_66932830_66998401
4933433G19Rik,13,66996819,67032408,antisense,-1,35589,chr13_66996819_67032408
Zfp712,13,67038596,67061170,protein_coding,-1,22574,chr13_67038596_67061170
Gm46440,13,67060505,67092042,antisense,1,31537,chr13_67060505_67092042
Rslcan18,13,67096613,67116263,protein_coding,-1,19650,chr13_67096613_67116263
Zfp759,13,67121660,67141787,protein_coding,1,20127,chr13_67121660_67141787
Gm48732,13,67143672,67145366,lincRNA,-1,1694,chr13_67143672_67145366
Rsl1,13,67173182,67184044,protein_coding,1,10862,chr13_67173182_67184044
Zfp455,13,67194506,67209298,protein_coding,1,14792,chr13_67194506_67209298
Gm49064,13,67226997,67229969,lincRNA,-1,2972,chr13_67226997_67229969
Zfp458,13,67254918,67278466,protein_coding,-1,23548,chr13_67254918_67278466
F630042J09Rik,13,67278577,67283361,lincRNA,1,4784,chr13_67278577_67283361
Zfp457,13,67288138,67306485,protein_coding,-1,18347,chr13_67288138_67306485
Gm48824,13,67307334,67308907,lincRNA,-1,1573,chr13_67307334_67308907
Zfp595,13,67312998,67332570,protein_coding,-1,19572,chr13_67312998_67332570
Gm28044,13,67317942,67360536,protein_coding,-1,42594,chr13_67317942_67360536
Gm28041,13,67345246,67375733,protein_coding,-1,30487,chr13_67345246_67375733
Gm17039,13,67360671,67365679,antisense,1,5008,chr13_67360671_67365679
Zfp456,13,67362113,67375810,protein_coding,-1,13697,chr13_67362113_67375810
Zfp429,13,67387905,67399819,protein_coding,-1,11914,chr13_67387905_67399819
Gm48900,13,67390475,67408858,antisense,1,18383,chr13_67390475_67408858
Zfp459,13,67405709,67421418,protein_coding,-1,15709,chr13_67405709_67421418
Zfp874a,13,67424549,67451624,protein_coding,-1,27075,chr13_67424549_67451624
Zfp874b,13,67471513,67484258,protein_coding,-1,12745,chr13_67471513_67484258
Gm48899,13,67472478,67473500,antisense,1,1022,chr13_67472478_67473500
Zfp58,13,67490167,67500555,protein_coding,-1,10388,chr13_67490167_67500555
Gm26965,13,67491152,67526151,protein_coding,-1,34999,chr13_67491152_67526151
Zfp87,13,67515781,67526177,protein_coding,-1,10396,chr13_67515781_67526177
Zfp748,13,67538641,67553830,protein_coding,-1,15189,chr13_67538641_67553830
9430065F17Rik,13,67553035,67564010,antisense,1,10975,chr13_67553035_67564010
Zfp729b,13,67589439,67609707,protein_coding,-1,20268,chr13_67589439_67609707
Gm49345,13,67592159,67637769,protein_coding,-1,45610,chr13_67592159_67637769
Zfp729a,13,67612763,67637791,protein_coding,-1,25028,chr13_67612763_67637791
Gm48095,13,67658669,67667943,antisense,1,9274,chr13_67658669_67667943
Zfp738,13,67658685,67687071,protein_coding,-1,28386,chr13_67658685_67687071
Zfp65,13,67705309,67729173,protein_coding,-1,23864,chr13_67705309_67729173
Zfp85,13,67747800,67755228,protein_coding,-1,7428,chr13_67747800_67755228
Zfp493,13,67779693,67792512,protein_coding,1,12819,chr13_67779693_67792512
4930525G20Rik,13,67796594,67830985,antisense,-1,34391,chr13_67796594_67830985
Zfp273,13,67813740,67827002,protein_coding,1,13262,chr13_67813740_67827002
Gm10037,13,67831106,67844035,protein_coding,1,12929,chr13_67831106_67844035
BC048507,13,67863326,67863925,protein_coding,1,599,chr13_67863326_67863925
Gm8016,13,68353364,68356825,lincRNA,-1,3461,chr13_68353364_68356825
Gm48436,13,68488998,68491389,lincRNA,-1,2391,chr13_68488998_68491389
Mtrr,13,68560780,68582149,protein_coding,-1,21369,chr13_68560780_68582149
Fastkd3,13,68582234,68592338,protein_coding,1,10104,chr13_68582234_68592338
Gm48556,13,68590481,68594722,antisense,-1,4241,chr13_68590481_68594722
1700001L19Rik,13,68597421,68614231,protein_coding,1,16810,chr13_68597421_68614231
Adcy2,13,68620043,68999541,protein_coding,-1,379498,chr13_68620043_68999541
Gm35161,13,68998793,69031550,antisense,1,32757,chr13_68998793_69031550
Gm26844,13,69141229,69143965,lincRNA,1,2736,chr13_69141229_69143965
Nsun2,13,69533746,69635780,protein_coding,1,102034,chr13_69533746_69635780
A530095I07Rik,13,69543046,69544023,antisense,-1,977,chr13_69543046_69544023
Srd5a1,13,69573449,69611442,protein_coding,-1,37993,chr13_69573449_69611442
Gm35618,13,69680589,69697676,lincRNA,-1,17087,chr13_69680589_69697676
Gm48819,13,69697811,69700895,lincRNA,1,3084,chr13_69697811_69700895
Ube2ql1,13,69702832,69739889,protein_coding,-1,37057,chr13_69702832_69739889
Med10,13,69802395,69816104,protein_coding,1,13709,chr13_69802395_69816104
4933416O17Rik,13,69959833,69963437,lincRNA,1,3604,chr13_69959833_69963437
1700084F23Rik,13,70004050,70028348,lincRNA,-1,24298,chr13_70004050_70028348
Gm3772,13,70021959,70119949,lincRNA,1,97990,chr13_70021959_70119949
AU017674,13,70149800,70205972,lincRNA,1,56172,chr13_70149800_70205972
4930520P13Rik,13,70232822,70248122,lincRNA,1,15300,chr13_70232822_70248122
Ice1,13,70551707,70637634,protein_coding,-1,85927,chr13_70551707_70637634
1700100L14Rik,13,70573241,70576110,antisense,1,2869,chr13_70573241_70576110
Gm36607,13,70706233,70733207,antisense,1,26974,chr13_70706233_70733207
Adamts16,13,70727802,70841811,protein_coding,-1,114009,chr13_70727802_70841811
Gm36529,13,70840451,70859609,antisense,1,19158,chr13_70840451_70859609
8030423J24Rik,13,70882948,70884503,lincRNA,1,1555,chr13_70882948_70884503
1700112M02Rik,13,71487607,71612709,lincRNA,1,125102,chr13_71487607_71612709
Gm47902,13,72769431,72786342,lincRNA,1,16911,chr13_72769431_72786342
Ndufs6,13,73319838,73328542,protein_coding,-1,8704,chr13_73319838_73328542
Mrpl36,13,73328513,73332178,protein_coding,1,3665,chr13_73328513_73332178
Lpcat1,13,73467197,73516422,protein_coding,1,49225,chr13_73467197_73516422
Slc6a3,13,73536747,73578672,protein_coding,1,41925,chr13_73536747_73578672
Clptm1l,13,73604006,73620605,protein_coding,1,16599,chr13_73604006_73620605
Tert,13,73626911,73649843,protein_coding,1,22932,chr13_73626911_73649843
Slc6a18,13,73661752,73678023,protein_coding,-1,16271,chr13_73661752_73678023
Slc6a19,13,73679745,73704865,protein_coding,-1,25120,chr13_73679745_73704865
Slc6a19os,13,73699826,73709853,antisense,1,10027,chr13_73699826_73709853
Slc12a7,13,73733094,73816754,protein_coding,1,83660,chr13_73733094_73816754
Nkd2,13,73818534,73847631,protein_coding,-1,29097,chr13_73818534_73847631
Trip13,13,73911347,73937784,protein_coding,-1,26437,chr13_73911347_73937784
Brd9,13,73937811,73960895,protein_coding,1,23084,chr13_73937811_73960895
Gm41002,13,73958941,73963733,antisense,-1,4792,chr13_73958941_73963733
Zdhhc11,13,73963851,73992990,protein_coding,1,29139,chr13_73963851_73992990
Tppp,13,74009407,74035753,protein_coding,1,26346,chr13_74009407_74035753
Cep72,13,74036500,74062299,protein_coding,-1,25799,chr13_74036500_74062299
Slc9a3,13,74121457,74169442,protein_coding,1,47985,chr13_74121457_74169442
Exoc3,13,74169488,74208732,protein_coding,-1,39244,chr13_74169488_74208732
Ahrr,13,74211118,74292331,protein_coding,-1,81213,chr13_74211118_74292331
Pdcd6,13,74303509,74317580,protein_coding,-1,14071,chr13_74303509_74317580
Sdha,13,74322254,74350280,protein_coding,-1,28026,chr13_74322254_74350280
Ccdc127,13,74350309,74365783,protein_coding,1,15474,chr13_74350309_74365783
Lrrc14b,13,74359578,74364005,protein_coding,-1,4427,chr13_74359578_74364005
Zfp72,13,74369326,74390836,protein_coding,-1,21510,chr13_74369326_74390836
Ftl1-ps1,13,74399694,74407346,protein_coding,1,7652,chr13_74399694_74407346
Gm47428,13,74404183,74406737,antisense,-1,2554,chr13_74404183_74406737
E430024I08Rik,13,74434781,74463429,lincRNA,-1,28648,chr13_74434781_74463429
Zfp825,13,74480054,74493992,protein_coding,-1,13938,chr13_74480054_74493992
Gm47467,13,74509598,74522461,lincRNA,-1,12863,chr13_74509598_74522461
Gm47469,13,74553910,74564256,lincRNA,-1,10346,chr13_74553910_74564256
Gm46430,13,74579358,74617945,lincRNA,-1,38587,chr13_74579358_74617945
Erap1,13,74639568,74693201,protein_coding,1,53633,chr13_74639568_74693201
Cast,13,74692368,74808810,protein_coding,-1,116442,chr13_74692368_74808810
Pcsk1,13,75089826,75134861,protein_coding,1,45035,chr13_75089826_75134861
1700037F03Rik,13,75700162,75707172,antisense,-1,7010,chr13_75700162_75707172
Ell2,13,75706757,75772364,protein_coding,1,65607,chr13_75706757_75772364
Glrx,13,75839868,75850154,protein_coding,1,10286,chr13_75839868_75850154
Rhobtb3,13,75869537,75943925,protein_coding,-1,74388,chr13_75869537_75943925
Spata9,13,75967150,75998972,protein_coding,1,31822,chr13_75967150_75998972
Rfesd,13,76001535,76018719,protein_coding,-1,17184,chr13_76001535_76018719
Gpr150,13,76054851,76056996,protein_coding,-1,2145,chr13_76054851_76056996
Arsk,13,76060422,76098660,protein_coding,-1,38238,chr13_76060422_76098660
Ttc37,13,76098734,76190316,protein_coding,1,91582,chr13_76098734_76190316
Fam81b,13,76201708,76305072,protein_coding,-1,103364,chr13_76201708_76305072
Gm31219,13,76255947,76278968,antisense,1,23021,chr13_76255947_76278968
Mctp1,13,76384535,77031810,protein_coding,1,647275,chr13_76384535_77031810
Slf1,13,77043088,77135473,protein_coding,-1,92385,chr13_77043088_77135473
2210408I21Rik,13,77135540,77613784,protein_coding,1,478244,chr13_77135540_77613784
Fam172a,13,77702033,78166235,protein_coding,1,464202,chr13_77702033_78166235
Gm38604,13,78123379,78183168,antisense,-1,59789,chr13_78123379_78183168
3110006O06Rik,13,78171630,78182973,lincRNA,1,11343,chr13_78171630_78182973
Nr2f1,13,78188973,78199757,protein_coding,-1,10784,chr13_78188973_78199757
A830082K12Rik,13,78198017,78279391,antisense,1,81374,chr13_78198017_78279391
Gm48399,13,78374179,78384198,lincRNA,1,10019,chr13_78374179_78384198
Gm31946,13,78427248,78442524,lincRNA,1,15276,chr13_78427248_78442524
Gm32067,13,78483354,78562570,lincRNA,1,79216,chr13_78483354_78562570
Gm48402,13,78638017,78643064,lincRNA,1,5047,chr13_78638017_78643064
Gm29318,13,79285712,79298242,lincRNA,1,12530,chr13_79285712_79298242
Gm28526,13,79873085,80130468,lincRNA,-1,257383,chr13_79873085_80130468
Arrdc3,13,80883384,80896042,protein_coding,1,12658,chr13_80883384_80896042
5430425K12Rik,13,80940411,80948597,lincRNA,1,8186,chr13_80940411_80948597
Gm4211,13,80957665,80963730,lincRNA,-1,6065,chr13_80957665_80963730
9330111N05Rik,13,80962888,81128864,antisense,1,165976,chr13_80962888_81128864
Adgrv1,13,81095068,81633154,protein_coding,-1,538086,chr13_81095068_81633154
Lysmd3,13,81657663,81672871,protein_coding,1,15208,chr13_81657663_81672871
Polr3g,13,81673843,81711013,protein_coding,-1,37170,chr13_81673843_81711013
Mblac2,13,81711341,81753275,protein_coding,1,41934,chr13_81711341_81753275
Gm17259,13,81778773,81783749,antisense,-1,4976,chr13_81778773_81783749
Cetn3,13,81783077,81797155,protein_coding,1,14078,chr13_81783077_81797155
Gm48155,13,82089757,82258960,lincRNA,1,169203,chr13_82089757_82258960
2310067P03Rik,13,83065457,83194347,lincRNA,1,128890,chr13_83065457_83194347
Mef2c,13,83504034,83667080,protein_coding,1,163046,chr13_83504034_83667080
C130071C03Rik,13,83721381,83884194,lincRNA,1,162813,chr13_83721381_83884194
Gm26803,13,83723442,83729582,lincRNA,-1,6140,chr13_83723442_83729582
2810049E08Rik,13,83891208,83928710,lincRNA,1,37502,chr13_83891208_83928710
Gm4241,13,83971355,83987991,lincRNA,-1,16636,chr13_83971355_83987991
Gm17750,13,84025297,84064772,lincRNA,-1,39475,chr13_84025297_84064772
A230107N01Rik,13,84219581,84222175,antisense,-1,2594,chr13_84219581_84222175
Tmem161b,13,84222296,84296141,protein_coding,1,73845,chr13_84222296_84296141
Ccnh,13,85189408,85223469,protein_coding,1,34061,chr13_85189408_85223469
Rasa1,13,85214780,85289130,protein_coding,-1,74350,chr13_85214780_85289130
Cox7c,13,86044816,86046904,protein_coding,-1,2088,chr13_86044816_86046904
Gm34585,13,88521190,88578168,lincRNA,1,56978,chr13_88521190_88578168
Edil3,13,88821472,89323223,protein_coding,1,501751,chr13_88821472_89323223
Hapln1,13,89539796,89611652,protein_coding,1,71856,chr13_89539796_89611652
Vcan,13,89655312,89742509,protein_coding,-1,87197,chr13_89655312_89742509
Gm4117,13,89739460,89887166,antisense,1,147706,chr13_89739460_89887166
Xrcc4,13,89774027,90089608,protein_coding,-1,315581,chr13_89774027_90089608
Tmem167,13,90089123,90143907,protein_coding,1,54784,chr13_90089123_90143907
Gm29680,13,90179217,90217142,lincRNA,-1,37925,chr13_90179217_90217142
Gm47520,13,90360130,90418100,lincRNA,-1,57970,chr13_90360130_90418100
Atp6ap1l,13,90883433,90905355,protein_coding,-1,21922,chr13_90883433_90905355
Rps23,13,90922958,90924950,protein_coding,1,1992,chr13_90922958_90924950
Atg10,13,90935356,91223968,protein_coding,-1,288612,chr13_90935356_91223968
Gm47381,13,91259376,91274954,lincRNA,1,15578,chr13_91259376_91274954
A830009L08Rik,13,91368990,91388085,lincRNA,-1,19095,chr13_91368990_91388085
Ssbp2,13,91460283,91703429,protein_coding,1,243146,chr13_91460283_91703429
4833422C13Rik,13,91701665,91741872,antisense,-1,40207,chr13_91701665_91741872
Acot12,13,91741512,91786148,protein_coding,1,44636,chr13_91741512_91786148
Zcchc9,13,91796533,91807705,protein_coding,-1,11172,chr13_91796533_91807705
Ckmt2,13,91853387,91876885,protein_coding,-1,23498,chr13_91853387_91876885
1700119I11Rik,13,91861432,91862044,antisense,1,612,chr13_91861432_91862044
Rasgrf2,13,91880400,92131656,protein_coding,-1,251256,chr13_91880400_92131656
Msh3,13,92211872,92355003,protein_coding,-1,143131,chr13_92211872_92355003
Gm20379,13,92305980,92307183,protein_coding,1,1203,chr13_92305980_92307183
Dhfr,13,92354726,92389053,protein_coding,1,34327,chr13_92354726_92389053
C030017D09Rik,13,92415017,92427224,antisense,-1,12207,chr13_92415017_92427224
Ankrd34b,13,92425896,92441658,protein_coding,1,15762,chr13_92425896_92441658
Fam151b,13,92449625,92484015,protein_coding,-1,34390,chr13_92449625_92484015
Zfyve16,13,92487108,92530868,protein_coding,-1,43760,chr13_92487108_92530868
Serinc5,13,92611091,92711947,protein_coding,1,100856,chr13_92611091_92711947
Thbs4,13,92751590,92794818,protein_coding,-1,43228,chr13_92751590_92794818
Mtx3,13,92844760,92858230,protein_coding,1,13470,chr13_92844760_92858230
Cmya5,13,93040713,93144724,protein_coding,-1,104011,chr13_93040713_93144724
Gm4814,13,93073304,93074757,antisense,1,1453,chr13_93073304_93074757
A630019I02Rik,13,93094833,93098968,antisense,1,4135,chr13_93094833_93098968
Homer1,13,93299635,93405129,protein_coding,1,105494,chr13_93299635_93405129
Jmy,13,93430101,93499808,protein_coding,-1,69707,chr13_93430101_93499808
Bhmt,13,93616675,93637961,protein_coding,-1,21286,chr13_93616675_93637961
Gm15622,13,93625382,93628633,antisense,1,3251,chr13_93625382_93628633
Bhmt2,13,93655720,93674302,protein_coding,-1,18582,chr13_93655720_93674302
Dmgdh,13,93674433,93752833,protein_coding,1,78400,chr13_93674433_93752833
AW495222,13,93706182,93719175,antisense,-1,12993,chr13_93706182_93719175
Arsb,13,93771630,93943016,protein_coding,1,171386,chr13_93771630_93943016
Gm47216,13,93983195,93991768,lincRNA,-1,8573,chr13_93983195_93991768
Lhfpl2,13,94057796,94195409,protein_coding,1,137613,chr13_94057796_94195409
Gm15907,13,94137447,94140117,lincRNA,-1,2670,chr13_94137447_94140117
Scamp1,13,94201310,94285857,protein_coding,-1,84547,chr13_94201310_94285857
Gm32089,13,94289448,94295006,lincRNA,-1,5558,chr13_94289448_94295006
Gm48102,13,94294017,94301250,lincRNA,1,7233,chr13_94294017_94301250
Ap3b1,13,94358960,94566317,protein_coding,1,207357,chr13_94358960_94566317
Gm48287,13,94645899,94647344,lincRNA,-1,1445,chr13_94645899_94647344
Gm32305,13,94685566,94700356,lincRNA,-1,14790,chr13_94685566_94700356
Gm32351,13,94701018,94702718,lincRNA,-1,1700,chr13_94701018_94702718
Tbca,13,94788910,94842922,protein_coding,1,54012,chr13_94788910_94842922
Wdr41,13,94976344,95023314,protein_coding,1,46970,chr13_94976344_95023314
Gm48350,13,95012681,95023790,antisense,-1,11109,chr13_95012681_95023790
Gm48420,13,95024301,95024900,antisense,1,599,chr13_95024301_95024900
Pde8b,13,95024454,95250336,protein_coding,-1,225882,chr13_95024454_95250336
Gm16243,13,95208112,95208936,antisense,1,824,chr13_95208112_95208936
Zbed3,13,95323612,95337841,protein_coding,1,14229,chr13_95323612_95337841
Aggf1,13,95350683,95375352,protein_coding,-1,24669,chr13_95350683_95375352
Crhbp,13,95431371,95444924,protein_coding,-1,13553,chr13_95431371_95444924
F2rl1,13,95511732,95525227,protein_coding,-1,13495,chr13_95511732_95525227
Gm48730,13,95535590,95545200,lincRNA,1,9610,chr13_95535590_95545200
F2r,13,95601803,95618487,protein_coding,-1,16684,chr13_95601803_95618487
Iqgap2,13,95627174,95892483,protein_coding,-1,265309,chr13_95627174_95892483
F2rl2,13,95696853,95702739,protein_coding,1,5886,chr13_95696853_95702739
Sv2c,13,95954594,96132577,protein_coding,-1,177983,chr13_95954594_96132577
Gm17190,13,96082054,96083231,protein_coding,1,1177,chr13_96082054_96083231
Gm29543,13,96133369,96134335,lincRNA,1,966,chr13_96133369_96134335
Poc5,13,96388294,96417737,protein_coding,1,29443,chr13_96388294_96417737
Ankdd1b,13,96416134,96471267,protein_coding,-1,55133,chr13_96416134_96471267
Polk,13,96480690,96542579,protein_coding,-1,61889,chr13_96480690_96542579
Gm17622,13,96490733,96491120,protein_coding,1,387,chr13_96490733_96491120
Col4a3bp,13,96542618,96640167,protein_coding,1,97549,chr13_96542618_96640167
Gm48133,13,96542993,96543652,antisense,-1,659,chr13_96542993_96543652
Hmgcr,13,96648967,96670936,protein_coding,-1,21969,chr13_96648967_96670936
Ankrd31,13,96748272,96910039,protein_coding,1,161767,chr13_96748272_96910039
Gcnt4,13,96924689,96950906,protein_coding,1,26217,chr13_96924689_96950906
Gm48597,13,96950372,96950914,antisense,-1,542,chr13_96950372_96950914
1700029F12Rik,13,97021864,97034362,protein_coding,-1,12498,chr13_97021864_97034362
Fam169a,13,97067286,97131013,protein_coding,1,63727,chr13_97067286_97131013
Gm6169,13,97098208,97099237,protein_coding,-1,1029,chr13_97098208_97099237
Nsa2,13,97129424,97137937,protein_coding,-1,8513,chr13_97129424_97137937
Gfm2,13,97137937,97181195,protein_coding,1,43258,chr13_97137937_97181195
Hexb,13,97176331,97198357,protein_coding,-1,22026,chr13_97176331_97198357
Enc1,13,97241105,97253034,protein_coding,1,11929,chr13_97241105_97253034
C430039J16Rik,13,97283183,97285560,lincRNA,1,2377,chr13_97283183_97285560
Gm33447,13,97376234,97380465,lincRNA,1,4231,chr13_97376234_97380465
Lncenc1,13,97434970,97497007,lincRNA,1,62037,chr13_97434970_97497007
Gm2379,13,97511204,97515730,lincRNA,1,4526,chr13_97511204_97515730
Gm41030,13,97523200,97527455,lincRNA,-1,4255,chr13_97523200_97527455
Gm5086,13,97559971,97583996,lincRNA,1,24025,chr13_97559971_97583996
5330416C01Rik,13,97733498,97747411,lincRNA,-1,13913,chr13_97733498_97747411
Gm41031,13,97796162,97825885,lincRNA,-1,29723,chr13_97796162_97825885
Gm34388,13,97865841,97876662,lincRNA,-1,10821,chr13_97865841_97876662
Arhgef28,13,97899469,98206439,protein_coding,-1,306970,chr13_97899469_98206439
Utp15,13,98246845,98263041,protein_coding,-1,16196,chr13_98246845_98263041
Ankra2,13,98263074,98274754,protein_coding,1,11680,chr13_98263074_98274754
Gm21976,13,98279887,98307154,protein_coding,1,27267,chr13_98279887_98307154
Btf3,13,98309896,98317006,protein_coding,-1,7110,chr13_98309896_98317006
Foxd1,13,98354242,98359305,protein_coding,1,5063,chr13_98354242_98359305
2310005E17Rik,13,98424109,98435065,lincRNA,-1,10956,chr13_98424109_98435065
Gm10320,13,98489348,98492001,protein_coding,-1,2653,chr13_98489348_98492001
Tmem174,13,98634978,98637410,protein_coding,-1,2432,chr13_98634978_98637410
Tmem171,13,98686235,98694834,protein_coding,-1,8599,chr13_98686235_98694834
Gm9465,13,98713074,98716510,lincRNA,-1,3436,chr13_98713074_98716510
Fcho2,13,98723403,98815449,protein_coding,-1,92046,chr13_98723403_98815449
Gm47551,13,98801172,98803736,antisense,1,2564,chr13_98801172_98803736
Tnpo1,13,98839019,98926384,protein_coding,-1,87365,chr13_98839019_98926384
Gm35215,13,98936763,98945916,lincRNA,-1,9153,chr13_98936763_98945916
Gm35279,13,98994151,98997418,lincRNA,1,3267,chr13_98994151_98997418
A930014D07Rik,13,99007099,99021695,lincRNA,1,14596,chr13_99007099_99021695
2310020H05Rik,13,99076526,99087921,lincRNA,-1,11395,chr13_99076526_99087921
Gm807,13,99100706,99107580,lincRNA,1,6874,chr13_99100706_99107580
Zfp366,13,99184823,99250656,protein_coding,1,65833,chr13_99184823_99250656
Ptcd2,13,99319647,99344705,protein_coding,-1,25058,chr13_99319647_99344705
Mrps27,13,99344786,99415562,protein_coding,1,70776,chr13_99344786_99415562
Map1b,13,99421446,99516540,protein_coding,-1,95094,chr13_99421446_99516540
Cartpt,13,99898489,99901091,protein_coding,-1,2602,chr13_99898489_99901091
Mccc2,13,99948530,100015639,protein_coding,-1,67109,chr13_99948530_100015639
Bdp1,13,100017994,100104070,protein_coding,-1,86076,chr13_100017994_100104070
BC001981,13,100106795,100108339,antisense,-1,1544,chr13_100106795_100108339
Serf1,13,100108012,100114571,protein_coding,1,6559,chr13_100108012_100114571
Smn1,13,100124852,100137690,protein_coding,1,12838,chr13_100124852_100137690
Naip2,13,100144063,100202092,protein_coding,-1,58029,chr13_100144063_100202092
Naip5,13,100211739,100246323,protein_coding,-1,34584,chr13_100211739_100246323
Naip6,13,100281121,100317674,protein_coding,-1,36553,chr13_100281121_100317674
Naip1,13,100407764,100452869,protein_coding,-1,45105,chr13_100407764_100452869
Gtf2h2,13,100460218,100492579,protein_coding,-1,32361,chr13_100460218_100492579
Ocln,13,100496507,100552718,protein_coding,-1,56211,chr13_100496507_100552718
Gm48596,13,100557426,100560639,lincRNA,1,3213,chr13_100557426_100560639
Marveld2,13,100595957,100616971,protein_coding,-1,21014,chr13_100595957_100616971
Rad17,13,100617164,100651051,protein_coding,-1,33887,chr13_100617164_100651051
Ak6,13,100650979,100666359,protein_coding,1,15380,chr13_100650979_100666359
Ccdc125,13,100669717,100697240,protein_coding,1,27523,chr13_100669717_100697240
Cdk7,13,100702631,100730939,protein_coding,-1,28308,chr13_100702631_100730939
Mrps36,13,100735955,100744659,protein_coding,-1,8704,chr13_100735955_100744659
Cenph,13,100759674,100775899,protein_coding,-1,16225,chr13_100759674_100775899
Ccnb1,13,100778650,100786570,protein_coding,-1,7920,chr13_100778650_100786570
Slc30a5,13,100802648,100833427,protein_coding,-1,30779,chr13_100802648_100833427
Gm29502,13,100847433,100977915,lincRNA,1,130482,chr13_100847433_100977915
5930438M14Rik,13,101232127,101247551,lincRNA,1,15424,chr13_101232127_101247551
4932411K12Rik,13,101254294,101464160,lincRNA,1,209866,chr13_101254294_101464160
Gm47533,13,101545206,101548279,lincRNA,1,3073,chr13_101545206_101548279
Pik3r1,13,101680563,101768217,protein_coding,-1,87654,chr13_101680563_101768217
Gm29927,13,102563187,102590285,lincRNA,-1,27098,chr13_102563187_102590285
Cd180,13,102693558,102739629,protein_coding,1,46071,chr13_102693558_102739629
Mast4,13,102732486,103334497,protein_coding,-1,602011,chr13_102732486_103334497
1700099I09Rik,13,102760255,102761896,antisense,1,1641,chr13_102760255_102761896
Gm17160,13,102762435,102764785,antisense,1,2350,chr13_102762435_102764785
Gm30551,13,103591395,103707633,lincRNA,-1,116238,chr13_103591395_103707633
Srek1,13,103739348,103774608,protein_coding,-1,35260,chr13_103739348_103774608
Erbin,13,103818787,103920514,protein_coding,-1,101727,chr13_103818787_103920514
Gm47849,13,103945928,103970124,lincRNA,-1,24196,chr13_103945928_103970124
Gm47851,13,103976312,103978330,lincRNA,-1,2018,chr13_103976312_103978330
Nln,13,104023057,104109614,protein_coding,-1,86557,chr13_104023057_104109614
Sgtb,13,104109741,104141735,protein_coding,1,31994,chr13_104109741_104141735
Trappc13,13,104142149,104178469,protein_coding,-1,36320,chr13_104142149_104178469
Trim23,13,104178797,104203372,protein_coding,1,24575,chr13_104178797_104203372
Ppwd1,13,104205124,104228843,protein_coding,-1,23719,chr13_104205124_104228843
Cenpk,13,104228611,104252392,protein_coding,1,23781,chr13_104228611_104252392
Adamts6,13,104287835,104496695,protein_coding,1,208860,chr13_104287835_104496695
Cwc27,13,104631140,104817142,protein_coding,-1,186002,chr13_104631140_104817142
2610204G07Rik,13,104684931,104694994,antisense,1,10063,chr13_104684931_104694994
Srek1ip1,13,104792484,104839274,protein_coding,1,46790,chr13_104792484_104839274
Rgs7bp,13,104945904,105054930,protein_coding,-1,109026,chr13_104945904_105054930
Rnf180,13,105130001,105294815,protein_coding,-1,164814,chr13_105130001_105294815
Htr1a,13,105443639,105448122,protein_coding,1,4483,chr13_105443639_105448122
Gm10739,13,105838547,106019783,lincRNA,1,181236,chr13_105838547_106019783
Gm30411,13,106747070,106761579,lincRNA,-1,14509,chr13_106747070_106761579
Gm28989,13,106788070,106796796,antisense,1,8726,chr13_106788070_106796796
Ipo11,13,106794439,106936958,protein_coding,-1,142519,chr13_106794439_106936958
Gm28988,13,106851900,106853846,antisense,1,1946,chr13_106851900_106853846
Dimt1,13,106947127,106960224,protein_coding,1,13097,chr13_106947127_106960224
Kif2a,13,106958996,107022126,protein_coding,-1,63130,chr13_106958996_107022126
Gm48684,13,107034284,107035217,lincRNA,1,933,chr13_107034284_107035217
Gm31452,13,107063693,107099252,lincRNA,1,35559,chr13_107063693_107099252
AI197445,13,107469822,107482718,lincRNA,1,12896,chr13_107469822_107482718
Gm32090,13,107605284,107612849,lincRNA,-1,7565,chr13_107605284_107612849
B230220B15Rik,13,107996285,108004669,lincRNA,1,8384,chr13_107996285_108004669
Ndufaf2,13,108002715,108158623,protein_coding,-1,155908,chr13_108002715_108158623
Smim15,13,108044446,108049172,protein_coding,1,4726,chr13_108044446_108049172
Ercc8,13,108158731,108195364,protein_coding,1,36633,chr13_108158731_108195364
Elovl7,13,108214404,108285683,protein_coding,1,71279,chr13_108214404_108285683
Depdc1b,13,108316332,108407782,protein_coding,1,91450,chr13_108316332_108407782
Pde4d,13,108449948,109953461,protein_coding,1,1503513,chr13_108449948_109953461
Rab3c,13,110054187,110280996,protein_coding,-1,226809,chr13_110054187_110280996
Gapt,13,110352616,110357199,protein_coding,-1,4583,chr13_110352616_110357199
Plk2,13,110395046,110400844,protein_coding,1,5798,chr13_110395046_110400844
Gm33045,13,110627288,110642730,lincRNA,1,15442,chr13_110627288_110642730
Gm33172,13,110683912,110686925,lincRNA,1,3013,chr13_110683912_110686925
4930526H09Rik,13,110882852,110903846,lincRNA,-1,20994,chr13_110882852_110903846
Gm38397,13,110903499,110908280,lincRNA,1,4781,chr13_110903499_110908280
3110015C05Rik,13,111211467,111229431,lincRNA,-1,17964,chr13_111211467_111229431
Gm6270,13,111361840,111368680,lincRNA,-1,6840,chr13_111361840_111368680
Gpbp1,13,111425680,111490111,protein_coding,-1,64431,chr13_111425680_111490111
Gm15288,13,111561372,111568553,antisense,-1,7181,chr13_111561372_111568553
Mier3,13,111680979,111718596,protein_coding,1,37617,chr13_111680979_111718596
Gm15287,13,111725517,111735124,antisense,1,9607,chr13_111725517_111735124
Map3k1,13,111746428,111808993,protein_coding,-1,62565,chr13_111746428_111808993
Gm15326,13,111867936,111874730,lincRNA,1,6794,chr13_111867936_111874730
Gm15322,13,111991466,111995486,lincRNA,1,4020,chr13_111991466_111995486
Gm48802,13,112165458,112172068,lincRNA,-1,6610,chr13_112165458_112172068
Ankrd55,13,112288451,112384002,protein_coding,1,95551,chr13_112288451_112384002
Gm48837,13,112356925,112367845,antisense,-1,10920,chr13_112356925_112367845
Gm48879,13,112429434,112436596,lincRNA,-1,7162,chr13_112429434_112436596
Il6st,13,112464070,112510086,protein_coding,1,46016,chr13_112464070_112510086
Il31ra,13,112519898,112594360,protein_coding,-1,74462,chr13_112519898_112594360
Ddx4,13,112598333,112652475,protein_coding,-1,54142,chr13_112598333_112652475
Slc38a9,13,112660751,112738749,protein_coding,1,77998,chr13_112660751_112738749
Gm47827,13,112669139,112685696,antisense,-1,16557,chr13_112669139_112685696
Plpp1,13,112800792,112867894,protein_coding,1,67102,chr13_112800792_112867894
Dhx29,13,112927454,112969432,protein_coding,1,41978,chr13_112927454_112969432
Ccno,13,112987802,112990777,protein_coding,1,2975,chr13_112987802_112990777
Mcidas,13,112993845,113000394,protein_coding,1,6549,chr13_112993845_113000394
Cdc20b,13,113035111,113091195,protein_coding,1,56084,chr13_113035111_113091195
Gpx8,13,113042753,113046410,protein_coding,-1,3657,chr13_113042753_113046410
1700084D21Rik,13,113136083,113144012,lincRNA,1,7929,chr13_113136083_113144012
Gzmk,13,113171608,113225908,protein_coding,-1,54300,chr13_113171608_113225908
Esm1,13,113209659,113218098,protein_coding,1,8439,chr13_113209659_113218098
BC067074,13,113293159,113379711,protein_coding,1,86552,chr13_113293159_113379711
Gm41071,13,113420336,113423887,lincRNA,-1,3551,chr13_113420336_113423887
4921509O07Rik,13,113446288,113502844,lincRNA,-1,56556,chr13_113446288_113502844
Gm34471,13,113529039,113567767,lincRNA,-1,38728,chr13_113529039_113567767
Snx18,13,113592179,113618564,protein_coding,-1,26385,chr13_113592179_113618564
Hspb3,13,113662896,113663676,protein_coding,-1,780,chr13_113662896_113663676
Gm34586,13,113672318,113686540,lincRNA,1,14222,chr13_113672318_113686540
Arl15,13,113794505,114157461,protein_coding,1,362956,chr13_113794505_114157461
A430090L17Rik,13,114124348,114151592,antisense,-1,27244,chr13_114124348_114151592
Ndufs4,13,114287795,114388258,protein_coding,-1,100463,chr13_114287795_114388258
Fst,13,114452290,114458951,protein_coding,-1,6661,chr13_114452290_114458951
Gm47040,13,114458663,114462047,antisense,1,3384,chr13_114458663_114462047
4930467J12Rik,13,114586513,114607084,lincRNA,-1,20571,chr13_114586513_114607084
4930544M13Rik,13,114607237,114697822,lincRNA,1,90585,chr13_114607237_114697822
Mocs2,13,114818236,114832275,protein_coding,1,14039,chr13_114818236_114832275
Itga2,13,114833081,114932100,protein_coding,-1,99019,chr13_114833081_114932100
Itga1,13,114953096,115101964,protein_coding,-1,148868,chr13_114953096_115101964
Gm10734,13,115089501,115090987,antisense,1,1486,chr13_115089501_115090987
Isl1,13,116298281,116309689,protein_coding,-1,11408,chr13_116298281_116309689
Gm47914,13,116558311,116677705,lincRNA,-1,119394,chr13_116558311_116677705
4930435F18Rik,13,116802095,116838178,lincRNA,-1,36083,chr13_116802095_116838178
Parp8,13,116854820,117025537,protein_coding,-1,170717,chr13_116854820_117025537
Gm6416,13,117130027,117135884,lincRNA,1,5857,chr13_117130027_117135884
Emb,13,117208536,117274415,protein_coding,1,65879,chr13_117208536_117274415
Gm17509,13,117218701,117221075,antisense,-1,2374,chr13_117218701_117221075
Hcn1,13,117602320,117987418,protein_coding,1,385098,chr13_117602320_117987418
4933413L06Rik,13,117706764,117720011,antisense,-1,13247,chr13_117706764_117720011
Mrps30,13,118378381,118387252,protein_coding,-1,8871,chr13_118378381_118387252
B430218F22Rik,13,118386630,118388124,antisense,1,1494,chr13_118386630_118388124
1700003P14Rik,13,118555360,118588704,lincRNA,1,33344,chr13_118555360_118588704
Gm10732,13,118603418,118658743,lincRNA,-1,55325,chr13_118603418_118658743
Fgf10,13,118669791,118792115,protein_coding,1,122324,chr13_118669791_118792115
Gm16263,13,118695292,118715396,antisense,-1,20104,chr13_118695292_118715396
Gm47336,13,119271619,119279545,lincRNA,-1,7926,chr13_119271619_119279545
Nnt,13,119335448,119408997,protein_coding,-1,73549,chr13_119335448_119408997
Paip1,13,119428601,119458218,protein_coding,1,29617,chr13_119428601_119458218
4833420G17Rik,13,119462768,119486120,protein_coding,1,23352,chr13_119462768_119486120
3110070M22Rik,13,119487252,119488384,antisense,-1,1132,chr13_119487252_119488384
Tmem267,13,119488039,119611059,protein_coding,1,123020,chr13_119488039_119611059
Gm48265,13,119609765,119613472,lincRNA,-1,3707,chr13_119609765_119613472
Ccl28,13,119623819,119654359,protein_coding,1,30540,chr13_119623819_119654359
1700074H08Rik,13,119680040,119681588,lincRNA,1,1548,chr13_119680040_119681588
Hmgcs1,13,119690379,119708260,protein_coding,1,17881,chr13_119690379_119708260
Gm48342,13,119698360,119704549,antisense,-1,6189,chr13_119698360_119704549
Nim1k,13,119710094,119755882,protein_coding,-1,45788,chr13_119710094_119755882
Gm41077,13,119756093,119769532,antisense,1,13439,chr13_119756093_119769532
Zfp131,13,119765187,119790889,protein_coding,-1,25702,chr13_119765187_119790889
D13Ertd608e,13,119836006,119846570,protein_coding,1,10564,chr13_119836006_119846570
Gm21761,13,119912095,119929272,protein_coding,-1,17177,chr13_119912095_119929272
Gm21188,13,120034605,120052194,protein_coding,-1,17589,chr13_120034605_120052194
Gm20767,13,120140246,120155335,protein_coding,1,15089,chr13_120140246_120155335
Rab10os,12,3235504,3250377,antisense,1,14873,chr12_3235504_3250377
Rab10,12,3247428,3309969,protein_coding,-1,62541,chr12_3247428_3309969
Gm26520,12,3343816,3357153,lincRNA,-1,13337,chr12_3343816_3357153
Kif3c,12,3365132,3406494,protein_coding,1,41362,chr12_3365132_3406494
Gm48512,12,3367248,3404066,antisense,-1,36818,chr12_3367248_3404066
1110002L01Rik,12,3403878,3427011,antisense,-1,23133,chr12_3403878_3427011
Asxl2,12,3426857,3506852,protein_coding,1,79995,chr12_3426857_3506852
Dtnb,12,3572381,3781796,protein_coding,1,209415,chr12_3572381_3781796
Dtnbos,12,3752543,3762146,antisense,-1,9603,chr12_3752543_3762146
Dnmt3a,12,3806007,3914443,protein_coding,1,108436,chr12_3806007_3914443
Dnmt3aos,12,3859293,3862244,antisense,-1,2951,chr12_3859293_3862244
Pomc,12,3954951,3960642,protein_coding,1,5691,chr12_3954951_3960642
Efr3b,12,3962554,4038915,protein_coding,-1,76361,chr12_3962554_4038915
Gm48001,12,3984665,3985422,antisense,1,757,chr12_3984665_3985422
Dnajc27,12,4082583,4110606,protein_coding,1,28023,chr12_4082583_4110606
Adcy3,12,4133103,4213525,protein_coding,1,80422,chr12_4133103_4213525
Cenpo,12,4196004,4234294,protein_coding,-1,38290,chr12_4196004_4234294
Ptrhd1,12,4234027,4239950,protein_coding,1,5923,chr12_4234027_4239950
4921501I09Rik,12,4241133,4247671,antisense,1,6538,chr12_4241133_4247671
Ncoa1,12,4247362,4477182,protein_coding,-1,229820,chr12_4247362_4477182
2900045O20Rik,12,4509317,4522370,lincRNA,1,13053,chr12_4509317_4522370
Gm31938,12,4524113,4529122,lincRNA,1,5009,chr12_4524113_4529122
Gm46332,12,4552546,4569538,lincRNA,-1,16992,chr12_4552546_4569538
Gm48610,12,4572401,4576756,lincRNA,-1,4355,chr12_4572401_4576756
Itsn2,12,4592638,4713962,protein_coding,1,121324,chr12_4592638_4713962
Gm48678,12,4595340,4655888,antisense,-1,60548,chr12_4595340_4655888
Fam228a,12,4713670,4738430,protein_coding,-1,24760,chr12_4713670_4738430
Fam228b,12,4739888,4769267,protein_coding,-1,29379,chr12_4739888_4769267
Pfn4,12,4769022,4778813,protein_coding,1,9791,chr12_4769022_4778813
Sf3b6,12,4817544,4827659,protein_coding,1,10115,chr12_4817544_4827659
Fkbp1b,12,4833174,4841591,protein_coding,-1,8417,chr12_4833174_4841591
Wdcp,12,4843303,4860043,protein_coding,1,16740,chr12_4843303_4860043
Mfsd2b,12,4862440,4874359,protein_coding,-1,11919,chr12_4862440_4874359
Ubxn2a,12,4879032,4907705,protein_coding,-1,28673,chr12_4879032_4907705
Atad2b,12,4917353,5047394,protein_coding,1,130041,chr12_4917353_5047394
Klhl29,12,5077472,5375682,protein_coding,-1,298210,chr12_5077472_5375682
2810032G03Rik,12,5375870,5416631,lincRNA,1,40761,chr12_5375870_5416631
Gm48619,12,6699753,6803300,lincRNA,1,103547,chr12_6699753_6803300
1700101O22Rik,12,7372039,7380330,lincRNA,-1,8291,chr12_7372039_7380330
Gm32828,12,7524002,7859766,lincRNA,-1,335764,chr12_7524002_7859766
Gm48633,12,7911889,7950061,lincRNA,-1,38172,chr12_7911889_7950061
Apob,12,7977648,8016835,protein_coding,1,39187,chr12_7977648_8016835
Gm33037,12,8042721,8209165,antisense,-1,166444,chr12_8042721_8209165
Ldah,12,8208107,8285759,protein_coding,1,77652,chr12_8208107_8285759
Gm48898,12,8291024,8293694,lincRNA,-1,2670,chr12_8291024_8293694
Gdf7,12,8297918,8301954,protein_coding,-1,4036,chr12_8297918_8301954
Hs1bp3,12,8313432,8343824,protein_coding,1,30392,chr12_8313432_8343824
Gm48071,12,8335460,8336717,antisense,-1,1257,chr12_8335460_8336717
Gm48075,12,8394209,8400356,lincRNA,1,6147,chr12_8394209_8400356
Rhob,12,8497661,8500009,protein_coding,-1,2348,chr12_8497661_8500009
5033421B08Rik,12,8511201,8562681,antisense,1,51480,chr12_8511201_8562681
Slc7a15,12,8528483,8599066,protein_coding,-1,70583,chr12_8528483_8599066
Pum2,12,8674134,8752581,protein_coding,1,78447,chr12_8674134_8752581
Sdc1,12,8771323,8793715,protein_coding,1,22392,chr12_8771323_8793715
9930038B18Rik,12,8873187,8893473,lincRNA,-1,20286,chr12_8873187_8893473
Gm47391,12,8912924,8917479,lincRNA,1,4555,chr12_8912924_8917479
Laptm4a,12,8921664,8938742,protein_coding,1,17078,chr12_8921664_8938742
Matn3,12,8947929,8972028,protein_coding,1,24099,chr12_8947929_8972028
Wdr35,12,8973892,9028847,protein_coding,1,54955,chr12_8973892_9028847
Ttc32,12,9029997,9041988,protein_coding,1,11991,chr12_9029997_9041988
Gm46323,12,9371438,9473770,lincRNA,1,102332,chr12_9371438_9473770
Gm48762,12,9494005,9496908,lincRNA,-1,2903,chr12_9494005_9496908
Gm48764,12,9503584,9509637,lincRNA,-1,6053,chr12_9503584_9509637
Osr1,12,9570116,9581500,protein_coding,1,11384,chr12_9570116_9581500
Gm48790,12,9729519,9734209,lincRNA,1,4690,chr12_9729519_9734209
Gm48791,12,10177143,10224794,lincRNA,1,47651,chr12_10177143_10224794
Nt5c1b,12,10369973,10390175,protein_coding,1,20202,chr12_10369973_10390175
Rdh14,12,10390772,10395562,protein_coding,1,4790,chr12_10390772_10395562
Gm38407,12,10446388,10531303,lincRNA,1,84915,chr12_10446388_10531303
7420701I03Rik,12,11047813,11078742,lincRNA,1,30929,chr12_11047813_11078742
Kcns3,12,11090202,11151056,protein_coding,-1,60854,chr12_11090202_11151056
9530020I12Rik,12,11185993,11204502,lincRNA,-1,18509,chr12_11185993_11204502
Gen1,12,11238920,11265801,protein_coding,-1,26881,chr12_11238920_11265801
Smc6,12,11265886,11319785,protein_coding,1,53899,chr12_11265886_11319785
Vsnl1,12,11325242,11436613,protein_coding,-1,111371,chr12_11325242_11436613
4930511A02Rik,12,11438227,11444812,lincRNA,1,6585,chr12_11438227_11444812
Rad51ap2,12,11456079,11462928,protein_coding,1,6849,chr12_11456079_11462928
Gm47833,12,11781535,11792951,lincRNA,1,11416,chr12_11781535_11792951
Gm34237,12,11826607,11897726,lincRNA,1,71119,chr12_11826607_11897726
Fam49a,12,12262139,12380965,protein_coding,1,118826,chr12_12262139_12380965
4921511I17Rik,12,12351522,12392615,antisense,-1,41093,chr12_12351522_12392615
Platr19,12,12787985,12794285,lincRNA,1,6300,chr12_12787985_12794285
4930519A11Rik,12,12902720,12907378,lincRNA,1,4658,chr12_12902720_12907378
Gm40271,12,12909428,12913029,lincRNA,1,3601,chr12_12909428_12913029
Mycn,12,12936093,12941914,protein_coding,-1,5821,chr12_12936093_12941914
Gm35208,12,12987317,12994199,lincRNA,1,6882,chr12_12987317_12994199
Gm48209,12,13046728,13054729,lincRNA,-1,8001,chr12_13046728_13054729
Gm35298,12,13102845,13115903,lincRNA,1,13058,chr12_13102845_13115903
Ddx1,12,13216973,13249213,protein_coding,-1,32240,chr12_13216973_13249213
Nbas,12,13269133,13583811,protein_coding,1,314678,chr12_13269133_13583811
Gm48311,12,13484808,13487047,antisense,-1,2239,chr12_13484808_13487047
Gm35725,12,13607789,13627646,lincRNA,-1,19857,chr12_13607789_13627646
Gm35890,12,13668853,13676084,lincRNA,1,7231,chr12_13668853_13676084
Gm48479,12,14013084,14057866,lincRNA,1,44782,chr12_14013084_14057866
Gm16497,12,14261534,14285725,lincRNA,1,24191,chr12_14261534_14285725
4930448C13Rik,12,14996388,15051598,lincRNA,-1,55210,chr12_14996388_15051598
Gm48539,12,15278417,15301045,lincRNA,-1,22628,chr12_15278417_15301045
Trib2,12,15791727,15816922,protein_coding,-1,25195,chr12_15791727_15816922
Gm48558,12,15842758,15850625,lincRNA,-1,7867,chr12_15842758_15850625
Gm48584,12,15976264,15980488,lincRNA,-1,4224,chr12_15976264_15980488
Gm36235,12,15980647,16015545,lincRNA,-1,34898,chr12_15980647_16015545
Gm48607,12,16185773,16206472,lincRNA,1,20699,chr12_16185773_16206472
Gm36372,12,16204911,16221279,lincRNA,-1,16368,chr12_16204911_16221279
Gm48606,12,16207733,16286119,lincRNA,1,78386,chr12_16207733_16286119
Gm48605,12,16229750,16232227,lincRNA,-1,2477,chr12_16229750_16232227
Lpin1,12,16535669,16646966,protein_coding,-1,111297,chr12_16535669_16646966
Ntsr2,12,16653382,16660227,protein_coding,1,6845,chr12_16653382_16660227
Greb1,12,16670615,16800886,protein_coding,-1,130271,chr12_16670615_16800886
Gm48140,12,16672240,16685013,antisense,1,12773,chr12_16672240_16685013
E2f6,12,16810963,16839742,protein_coding,1,28779,chr12_16810963_16839742
Gm36495,12,16844881,16850881,lincRNA,-1,6000,chr12_16844881_16850881
Rock2,12,16894895,16987823,protein_coding,1,92928,chr12_16894895_16987823
Pqlc3,12,16988648,17000408,protein_coding,-1,11760,chr12_16988648_17000408
2410004P03Rik,12,17003319,17011727,protein_coding,-1,8408,chr12_17003319_17011727
Gm48538,12,17065413,17074550,lincRNA,1,9137,chr12_17065413_17074550
Kcnf1,12,17172100,17176888,protein_coding,-1,4788,chr12_17172100_17176888
Pdia6,12,17266545,17284770,protein_coding,1,18225,chr12_17266545_17284770
Atp6v1c2,12,17284721,17329359,protein_coding,-1,44638,chr12_17284721_17329359
Nol10,12,17348458,17430095,protein_coding,1,81637,chr12_17348458_17430095
Gm36752,12,17436618,17446443,lincRNA,1,9825,chr12_17436618_17446443
Odc1,12,17544794,17551505,protein_coding,1,6711,chr12_17544794_17551505
Gm48313,12,17603249,17607231,lincRNA,-1,3982,chr12_17603249_17607231
Hpcal1,12,17690856,17791933,protein_coding,1,101077,chr12_17690856_17791933
5730507C01Rik,12,18514510,18535254,protein_coding,1,20744,chr12_18514510_18535254
Gm40849,12,19044706,19055179,lincRNA,1,10473,chr12_19044706_19055179
Gm10479,12,20426913,20435417,lincRNA,1,8504,chr12_20426913_20435417
Gm5784,12,19387809,19433081,lincRNA,1,45272,chr12_19387809_19433081
Gm49371,12,19560110,19564157,lincRNA,1,4047,chr12_19560110_19564157
Asap2,12,20990459,21270171,protein_coding,1,279712,chr12_20990459_21270171
Itgb1bp1,12,21267420,21286284,protein_coding,-1,18864,chr12_21267420_21286284
Cpsf3,12,21285391,21315056,protein_coding,1,29665,chr12_21285391_21315056
Iah1,12,21316389,21323819,protein_coding,1,7430,chr12_21316389_21323819
Adam17,12,21323509,21373632,protein_coding,-1,50123,chr12_21323509_21373632
Ywhaq,12,21390071,21417637,protein_coding,-1,27566,chr12_21390071_21417637
Gm4419,12,21417323,21421064,antisense,1,3741,chr12_21417323_21421064
Gm4425,12,22115756,22156646,lincRNA,-1,40890,chr12_22115756_22156646
2410018L13Rik,12,22953997,23010284,lincRNA,-1,56287,chr12_22953997_23010284
Gm10330,12,23779278,23780178,processed_pseudogene,-1,900,chr12_23779278_23780178
9030624G23Rik,12,24043202,24097246,protein_coding,-1,54044,chr12_24043202_24097246
Taf1b,12,24498359,24558539,protein_coding,1,60180,chr12_24498359_24558539
Grhl1,12,24572283,24617391,protein_coding,1,45108,chr12_24572283_24617391
Klf11,12,24651274,24662789,protein_coding,1,11515,chr12_24651274_24662789
Cys1,12,24665833,24681813,protein_coding,-1,15980,chr12_24665833_24681813
Rrm2,12,24708241,24714146,protein_coding,1,5905,chr12_24708241_24714146
Gm48896,12,24762341,24764936,lincRNA,1,2595,chr12_24762341_24764936
Mboat2,12,24830879,24964397,protein_coding,1,133518,chr12_24830879_24964397
Kidins220,12,24974925,25063152,protein_coding,1,88227,chr12_24974925_25063152
Gm47701,12,25064692,25067478,lincRNA,1,2786,chr12_25064692_25067478
Id2,12,25093799,25097140,protein_coding,-1,3341,chr12_25093799_25097140
Gm17746,12,25129174,25134931,lincRNA,1,5757,chr12_25129174_25134931
Gm36287,12,25150915,25209377,lincRNA,1,58462,chr12_25150915_25209377
Gm47713,12,25300071,25304613,lincRNA,-1,4542,chr12_25300071_25304613
Gm47733,12,25871153,25871561,lincRNA,1,408,chr12_25871153_25871561
Gm29687,12,26091962,26210505,lincRNA,-1,118543,chr12_26091962_26210505
4930480M12Rik,12,26211267,26240707,lincRNA,1,29440,chr12_26211267_26240707
Gm29968,12,26235530,26252545,lincRNA,-1,17015,chr12_26235530_26252545
Rnf144a,12,26300964,26415254,protein_coding,-1,114290,chr12_26300964_26415254
4930549C15Rik,12,26346717,26371748,antisense,1,25031,chr12_26346717_26371748
Rsad2,12,26442746,26456452,protein_coding,-1,13706,chr12_26442746_26456452
Cmpk2,12,26469204,26479837,protein_coding,1,10633,chr12_26469204_26479837
1700020D12Rik,12,26572108,26602309,lincRNA,-1,30201,chr12_26572108_26602309
Gm47847,12,26597259,26645747,lincRNA,1,48488,chr12_26597259_26645747
4933409F18Rik,12,26814371,26834873,lincRNA,-1,20502,chr12_26814371_26834873
Gm9866,12,27050950,27160633,lincRNA,-1,109683,chr12_27050950_27160633
Sox11,12,27334264,27342574,protein_coding,-1,8310,chr12_27334264_27342574
Gm4166,12,27598201,27615362,lincRNA,1,17161,chr12_27598201_27615362
Gm45941,12,27946042,27982234,lincRNA,1,36192,chr12_27946042_27982234
Gm47872,12,28249759,28339409,lincRNA,-1,89650,chr12_28249759_28339409
Dcdc2c,12,28437795,28552399,protein_coding,-1,114604,chr12_28437795_28552399
Allc,12,28553755,28582523,protein_coding,-1,28768,chr12_28553755_28582523
Colec11,12,28594173,28623377,protein_coding,-1,29204,chr12_28594173_28623377
Rps7,12,28630854,28635953,protein_coding,-1,5099,chr12_28630854_28635953
Rnaseh1,12,28649602,28659589,protein_coding,1,9987,chr12_28649602_28659589
Adi1,12,28675231,28682175,protein_coding,1,6944,chr12_28675231_28682175
Trappc12,12,28690628,28750472,protein_coding,-1,59844,chr12_28690628_28750472
Eipr1,12,28751803,28869865,protein_coding,1,118062,chr12_28751803_28869865
Gm31508,12,28910229,29041874,lincRNA,1,131645,chr12_28910229_29041874
4833405L11Rik,12,29104487,29106850,lincRNA,-1,2363,chr12_29104487_29106850
Gm31333,12,29139167,29199768,lincRNA,1,60601,chr12_29139167_29199768
Myt1l,12,29528384,29923213,protein_coding,1,394829,chr12_29528384_29923213
C630031E19Rik,12,29675628,29686445,antisense,-1,10817,chr12_29675628_29686445
Pxdn,12,29937608,30017658,protein_coding,1,80050,chr12_29937608_30017658
Tpo,12,30054659,30132624,protein_coding,-1,77965,chr12_30054659_30132624
Gm15691,12,30059657,30062113,antisense,1,2456,chr12_30059657_30062113
Sntg2,12,30174482,30373375,protein_coding,-1,198893,chr12_30174482_30373375
2310016D03Rik,12,30410559,30467358,lincRNA,-1,56799,chr12_30410559_30467358
Tmem18,12,30584426,30591215,protein_coding,1,6789,chr12_30584426_30591215
Alkal2,12,30884322,30893854,protein_coding,1,9532,chr12_30884322_30893854
Acp1,12,30893326,30911589,protein_coding,-1,18263,chr12_30893326_30911589
Sh3yl1,12,30911668,30960162,protein_coding,1,48494,chr12_30911668_30960162
Fam110c,12,31073861,31080251,protein_coding,1,6390,chr12_31073861_31080251
Gm32443,12,31082581,31090561,lincRNA,-1,7980,chr12_31082581_31090561
6030469F06Rik,12,31142760,31201085,processed_transcript,1,58325,chr12_31142760_31201085
Lamb1,12,31265234,31329644,protein_coding,1,64410,chr12_31265234_31329644
Dld,12,31331277,31351453,protein_coding,-1,20176,chr12_31331277_31351453
Slc26a3,12,31390871,31473917,protein_coding,1,83046,chr12_31390871_31473917
Cbll1,12,31484829,31499616,protein_coding,-1,14787,chr12_31484829_31499616
Gm29542,12,31486958,31487889,antisense,1,931,chr12_31486958_31487889
Slc26a4,12,31519827,31559969,protein_coding,-1,40142,chr12_31519827_31559969
Bcap29,12,31590967,31634658,protein_coding,-1,43691,chr12_31590967_31634658
Dus4l,12,31640050,31654826,protein_coding,-1,14776,chr12_31640050_31654826
Cog5,12,31654869,31937630,protein_coding,1,282761,chr12_31654869_31937630
Gpr22,12,31706867,31713947,protein_coding,-1,7080,chr12_31706867_31713947
Gm48809,12,31846523,31849626,antisense,-1,3103,chr12_31846523_31849626
Hbp1,12,31926254,31950535,protein_coding,-1,24281,chr12_31926254_31950535
Prkar2b,12,31958476,32061296,protein_coding,-1,102820,chr12_31958476_32061296
Gm33111,12,32073286,32080850,lincRNA,-1,7564,chr12_32073286_32080850
5430401H09Rik,12,32096613,32123702,lincRNA,-1,27089,chr12_32096613_32123702
Pik3cg,12,32173473,32208659,protein_coding,-1,35186,chr12_32173473_32208659
Ccdc71l,12,32378704,32382943,protein_coding,1,4239,chr12_32378704_32382943
Nampt,12,32819545,32853349,protein_coding,1,33804,chr12_32819545_32853349
4933406C10Rik,12,32919384,32953789,lincRNA,-1,34405,chr12_32919384_32953789
Sypl,12,32953891,32979860,protein_coding,1,25969,chr12_32953891_32979860
Cdhr3,12,33033796,33092875,protein_coding,-1,59079,chr12_33033796_33092875
Gm16267,12,33111962,33138945,lincRNA,1,26983,chr12_33111962_33138945
Atxn7l1,12,33147693,33373185,protein_coding,1,225492,chr12_33147693_33373185
Atxn7l1os1,12,33193994,33228854,antisense,-1,34860,chr12_33193994_33228854
Atxn7l1os2,12,33358243,33394760,antisense,-1,36517,chr12_33358243_33394760
Efcab10,12,33394854,33401267,protein_coding,1,6413,chr12_33394854_33401267
Twistnb,12,33429635,33441392,protein_coding,1,11757,chr12_33429635_33441392
Ferd3l,12,33928425,33929310,protein_coding,1,885,chr12_33928425_33929310
Twist1,12,33957671,33959829,protein_coding,1,2158,chr12_33957671_33959829
Hdac9,12,34047580,34917095,protein_coding,-1,869515,chr12_34047580_34917095
Snx13,12,35047186,35147479,protein_coding,1,100293,chr12_35047186_35147479
Ahr,12,35497974,35535038,protein_coding,-1,37064,chr12_35497974_35535038
Gm48236,12,35534421,35590446,lincRNA,1,56025,chr12_35534421_35590446
Gm34047,12,35602544,35694682,lincRNA,1,92138,chr12_35602544_35694682
9130015A21Rik,12,35672282,35695118,lincRNA,-1,22836,chr12_35672282_35695118
Agr3,12,35925620,35949736,protein_coding,1,24116,chr12_35925620_35949736
Agr2,12,35992907,36004087,protein_coding,1,11180,chr12_35992907_36004087
Tspan13,12,36014557,36042500,protein_coding,-1,27943,chr12_36014557_36042500
Bzw2,12,36091835,36158080,protein_coding,-1,66245,chr12_36091835_36158080
Ankmy2,12,36157114,36197291,protein_coding,1,40177,chr12_36157114_36197291
Lrrc72,12,36208345,36253398,protein_coding,-1,45053,chr12_36208345_36253398
Gm40392,12,36264925,36291051,lincRNA,1,26126,chr12_36264925_36291051
Sostdc1,12,36314139,36318452,protein_coding,1,4313,chr12_36314139_36318452
Gm34215,12,36326341,36331936,lincRNA,1,5595,chr12_36326341_36331936
D630036H23Rik,12,36381242,36382181,lincRNA,-1,939,chr12_36381242_36382181
Gm40394,12,36877965,36903033,lincRNA,1,25068,chr12_36877965_36903033
Gm48613,12,36945251,36952555,lincRNA,-1,7304,chr12_36945251_36952555
Gm48616,12,37013575,37089385,lincRNA,1,75810,chr12_37013575_37089385
Meox2,12,37108540,37179534,protein_coding,1,70994,chr12_37108540_37179534
Agmo,12,37241641,37582202,protein_coding,1,340561,chr12_37241641_37582202
Gm34408,12,37446746,37475031,antisense,-1,28285,chr12_37446746_37475031
Dgkb,12,37817726,38634239,protein_coding,1,816513,chr12_37817726_38634239
Gm48715,12,38047093,38075735,antisense,-1,28642,chr12_38047093_38075735
4930428E07Rik,12,38552808,38614521,antisense,-1,61713,chr12_38552808_38614521
Etv1,12,38779380,38870484,protein_coding,1,91104,chr12_38779380_38870484
Gm34662,12,38973722,38984018,lincRNA,-1,10296,chr12_38973722_38984018
Gm34809,12,39061907,39154761,lincRNA,-1,92854,chr12_39061907_39154761
Gm34923,12,39485844,39526955,lincRNA,-1,41111,chr12_39485844_39526955
Gm47868,12,39899010,39922859,lincRNA,-1,23849,chr12_39899010_39922859
Arl4a,12,40005447,40038025,protein_coding,-1,32578,chr12_40005447_40038025
Arl4aos,12,40038099,40040027,antisense,1,1928,chr12_40038099_40040027
Scin,12,40059769,40134228,protein_coding,-1,74459,chr12_40059769_40134228
Lsmem1,12,40175493,40199490,protein_coding,-1,23997,chr12_40175493_40199490
Gm17056,12,40198656,40201105,antisense,1,2449,chr12_40198656_40201105
Ifrd1,12,40201567,40248504,protein_coding,-1,46937,chr12_40201567_40248504
Gm7008,12,40222758,40229184,antisense,1,6426,chr12_40222758_40229184
Zfp277,12,40315046,40445902,protein_coding,-1,130856,chr12_40315046_40445902
Dock4,12,40445952,40846874,protein_coding,1,400922,chr12_40445952_40846874
Immp2l,12,41024090,41955588,protein_coding,1,931498,chr12_41024090_41955588
Gm47375,12,41041824,41044939,antisense,-1,3115,chr12_41041824_41044939
Gm47376,12,41342820,41348090,antisense,-1,5270,chr12_41342820_41348090
Gm47373,12,41386379,41391216,antisense,-1,4837,chr12_41386379_41391216
Gm47368,12,41405131,41412665,antisense,-1,7534,chr12_41405131_41412665
Lrrn3,12,41451668,41486431,protein_coding,-1,34763,chr12_41451668_41486431
Gm47371,12,41798182,41828523,antisense,-1,30341,chr12_41798182_41828523
Gm46348,12,41918708,42016756,lincRNA,-1,98048,chr12_41918708_42016756
Gm47013,12,42088439,42115803,lincRNA,1,27364,chr12_42088439_42115803
Gm47020,12,42117824,42151840,lincRNA,-1,34016,chr12_42117824_42151840
Gm47030,12,43306143,43364488,lincRNA,1,58345,chr12_43306143_43364488
Gm10165,12,43810543,43844193,lincRNA,-1,33650,chr12_43810543_43844193
Gm46349,12,43955679,43961097,lincRNA,-1,5418,chr12_43955679_43961097
Dnajb9,12,44205559,44210326,protein_coding,-1,4767,chr12_44205559_44210326
Gm47096,12,44220387,44269118,lincRNA,-1,48731,chr12_44220387_44269118
Pnpla8,12,44221370,44322532,protein_coding,1,101162,chr12_44221370_44322532
Nrcam,12,44328885,44601964,protein_coding,1,273079,chr12_44328885_44601964
Stxbp6,12,44852484,45074709,protein_coding,-1,222225,chr12_44852484_45074709
Gm48508,12,45094012,45162048,lincRNA,1,68036,chr12_45094012_45162048
Gm9921,12,45429377,45441698,lincRNA,1,12321,chr12_45429377_45441698
Gm33680,12,45466273,45546677,lincRNA,1,80404,chr12_45466273_45546677
Gm48522,12,45731415,45736901,lincRNA,-1,5486,chr12_45731415_45736901
Gm48535,12,46658603,46665709,lincRNA,-1,7106,chr12_46658603_46665709
B230217J21Rik,12,46667317,46692992,lincRNA,1,25675,chr12_46667317_46692992
Nova1,12,46694517,46818929,protein_coding,-1,124412,chr12_46694517_46818929
Gm48578,12,47532257,47544289,lincRNA,1,12032,chr12_47532257_47544289
Gm34304,12,49368729,49381885,lincRNA,-1,13156,chr12_49368729_49381885
Foxg1,12,49382660,49386861,protein_coding,1,4201,chr12_49382660_49386861
Gm43517,12,49385174,49394127,protein_coding,1,8953,chr12_49385174_49394127
3110039M20Rik,12,49389652,49407360,lincRNA,1,17708,chr12_49389652_49407360
1810007C17Rik,12,49476991,49480862,lincRNA,-1,3871,chr12_49476991_49480862
Gm40418,12,50120309,50145236,lincRNA,1,24927,chr12_50120309_50145236
Prkd1,12,50341231,50649098,protein_coding,-1,307867,chr12_50341231_50649098
Gm48779,12,50753097,50900985,lincRNA,1,147888,chr12_50753097_50900985
Gm40421,12,50985300,51004873,lincRNA,-1,19573,chr12_50985300_51004873
1700008C04Rik,12,51005158,51062543,lincRNA,1,57385,chr12_51005158_51062543
G2e3,12,51348061,51376986,protein_coding,1,28925,chr12_51348061_51376986
Scfd1,12,51377510,51450101,protein_coding,1,72591,chr12_51377510_51450101
Coch,12,51593341,51605771,protein_coding,1,12430,chr12_51593341_51605771
Strn3,12,51609632,51691897,protein_coding,-1,82265,chr12_51609632_51691897
Ap4s1,12,51691033,51744786,protein_coding,1,53753,chr12_51691033_51744786
Hectd1,12,51743722,51829536,protein_coding,-1,85814,chr12_51743722_51829536
Heatr5a,12,51875871,51971321,protein_coding,-1,95450,chr12_51875871_51971321
Dtd2,12,51988312,52006501,protein_coding,-1,18189,chr12_51988312_52006501
Gpr33,12,52023003,52028063,protein_coding,-1,5060,chr12_52023003_52028063
Nubpl,12,52097737,52312744,protein_coding,1,215007,chr12_52097737_52312744
Gm47431,12,52401359,52448125,lincRNA,-1,46766,chr12_52401359_52448125
Gm35188,12,52496326,52581409,lincRNA,-1,85083,chr12_52496326_52581409
Arhgap5,12,52503972,52571975,protein_coding,1,68003,chr12_52503972_52571975
1700031P21Rik,12,52599981,52602322,lincRNA,-1,2341,chr12_52599981_52602322
Gm35239,12,52607670,52628812,lincRNA,1,21142,chr12_52607670_52628812
Akap6,12,52699383,53155599,protein_coding,1,456216,chr12_52699383_53155599
Npas3,12,53248157,54072175,protein_coding,1,824018,chr12_53248157_54072175
1700030L22Rik,12,53303352,53309846,antisense,-1,6494,chr12_53303352_53309846
1700060O08Rik,12,54062048,54079392,antisense,-1,17344,chr12_54062048_54079392
Gm35818,12,54091430,54106885,lincRNA,-1,15455,chr12_54091430_54106885
Egln3,12,54178981,54203860,protein_coding,-1,24879,chr12_54178981_54203860
1700104L18Rik,12,54233615,54242320,lincRNA,1,8705,chr12_54233615_54242320
Gm47552,12,54316164,54317015,lincRNA,-1,851,chr12_54316164_54317015
Gm46328,12,54400176,54405654,lincRNA,1,5478,chr12_54400176_54405654
Gm10465,12,54512421,54517079,lincRNA,-1,4658,chr12_54512421_54517079
Sptssa,12,54645392,54656573,protein_coding,-1,11181,chr12_54645392_54656573
Gm40884,12,54658820,54659907,lincRNA,1,1087,chr12_54658820_54659907
Eapp,12,54670340,54695897,protein_coding,-1,25557,chr12_54670340_54695897
Snx6,12,54746349,54795703,protein_coding,-1,49354,chr12_54746349_54795703
Cfl2,12,54858809,54862877,protein_coding,-1,4068,chr12_54858809_54862877
Baz1a,12,54892989,55014348,protein_coding,-1,121359,chr12_54892989_55014348
2700097O09Rik,12,55045661,55080110,protein_coding,-1,34449,chr12_55045661_55080110
Srp54a,12,55080262,55115367,protein_coding,1,35105,chr12_55080262_55115367
Fam177a,12,55124469,55142104,protein_coding,1,17635,chr12_55124469_55142104
Srp54b,12,55155104,55189573,protein_coding,1,34469,chr12_55155104_55189573
Srp54c,12,55230168,55263836,protein_coding,1,33668,chr12_55230168_55263836
Ppp2r3c,12,55278991,55302998,protein_coding,-1,24007,chr12_55278991_55302998
Psma6,12,55384222,55418454,protein_coding,1,34232,chr12_55384222_55418454
Nfkbia,12,55489410,55492647,protein_coding,-1,3237,chr12_55489410_55492647
Aldoart2,12,55565239,55566896,protein_coding,1,1657,chr12_55565239_55566896
Insm2,12,55599427,55602086,protein_coding,1,2659,chr12_55599427_55602086
Ralgapa1,12,55602896,55821167,protein_coding,-1,218271,chr12_55602896_55821167
Brms1l,12,55836324,55869736,protein_coding,1,33412,chr12_55836324_55869736
Gm47682,12,56246648,56254398,lincRNA,-1,7750,chr12_56246648_56254398
Gm19990,12,56253243,56266384,lincRNA,1,13141,chr12_56253243_56266384
Mbip,12,56328303,56345894,protein_coding,-1,17591,chr12_56328303_56345894
Nkx2-1,12,56531958,56536908,protein_coding,-1,4950,chr12_56531958_56536908
Gm26973,12,56535343,56607476,antisense,1,72133,chr12_56535343_56607476
Nkx2-9,12,56611389,56613284,protein_coding,-1,1895,chr12_56611389_56613284
Gm15524,12,56689918,56692964,antisense,-1,3046,chr12_56689918_56692964
Pax9,12,56691767,56712822,protein_coding,1,21055,chr12_56691767_56712822
Slc25a21,12,56712634,57197472,protein_coding,-1,484838,chr12_56712634_57197472
Prps1l3,12,57230412,57239882,protein_coding,1,9470,chr12_57230412_57239882
Mipol1,12,57230427,57497199,protein_coding,1,266772,chr12_57230427_57497199
Gm16246,12,57441190,57450120,antisense,-1,8930,chr12_57441190_57450120
Foxa1,12,57540628,57546916,protein_coding,-1,6288,chr12_57540628_57546916
Ttc6,12,57564113,57737928,protein_coding,1,173815,chr12_57564113_57737928
4921518K17Rik,12,57585975,57618602,antisense,-1,32627,chr12_57585975_57618602
Gm46329,12,57951211,58077436,lincRNA,1,126225,chr12_57951211_58077436
Sstr1,12,58211772,58214444,protein_coding,1,2672,chr12_58211772_58214444
Clec14a,12,58264720,58269290,protein_coding,-1,4570,chr12_58264720_58269290
Gm47645,12,58813883,58815197,lincRNA,1,1314,chr12_58813883_58815197
Gm17529,12,58953089,58968011,antisense,1,14922,chr12_58953089_58968011
Sec23a,12,58958383,59012017,protein_coding,-1,53634,chr12_58958383_59012017
Gemin2,12,59013393,59028470,protein_coding,1,15077,chr12_59013393_59028470
Trappc6b,12,59043092,59061472,protein_coding,-1,18380,chr12_59043092_59061472
Pnn,12,59066884,59073998,protein_coding,1,7114,chr12_59066884_59073998
Mia2,12,59095799,59191583,protein_coding,1,95784,chr12_59095799_59191583
Fbxo33,12,59200655,59219725,protein_coding,-1,19070,chr12_59200655_59219725
Gm48301,12,61195126,61234643,lincRNA,1,39517,chr12_61195126_61234643
Gm20063,12,61499660,61521820,lincRNA,-1,22160,chr12_61499660_61521820
Lrfn5,12,61523150,61858342,protein_coding,1,335192,chr12_61523150_61858342
Gm48421,12,64143748,64197261,lincRNA,1,53513,chr12_64143748_64197261
Gm48422,12,64147856,64152948,lincRNA,-1,5092,chr12_64147856_64152948
Gm527,12,64917906,64924592,protein_coding,1,6686,chr12_64917906_64924592
Klhl28,12,64938833,64965534,protein_coding,-1,26701,chr12_64938833_64965534
Togaram1,12,64965804,65022573,protein_coding,1,56769,chr12_64965804_65022573
Gm48559,12,64980630,64982936,antisense,-1,2306,chr12_64980630_64982936
Prpf39,12,65036333,65063386,protein_coding,1,27053,chr12_65036333_65063386
Fkbp3,12,65062424,65074007,protein_coding,-1,11583,chr12_65062424_65074007
Fancm,12,65075603,65132058,protein_coding,1,56455,chr12_65075603_65132058
Mis18bp1,12,65132734,65172604,protein_coding,-1,39870,chr12_65132734_65172604
4930471E15Rik,12,65182380,65186387,lincRNA,1,4007,chr12_65182380_65186387
Gm31063,12,65187872,65213501,lincRNA,-1,25629,chr12_65187872_65213501
Wdr20rt,12,65225517,65233359,protein_coding,1,7842,chr12_65225517_65233359
Gm47979,12,66333502,66368385,lincRNA,-1,34883,chr12_66333502_66368385
Mdga2,12,66466060,67222549,protein_coding,-1,756489,chr12_66466060_67222549
Gm47432,12,67651385,67658263,lincRNA,1,6878,chr12_67651385_67658263
Gm47453,12,68047704,68067037,lincRNA,-1,19333,chr12_68047704_68067037
Gm47456,12,68340465,68445833,lincRNA,-1,105368,chr12_68340465_68445833
Gm47489,12,68511818,68532231,lincRNA,-1,20413,chr12_68511818_68532231
Gm47515,12,68896529,68994970,lincRNA,-1,98441,chr12_68896529_68994970
Gm2912,12,68970570,68989377,lincRNA,1,18807,chr12_68970570_68989377
Gm47518,12,69115014,69120347,lincRNA,-1,5333,chr12_69115014_69120347
Gm31447,12,69129836,69145076,lincRNA,1,15240,chr12_69129836_69145076
Rps29,12,69157722,69159186,protein_coding,-1,1464,chr12_69157722_69159186
Lrr1,12,69168814,69179009,protein_coding,1,10195,chr12_69168814_69179009
Rpl36al,12,69182731,69184083,protein_coding,-1,1352,chr12_69182731_69184083
Gm49383,12,69182834,69197104,protein_coding,-1,14270,chr12_69182834_69197104
Mgat2,12,69184157,69186770,protein_coding,1,2613,chr12_69184157_69186770
Gm49384,12,69189839,69204267,protein_coding,-1,14428,chr12_69189839_69204267
Pole2,12,69201773,69228195,protein_coding,-1,26422,chr12_69201773_69228195
Gm47545,12,69227926,69238284,antisense,1,10358,chr12_69227926_69238284
Klhdc1,12,69241176,69284632,protein_coding,1,43456,chr12_69241176_69284632
Gm15561,12,69267771,69273432,antisense,-1,5661,chr12_69267771_69273432
Klhdc2,12,69296681,69310687,protein_coding,1,14006,chr12_69296681_69310687
Nemf,12,69310522,69357165,protein_coding,-1,46643,chr12_69310522_69357165
Gm9887,12,69370484,69372468,antisense,-1,1984,chr12_69370484_69372468
Arf6,12,69372150,69373783,protein_coding,1,1633,chr12_69372150_69373783
Vcpkmt,12,69577628,69583110,protein_coding,-1,5482,chr12_69577628_69583110
Sos2,12,69583762,69681852,protein_coding,-1,98090,chr12_69583762_69681852
L2hgdh,12,69690433,69724873,protein_coding,-1,34440,chr12_69690433_69724873
Cdkl1,12,69746848,69791267,protein_coding,-1,44419,chr12_69746848_69791267
Map4k5,12,69803750,69893200,protein_coding,-1,89450,chr12_69803750_69893200
Atl1,12,69892614,69966417,protein_coding,1,73803,chr12_69892614_69966417
Sav1,12,69965012,69987002,protein_coding,-1,21990,chr12_69965012_69987002
Nin,12,70011435,70113717,protein_coding,-1,102282,chr12_70011435_70113717
Abhd12b,12,70154142,70183887,protein_coding,1,29745,chr12_70154142_70183887
Pygl,12,70190811,70231488,protein_coding,-1,40677,chr12_70190811_70231488
F730035M05Rik,12,70227841,70234165,lincRNA,1,6324,chr12_70227841_70234165
Trim9,12,70244533,70347614,protein_coding,-1,103081,chr12_70244533_70347614
Gm48747,12,70251165,70275597,antisense,1,24432,chr12_70251165_70275597
Tmx1,12,70453095,70468040,protein_coding,1,14945,chr12_70453095_70468040
Gm48847,12,70478615,70493247,lincRNA,1,14632,chr12_70478615_70493247
Gm32219,12,70522598,70544587,lincRNA,1,21989,chr12_70522598_70544587
Gm24474,12,70650182,70693780,lincRNA,1,43598,chr12_70650182_70693780
Gm32369,12,70675847,70681850,lincRNA,-1,6003,chr12_70675847_70681850
Gm40437,12,70729174,70825345,lincRNA,-1,96171,chr12_70729174_70825345
Frmd6,12,70825514,70902234,protein_coding,1,76720,chr12_70825514_70902234
Gm46355,12,70909474,70912151,lincRNA,-1,2677,chr12_70909474_70912151
Gm10457,12,70912259,70914485,lincRNA,1,2226,chr12_70912259_70914485
Actr10,12,70937857,70964718,protein_coding,1,26861,chr12_70937857_70964718
Psma3,12,70974621,70996347,protein_coding,1,21726,chr12_70974621_70996347
Arid4a,12,71015990,71098592,protein_coding,1,82602,chr12_71015990_71098592
Tomm20l,12,71111428,71123221,protein_coding,1,11793,chr12_71111428_71123221
Timm9,12,71123173,71136684,protein_coding,-1,13511,chr12_71123173_71136684
2700049A03Rik,12,71136848,71243303,protein_coding,1,106455,chr12_71136848_71243303
Dact1,12,71309884,71320107,protein_coding,1,10223,chr12_71309884_71320107
Gm33016,12,71337628,71342803,lincRNA,1,5175,chr12_71337628_71342803
Gm40438,12,71355441,71498711,lincRNA,1,143270,chr12_71355441_71498711
4930404H11Rik,12,71488285,71556133,lincRNA,1,67848,chr12_71488285_71556133
9630002D21Rik,12,71577748,71718696,lincRNA,1,140948,chr12_71577748_71718696
Daam1,12,71831078,71992333,protein_coding,1,161255,chr12_71831078_71992333
Gpr135,12,72067976,72071125,protein_coding,-1,3149,chr12_72067976_72071125
L3hypdh,12,72073428,72085439,protein_coding,-1,12011,chr12_72073428_72085439
Jkamp,12,72085589,72101461,protein_coding,1,15872,chr12_72085589_72101461
Ccdc175,12,72101300,72185029,protein_coding,-1,83729,chr12_72101300_72185029
Rtn1,12,72211752,72409054,protein_coding,-1,197302,chr12_72211752_72409054
Lrrc9,12,72441866,72530750,protein_coding,1,88884,chr12_72441866_72530750
Pcnx4,12,72536383,72580119,protein_coding,1,43736,chr12_72536383_72580119
Gm4756,12,72576002,72649661,protein_coding,-1,73659,chr12_72576002_72649661
Dhrs7,12,72650353,72664909,protein_coding,-1,14556,chr12_72650353_72664909
Ppm1a,12,72757455,72799819,protein_coding,1,42364,chr12_72757455_72799819
Gm33785,12,72817712,72821823,lincRNA,1,4111,chr12_72817712_72821823
4930447C04Rik,12,72881109,72940774,protein_coding,-1,59665,chr12_72881109_72940774
Gm26709,12,72945807,72965931,lincRNA,1,20124,chr12_72945807_72965931
Six1,12,73040015,73053887,protein_coding,-1,13872,chr12_73040015_73053887
Six4,12,73099609,73113456,protein_coding,-1,13847,chr12_73099609_73113456
Mnat1,12,73123717,73273988,protein_coding,1,150271,chr12_73123717_73273988
Trmt5,12,73280011,73286710,protein_coding,-1,6699,chr12_73280011_73286710
Slc38a6,12,73286779,73354049,protein_coding,1,67270,chr12_73286779_73354049
Gm48653,12,73355081,73361997,lincRNA,1,6916,chr12_73355081_73361997
D830013O20Rik,12,73364075,73409557,lincRNA,-1,45482,chr12_73364075_73409557
Gm48656,12,73452142,73456907,lincRNA,-1,4765,chr12_73452142_73456907
Gm34016,12,73489915,73508670,lincRNA,-1,18755,chr12_73489915_73508670
2210039B01Rik,12,73548478,73551986,lincRNA,1,3508,chr12_73548478_73551986
Prkch,12,73584796,73778185,protein_coding,1,193389,chr12_73584796_73778185
Gm8075,12,73793483,73808411,lincRNA,1,14928,chr12_73793483_73808411
Gm15283,12,73843039,73949814,antisense,-1,106775,chr12_73843039_73949814
Hif1a,12,73901375,73947530,protein_coding,1,46155,chr12_73901375_73947530
Snapc1,12,73964481,73988966,protein_coding,1,24485,chr12_73964481_73988966
Syt16,12,73997661,74273267,protein_coding,1,275606,chr12_73997661_74273267
Gm29587,12,74222498,74235140,antisense,-1,12642,chr12_74222498_74235140
Dbpht2,12,74296668,74302008,lincRNA,1,5340,chr12_74296668_74302008
Gm34552,12,74314201,74317162,lincRNA,-1,2961,chr12_74314201_74317162
Gm39473,12,74825345,74827722,lincRNA,1,2377,chr12_74825345_74827722
4930442G10Rik,12,74842738,74849666,lincRNA,1,6928,chr12_74842738_74849666
Kcnh5,12,74897220,75177332,protein_coding,-1,280112,chr12_74897220_75177332
Rhoj,12,75308322,75401456,protein_coding,1,93134,chr12_75308322_75401456
Ppp2r5e,12,75450881,75596245,protein_coding,-1,145364,chr12_75450881_75596245
Gm47689,12,75579865,75581699,antisense,1,1834,chr12_75579865_75581699
Wdr89,12,75630596,75669537,protein_coding,-1,38941,chr12_75630596_75669537
Sgpp1,12,75714249,75735729,protein_coding,-1,21480,chr12_75714249_75735729
Syne2,12,75818134,76110926,protein_coding,1,292792,chr12_75818134_76110926
Esr2,12,76120419,76177259,protein_coding,-1,56840,chr12_76120419_76177259
Tex21,12,76198686,76246746,protein_coding,-1,48060,chr12_76198686_76246746
Mthfd1,12,76255298,76319803,protein_coding,1,64505,chr12_76255298_76319803
Gm34868,12,76287894,76306983,antisense,-1,19089,chr12_76287894_76306983
Akap5,12,76324891,76334153,protein_coding,1,9262,chr12_76324891_76334153
Zbtb25,12,76347782,76369602,protein_coding,-1,21820,chr12_76347782_76369602
Zbtb1,12,76370266,76396950,protein_coding,1,26684,chr12_76370266_76396950
4930426I24Rik,12,76402751,76403982,lincRNA,-1,1231,chr12_76402751_76403982
Hspa2,12,76404176,76406938,protein_coding,1,2762,chr12_76404176_76406938
Ppp1r36,12,76417538,76439492,protein_coding,1,21954,chr12_76417538_76439492
Gm10451,12,76444497,76451336,lincRNA,1,6839,chr12_76444497_76451336
Plekhg3,12,76530891,76580488,protein_coding,1,49597,chr12_76530891_76580488
Sptb,12,76580488,76710547,protein_coding,-1,130059,chr12_76580488_76710547
Churc1,12,76765538,76783180,protein_coding,1,17642,chr12_76765538_76783180
Fntb,12,76765589,76921412,protein_coding,1,155823,chr12_76765589_76921412
Gpx2,12,76792333,76795554,protein_coding,-1,3221,chr12_76792333_76795554
Rab15,12,76797960,76822908,protein_coding,-1,24948,chr12_76797960_76822908
Max,12,76937269,76962201,protein_coding,-1,24932,chr12_76937269_76962201
Gm35041,12,76972460,77022037,lincRNA,1,49577,chr12_76972460_77022037
Fut8,12,77238125,77476338,protein_coding,1,238213,chr12_77238125_77476338
Gm35240,12,77553347,77569709,lincRNA,1,16362,chr12_77553347_77569709
4930458K08Rik,12,77683061,77689491,lincRNA,1,6430,chr12_77683061_77689491
Gm6657,12,78194242,78209029,protein_coding,1,14787,chr12_78194242_78209029
Gphn,12,78226379,78684772,protein_coding,1,458393,chr12_78226379_78684772
Fam71d,12,78691535,78734516,protein_coding,1,42981,chr12_78691535_78734516
Mpp5,12,78748907,78840714,protein_coding,1,91807,chr12_78748907_78840714
Atp6v1d,12,78840725,78861638,protein_coding,-1,20913,chr12_78840725_78861638
Eif2s1,12,78861819,78887010,protein_coding,1,25191,chr12_78861819_78887010
Plek2,12,78888691,78906964,protein_coding,-1,18273,chr12_78888691_78906964
Tmem229b,12,78961795,79007627,protein_coding,-1,45832,chr12_78961795_79007627
Plekhh1,12,79029163,79081655,protein_coding,1,52492,chr12_79029163_79081655
Pigh,12,79080664,79089651,protein_coding,-1,8987,chr12_79080664_79089651
9230116L04Rik,12,79088705,79103939,lincRNA,-1,15234,chr12_79088705_79103939
Arg2,12,79130777,79156301,protein_coding,1,25524,chr12_79130777_79156301
Gm48780,12,79150936,79151932,antisense,-1,996,chr12_79150936_79151932
Vti1b,12,79156017,79172667,protein_coding,-1,16650,chr12_79156017_79172667
Rdh11,12,79174337,79192293,protein_coding,-1,17956,chr12_79174337_79192293
Rdh12,12,79208914,79222665,protein_coding,1,13751,chr12_79208914_79222665
Zfyve26,12,79232346,79296304,protein_coding,-1,63958,chr12_79232346_79296304
Rad51b,12,79297282,79814690,protein_coding,1,517408,chr12_79297282_79814690
9430078K24Rik,12,79917019,79936264,lincRNA,-1,19245,chr12_79917019_79936264
Gm36660,12,80018415,80081434,lincRNA,-1,63019,chr12_80018415_80081434
Gm47752,12,80091367,80101172,lincRNA,1,9805,chr12_80091367_80101172
Zfp36l1,12,80107754,80113013,protein_coding,-1,5259,chr12_80107754_80113013
1300014J16Rik,12,80115863,80117199,lincRNA,1,1336,chr12_80115863_80117199
Actn1,12,80167547,80260371,protein_coding,-1,92824,chr12_80167547_80260371
Gm47767,12,80209243,80211916,antisense,1,2673,chr12_80209243_80211916
Gm47766,12,80259443,80260557,antisense,1,1114,chr12_80259443_80260557
Dcaf5,12,80335848,80436601,protein_coding,-1,100753,chr12_80335848_80436601
Gm30025,12,80435209,80435936,antisense,1,727,chr12_80435209_80435936
Exd2,12,80463095,80500227,protein_coding,1,37132,chr12_80463095_80500227
2310002D06Rik,12,80507206,80517954,lincRNA,1,10748,chr12_80507206_80517954
Galnt16,12,80518277,80630972,protein_coding,1,112695,chr12_80518277_80630972
4933406B15Rik,12,80583011,80597140,antisense,-1,14129,chr12_80583011_80597140
Erh,12,80634022,80644341,protein_coding,-1,10319,chr12_80634022_80644341
Gm47879,12,80635992,80637371,antisense,1,1379,chr12_80635992_80637371
Slc39a9,12,80643883,80683342,protein_coding,1,39459,chr12_80643883_80683342
Plekhd1os,12,80686370,80692466,antisense,-1,6096,chr12_80686370_80692466
Plekhd1,12,80692591,80724214,protein_coding,1,31623,chr12_80692591_80724214
Ccdc177,12,80754043,80760687,protein_coding,-1,6644,chr12_80754043_80760687
Gm26796,12,80758406,80762793,antisense,1,4387,chr12_80758406_80762793
Susd6,12,80790510,80880835,protein_coding,1,90325,chr12_80790510_80880835
Srsf5,12,80945504,80950507,protein_coding,1,5003,chr12_80945504_80950507
Slc10a1,12,80953183,80968705,protein_coding,-1,15522,chr12_80953183_80968705
Smoc1,12,81026808,81186414,protein_coding,1,159606,chr12_81026808_81186414
Slc8a3,12,81197915,81333180,protein_coding,-1,135265,chr12_81197915_81333180
Gm3693,12,81228284,81243258,antisense,1,14974,chr12_81228284_81243258
Gm20498,12,81358860,81532905,protein_coding,-1,174045,chr12_81358860_81532905
Gm28370,12,81492199,81497015,antisense,1,4816,chr12_81492199_81497015
Synj2bp,12,81497941,81532911,protein_coding,-1,34970,chr12_81497941_81532911
Adam21,12,81558584,81568474,protein_coding,-1,9890,chr12_81558584_81568474
Med6,12,81573557,81595008,protein_coding,-1,21451,chr12_81573557_81595008
Gm16572,12,81587799,81589640,antisense,1,1841,chr12_81587799_81589640
Ttc9,12,81631249,81667557,protein_coding,1,36308,chr12_81631249_81667557
Map3k9,12,81721010,81781175,protein_coding,-1,60165,chr12_81721010_81781175
Gm47080,12,81827799,81853031,lincRNA,1,25232,chr12_81827799_81853031
Pcnx,12,81860023,82000924,protein_coding,1,140901,chr12_81860023_82000924
Gm48242,12,82168850,82169105,lincRNA,-1,255,chr12_82168850_82169105
Sipa1l1,12,82169320,82451786,protein_coding,1,282466,chr12_82169320_82451786
Rgs6,12,82588292,83162056,protein_coding,1,573764,chr12_82588292_83162056
1700085C21Rik,12,82932520,82939155,antisense,-1,6635,chr12_82932520_82939155
Gm29530,12,83063392,83098874,antisense,-1,35482,chr12_83063392_83098874
Dpf3,12,83213745,83487716,protein_coding,-1,273971,chr12_83213745_83487716
Dcaf4,12,83520466,83541920,protein_coding,1,21454,chr12_83520466_83541920
Zfyve1,12,83546558,83597222,protein_coding,-1,50664,chr12_83546558_83597222
Rbm25,12,83631236,83683123,protein_coding,1,51887,chr12_83631236_83683123
Gm29361,12,83631834,83633833,antisense,-1,1999,chr12_83631834_83633833
Psen1,12,83688152,83735199,protein_coding,1,47047,chr12_83688152_83735199
Gm47666,12,83730062,83731457,antisense,-1,1395,chr12_83730062_83731457
Papln,12,83763634,83792382,protein_coding,1,28748,chr12_83763634_83792382
Numb,12,83794034,83921934,protein_coding,-1,127900,chr12_83794034_83921934
Gm26571,12,83945209,83951355,antisense,-1,6146,chr12_83945209_83951355
Riox1,12,83950608,83952951,protein_coding,1,2343,chr12_83950608_83952951
Heatr4,12,83954499,83984852,protein_coding,-1,30353,chr12_83954499_83984852
Acot2,12,83987861,83993873,protein_coding,1,6012,chr12_83987861_83993873
Acot1,12,84009490,84018371,protein_coding,1,8881,chr12_84009490_84018371
Acot4,12,84038379,84048601,protein_coding,1,10222,chr12_84038379_84048601
Gm49366,12,84038935,84058613,protein_coding,1,19678,chr12_84038935_84058613
4732463B04Rik,12,84039469,84053807,antisense,-1,14338,chr12_84039469_84053807
Acot3,12,84052144,84060402,protein_coding,1,8258,chr12_84052144_84060402
Acot5,12,84069325,84076020,protein_coding,1,6695,chr12_84069325_84076020
Acot6,12,84100654,84111349,protein_coding,1,10695,chr12_84100654_84111349
Dnal1,12,84114366,84147498,protein_coding,1,33132,chr12_84114366_84147498
Pnma1,12,84146131,84148489,protein_coding,-1,2358,chr12_84146131_84148489
Elmsan1,12,84149176,84218881,protein_coding,-1,69705,chr12_84149176_84218881
Gm31513,12,84195969,84199580,antisense,1,3611,chr12_84195969_84199580
Ptgr2,12,84285232,84315832,protein_coding,1,30600,chr12_84285232_84315832
Zfp410,12,84316852,84343723,protein_coding,1,26871,chr12_84316852_84343723
Fam161b,12,84345309,84361833,protein_coding,-1,16524,chr12_84345309_84361833
Coq6,12,84361657,84373796,protein_coding,1,12139,chr12_84361657_84373796
Entpd5,12,84373857,84409029,protein_coding,-1,35172,chr12_84373857_84409029
Bbof1,12,84409071,84442887,protein_coding,1,33816,chr12_84409071_84442887
Aldh6a1,12,84430717,84451004,protein_coding,-1,20287,chr12_84430717_84451004
Lin52,12,84451422,84546145,protein_coding,1,94723,chr12_84451422_84546145
Vsx2,12,84569762,84595457,protein_coding,1,25695,chr12_84569762_84595457
Abcd4,12,84601464,84617413,protein_coding,-1,15949,chr12_84601464_84617413
Vrtn,12,84641019,84651455,protein_coding,1,10436,chr12_84641019_84651455
Syndig1l,12,84677277,84698831,protein_coding,-1,21554,chr12_84677277_84698831
Npc2,12,84754562,84773152,protein_coding,-1,18590,chr12_84754562_84773152
Isca2,12,84773251,84775088,protein_coding,1,1837,chr12_84773251_84775088
Ltbp2,12,84783212,84876532,protein_coding,-1,93320,chr12_84783212_84876532
D030025P21Rik,12,84875769,84879755,antisense,1,3986,chr12_84875769_84879755
Gm48709,12,84881824,84889276,lincRNA,1,7452,chr12_84881824_84889276
Gm17139,12,84918148,84919238,antisense,1,1090,chr12_84918148_84919238
Arel1,12,84918148,84970900,protein_coding,-1,52752,chr12_84918148_84970900
Fcf1,12,84970897,84983303,protein_coding,1,12406,chr12_84970897_84983303
Ylpm1,12,84996321,85070515,protein_coding,1,74194,chr12_84996321_85070515
Prox2os,12,85086374,85088228,antisense,1,1854,chr12_85086374_85088228
Prox2,12,85086385,85110759,protein_coding,-1,24374,chr12_85086385_85110759
Dlst,12,85110833,85134845,protein_coding,1,24012,chr12_85110833_85134845
Rps6kl1,12,85135249,85151264,protein_coding,-1,16015,chr12_85135249_85151264
Pgf,12,85166635,85177790,protein_coding,-1,11155,chr12_85166635_85177790
Eif2b2,12,85219481,85226628,protein_coding,1,7147,chr12_85219481_85226628
Mlh3,12,85234520,85270599,protein_coding,-1,36079,chr12_85234520_85270599
Acyp1,12,85272398,85288438,protein_coding,-1,16040,chr12_85272398_85288438
Zc2hc1c,12,85274286,85299358,protein_coding,1,25072,chr12_85274286_85299358
Nek9,12,85299514,85339362,protein_coding,-1,39848,chr12_85299514_85339362
Tmed10,12,85340614,85374847,protein_coding,-1,34233,chr12_85340614_85374847
Gm47819,12,85374117,85376632,antisense,1,2515,chr12_85374117_85376632
Gm40477,12,85429110,85436249,lincRNA,-1,7139,chr12_85429110_85436249
Fos,12,85473890,85477273,protein_coding,1,3383,chr12_85473890_85477273
Gm32296,12,85529598,85542280,lincRNA,1,12682,chr12_85529598_85542280
Jdp2,12,85599027,85639878,protein_coding,1,40851,chr12_85599027_85639878
Batf,12,85686669,85709087,protein_coding,1,22418,chr12_85686669_85709087
Flvcr2,12,85746539,85813585,protein_coding,1,67046,chr12_85746539_85813585
Erg28,12,85815448,85824550,protein_coding,-1,9102,chr12_85815448_85824550
Ttll5,12,85824659,86061893,protein_coding,1,237234,chr12_85824659_86061893
Gm26531,12,85962598,85979021,antisense,-1,16423,chr12_85962598_85979021
Tgfb3,12,86056745,86079041,protein_coding,-1,22296,chr12_86056745_86079041
Ift43,12,86082541,86162459,protein_coding,1,79918,chr12_86082541_86162459
Gm805,12,86169341,86195102,lincRNA,1,25761,chr12_86169341_86195102
Gpatch2l,12,86241858,86291784,protein_coding,1,49926,chr12_86241858_86291784
4732487G21Rik,12,86290761,86306006,lincRNA,-1,15245,chr12_86290761_86306006
Esrrb,12,86361117,86521628,protein_coding,1,160511,chr12_86361117_86521628
Vash1,12,86678700,86692091,protein_coding,1,13391,chr12_86678700_86692091
Angel1,12,86700502,86726460,protein_coding,-1,25958,chr12_86700502_86726460
Lrrc74a,12,86734369,86763797,protein_coding,1,29428,chr12_86734369_86763797
Irf2bpl,12,86880701,86884798,protein_coding,-1,4097,chr12_86880701_86884798
Cipc,12,86947043,86965362,protein_coding,1,18319,chr12_86947043_86965362
Zdhhc22,12,86980763,86990430,protein_coding,-1,9667,chr12_86980763_86990430
Tmem63c,12,87021340,87090043,protein_coding,1,68703,chr12_87021340_87090043
Ngb,12,87097531,87102539,protein_coding,-1,5008,chr12_87097531_87102539
Pomt2,12,87106861,87147968,protein_coding,-1,41107,chr12_87106861_87147968
Gstz1,12,87147165,87164723,protein_coding,1,17558,chr12_87147165_87164723
Gm6566,12,87149475,87155486,antisense,-1,6011,chr12_87149475_87155486
Tmed8,12,87166237,87200454,protein_coding,-1,34217,chr12_87166237_87200454
Samd15,12,87199723,87213541,protein_coding,1,13818,chr12_87199723_87213541
Noxred1,12,87221040,87238732,protein_coding,-1,17692,chr12_87221040_87238732
Vipas39,12,87238868,87266256,protein_coding,-1,27388,chr12_87238868_87266256
Ahsa1,12,87266479,87273998,protein_coding,1,7519,chr12_87266479_87273998
Ism2,12,87278638,87299705,protein_coding,-1,21067,chr12_87278638_87299705
Sptlc2,12,87305058,87388355,protein_coding,-1,83297,chr12_87305058_87388355
Alkbh1,12,87425840,87444017,protein_coding,-1,18177,chr12_87425840_87444017
Slirp,12,87443896,87452206,protein_coding,1,8310,chr12_87443896_87452206
Snw1,12,87449075,87472274,protein_coding,-1,23199,chr12_87449075_87472274
Gm16381,12,87644118,87644620,protein_coding,-1,502,chr12_87644118_87644620
Gm21319,12,87772425,87775755,protein_coding,-1,3330,chr12_87772425_87775755
BB287469,12,87816577,87820676,protein_coding,1,4099,chr12_87816577_87820676
Adck1,12,88360554,88461724,protein_coding,1,101170,chr12_88360554_88461724
3200001D21Rik,12,88365314,88377323,antisense,-1,12009,chr12_88365314_88377323
4930473H19Rik,12,88434113,88442254,antisense,-1,8141,chr12_88434113_88442254
Gm48664,12,88631356,88706819,lincRNA,1,75463,chr12_88631356_88706819
Nrxn3,12,88722876,90334935,protein_coding,1,1612059,chr12_88722876_90334935
Gm2270,12,90364252,90367678,lincRNA,1,3426,chr12_90364252_90367678
Gm47684,12,90393903,90398662,lincRNA,-1,4759,chr12_90393903_90398662
Gm40538,12,90399667,90408824,lincRNA,-1,9157,chr12_90399667_90408824
Dio2,12,90724552,90738438,protein_coding,-1,13886,chr12_90724552_90738438
4930544I03Rik,12,90753208,90969798,lincRNA,-1,216590,chr12_90753208_90969798
Cep128,12,90998492,91384409,protein_coding,-1,385917,chr12_90998492_91384409
5430427M07Rik,12,91045848,91079907,antisense,1,34059,chr12_91045848_91079907
Tshr,12,91384563,91549808,protein_coding,1,165245,chr12_91384563_91549808
Gtf2a1,12,91555262,91590487,protein_coding,-1,35225,chr12_91555262_91590487
Ston2,12,91633009,91788387,protein_coding,-1,155378,chr12_91633009_91788387
Gm16876,12,91684665,91693590,antisense,1,8925,chr12_91684665_91693590
Sel1l,12,91806043,91849157,protein_coding,-1,43114,chr12_91806043_91849157
Gm40548,12,92010419,92012411,lincRNA,1,1992,chr12_92010419_92012411
4930559C10Rik,12,93416458,93444823,lincRNA,-1,28365,chr12_93416458_93444823
Flrt2,12,95692226,95785215,protein_coding,1,92989,chr12_95692226_95785215
Gm47397,12,97098706,97102464,lincRNA,-1,3758,chr12_97098706_97102464
Gm40552,12,97312849,97315853,lincRNA,1,3004,chr12_97312849_97315853
Gm35274,12,97735441,97740244,lincRNA,-1,4803,chr12_97735441_97740244
Gm35326,12,97869779,97872520,lincRNA,-1,2741,chr12_97869779_97872520
Gm47415,12,98076355,98108567,lincRNA,-1,32212,chr12_98076355_98108567
Galc,12,98202294,98259459,protein_coding,-1,57165,chr12_98202294_98259459
Gm47439,12,98259060,98260307,antisense,1,1247,chr12_98259060_98260307
Gpr65,12,98268635,98276644,protein_coding,1,8009,chr12_98268635_98276644
Gm47566,12,98274732,98279661,antisense,-1,4929,chr12_98274732_98279661
Kcnk10,12,98429437,98578310,protein_coding,-1,148873,chr12_98429437_98578310
Gm40893,12,98523844,98526583,antisense,1,2739,chr12_98523844_98526583
Spata7,12,98628157,98669815,protein_coding,1,41658,chr12_98628157_98669815
Ptpn21,12,98676741,98737405,protein_coding,-1,60664,chr12_98676741_98737405
Zc3h14,12,98746964,98787753,protein_coding,1,40789,chr12_98746964_98787753
Eml5,12,98786805,98901484,protein_coding,-1,114679,chr12_98786805_98901484
Ttc8,12,98920574,98983238,protein_coding,1,62664,chr12_98920574_98983238
Gm47109,12,98991340,98993009,lincRNA,-1,1669,chr12_98991340_98993009
Gm47116,12,99033500,99063458,lincRNA,-1,29958,chr12_99033500_99063458
4930474N09Rik,12,99161277,99162808,lincRNA,-1,1531,chr12_99161277_99162808
Foxn3,12,99190078,99563582,protein_coding,-1,373504,chr12_99190078_99563582
3300002A11Rik,12,99341154,99361827,antisense,1,20673,chr12_99341154_99361827
Gm47177,12,99567882,99569668,lincRNA,-1,1786,chr12_99567882_99569668
1700064M15Rik,12,99626053,99627974,lincRNA,-1,1921,chr12_99626053_99627974
Gm19951,12,99643093,99647221,lincRNA,1,4128,chr12_99643093_99647221
Efcab11,12,99693045,99884439,protein_coding,-1,191394,chr12_99693045_99884439
Gm47207,12,99821678,99850951,antisense,1,29273,chr12_99821678_99850951
Tdp1,12,99884517,99955219,protein_coding,1,70702,chr12_99884517_99955219
Kcnk13,12,99964499,100062682,protein_coding,1,98183,chr12_99964499_100062682
4930477G07Rik,12,100076908,100097218,lincRNA,-1,20310,chr12_100076908_100097218
Psmc1,12,100110154,100123405,protein_coding,1,13251,chr12_100110154_100123405
Nrde2,12,100125452,100159653,protein_coding,-1,34201,chr12_100125452_100159653
Calm1,12,100199435,100209814,protein_coding,1,10379,chr12_100199435_100209814
Gm40557,12,100237754,100242444,lincRNA,-1,4690,chr12_100237754_100242444
Ttc7b,12,100300770,100520826,protein_coding,-1,220056,chr12_100300770_100520826
Gm48383,12,100465039,100488390,antisense,1,23351,chr12_100465039_100488390
Rps6ka5,12,100548439,100726983,protein_coding,-1,178544,chr12_100548439_100726983
Dglucy,12,100779057,100896981,protein_coding,1,117924,chr12_100779057_100896981
Gpr68,12,100876682,100908198,protein_coding,-1,31516,chr12_100876682_100908198
Ccdc88c,12,100911523,101029056,protein_coding,-1,117533,chr12_100911523_101029056
A630072L19Rik,12,100941742,100949875,antisense,1,8133,chr12_100941742_100949875
Gm36756,12,100986623,101014822,antisense,1,28199,chr12_100986623_101014822
Gm47639,12,101039092,101042808,antisense,1,3716,chr12_101039092_101042808
Ppp4r3a,12,101039409,101083702,protein_coding,-1,44293,chr12_101039409_101083702
D130020L05Rik,12,101082451,101088927,antisense,1,6476,chr12_101082451_101088927
Catsperb,12,101404653,101626009,protein_coding,1,221356,chr12_101404653_101626009
Tc2n,12,101645443,101718523,protein_coding,-1,73080,chr12_101645443_101718523
Fbln5,12,101746565,101819055,protein_coding,-1,72490,chr12_101746565_101819055
Trip11,12,101834043,101913267,protein_coding,-1,79224,chr12_101834043_101913267
Atxn3,12,101918901,101958246,protein_coding,-1,39345,chr12_101918901_101958246
Cpsf2,12,101975988,102006424,protein_coding,1,30436,chr12_101975988_102006424
Gm16339,12,102127806,102129906,antisense,-1,2100,chr12_102127806_102129906
Slc24a4,12,102128733,102267091,protein_coding,1,138358,chr12_102128733_102267091
Rin3,12,102283048,102390855,protein_coding,1,107807,chr12_102283048_102390855
Lgmn,12,102394084,102439813,protein_coding,-1,45729,chr12_102394084_102439813
Gm30198,12,102447328,102467609,lincRNA,1,20281,chr12_102447328_102467609
Golga5,12,102469135,102497907,protein_coding,1,28772,chr12_102469135_102497907
Chga,12,102554969,102565028,protein_coding,1,10059,chr12_102554969_102565028
Itpk1,12,102568582,102704930,protein_coding,-1,136348,chr12_102568582_102704930
Gm20069,12,102612680,102618516,antisense,1,5836,chr12_102612680_102618516
Gm28051,12,102719975,102757765,protein_coding,-1,37790,chr12_102719975_102757765
Gm20604,12,102741732,102758672,protein_coding,-1,16940,chr12_102741732_102758672
Tmem251,12,102743762,102747561,protein_coding,1,3799,chr12_102743762_102747561
Ubr7,12,102757967,102777707,protein_coding,1,19740,chr12_102757967_102777707
Btbd7,12,102780797,102878471,protein_coding,-1,97674,chr12_102780797_102878471
Gm47167,12,102838108,102874891,antisense,1,36783,chr12_102838108_102874891
Unc79,12,102948859,103184065,protein_coding,1,235206,chr12_102948859_103184065
Prima1,12,103196908,103242150,protein_coding,-1,45242,chr12_103196908_103242150
Fam181a,12,103310975,103317065,protein_coding,1,6090,chr12_103310975_103317065
Gm29508,12,103312367,103314769,antisense,-1,2402,chr12_103312367_103314769
Asb2,12,103321142,103356001,protein_coding,-1,34859,chr12_103321142_103356001
Gm15523,12,103336906,103348057,antisense,1,11151,chr12_103336906_103348057
Otub2,12,103388682,103406350,protein_coding,1,17668,chr12_103388682_103406350
Ddx24,12,103407982,103425830,protein_coding,-1,17848,chr12_103407982_103425830
Ifi27,12,103434211,103440239,protein_coding,1,6028,chr12_103434211_103440239
Ifi27l2a,12,103442167,103443680,protein_coding,-1,1513,chr12_103442167_103443680
Ifi27l2b,12,103450898,103457223,protein_coding,-1,6325,chr12_103450898_103457223
Ppp4r4,12,103532283,103613831,protein_coding,1,81548,chr12_103532283_103613831
Serpina10,12,103614786,103631444,protein_coding,-1,16658,chr12_103614786_103631444
Serpina1b,12,103728156,103830373,protein_coding,-1,102217,chr12_103728156_103830373
Serpina1a,12,103853589,103863562,protein_coding,-1,9973,chr12_103853589_103863562
Serpina1c,12,103894926,103904887,protein_coding,-1,9961,chr12_103894926_103904887
Serpina1e,12,103946931,103958975,protein_coding,-1,12044,chr12_103946931_103958975
Serpina11,12,103980243,103989957,protein_coding,-1,9714,chr12_103980243_103989957
Serpina9,12,103994743,104013755,protein_coding,-1,19012,chr12_103994743_104013755
Serpina12,12,104028769,104044443,protein_coding,-1,15674,chr12_104028769_104044443
Serpina3c,12,104146382,104153870,protein_coding,-1,7488,chr12_104146382_104153870
Serpina3i,12,104263122,104269372,protein_coding,1,6250,chr12_104263122_104269372
Serpina3m,12,104338486,104394257,protein_coding,1,55771,chr12_104338486_104394257
Serpina3n,12,104406729,104414329,protein_coding,1,7600,chr12_104406729_104414329
Dicer1,12,104687742,104751952,protein_coding,-1,64210,chr12_104687742_104751952
Clmn,12,104763117,104865076,protein_coding,-1,101959,chr12_104763117_104865076
4930408O17Rik,12,104857371,104871535,lincRNA,1,14164,chr12_104857371_104871535
Gm28875,12,104925501,104926689,lincRNA,-1,1188,chr12_104925501_104926689
Syne3,12,104929933,105009809,protein_coding,-1,79876,chr12_104929933_105009809
Gm47648,12,105021359,105029936,lincRNA,1,8577,chr12_105021359_105029936
Snhg10,12,105030617,105032279,lincRNA,-1,1662,chr12_105030617_105032279
Glrx5,12,105032688,105042906,protein_coding,1,10218,chr12_105032688_105042906
Tcl1b2,12,105146014,105155225,protein_coding,1,9211,chr12_105146014_105155225
Tcl1b4,12,105201957,105206993,protein_coding,1,5036,chr12_105201957_105206993
Tcl1,12,105216750,105222793,protein_coding,-1,6043,chr12_105216750_105222793
Tunar,12,105333870,105383932,protein_coding,1,50062,chr12_105333870_105383932
Gm2721,12,105394860,105404618,lincRNA,-1,9758,chr12_105394860_105404618
Gm46376,12,105404019,105412005,lincRNA,1,7986,chr12_105404019_105412005
D430019H16Rik,12,105453856,105493095,protein_coding,1,39239,chr12_105453856_105493095
Gm47796,12,105561263,105562556,lincRNA,1,1293,chr12_105561263_105562556
Bdkrb2,12,105563226,105595237,protein_coding,1,32011,chr12_105563226_105595237
Bdkrb1,12,105603085,105605428,protein_coding,1,2343,chr12_105603085_105605428
Atg2b,12,105616136,105685211,protein_coding,-1,69075,chr12_105616136_105685211
Gskip,12,105684829,105703023,protein_coding,1,18194,chr12_105684829_105703023
Ak7,12,105705976,105782447,protein_coding,1,76471,chr12_105705976_105782447
Papola,12,105784694,105838944,protein_coding,1,54250,chr12_105784694_105838944
Gm48807,12,105864262,105874745,lincRNA,1,10483,chr12_105864262_105874745
Gm19554,12,105899841,105902150,lincRNA,1,2309,chr12_105899841_105902150
Vrk1,12,106010228,106077426,protein_coding,1,67198,chr12_106010228_106077426
Gm32635,12,106094823,106098971,lincRNA,-1,4148,chr12_106094823_106098971
Gm47646,12,106131978,106145400,lincRNA,-1,13422,chr12_106131978_106145400
Gm17032,12,106327368,106330821,lincRNA,1,3453,chr12_106327368_106330821
1700121N20Rik,12,106442653,106447666,lincRNA,-1,5013,chr12_106442653_106447666
Gm17033,12,106558750,106574924,lincRNA,1,16174,chr12_106558750_106574924
4933406K04Rik,12,106685607,106716362,lincRNA,-1,30755,chr12_106685607_106716362
1700013N06Rik,12,106837982,106878841,lincRNA,1,40859,chr12_106837982_106878841
Gm16087,12,106953812,106955928,lincRNA,-1,2116,chr12_106953812_106955928
Gm16086,12,107079360,107099673,lincRNA,-1,20313,chr12_107079360_107099673
Gm16084,12,107147164,107160207,lincRNA,-1,13043,chr12_107147164_107160207
Gm3234,12,107463269,107488583,lincRNA,-1,25314,chr12_107463269_107488583
4930465M20Rik,12,107723740,107735496,lincRNA,-1,11756,chr12_107723740_107735496
Gm15208,12,107744136,107784041,lincRNA,-1,39905,chr12_107744136_107784041
Bcl11b,12,107910403,108003602,protein_coding,-1,93199,chr12_107910403_108003602
Setd3,12,108106431,108179314,protein_coding,-1,72883,chr12_108106431_108179314
Ccnk,12,108179579,108203359,protein_coding,1,23780,chr12_108179579_108203359
Ccdc85c,12,108203602,108275425,protein_coding,-1,71823,chr12_108203602_108275425
Hhipl1,12,108306270,108330869,protein_coding,1,24599,chr12_108306270_108330869
4930478K11Rik,12,108313779,108328030,antisense,-1,14251,chr12_108313779_108328030
Cyp46a1,12,108334381,108362234,protein_coding,1,27853,chr12_108334381_108362234
Eml1,12,108370957,108539617,protein_coding,1,168660,chr12_108370957_108539617
Gm16596,12,108537243,108555618,antisense,-1,18375,chr12_108537243_108555618
Evl,12,108554720,108688516,protein_coding,1,133796,chr12_108554720_108688516
Degs2,12,108678711,108702315,protein_coding,-1,23604,chr12_108678711_108702315
Gm33467,12,108695486,108696446,antisense,1,960,chr12_108695486_108696446
Gm33682,12,108762032,108762970,lincRNA,-1,938,chr12_108762032_108762970
Yy1,12,108792973,108820148,protein_coding,1,27175,chr12_108792973_108820148
Slc25a29,12,108825873,108835883,protein_coding,-1,10010,chr12_108825873_108835883
Slc25a47,12,108836046,108856815,protein_coding,1,20769,chr12_108836046_108856815
Wars,12,108860030,108894174,protein_coding,-1,34144,chr12_108860030_108894174
Wdr25,12,108893631,109028452,protein_coding,1,134821,chr12_108893631_109028452
Begain,12,109032187,109068217,protein_coding,-1,36030,chr12_109032187_109068217
Dlk1,12,109452823,109463336,protein_coding,1,10513,chr12_109452823_109463336
Gm34081,12,109493529,109516740,lincRNA;lncRNA,-1,23211,chr12_109493529_109516740
Meg3,12,109541001,109571726,lincRNA,1,30725,chr12_109541001_109571726
Rtl1,12,109589193,109600838,protein_coding,-1,11645,chr12_109589193_109600838
B830012L14Rik,12,109676277,109715063,lincRNA;lncRNA,1,38786,chr12_109676277_109715063
Mirg,12,109729764,109749460,lincRNA,1,19696,chr12_109729764_109749460
Gm34667,12,109990882,110023873,lincRNA,-1,32991,chr12_109990882_110023873
Gm34719,12,110046686,110086423,lincRNA,-1,39737,chr12_110046686_110086423
3110009F21Rik,12,110151654,110158077,lincRNA,-1,6423,chr12_110151654_110158077
Gm40576,12,110225515,110236362,lincRNA,-1,10847,chr12_110225515_110236362
Dio3,12,110279068,110281097,protein_coding,1,2029,chr12_110279068_110281097
Ppp2r5c,12,110447120,110583062,protein_coding,1,135942,chr12_110447120_110583062
Gm35558,12,110596608,110597359,lincRNA,-1,751,chr12_110596608_110597359
Dync1h1,12,110601452,110666945,protein_coding,1,65493,chr12_110601452_110666945
Gm17111,12,110664892,110665408,antisense,-1,516,chr12_110664892_110665408
1700001K19Rik,12,110667688,110682619,protein_coding,-1,14931,chr12_110667688_110682619
Hsp90aa1,12,110690605,110702728,protein_coding,-1,12123,chr12_110690605_110702728
Wdr20,12,110737944,110804238,protein_coding,1,66294,chr12_110737944_110804238
Mok,12,110807798,110840939,protein_coding,-1,33141,chr12_110807798_110840939
Gm26912,12,110842276,110845216,lincRNA,-1,2940,chr12_110842276_110845216
Zfp839,12,110850253,110869996,protein_coding,1,19743,chr12_110850253_110869996
Cinp,12,110872610,110889145,protein_coding,-1,16535,chr12_110872610_110889145
Tecpr2,12,110889264,110972394,protein_coding,1,83130,chr12_110889264_110972394
Ankrd9,12,110975353,110979040,protein_coding,-1,3687,chr12_110975353_110979040
6030440G07Rik,12,110994398,111013869,lincRNA,1,19471,chr12_110994398_111013869
Rcor1,12,111039351,111115901,protein_coding,1,76550,chr12_111039351_111115901
4930595D18Rik,12,111159850,111184491,protein_coding,-1,24641,chr12_111159850_111184491
Traf3,12,111166370,111267153,protein_coding,1,100783,chr12_111166370_111267153
Amn,12,111271095,111276426,protein_coding,1,5331,chr12_111271095_111276426
A230087F16Rik,12,111284762,111293988,antisense,1,9226,chr12_111284762_111293988
Cdc42bpb,12,111292976,111377718,protein_coding,-1,84742,chr12_111292976_111377718
Lbhd2,12,111406809,111412090,protein_coding,1,5281,chr12_111406809_111412090
Exoc3l4,12,111417017,111431678,protein_coding,1,14661,chr12_111417017_111431678
Gm10425,12,111426874,111430946,antisense,-1,4072,chr12_111426874_111430946
Tnfaip2,12,111442469,111455018,protein_coding,1,12549,chr12_111442469_111455018
Gm40578,12,111450405,111500840,antisense,-1,50435,chr12_111450405_111500840
Eif5,12,111538016,111546752,protein_coding,1,8736,chr12_111538016_111546752
Mark3,12,111574523,111656221,protein_coding,1,81698,chr12_111574523_111656221
Ckb,12,111669361,111672338,protein_coding,-1,2977,chr12_111669361_111672338
Trmt61a,12,111678105,111683902,protein_coding,1,5797,chr12_111678105_111683902
Gm36635,12,111703082,111705550,lincRNA,1,2468,chr12_111703082_111705550
Bag5,12,111709488,111713257,protein_coding,-1,3769,chr12_111709488_111713257
Apopt1,12,111713261,111755053,protein_coding,1,41792,chr12_111713261_111755053
Gm15996,12,111730094,111731831,antisense,-1,1737,chr12_111730094_111731831
Klc1,12,111758849,111807844,protein_coding,1,48995,chr12_111758849_111807844
Xrcc3,12,111803192,111813873,protein_coding,-1,10681,chr12_111803192_111813873
Zfyve21,12,111814170,111832192,protein_coding,1,18022,chr12_111814170_111832192
Ppp1r13b,12,111828457,111908110,protein_coding,-1,79653,chr12_111828457_111908110
5033406O09Rik,12,111941991,111944484,lincRNA,-1,2493,chr12_111941991_111944484
Tdrd9,12,111971559,112068854,protein_coding,1,97295,chr12_111971559_112068854
Rd3l,12,111979111,111981317,protein_coding,-1,2206,chr12_111979111_111981317
Aspg,12,112106679,112127559,protein_coding,1,20880,chr12_112106679_112127559
Kif26a,12,112146208,112181747,protein_coding,1,35539,chr12_112146208_112181747
E330035G20Rik,12,112391526,112405812,lincRNA,-1,14286,chr12_112391526_112405812
B020018J22Rik,12,112428284,112435338,lincRNA,-1,7054,chr12_112428284_112435338
A530016L24Rik,12,112489448,112499927,protein_coding,1,10479,chr12_112489448_112499927
Tmem179,12,112500189,112516747,protein_coding,-1,16558,chr12_112500189_112516747
Inf2,12,112588784,112615557,protein_coding,1,26773,chr12_112588784_112615557
Adssl1,12,112620045,112641360,protein_coding,1,21315,chr12_112620045_112641360
Siva1,12,112644679,112649149,protein_coding,1,4470,chr12_112644679_112649149
Akt1,12,112653821,112674884,protein_coding,-1,21063,chr12_112653821_112674884
Zbtb42,12,112678828,112682747,protein_coding,1,3919,chr12_112678828_112682747
Cep170b,12,112720455,112746592,protein_coding,1,26137,chr12_112720455_112746592
Pld4,12,112760655,112768990,protein_coding,1,8335,chr12_112760655_112768990
Ahnak2,12,112772194,112802657,protein_coding,-1,30463,chr12_112772194_112802657
Cdca4,12,112820229,112829423,protein_coding,-1,9194,chr12_112820229_112829423
Gpr132,12,112850873,112868228,protein_coding,-1,17355,chr12_112850873_112868228
Jag2,12,112907819,112929776,protein_coding,-1,21957,chr12_112907819_112929776
Nudt14,12,112934291,112942124,protein_coding,-1,7833,chr12_112934291_112942124
Gm26583,12,112946363,112950512,lincRNA,-1,4149,chr12_112946363_112950512
Brf1,12,112960085,113000704,protein_coding,-1,40619,chr12_112960085_113000704
Btbd6,12,112976482,112978945,protein_coding,1,2463,chr12_112976482_112978945
9230104M06Rik,12,112999964,113001926,antisense,1,1962,chr12_112999964_113001926
Pacs2,12,113014508,113074401,protein_coding,1,59893,chr12_113014508_113074401
Tex22,12,113074502,113088917,protein_coding,1,14415,chr12_113074502_113088917
Mta1,12,113098278,113137206,protein_coding,1,38928,chr12_113098278_113137206
Crip2,12,113140236,113145506,protein_coding,1,5270,chr12_113140236_113145506
Crip1,12,113146316,113153879,protein_coding,1,7563,chr12_113146316_113153879
Tedc1,12,113156421,113166048,protein_coding,1,9627,chr12_113156421_113166048
Tmem121,12,113185930,113189523,protein_coding,1,3593,chr12_113185930_113189523
Ighe,12,113269260,113273248,IG_C_gene,-1,3988,chr12_113269260_113273248
Ighg2c,12,113285325,113288932,IG_C_gene,-1,3607,chr12_113285325_113288932
Ighg2b,12,113302965,113307933,IG_C_gene,-1,4968,chr12_113302965_113307933
Ighd,12,113406604,113416324,IG_C_gene,-1,9720,chr12_113406604_113416324
Ighm,12,113418558,113422730,IG_C_gene,-1,4172,chr12_113418558_113422730
Gm37976,12,113718318,113719231,IG_V_pseudogene,-1,913,chr12_113718318_113719231
Ighv7-1,12,113896408,113896946,IG_V_gene,-1,538,chr12_113896408_113896946
Gm30948,12,115262684,115287908,lincRNA,1,25224,chr12_115262684_115287908
Gm19331,12,115386846,115397688,lincRNA,1,10842,chr12_115386846_115397688
Zfp386,12,116047724,116063360,protein_coding,1,15636,chr12_116047724_116063360
Vipr2,12,116077726,116146261,protein_coding,1,68535,chr12_116077726_116146261
Gm20658,12,116102769,116138648,antisense,-1,35879,chr12_116102769_116138648
Wdr60,12,116206262,116263022,protein_coding,-1,56760,chr12_116206262_116263022
Gm11027,12,116275386,116275612,protein_coding,1,226,chr12_116275386_116275612
Gm48079,12,116279682,116280231,lincRNA,-1,549,chr12_116279682_116280231
Esyt2,12,116281196,116391050,protein_coding,1,109854,chr12_116281196_116391050
Ncapg2,12,116405402,116463731,protein_coding,1,58329,chr12_116405402_116463731
Ptprn2,12,116485720,117276849,protein_coding,1,791129,chr12_116485720_117276849
Gm5441,12,117234521,117337022,antisense,-1,102501,chr12_117234521_117337022
Rapgef5,12,117516479,117759737,protein_coding,1,243258,chr12_117516479_117759737
Cdca7l,12,117804289,117878706,protein_coding,1,74417,chr12_117804289_117878706
Dnah11,12,117877982,118199043,protein_coding,-1,321061,chr12_117877982_118199043
Sp4,12,118234933,118301440,protein_coding,-1,66507,chr12_118234933_118301440
D230030E09Rik,12,118518297,118530193,lincRNA,-1,11896,chr12_118518297_118530193
Sp8,12,118846329,118852576,protein_coding,1,6247,chr12_118846329_118852576
Abcb5,12,118867824,118966421,protein_coding,-1,98597,chr12_118867824_118966421
Itgb8,12,119158022,119238802,protein_coding,-1,80780,chr12_119158022_119238802
Macc1,12,119314270,119469987,protein_coding,1,155717,chr12_119314270_119469987
Tmem196,12,119945822,120021246,protein_coding,1,75424,chr12_119945822_120021246
Gm49231,15,3128564,3190446,lincRNA;lncRNA,1,61882,chr15_3128564_3190446
Selenop,15,3268547,3280508,protein_coding,1,11961,chr15_3268547_3280508
Ccdc152,15,3280070,3303526,protein_coding,-1,23456,chr15_3280070_3303526
Ghr,15,3317760,3583492,protein_coding,-1,265732,chr15_3317760_3583492
Fbxo4,15,3965445,3979573,protein_coding,-1,14128,chr15_3965445_3979573
AW549877,15,3982035,3995744,protein_coding,-1,13709,chr15_3982035_3995744
Gm2093,15,3996039,4015858,lincRNA,1,19819,chr15_3996039_4015858
Oxct1,15,4026383,4155344,protein_coding,1,128961,chr15_4026383_4155344
Gm15632,15,4069226,4072032,antisense,-1,2806,chr15_4069226_4072032
Plcxd3,15,4375491,4575553,protein_coding,1,200062,chr15_4375491_4575553
C6,15,4727175,4814967,protein_coding,1,87792,chr15_4727175_4814967
Mroh2b,15,4898737,4962205,protein_coding,1,63468,chr15_4898737_4962205
C7,15,4988762,5063740,protein_coding,-1,74978,chr15_4988762_5063740
Card6,15,5095981,5108539,protein_coding,-1,12558,chr15_5095981_5108539
Rpl37,15,5116645,5119140,protein_coding,1,2495,chr15_5116645_5119140
Prkaa1,15,5143861,5181899,protein_coding,1,38038,chr15_5143861_5181899
Gm15938,15,5175085,5185723,antisense,-1,10638,chr15_5175085_5185723
Ttc33,15,5185525,5218336,protein_coding,1,32811,chr15_5185525_5218336
Ptger4,15,5206661,5244187,protein_coding,-1,37526,chr15_5206661_5244187
Dab2,15,6299788,6440712,protein_coding,1,140924,chr15_6299788_6440712
Gm16311,15,6303244,6309913,antisense,-1,6669,chr15_6303244_6309913
C9,15,6445327,6498751,protein_coding,1,53424,chr15_6445327_6498751
Fyb,15,6522853,6663313,protein_coding,1,140460,chr15_6522853_6663313
Gm2245,15,6604341,6654303,antisense,-1,49962,chr15_6604341_6654303
Rictor,15,6708379,6800401,protein_coding,1,92022,chr15_6708379_6800401
Osmr,15,6813577,6874969,protein_coding,-1,61392,chr15_6813577_6874969
Lifr,15,7090614,7197489,protein_coding,1,106875,chr15_7090614_7197489
Egflam,15,7206120,7398395,protein_coding,-1,192275,chr15_7206120_7398395
Gm16029,15,7397897,7411381,antisense,1,13484,chr15_7397897_7411381
Gm49207,15,7760714,7760992,lincRNA,1,278,chr15_7760714_7760992
Gdnf,15,7810846,7837575,protein_coding,1,26729,chr15_7810846_7837575
Wdr70,15,7873055,8099209,protein_coding,-1,226154,chr15_7873055_8099209
Nup155,15,8109273,8161247,protein_coding,1,51974,chr15_8109273_8161247
Nipbl,15,8290617,8444463,protein_coding,-1,153846,chr15_8290617_8444463
Gm49247,15,8480871,8481945,lincRNA,-1,1074,chr15_8480871_8481945
Gm31282,15,8482119,8500343,lincRNA,1,18224,chr15_8482119_8500343
Gm49249,15,8512327,8532794,lincRNA,1,20467,chr15_8512327_8532794
Slc1a3,15,8634124,8710764,protein_coding,-1,76640,chr15_8634124_8710764
Ranbp3l,15,8967949,9067335,protein_coding,1,99386,chr15_8967949_9067335
Nadk2,15,9071260,9110891,protein_coding,1,39631,chr15_9071260_9110891
Skp2,15,9111985,9155425,protein_coding,-1,43440,chr15_9111985_9155425
Lmbrd2,15,9140550,9202483,protein_coding,1,61933,chr15_9140550_9202483
Ugt3a1,15,9276888,9315032,protein_coding,1,38144,chr15_9276888_9315032
Ugt3a2,15,9335550,9370955,protein_coding,1,35405,chr15_9335550_9370955
Capsl,15,9436028,9466038,protein_coding,1,30010,chr15_9436028_9466038
Il7r,15,9505788,9530176,protein_coding,-1,24388,chr15_9505788_9530176
Spef2,15,9578193,9748868,protein_coding,-1,170675,chr15_9578193_9748868
Prlr,15,10177238,10349180,protein_coding,1,171942,chr15_10177238_10349180
Gm21973,15,10325380,10373749,protein_coding,1,48369,chr15_10325380_10373749
Agxt2,15,10358532,10410153,protein_coding,1,51621,chr15_10358532_10410153
Dnajc21,15,10446756,10470516,protein_coding,-1,23760,chr15_10446756_10470516
Brix1,15,10474779,10485947,protein_coding,-1,11168,chr15_10474779_10485947
Rad1,15,10486018,10499063,protein_coding,1,13045,chr15_10486018_10499063
Ttc23l,15,10500102,10558668,protein_coding,-1,58566,chr15_10500102_10558668
Rai14,15,10568969,10714624,protein_coding,-1,145655,chr15_10568969_10714624
Gm10389,15,10600293,10611651,antisense,1,11358,chr15_10600293_10611651
Gm19276,15,10814792,10835214,lincRNA,1,20422,chr15_10814792_10835214
C1qtnf3,15,10952332,10980150,protein_coding,1,27818,chr15_10952332_10980150
Amacr,15,10981756,10996626,protein_coding,1,14870,chr15_10981756_10996626
Slc45a2,15,11000721,11029233,protein_coding,1,28512,chr15_11000721_11029233
Rxfp3,15,11033717,11037991,protein_coding,-1,4274,chr15_11033717_11037991
Adamts12,15,11064790,11349231,protein_coding,1,284441,chr15_11064790_11349231
Tars,15,11382301,11399665,protein_coding,-1,17364,chr15_11382301_11399665
Gm49106,15,11625097,11630746,lincRNA,-1,5649,chr15_11625097_11630746
Gm49107,15,11630729,11638325,lincRNA,1,7596,chr15_11630729_11638325
Npr3,15,11839896,11907287,protein_coding,-1,67391,chr15_11839896_11907287
1700047G03Rik,15,11964276,11970086,lincRNA,1,5810,chr15_11964276_11970086
Sub1,15,11981339,11996983,protein_coding,-1,15644,chr15_11981339_11996983
Gm34759,15,12068248,12085197,lincRNA,-1,16949,chr15_12068248_12085197
Zfr,15,12117831,12185683,protein_coding,1,67852,chr15_12117831_12185683
Gm49240,15,12194907,12196619,lincRNA,-1,1712,chr15_12194907_12196619
Mtmr12,15,12205028,12274496,protein_coding,1,69468,chr15_12205028_12274496
1810049J17Rik,15,12321438,12321899,protein_coding,-1,461,chr15_12321438_12321899
Golph3,15,12321450,12351591,protein_coding,1,30141,chr15_12321450_12351591
Pdzd2,15,12359711,12739924,protein_coding,-1,380213,chr15_12359711_12739924
6030458C11Rik,15,12808177,12824649,protein_coding,-1,16472,chr15_12808177_12824649
Drosha,15,12824815,12935291,protein_coding,1,110476,chr15_12824815_12935291
Cdh6,15,13028701,13173675,protein_coding,-1,144974,chr15_13028701_13173675
Gm49113,15,13754781,13761027,lincRNA,-1,6246,chr15_13754781_13761027
Gm49116,15,14459376,14480986,lincRNA,1,21610,chr15_14459376_14480986
4930557F08Rik,15,15779994,15823424,lincRNA,1,43430,chr15_15779994_15823424
Gm49126,15,16496911,16549904,lincRNA,1,52993,chr15_16496911_16549904
Cdh9,15,16728756,16857094,protein_coding,1,128338,chr15_16728756_16857094
Gm49127,15,16830234,16850964,antisense,-1,20730,chr15_16830234_16850964
Gm49128,15,17025339,17076939,lincRNA,-1,51600,chr15_17025339_17076939
Gm41277,15,18057826,18064111,lincRNA,-1,6285,chr15_18057826_18064111
C030047K22Rik,15,18697684,18818774,lincRNA,-1,121090,chr15_18697684_18818774
Cdh10,15,18818947,19014236,protein_coding,1,195289,chr15_18818947_19014236
Gm35496,15,19185373,19203329,lincRNA,1,17956,chr15_19185373_19203329
Gm49162,15,19302948,19395422,lincRNA,-1,92474,chr15_19302948_19395422
Gm49166,15,19678232,19691806,lincRNA,1,13574,chr15_19678232_19691806
Cdh12,15,20449265,21589533,protein_coding,1,1140268,chr15_20449265_21589533
Acot10,15,20665214,20666750,protein_coding,-1,1536,chr15_20665214_20666750
Cdh18,15,22549022,23474418,protein_coding,1,925396,chr15_22549022_23474418
Gm49191,15,23401464,23414457,antisense,-1,12993,chr15_23401464_23414457
Gm35769,15,24849672,24907208,lincRNA,-1,57536,chr15_24849672_24907208
Gm2824,15,24981620,25027358,lincRNA,-1,45738,chr15_24981620_25027358
Gm35996,15,25101020,25128404,lincRNA,-1,27384,chr15_25101020_25128404
9230109A22Rik,15,25137530,25238830,lincRNA,-1,101300,chr15_25137530_25238830
4930445E18Rik,15,25285802,25332659,lincRNA,-1,46857,chr15_25285802_25332659
Basp1,15,25363277,25413764,protein_coding,-1,50487,chr15_25363277_25413764
Gm5468,15,25414192,25414873,lincRNA,1,681,chr15_25414192_25414873
Gm48956,15,25414637,25445640,lincRNA,-1,31003,chr15_25414637_25445640
Gm36642,15,25528879,25593091,lincRNA,-1,64212,chr15_25528879_25593091
Myo10,15,25622525,25813673,protein_coding,1,191148,chr15_25622525_25813673
Retreg1,15,25843180,25973687,protein_coding,1,130507,chr15_25843180_25973687
Zfp622,15,25984366,25998481,protein_coding,1,14115,chr15_25984366_25998481
Gm41279,15,26054365,26062438,lincRNA,-1,8073,chr15_26054365_26062438
Fbxl7,15,26540459,26895580,protein_coding,-1,355121,chr15_26540459_26895580
Gm49267,15,26609503,26644048,antisense,1,34545,chr15_26609503_26644048
Gm36899,15,27459835,27463449,lincRNA,-1,3614,chr15_27459835_27463449
Ank,15,27466677,27594909,protein_coding,1,128232,chr15_27466677_27594909
Otulin,15,27542635,27630693,protein_coding,-1,88058,chr15_27542635_27630693
Trio,15,27730651,28025848,protein_coding,-1,295197,chr15_27730651_28025848
Gm31458,15,28053099,28118452,lincRNA,-1,65353,chr15_28053099_28118452
Dnah5,15,28203752,28472052,protein_coding,1,268300,chr15_28203752_28472052
Ctnnd2,15,30172593,31029341,protein_coding,1,856748,chr15_30172593_31029341
4930570B17Rik,15,30597094,30626621,antisense,-1,29527,chr15_30597094_30626621
9630009A06Rik,15,30961300,30962878,antisense,-1,1578,chr15_30961300_30962878
4930430F21Rik,15,31039128,31043331,lincRNA,1,4203,chr15_31039128_31043331
Dap,15,31224314,31274341,protein_coding,1,50027,chr15_31224314_31274341
Ankrd33b,15,31291478,31367726,protein_coding,-1,76248,chr15_31291478_31367726
Ropn1l,15,31441211,31453737,protein_coding,-1,12526,chr15_31441211_31453737
Cmbl,15,31565389,31590119,protein_coding,1,24730,chr15_31565389_31590119
Cct5,15,31590800,31601804,protein_coding,-1,11004,chr15_31590800_31601804
Snhg18,15,32240565,32244662,lincRNA,-1,4097,chr15_32240565_32244662
Sema5a,15,32244810,32696341,protein_coding,1,451531,chr15_32244810_32696341
4930465K09Rik,15,32619744,32623505,antisense,-1,3761,chr15_32619744_32623505
Gm41289,15,32757416,32773152,lincRNA,-1,15736,chr15_32757416_32773152
Gm32618,15,32778904,32796006,lincRNA,1,17102,chr15_32778904_32796006
Sdc2,15,32920723,33034935,protein_coding,1,114212,chr15_32920723_33034935
Gm32764,15,33046021,33073523,lincRNA,-1,27502,chr15_33046021_33073523
Cpq,15,33083129,33594552,protein_coding,1,511423,chr15_33083129_33594552
4930592A05Rik,15,33593881,33653436,antisense,-1,59555,chr15_33593881_33653436
Tspyl5,15,33683875,33687884,protein_coding,-1,4009,chr15_33683875_33687884
Gm41290,15,34021995,34037780,lincRNA,-1,15785,chr15_34021995_34037780
Mtdh,15,34082694,34145624,protein_coding,1,62930,chr15_34082694_34145624
Laptm4b,15,34238028,34284302,protein_coding,1,46274,chr15_34238028_34284302
Matn2,15,34306677,34436273,protein_coding,1,129596,chr15_34306677_34436273
9430069I07Rik,15,34349051,34357872,protein_coding,-1,8821,chr15_34349051_34357872
Rpl30,15,34440505,34443640,protein_coding,-1,3135,chr15_34440505_34443640
Erich5,15,34453305,34473892,protein_coding,1,20587,chr15_34453305_34473892
Rida,15,34484021,34495255,protein_coding,-1,11234,chr15_34484021_34495255
Pop1,15,34495304,34530648,protein_coding,1,35344,chr15_34495304_34530648
Nipal2,15,34572799,34679212,protein_coding,-1,106413,chr15_34572799_34679212
4930413F20Rik,15,34675073,34679204,antisense,1,4131,chr15_34675073_34679204
Kcns2,15,34837355,34843407,protein_coding,1,6052,chr15_34837355_34843407
Stk3,15,34875496,35178921,protein_coding,-1,303425,chr15_34875496_35178921
Gm33497,15,35200804,35273666,lincRNA,1,72862,chr15_35200804_35273666
BC048602,15,35307005,35328535,lincRNA,-1,21530,chr15_35307005_35328535
Gm48960,15,35368453,35373147,antisense,-1,4694,chr15_35368453_35373147
Vps13b,15,35371160,35931229,protein_coding,1,560069,chr15_35371160_35931229
Cox6c,15,35925886,35938246,protein_coding,-1,12360,chr15_35925886_35938246
Rgs22,15,36009479,36140400,protein_coding,-1,130921,chr15_36009479_36140400
Fbxo43,15,36150060,36164884,protein_coding,-1,14824,chr15_36150060_36164884
Polr2k,15,36174010,36177010,protein_coding,1,3000,chr15_36174010_36177010
Spag1,15,36178099,36235621,protein_coding,1,57522,chr15_36178099_36235621
Gm41293,15,36206374,36210705,antisense,-1,4331,chr15_36206374_36210705
Rnf19a,15,36239933,36283147,protein_coding,-1,43214,chr15_36239933_36283147
Gm34150,15,36375049,36376090,lincRNA,1,1041,chr15_36375049_36376090
Gm34093,15,36375343,36390172,lincRNA,-1,14829,chr15_36375343_36390172
Gm49224,15,36433319,36436691,lincRNA,-1,3372,chr15_36433319_36436691
Ankrd46,15,36477668,36496820,protein_coding,-1,19152,chr15_36477668_36496820
Snx31,15,36504062,36555573,protein_coding,-1,51511,chr15_36504062_36555573
Pabpc1,15,36595661,36609668,protein_coding,-1,14007,chr15_36595661_36609668
Gm49262,15,36629160,36629991,lincRNA,1,831,chr15_36629160_36629991
Gm46515,15,36632769,36695665,lincRNA,-1,62896,chr15_36632769_36695665
Gm10385,15,36690103,36694949,lincRNA,1,4846,chr15_36690103_36694949
Gm49263,15,36723647,36725236,lincRNA,1,1589,chr15_36723647_36725236
Ywhaz,15,36770770,36796929,protein_coding,-1,26159,chr15_36770770_36796929
Gm49282,15,36842816,36844338,lincRNA,1,1522,chr15_36842816_36844338
Gm10384,15,36870501,36879816,lincRNA,-1,9315,chr15_36870501_36879816
Gm41300,15,36906611,36931686,lincRNA,-1,25075,chr15_36906611_36931686
Gm34590,15,36938864,36949605,lincRNA,1,10741,chr15_36938864_36949605
Zfp706,15,36997027,37007773,protein_coding,-1,10746,chr15_36997027_37007773
Gm26766,15,37007523,37044100,antisense,1,36577,chr15_37007523_37044100
Grhl2,15,37233036,37363569,protein_coding,1,130533,chr15_37233036_37363569
Ncald,15,37366175,37792570,protein_coding,-1,426395,chr15_37366175_37792570
Gm28221,15,37367205,37368498,antisense,1,1293,chr15_37367205_37368498
4930447A16Rik,15,37425554,37440644,protein_coding,1,15090,chr15_37425554_37440644
Gm15942,15,37700704,37720853,antisense,1,20149,chr15_37700704_37720853
Gm35019,15,37892995,37899716,lincRNA,-1,6721,chr15_37892995_37899716
Rrm2b,15,37923952,37961318,protein_coding,-1,37366,chr15_37923952_37961318
Gm49085,15,37960471,37966218,antisense,1,5747,chr15_37960471_37966218
Ubr5,15,37967328,38078854,protein_coding,-1,111526,chr15_37967328_38078854
Gm35167,15,38184009,38202217,lincRNA,-1,18208,chr15_38184009_38202217
Gm49313,15,38239702,38255310,lincRNA,-1,15608,chr15_38239702_38255310
Klf10,15,38291463,38300706,protein_coding,-1,9243,chr15_38291463_38300706
Gm35248,15,38312293,38343139,lincRNA,1,30846,chr15_38312293_38343139
Gm41307,15,38385634,38404154,lincRNA,-1,18520,chr15_38385634_38404154
G930009F23Rik,15,38436225,38455134,lincRNA,-1,18909,chr15_38436225_38455134
Azin1,15,38487427,38519266,protein_coding,-1,31839,chr15_38487427_38519266
Gm49077,15,38518786,38520051,antisense,1,1265,chr15_38518786_38520051
2310043O21Rik,15,38549343,38594934,lincRNA;lncRNA,-1,45591,chr15_38549343_38594934
1100001I12Rik,15,38640943,38659839,lincRNA;lncRNA,-1,18896,chr15_38640943_38659839
Atp6v1c1,15,38661933,38692446,protein_coding,1,30513,chr15_38661933_38692446
Gm45924,15,38713483,38728516,lincRNA;lncRNA,-1,15033,chr15_38713483_38728516
Gm49097,CHR_MG4261_PATCH,38796222,38938622,antisense;lncRNA,-1,142400,chrCHR_MG4261_PATCH_38796222_38938622
Baalc,15,38796295,38952912,protein_coding,1,156617,chr15_38796295_38952912
Fzd6,15,38869185,39038188,protein_coding,1,169003,chr15_38869185_39038188
Cthrc1,15,38940083,39087121,protein_coding,1,147038,chr15_38940083_39087121
Slc25a32,15,38954382,39112716,protein_coding,-1,158334,chr15_38954382_39112716
Dcaf13,15,38976016,39146856,protein_coding,1,170840,chr15_38976016_39146856
Rims2,15,39198261,39684372,protein_coding,1,486111,chr15_39198261_39684372
Dcstamp,15,39745930,39760938,protein_coding,1,15008,chr15_39745930_39760938
Dpys,15,39768487,39857470,protein_coding,-1,88983,chr15_39768487_39857470
Gm16291,15,39797045,39812377,antisense,1,15332,chr15_39797045_39812377
Lrp12,15,39870589,39943994,protein_coding,-1,73405,chr15_39870589_39943994
AU022793,15,39962649,39967024,lincRNA,1,4375,chr15_39962649_39967024
Gm33251,15,40045191,40128982,lincRNA,1,83791,chr15_40045191_40128982
9330182O14Rik,15,40134365,40150010,protein_coding,1,15645,chr15_40134365_40150010
Gm33301,15,40162581,40168076,lincRNA,1,5495,chr15_40162581_40168076
Gm41311,15,40343260,40393307,lincRNA,1,50047,chr15_40343260_40393307
Gm16294,15,40511322,40527277,lincRNA,-1,15955,chr15_40511322_40527277
Zfpm2,15,40655035,41104592,protein_coding,1,449557,chr15_40655035_41104592
Oxr1,15,41447482,41861048,protein_coding,1,413566,chr15_41447482_41861048
Gm26854,15,41758060,41788911,antisense,-1,30851,chr15_41758060_41788911
Abra,15,41864076,41869720,protein_coding,-1,5644,chr15_41864076_41869720
Angpt1,15,42424723,42676977,protein_coding,-1,252254,chr15_42424723_42676977
Gm17473,15,42676241,42704616,antisense,1,28375,chr15_42676241_42704616
Rspo2,15,43020794,43170826,protein_coding,-1,150032,chr15_43020794_43170826
Eif3e,15,43250058,43282719,protein_coding,-1,32661,chr15_43250058_43282719
Gm49271,15,43368915,43377673,lincRNA,-1,8758,chr15_43368915_43377673
Gm10373,15,43430943,43477036,lincRNA,-1,46093,chr15_43430943_43477036
Emc2,15,43477229,43527763,protein_coding,1,50534,chr15_43477229_43527763
Tmem74,15,43864646,43870036,protein_coding,-1,5390,chr15_43864646_43870036
Trhr,15,44196135,44235912,protein_coding,1,39777,chr15_44196135_44235912
Nudcd1,15,44373163,44428307,protein_coding,-1,55144,chr15_44373163_44428307
Eny2,15,44428042,44438256,protein_coding,1,10214,chr15_44428042_44438256
Pkhd1l1,15,44457494,44601369,protein_coding,1,143875,chr15_44457494_44601369
Ebag9,15,44619175,44641515,protein_coding,1,22340,chr15_44619175_44641515
Sybu,15,44671856,44788063,protein_coding,-1,116207,chr15_44671856_44788063
Kcnv1,15,45106284,45114920,protein_coding,-1,8636,chr15_45106284_45114920
1700022A22Rik,15,46324559,46373907,lincRNA,1,49348,chr15_46324559_46373907
4930523O13Rik,15,46435866,46496181,lincRNA,-1,60315,chr15_46435866_46496181
4930548G14Rik,15,46623305,46639858,lincRNA,1,16553,chr15_46623305_46639858
Csmd3,15,47580637,48792063,protein_coding,-1,1211426,chr15_47580637_48792063
Gm41318,15,49194337,49203313,lincRNA,1,8976,chr15_49194337_49203313
Gm49198,15,50286898,50335014,lincRNA,1,48116,chr15_50286898_50335014
Trps1,15,50654752,50890463,protein_coding,-1,235711,chr15_50654752_50890463
Gm48913,15,50897639,50946307,lincRNA,1,48668,chr15_50897639_50946307
Gm19303,15,51231640,51395610,lincRNA,-1,163970,chr15_51231640_51395610
Gm34562,15,51601772,51629635,lincRNA,-1,27863,chr15_51601772_51629635
Eif3h,15,51786558,51865523,protein_coding,-1,78965,chr15_51786558_51865523
Utp23,15,51877429,51884614,protein_coding,1,7185,chr15_51877429_51884614
Gm34678,15,51880373,51897041,antisense,-1,16668,chr15_51880373_51897041
Gm48923,15,51897087,51899767,lincRNA,1,2680,chr15_51897087_51899767
Rad21,15,51962240,51991747,protein_coding,-1,29507,chr15_51962240_51991747
Aard,15,52040107,52045722,protein_coding,1,5615,chr15_52040107_52045722
Slc30a8,15,52295553,52335798,protein_coding,1,40245,chr15_52295553_52335798
Gm41322,15,52445122,52449761,lincRNA,1,4639,chr15_52445122_52449761
Med30,15,52712408,52730564,protein_coding,1,18156,chr15_52712408_52730564
Gm34794,15,52751427,52786267,lincRNA,-1,34840,chr15_52751427_52786267
Ext1,15,53064038,53346159,protein_coding,-1,282121,chr15_53064038_53346159
Samd12,15,53453810,53902537,protein_coding,-1,448727,chr15_53453810_53902537
1700015H07Rik,15,53621655,53623270,antisense,1,1615,chr15_53621655_53623270
Gm7489,15,53884906,53886597,protein_coding,1,1691,chr15_53884906_53886597
Tnfrsf11b,15,54250619,54278484,protein_coding,-1,27865,chr15_54250619_54278484
Colec10,15,54410774,54466358,protein_coding,1,55584,chr15_54410774_54466358
Mal2,15,54571192,54602847,protein_coding,1,31655,chr15_54571192_54602847
Enpp2,15,54838901,54952892,protein_coding,-1,113991,chr15_54838901_54952892
Taf2,15,55015131,55072152,protein_coding,-1,57021,chr15_55015131_55072152
Dscc1,15,55076099,55090491,protein_coding,-1,14392,chr15_55076099_55090491
Gm41325,15,55084561,55097699,antisense,1,13138,chr15_55084561_55097699
Deptor,15,55112317,55259271,protein_coding,1,146954,chr15_55112317_55259271
Col14a1,15,55307750,55520803,protein_coding,1,213053,chr15_55307750_55520803
Mrpl13,15,55534094,55557748,protein_coding,-1,23654,chr15_55534094_55557748
Mtbp,15,55557408,55626423,protein_coding,1,69015,chr15_55557408_55626423
Sntb1,15,55636388,55906949,protein_coding,-1,270561,chr15_55636388_55906949
Gm46516,15,55923402,55960906,lincRNA,1,37504,chr15_55923402_55960906
Gm49212,15,56046552,56049832,lincRNA,-1,3280,chr15_56046552_56049832
Has2,15,56665627,56694539,protein_coding,-1,28912,chr15_56665627_56694539
Gm2582,15,56880409,57006624,lincRNA,-1,126215,chr15_56880409_57006624
Slc22a22,15,57243767,57477625,protein_coding,-1,233858,chr15_57243767_57477625
Zhx2,15,57694665,57839832,protein_coding,1,145167,chr15_57694665_57839832
Gm16006,15,57708114,57708927,antisense,-1,813,chr15_57708114_57708927
9330154K18Rik,15,57736563,57738666,antisense,-1,2103,chr15_57736563_57738666
Derl1,15,57869502,57892448,protein_coding,-1,22946,chr15_57869502_57892448
Tbc1d31,15,57912199,57970067,protein_coding,1,57868,chr15_57912199_57970067
Fam83a,15,57985419,58011009,protein_coding,1,25590,chr15_57985419_58011009
9130401M01Rik,15,58022259,58034325,protein_coding,-1,12066,chr15_58022259_58034325
Gm29394,15,58028243,58076425,protein_coding,-1,48182,chr15_58028243_58076425
Zhx1,15,58047003,58076541,protein_coding,-1,29538,chr15_58047003_58076541
Atad2,15,58094044,58135082,protein_coding,-1,41038,chr15_58094044_58135082
Wdyhv1,15,58141377,58158665,protein_coding,1,17288,chr15_58141377_58158665
Fbxo32,15,58175879,58214932,protein_coding,-1,39053,chr15_58175879_58214932
Gm15943,CHR_MG74_PATCH,58214475,58324053,antisense;lncRNA,1,109578,chrCHR_MG74_PATCH_58214475_58324053
Klhl38,15,58314573,58324169,protein_coding,-1,9596,chr15_58314573_58324169
Gm2675,15,58405824,58419775,lincRNA;lncRNA,1,13951,chr15_58405824_58419775
Fam91a1,15,58415468,58466189,protein_coding,1,50721,chr15_58415468_58466189
Fer1l6,15,58510048,58673541,protein_coding,1,163493,chr15_58510048_58673541
Tmem65,15,58782269,58823638,protein_coding,-1,41369,chr15_58782269_58823638
Trmt12,15,58872674,58877127,protein_coding,1,4453,chr15_58872674_58877127
Rnf139,15,58889229,58907057,protein_coding,1,17828,chr15_58889229_58907057
Gm49356,15,58889298,58937359,protein_coding,1,48061,chr15_58889298_58937359
Tatdn1,15,58890155,58933738,protein_coding,-1,43583,chr15_58890155_58933738
Ndufb9,15,58933756,58939488,protein_coding,1,5732,chr15_58933756_58939488
Mtss1,15,58941234,59082005,protein_coding,-1,140771,chr15_58941234_59082005
4930544F09Rik,15,58984136,58988905,antisense,1,4769,chr15_58984136_58988905
Gm36617,15,59275396,59291946,lincRNA,1,16550,chr15_59275396_59291946
Sqle,15,59315077,59331192,protein_coding,1,16115,chr15_59315077_59331192
Washc5,15,59331997,59374167,protein_coding,-1,42170,chr15_59331997_59374167
Nsmce2,15,59374247,59601684,protein_coding,1,227437,chr15_59374247_59601684
Trib1,15,59648350,59657099,protein_coding,1,8749,chr15_59648350_59657099
Gm19510,15,59788417,59794959,lincRNA,-1,6542,chr15_59788417_59794959
Gm2682,15,60120540,60187408,lincRNA,-1,66868,chr15_60120540_60187408
A1bg,15,60896859,60923012,protein_coding,-1,26153,chr15_60896859_60923012
4930402D18Rik,15,60912974,60955320,antisense,1,42346,chr15_60912974_60955320
Myc,15,61985391,61990374,protein_coding,1,4983,chr15_61985391_61990374
Pvt1,15,62037986,62378096,lincRNA,1,340110,chr15_62037986_62378096
Gm30159,15,63067008,63143105,lincRNA,-1,76097,chr15_63067008_63143105
Gm41335,15,63176838,63718289,lincRNA,-1,541451,chr15_63176838_63718289
Gm49014,15,63255904,63278780,lincRNA,1,22876,chr15_63255904_63278780
4930449C09Rik,15,63717818,63737680,lincRNA,1,19862,chr15_63717818_63737680
Gm49019,15,63751659,63755435,lincRNA,1,3776,chr15_63751659_63755435
Gsdmc,15,63775968,63808759,protein_coding,-1,32791,chr15_63775968_63808759
Gsdmc2,15,63824346,63845177,protein_coding,-1,20831,chr15_63824346_63845177
Gsdmc3,15,63857724,63878558,protein_coding,-1,20834,chr15_63857724_63878558
Gsdmc4,15,63891264,63912297,protein_coding,-1,21033,chr15_63891264_63912297
Fam49b,15,63929097,64060478,protein_coding,-1,131381,chr15_63929097_64060478
Asap1,15,64086857,64382919,protein_coding,-1,296062,chr15_64086857_64382919
Gm20717,15,64098317,64101397,antisense,1,3080,chr15_64098317_64101397
1700010G06Rik,15,64314497,64316076,antisense,1,1579,chr15_64314497_64316076
Gm30563,15,64396379,64433598,lincRNA,1,37219,chr15_64396379_64433598
Gm30691,15,64627409,64633508,lincRNA,-1,6099,chr15_64627409_64633508
Adcy8,15,64697084,64922296,protein_coding,-1,225212,chr15_64697084_64922296
Gm21798,15,64817694,64937996,protein_coding,1,120302,chr15_64817694_64937996
Gm21961,15,64979544,65014904,protein_coding,-1,35360,chr15_64979544_65014904
Efr3a,15,65787034,65873816,protein_coding,1,86782,chr15_65787034_65873816
Oc90,15,65876053,65912397,protein_coding,-1,36344,chr15_65876053_65912397
Hhla1,15,65916609,65976804,protein_coding,-1,60195,chr15_65916609_65976804
Kcnq3,15,65986387,66286642,protein_coding,-1,300255,chr15_65986387_66286642
Gm27153,15,66074552,66091807,antisense,1,17255,chr15_66074552_66091807
Gm27242,15,66286917,66290243,lincRNA,1,3326,chr15_66286917_66290243
Gm30929,15,66335133,66340714,lincRNA,-1,5581,chr15_66335133_66340714
Lrrc6,15,66379858,66500910,protein_coding,-1,121052,chr15_66379858_66500910
Tmem71,15,66526212,66561103,protein_coding,-1,34891,chr15_66526212_66561103
Phf20l1,15,66577560,66647976,protein_coding,1,70416,chr15_66577560_66647976
Tg,15,66670753,66850721,protein_coding,1,179968,chr15_66670753_66850721
Sla,15,66780819,66831829,protein_coding,-1,51010,chr15_66780819_66831829
Ndrg1,15,66929318,66969640,protein_coding,-1,40322,chr15_66929318_66969640
Gm17035,15,66929607,66931107,antisense,1,1500,chr15_66929607_66931107
St3gal1,15,67102875,67176830,protein_coding,-1,73955,chr15_67102875_67176830
1700012I11Rik,15,67226769,67377094,lincRNA,1,150325,chr15_67226769_67377094
Zfat,15,68083764,68258856,protein_coding,-1,175092,chr15_68083764_68258856
Gm20732,15,68340983,68363176,lincRNA,-1,22193,chr15_68340983_68363176
Gm7125,15,68792320,68883576,lincRNA,1,91256,chr15_68792320_68883576
Khdrbs3,15,68928420,69101211,protein_coding,1,172791,chr15_68928420_69101211
Fam135b,15,71431609,71727838,protein_coding,-1,296229,chr15_71431609_71727838
Col22a1,15,71795795,72034227,protein_coding,-1,238432,chr15_71795795_72034227
Gm16308,15,71810108,71813780,antisense,1,3672,chr15_71810108_71813780
Kcnk9,15,72501089,72546340,protein_coding,-1,45251,chr15_72501089_72546340
Trappc9,15,72589620,73061204,protein_coding,-1,471584,chr15_72589620_73061204
Chrac1,15,73090392,73097554,protein_coding,1,7162,chr15_73090392_73097554
Ago2,15,73095844,73184935,protein_coding,-1,89091,chr15_73095844_73184935
Ptk2,15,73205102,73423280,protein_coding,-1,218178,chr15_73205102_73423280
1700085D07Rik,15,73249546,73264120,antisense,1,14574,chr15_73249546_73264120
Dennd3,15,73512560,73572242,protein_coding,1,59682,chr15_73512560_73572242
Slc45a4,15,73577424,73645762,protein_coding,-1,68338,chr15_73577424_73645762
Gpr20,15,73694604,73707505,protein_coding,-1,12901,chr15_73694604_73707505
Ptp4a3,15,73723145,73758766,protein_coding,1,35621,chr15_73723145_73758766
Mroh5,15,73760067,73839699,protein_coding,-1,79632,chr15_73760067_73839699
Gm6569,15,73834561,73839908,protein_coding,1,5347,chr15_73834561_73839908
Adgrb1,15,74516195,74589465,protein_coding,1,73270,chr15_74516195_74589465
Mroh4,15,74606029,74636353,protein_coding,-1,30324,chr15_74606029_74636353
Arc,15,74669083,74672570,protein_coding,-1,3487,chr15_74669083_74672570
Jrk,15,74702301,74709535,protein_coding,-1,7234,chr15_74702301_74709535
4933427E11Rik,15,74709161,74710374,antisense,1,1213,chr15_74709161_74710374
Psca,15,74714839,74717069,protein_coding,1,2230,chr15_74714839_74717069
Them6,15,74721204,74724639,protein_coding,1,3435,chr15_74721204_74724639
Slurp1,15,74724318,74728034,protein_coding,-1,3716,chr15_74724318_74728034
Lynx1,15,74747852,74753046,protein_coding,-1,5194,chr15_74747852_74753046
Ly6d,15,74762056,74763620,protein_coding,-1,1564,chr15_74762056_74763620
Gm17189,15,74784065,74800640,antisense,1,16575,chr15_74784065_74800640
Ly6k,15,74796874,74799986,protein_coding,-1,3112,chr15_74796874_74799986
Gml,15,74813452,74818815,protein_coding,-1,5363,chr15_74813452_74818815
Gml2,15,74819071,74834871,protein_coding,1,15800,chr15_74819071_74834871
Cyp11b1,15,74834125,74841643,protein_coding,-1,7518,chr15_74834125_74841643
Ly6e,15,74955051,74959905,protein_coding,1,4854,chr15_74955051_74959905
Ly6a,15,74994877,74998031,protein_coding,-1,3154,chr15_74994877_74998031
Gm28068,15,75007303,75024410,lincRNA,1,17107,chr15_75007303_75024410
Ly6c1,15,75044018,75048830,protein_coding,-1,4812,chr15_75044018_75048830
Gm28502,15,75076210,75079094,lincRNA,-1,2884,chr15_75076210_75079094
Ly6h,15,75551268,75567255,protein_coding,-1,15987,chr15_75551268_75567255
Zfp41,15,75616679,75629827,protein_coding,1,13148,chr15_75616679_75629827
Top1mt,15,75657035,75678800,protein_coding,-1,21765,chr15_75657035_75678800
Gm15945,15,75661407,75663529,antisense,1,2122,chr15_75661407_75663529
Rhpn1,15,75704280,75715485,protein_coding,1,11205,chr15_75704280_75715485
Mafa,15,75745490,75748228,protein_coding,-1,2738,chr15_75745490_75748228
Zc3h3,15,75754430,75841915,protein_coding,-1,87485,chr15_75754430_75841915
Gsdmd,15,75862327,75867408,protein_coding,1,5081,chr15_75862327_75867408
Mroh6,15,75884137,75888770,protein_coding,-1,4633,chr15_75884137_75888770
Naprt,15,75890956,75894481,protein_coding,-1,3525,chr15_75890956_75894481
Eef1d,15,75894205,75909556,protein_coding,-1,15351,chr15_75894205_75909556
Tigd5,15,75909735,75914535,protein_coding,1,4800,chr15_75909735_75914535
Pycrl,15,75916477,75921560,protein_coding,-1,5083,chr15_75916477_75921560
Tsta3,15,75924676,75929832,protein_coding,-1,5156,chr15_75924676_75929832
Zfp623,15,75940952,75949400,protein_coding,1,8448,chr15_75940952_75949400
Zfp707,15,75969123,75975868,protein_coding,1,6745,chr15_75969123_75975868
Ccdc166,15,75979872,75982455,protein_coding,-1,2583,chr15_75979872_75982455
Mapk15,15,75993769,75999154,protein_coding,1,5385,chr15_75993769_75999154
Fam83h,15,76001093,76014336,protein_coding,-1,13243,chr15_76001093_76014336
Scrib,15,76047158,76069784,protein_coding,-1,22626,chr15_76047158_76069784
Puf60,15,76070182,76080924,protein_coding,-1,10742,chr15_76070182_76080924
Gm48952,15,76083764,76087655,lincRNA,1,3891,chr15_76083764_76087655
Nrbp2,15,76085518,76091627,protein_coding,-1,6109,chr15_76085518_76091627
Eppk1,15,76101481,76120195,protein_coding,-1,18714,chr15_76101481_76120195
BC024139,15,76119517,76126596,protein_coding,-1,7079,chr15_76119517_76126596
Plec,15,76170974,76232574,protein_coding,-1,61600,chr15_76170974_76232574
Parp10,15,76231174,76243441,protein_coding,-1,12267,chr15_76231174_76243441
Grina,15,76246764,76249904,protein_coding,1,3140,chr15_76246764_76249904
Spatc1,15,76268089,76292572,protein_coding,1,24483,chr15_76268089_76292572
Smpd5,15,76294348,76296896,protein_coding,1,2548,chr15_76294348_76296896
Oplah,15,76296601,76328015,protein_coding,-1,31414,chr15_76296601_76328015
Exosc4,15,76327397,76330677,protein_coding,1,3280,chr15_76327397_76330677
Gpaa1,15,76331231,76334907,protein_coding,1,3676,chr15_76331231_76334907
Cyc1,15,76343523,76346260,protein_coding,1,2737,chr15_76343523_76346260
Sharpin,15,76347040,76351111,protein_coding,-1,4071,chr15_76347040_76351111
Maf1,15,76351294,76354380,protein_coding,1,3086,chr15_76351294_76354380
Gm35339,15,76354432,76365201,protein_coding,1,10769,chr15_76354432_76365201
Hgh1,15,76368898,76371437,protein_coding,1,2539,chr15_76368898_76371437
Tssk5,15,76371952,76374938,protein_coding,-1,2986,chr15_76371952_76374938
Mroh1,15,76380261,76453038,protein_coding,1,72777,chr15_76380261_76453038
Bop1,15,76452989,76477277,protein_coding,-1,24288,chr15_76452989_76477277
Scx,15,76457452,76459458,protein_coding,1,2006,chr15_76457452_76459458
Hsf1,15,76477422,76501913,protein_coding,1,24491,chr15_76477422_76501913
Dgat1,15,76502015,76511953,protein_coding,-1,9938,chr15_76502015_76511953
Scrt1,15,76516203,76522499,protein_coding,-1,6296,chr15_76516203_76522499
Fbxl6,15,76535721,76538746,protein_coding,-1,3025,chr15_76535721_76538746
Slc52a2,15,76538832,76544608,protein_coding,1,5776,chr15_76538832_76544608
Adck5,15,76576358,76595816,protein_coding,1,19458,chr15_76576358_76595816
Cpsf1,15,76595803,76607591,protein_coding,-1,11788,chr15_76595803_76607591
Slc39a4,15,76612383,76617384,protein_coding,-1,5001,chr15_76612383_76617384
Vps28,15,76622087,76626086,protein_coding,-1,3999,chr15_76622087_76626086
Tonsl,15,76626002,76639958,protein_coding,-1,13956,chr15_76626002_76639958
Cyhr1,15,76643395,76660117,protein_coding,-1,16722,chr15_76643395_76660117
Kifc2,15,76659858,76668196,protein_coding,1,8338,chr15_76659858_76668196
Ppp1r16a,15,76671615,76694919,protein_coding,1,23304,chr15_76671615_76694919
Gpt,15,76695716,76699686,protein_coding,1,3970,chr15_76695716_76699686
Mfsd3,15,76701465,76704239,protein_coding,1,2774,chr15_76701465_76704239
Recql4,15,76703553,76710548,protein_coding,-1,6995,chr15_76703553_76710548
Lrrc14,15,76710623,76717699,protein_coding,1,7076,chr15_76710623_76717699
Lrrc24,15,76715276,76722173,protein_coding,-1,6897,chr15_76715276_76722173
C030006K11Rik,15,76721465,76723845,protein_coding,-1,2380,chr15_76721465_76723845
Arhgap39,15,76723985,76818170,protein_coding,-1,94185,chr15_76723985_76818170
Zfp251,15,76851609,76871435,protein_coding,-1,19826,chr15_76851609_76871435
Zfp7,15,76879259,76892395,protein_coding,1,13136,chr15_76879259_76892395
Commd5,15,76899910,76901305,protein_coding,1,1395,chr15_76899910_76901305
Rpl8,15,76904078,76906314,protein_coding,1,2236,chr15_76904078_76906314
Zfp647,15,76910371,76925448,protein_coding,-1,15077,chr15_76910371_76925448
1110038F14Rik,15,76948506,76950979,protein_coding,1,2473,chr15_76948506_76950979
Mb,15,77015487,77050670,protein_coding,-1,35183,chr15_77015487_77050670
Apol6,15,77044729,77057106,protein_coding,1,12377,chr15_77044729_77057106
Rbfox2,15,77078990,77307004,protein_coding,-1,228014,chr15_77078990_77307004
1700109K24Rik,15,77084398,77096314,antisense,1,11916,chr15_77084398_77096314
Apol7a,15,77388219,77399110,protein_coding,-1,10891,chr15_77388219_77399110
Apol9a,15,77403789,77411135,protein_coding,-1,7346,chr15_77403789_77411135
Apol7b,15,77422209,77447492,protein_coding,-1,25283,chr15_77422209_77447492
Apol10a,15,77477047,77491069,protein_coding,1,14022,chr15_77477047_77491069
Apol7c,15,77524852,77533316,protein_coding,-1,8464,chr15_77524852_77533316
1700025B11Rik,15,77558239,77561892,protein_coding,-1,3653,chr15_77558239_77561892
Apol10b,15,77583819,77596125,protein_coding,-1,12306,chr15_77583819_77596125
Apol7e,15,77698857,77719285,protein_coding,1,20428,chr15_77698857_77719285
Apol9b,15,77729039,77736382,protein_coding,1,7343,chr15_77729039_77736382
Apol8,15,77747798,77757003,protein_coding,-1,9205,chr15_77747798_77757003
Myh9,15,77760587,77842175,protein_coding,-1,81588,chr15_77760587_77842175
Txn2,15,77915047,77929006,protein_coding,-1,13959,chr15_77915047_77929006
Foxred2,15,77940522,77956722,protein_coding,-1,16200,chr15_77940522_77956722
Eif3d,15,77958998,77970813,protein_coding,-1,11815,chr15_77958998_77970813
Gm17638,15,77961674,77967126,antisense,1,5452,chr15_77961674_77967126
Cacng2,15,77991748,78120028,protein_coding,-1,128280,chr15_77991748_78120028
A730060N03Rik,15,78119706,78144142,antisense,1,24436,chr15_78119706_78144142
Ift27,15,78159463,78174107,protein_coding,-1,14644,chr15_78159463_78174107
Pvalb,15,78191114,78206400,protein_coding,-1,15286,chr15_78191114_78206400
Ncf4,15,78244801,78262580,protein_coding,1,17779,chr15_78244801_78262580
Csf2rb2,15,78282507,78305721,protein_coding,-1,23214,chr15_78282507_78305721
Csf2rb,15,78325752,78353847,protein_coding,1,28095,chr15_78325752_78353847
Tex33,15,78378400,78395912,protein_coding,-1,17512,chr15_78378400_78395912
Tst,15,78399556,78405907,protein_coding,-1,6351,chr15_78399556_78405907
Mpst,15,78406416,78414013,protein_coding,1,7597,chr15_78406416_78414013
Kctd17,15,78428564,78439303,protein_coding,1,10739,chr15_78428564_78439303
Tmprss6,15,78439667,78468634,protein_coding,-1,28967,chr15_78439667_78468634
Il2rb,15,78479256,78495271,protein_coding,-1,16015,chr15_78479256_78495271
C1qtnf6,15,78523346,78531416,protein_coding,-1,8070,chr15_78523346_78531416
Sstr3,15,78537008,78544685,protein_coding,-1,7677,chr15_78537008_78544685
Rac2,15,78559167,78572783,protein_coding,-1,13616,chr15_78559167_78572783
Cyth4,15,78597047,78622019,protein_coding,1,24972,chr15_78597047_78622019
Elfn2,15,78667331,78718771,protein_coding,-1,51440,chr15_78667331_78718771
Mfng,15,78755882,78773475,protein_coding,-1,17593,chr15_78755882_78773475
Card10,15,78775138,78803042,protein_coding,-1,27904,chr15_78775138_78803042
Cdc42ep1,15,78842624,78850897,protein_coding,1,8273,chr15_78842624_78850897
Lgals2,15,78850860,78855529,protein_coding,-1,4669,chr15_78850860_78855529
Gm26634,15,78862956,78868533,lincRNA,-1,5577,chr15_78862956_78868533
Gga1,15,78877190,78894585,protein_coding,1,17395,chr15_78877190_78894585
1700027A07Rik,15,78911966,78913660,antisense,-1,1694,chr15_78911966_78913660
Pdxp,15,78913919,78919517,protein_coding,1,5598,chr15_78913919_78919517
Lgals1,15,78926725,78930465,protein_coding,1,3740,chr15_78926725_78930465
Nol12,15,78934933,78943638,protein_coding,1,8705,chr15_78934933_78943638
Triobp,15,78947724,79005869,protein_coding,1,58145,chr15_78947724_79005869
H1f0,15,79028450,79030504,protein_coding,1,2054,chr15_79028450_79030504
Gcat,15,79030874,79042531,protein_coding,1,11657,chr15_79030874_79042531
Galr3,15,79041885,79043558,protein_coding,1,1673,chr15_79041885_79043558
Ankrd54,15,79053094,79062893,protein_coding,-1,9799,chr15_79053094_79062893
Eif3l,15,79075179,79094405,protein_coding,1,19226,chr15_79075179_79094405
Micall1,15,79108898,79136900,protein_coding,1,28002,chr15_79108898_79136900
1700088E04Rik,15,79129349,79141253,protein_coding,-1,11904,chr15_79129349_79141253
Polr2f,15,79141009,79151774,protein_coding,1,10765,chr15_79141009_79151774
Sox10,15,79154908,79165240,protein_coding,-1,10332,chr15_79154908_79165240
Pick1,15,79229173,79249484,protein_coding,1,20311,chr15_79229173_79249484
Slc16a8,15,79251014,79254761,protein_coding,-1,3747,chr15_79251014_79254761
Baiap2l2,15,79258195,79285537,protein_coding,-1,27342,chr15_79258195_79285537
Pla2g6,15,79286228,79328390,protein_coding,-1,42162,chr15_79286228_79328390
Gm20420,15,79314196,79316658,antisense,1,2462,chr15_79314196_79316658
Maff,15,79346621,79359076,protein_coding,1,12455,chr15_79346621_79359076
Tmem184b,15,79360684,79403569,protein_coding,-1,42885,chr15_79360684_79403569
Csnk1e,15,79417856,79455566,protein_coding,-1,37710,chr15_79417856_79455566
Gm16059,15,79427220,79431629,antisense,1,4409,chr15_79427220_79431629
Kcnj4,15,79483714,79505241,protein_coding,-1,21527,chr15_79483714_79505241
Kdelr3,15,79516411,79527739,protein_coding,1,11328,chr15_79516411_79527739
Ddx17,15,79527736,79546741,protein_coding,-1,19005,chr15_79527736_79546741
Dmc1,15,79561497,79605109,protein_coding,-1,43612,chr15_79561497_79605109
Fam227a,15,79609576,79658956,protein_coding,-1,49380,chr15_79609576_79658956
Cby1,15,79659199,79667660,protein_coding,1,8461,chr15_79659199_79667660
Tomm22,15,79670861,79673400,protein_coding,1,2539,chr15_79670861_79673400
Josd1,15,79674251,79687919,protein_coding,-1,13668,chr15_79674251_79687919
Gtpbp1,15,79690845,79721479,protein_coding,1,30634,chr15_79690845_79721479
Sun2,15,79724070,79742536,protein_coding,-1,18466,chr15_79724070_79742536
Gm16575,15,79739574,79741798,antisense,1,2224,chr15_79739574_79741798
Dnal4,15,79761453,79777849,protein_coding,-1,16396,chr15_79761453_79777849
Nptxr,15,79786351,79804766,protein_coding,-1,18415,chr15_79786351_79804766
Npcd,15,79789675,79834237,protein_coding,-1,44562,chr15_79789675_79834237
Cbx6,15,79823896,79834688,protein_coding,-1,10792,chr15_79823896_79834688
AC113595.1,15,79889532,79893120,antisense,1,3588,chr15_79889532_79893120
Apobec3,15,79891659,79915906,protein_coding,1,24247,chr15_79891659_79915906
Cbx7,15,79915807,79971119,protein_coding,-1,55312,chr15_79915807_79971119
Pdgfb,15,79995874,80014977,protein_coding,-1,19103,chr15_79995874_80014977
Rpl3,15,80077791,80091868,protein_coding,-1,14077,chr15_80077791_80091868
Syngr1,15,80091334,80119501,protein_coding,1,28167,chr15_80091334_80119501
Tab1,15,80133127,80161707,protein_coding,1,28580,chr15_80133127_80161707
Mgat3,15,80173721,80215519,protein_coding,1,41798,chr15_80173721_80215519
Mief1,15,80234018,80253371,protein_coding,1,19353,chr15_80234018_80253371
Atf4,15,80255184,80257541,protein_coding,1,2357,chr15_80255184_80257541
Rps19bp1,15,80260615,80264315,protein_coding,-1,3700,chr15_80260615_80264315
Cacna1i,15,80287238,80398279,protein_coding,1,111041,chr15_80287238_80398279
Enthd1,15,80452240,80565156,protein_coding,-1,112916,chr15_80452240_80565156
Grap2,15,80572594,80652854,protein_coding,1,80260,chr15_80572594_80652854
Fam83f,15,80671847,80700425,protein_coding,1,28578,chr15_80671847_80700425
Tnrc6b,15,80711313,80941085,protein_coding,1,229772,chr15_80711313_80941085
Adsl,15,80948490,80970946,protein_coding,1,22456,chr15_80948490_80970946
Sgsm3,15,80977765,81012290,protein_coding,1,34525,chr15_80977765_81012290
Mchr1,15,81235499,81238964,protein_coding,1,3465,chr15_81235499_81238964
Slc25a17,15,81318911,81360812,protein_coding,-1,41901,chr15_81318911_81360812
St13,15,81363669,81400077,protein_coding,-1,36408,chr15_81363669_81400077
Xpnpep3,15,81400138,81457482,protein_coding,1,57344,chr15_81400138_81457482
Dnajb7,15,81406926,81408299,protein_coding,-1,1373,chr15_81406926_81408299
Gm17025,15,81415560,81419188,antisense,-1,3628,chr15_81415560_81419188
Rbx1,15,81466296,81476369,protein_coding,1,10073,chr15_81466296_81476369
Ep300,15,81585351,81652077,protein_coding,1,66726,chr15_81585351_81652077
L3mbtl2,15,81663889,81688315,protein_coding,1,24426,chr15_81663889_81688315
Chadl,15,81678296,81697287,protein_coding,-1,18991,chr15_81678296_81697287
Rangap1,15,81704248,81745530,protein_coding,-1,41282,chr15_81704248_81745530
Zc3h7b,15,81745057,81796260,protein_coding,1,51203,chr15_81745057_81796260
Gm17597,15,81800791,81802613,antisense,-1,1822,chr15_81800791_81802613
Tef,15,81802421,81826863,protein_coding,1,24442,chr15_81802421_81826863
Tob2,15,81848272,81858796,protein_coding,-1,10524,chr15_81848272_81858796
Phf5a,15,81864520,81871911,protein_coding,-1,7391,chr15_81864520_81871911
Aco2,15,81872309,81915133,protein_coding,1,42824,chr15_81872309_81915133
Polr3h,15,81888228,81926240,protein_coding,-1,38012,chr15_81888228_81926240
Csdc2,15,81936759,81950941,protein_coding,1,14182,chr15_81936759_81950941
Pmm1,15,81951108,81960930,protein_coding,-1,9822,chr15_81951108_81960930
Xrcc6,15,81987835,82040085,protein_coding,1,52250,chr15_81987835_82040085
Desi1,15,81992523,82033862,protein_coding,-1,41339,chr15_81992523_82033862
Snu13,15,82040525,82047598,protein_coding,-1,7073,chr15_82040525_82047598
Mei1,15,82069996,82126814,protein_coding,1,56818,chr15_82069996_82126814
Ccdc134,15,82127922,82142203,protein_coding,1,14281,chr15_82127922_82142203
Srebf2,15,82147181,82205379,protein_coding,1,58198,chr15_82147181_82205379
Shisa8,15,82206168,82212815,protein_coding,-1,6647,chr15_82206168_82212815
Tnfrsf13c,15,82221743,82224369,protein_coding,-1,2626,chr15_82221743_82224369
Cenpm,15,82233779,82244748,protein_coding,-1,10969,chr15_82233779_82244748
1500009C09Rik,15,82252397,82260753,protein_coding,1,8356,chr15_82252397_82260753
Wbp2nl,15,82298954,82314623,protein_coding,1,15669,chr15_82298954_82314623
Naga,15,82329532,82338925,protein_coding,-1,9393,chr15_82329532_82338925
Smdt1,15,82338959,82349091,protein_coding,1,10132,chr15_82338959_82349091
Ndufa6,15,82350140,82354322,protein_coding,-1,4182,chr15_82350140_82354322
Cyp2d22,15,82370527,82380260,protein_coding,-1,9733,chr15_82370527_82380260
Cyp2d11,15,82389154,82394022,protein_coding,-1,4868,chr15_82389154_82394022
Cyp2d9,15,82433437,82456845,protein_coding,1,23408,chr15_82433437_82456845
Cyp2d34,15,82615965,82620946,protein_coding,-1,4981,chr15_82615965_82620946
Cyp2d26,15,82790101,82794294,protein_coding,-1,4193,chr15_82790101_82794294
Tcf20,15,82808436,82987872,protein_coding,-1,179436,chr15_82808436_82987872
Gm20324,15,82899080,82905818,antisense,1,6738,chr15_82899080_82905818
Nfam1,15,82992973,83033306,protein_coding,-1,40333,chr15_82992973_83033306
Serhl,15,83089506,83116674,protein_coding,1,27168,chr15_83089506_83116674
Gm17206,15,83102072,83105929,antisense,-1,3857,chr15_83102072_83105929
Rrp7a,15,83113433,83122801,protein_coding,-1,9368,chr15_83113433_83122801
Poldip3,15,83125976,83149384,protein_coding,-1,23408,chr15_83125976_83149384
Cyb5r3,15,83153494,83172592,protein_coding,-1,19098,chr15_83153494_83172592
A4galt,15,83226722,83251774,protein_coding,-1,25052,chr15_83226722_83251774
Arfgap3,15,83299739,83350247,protein_coding,-1,50508,chr15_83299739_83350247
1700001L05Rik,15,83353847,83367282,lincRNA,-1,13435,chr15_83353847_83367282
Pacsin2,15,83375607,83464606,protein_coding,-1,88999,chr15_83375607_83464606
Ttll1,15,83483769,83510893,protein_coding,-1,27124,chr15_83483769_83510893
Bik,15,83526862,83544634,protein_coding,1,17772,chr15_83526862_83544634
Mcat,15,83546797,83563787,protein_coding,-1,16990,chr15_83546797_83563787
Tspo,15,83563592,83574203,protein_coding,1,10611,chr15_83563592_83574203
Ttll12,15,83575090,83595157,protein_coding,-1,20067,chr15_83575090_83595157
Scube1,15,83604999,83725021,protein_coding,-1,120022,chr15_83604999_83725021
Mpped1,15,83779467,83858494,protein_coding,1,79027,chr15_83779467_83858494
Efcab6,15,83866712,84065379,protein_coding,-1,198667,chr15_83866712_84065379
Sult4a1,15,84076097,84105754,protein_coding,-1,29657,chr15_84076097_84105754
Pnpla5,15,84112356,84123175,protein_coding,-1,10819,chr15_84112356_84123175
Pnpla3,15,84167837,84187236,protein_coding,1,19399,chr15_84167837_84187236
Samm50,15,84192241,84217267,protein_coding,1,25026,chr15_84192241_84217267
Parvb,15,84232043,84315688,protein_coding,1,83645,chr15_84232043_84315688
Parvg,15,84324026,84342978,protein_coding,1,18952,chr15_84324026_84342978
Rtl6,15,84553398,84557823,protein_coding,-1,4425,chr15_84553398_84557823
Prr5,15,84669620,84703673,protein_coding,1,34053,chr15_84669620_84703673
Arhgap8,15,84720052,84772207,protein_coding,1,52155,chr15_84720052_84772207
Phf21b,15,84785381,84856049,protein_coding,-1,70668,chr15_84785381_84856049
Gm29666,15,84910438,84920038,protein_coding,-1,9600,chr15_84910438_84920038
Nup50,15,84923411,84942963,protein_coding,1,19552,chr15_84923411_84942963
5031439G07Rik,15,84943936,84988551,protein_coding,-1,44615,chr15_84943936_84988551
Upk3a,15,85017141,85022547,protein_coding,1,5406,chr15_85017141_85022547
Fam118a,15,85028948,85062830,protein_coding,1,33882,chr15_85028948_85062830
Smc1b,15,85064689,85131964,protein_coding,-1,67275,chr15_85064689_85131964
Ribc2,15,85132078,85144570,protein_coding,1,12492,chr15_85132078_85144570
Fbln1,15,85205949,85286535,protein_coding,1,80586,chr15_85205949_85286535
Atxn10,15,85336245,85463212,protein_coding,1,126967,chr15_85336245_85463212
7530416G11Rik,15,85492736,85503227,protein_coding,-1,10491,chr15_85492736_85503227
Wnt7b,15,85535437,85582473,protein_coding,-1,47036,chr15_85535437_85582473
AU022754,15,85580252,85593708,antisense,1,13456,chr15_85580252_85593708
Ppara,15,85734983,85802819,protein_coding,1,67836,chr15_85734983_85802819
Cdpf1,15,85806972,85811697,protein_coding,-1,4725,chr15_85806972_85811697
Pkdrej,15,85814670,85821734,protein_coding,-1,7064,chr15_85814670_85821734
Ttc38,15,85832306,85858822,protein_coding,1,26516,chr15_85832306_85858822
Gtse1,15,85859745,85876573,protein_coding,1,16828,chr15_85859745_85876573
Trmu,15,85879312,85897394,protein_coding,1,18082,chr15_85879312_85897394
Celsr1,15,85898929,86034203,protein_coding,-1,135274,chr15_85898929_86034203
Gramd4,15,86057695,86137634,protein_coding,1,79939,chr15_86057695_86137634
Gm15722,15,86087640,86090060,antisense,-1,2420,chr15_86087640_86090060
Cerk,15,86139128,86186141,protein_coding,-1,47013,chr15_86139128_86186141
Gm15569,15,86185728,86187152,antisense,1,1424,chr15_86185728_86187152
Tbc1d22a,15,86214459,86498503,protein_coding,1,284044,chr15_86214459_86498503
Brd1,15,88687034,88734233,protein_coding,-1,47199,chr15_88687034_88734233
Zbed4,15,88751660,88784516,protein_coding,1,32856,chr15_88751660_88784516
Alg12,15,88805244,88819318,protein_coding,-1,14074,chr15_88805244_88819318
Creld2,15,88819646,88826683,protein_coding,1,7037,chr15_88819646_88826683
Pim3,15,88862186,88865726,protein_coding,1,3540,chr15_88862186_88865726
Ttll8,15,88890633,88954418,protein_coding,-1,63785,chr15_88890633_88954418
Mlc1,15,88955884,88979007,protein_coding,-1,23123,chr15_88955884_88979007
Mov10l1,15,88982909,89055152,protein_coding,1,72243,chr15_88982909_89055152
Panx2,15,89059734,89073567,protein_coding,1,13833,chr15_89059734_89073567
1810021B22Rik,15,89071196,89075852,antisense,-1,4656,chr15_89071196_89075852
Trabd,15,89075124,89087077,protein_coding,1,11953,chr15_89075124_89087077
Selenoo,15,89089084,89100340,protein_coding,1,11256,chr15_89089084_89100340
Tubgcp6,15,89098357,89123112,protein_coding,-1,24755,chr15_89098357_89123112
Hdac10,15,89123307,89128700,protein_coding,-1,5393,chr15_89123307_89128700
Mapk12,15,89130584,89140703,protein_coding,-1,10119,chr15_89130584_89140703
Mapk11,15,89142486,89149628,protein_coding,-1,7142,chr15_89142486_89149628
Plxnb2,15,89155549,89180788,protein_coding,-1,25239,chr15_89155549_89180788
Dennd6b,15,89182213,89196496,protein_coding,-1,14283,chr15_89182213_89196496
Ppp6r2,15,89211553,89287010,protein_coding,1,75457,chr15_89211553_89287010
Sbf1,15,89288236,89315311,protein_coding,-1,27075,chr15_89288236_89315311
Adm2,15,89322720,89324731,protein_coding,1,2011,chr15_89322720_89324731
Lmf2,15,89351004,89355659,protein_coding,-1,4655,chr15_89351004_89355659
Ncaph2,15,89355719,89372826,protein_coding,1,17107,chr15_89355719_89372826
Sco2,15,89371637,89373846,protein_coding,-1,2209,chr15_89371637_89373846
Tymp,15,89371931,89377039,protein_coding,-1,5108,chr15_89371931_89377039
Odf3b,15,89377449,89379587,protein_coding,-1,2138,chr15_89377449_89379587
Klhdc7b,15,89384917,89388867,protein_coding,1,3950,chr15_89384917_89388867
Syce3,15,89390174,89410503,protein_coding,-1,20329,chr15_89390174_89410503
Chkb,15,89426360,89429908,protein_coding,-1,3548,chr15_89426360_89429908
C730034F03Rik,15,89429589,89430868,bidirectional_promoter_lncRNA,1,1279,chr15_89429589_89430868
Mapk8ip2,15,89453913,89464468,protein_coding,1,10555,chr15_89453913_89464468
Arsa,15,89472476,89477425,protein_coding,-1,4949,chr15_89472476_89477425
C230037L18Rik,15,89476236,89484847,antisense,1,8611,chr15_89476236_89484847
Shank3,15,89499623,89560261,protein_coding,1,60638,chr15_89499623_89560261
Gm15609,15,89520096,89523677,lincRNA,-1,3581,chr15_89520096_89523677
Acr,15,89568326,89574585,protein_coding,1,6259,chr15_89568326_89574585
Rabl2,15,89582533,89591923,protein_coding,-1,9390,chr15_89582533_89591923
Syt10,15,89782393,89841860,protein_coding,-1,59467,chr15_89782393_89841860
Alg10b,15,90224311,90233471,protein_coding,1,9160,chr15_90224311_90233471
Cpne8,15,90487482,90679432,protein_coding,-1,191950,chr15_90487482_90679432
Kif21a,15,90933276,91049948,protein_coding,-1,116672,chr15_90933276_91049948
Abcd2,15,91145871,91191799,protein_coding,-1,45928,chr15_91145871_91191799
CN725425,15,91199494,91260894,protein_coding,1,61400,chr15_91199494_91260894
Slc2a13,15,91267696,91573261,protein_coding,-1,305565,chr15_91267696_91573261
4933438A12Rik,15,91597583,91604676,lincRNA,1,7093,chr15_91597583_91604676
Lrrk2,15,91673175,91816120,protein_coding,1,142945,chr15_91673175_91816120
Smgc,15,91838265,91861438,protein_coding,1,23173,chr15_91838265_91861438
Cntn1,15,92051165,92341967,protein_coding,1,290802,chr15_92051165_92341967
Gm26760,15,92344359,92378103,lincRNA,1,33744,chr15_92344359_92378103
Pdzrn4,15,92396881,92771819,protein_coding,1,374938,chr15_92396881_92771819
Gm30085,15,93001824,93007017,lincRNA,1,5193,chr15_93001824_93007017
Gxylt1,15,93239742,93275179,protein_coding,-1,35437,chr15_93239742_93275179
Yaf2,15,93284278,93336935,protein_coding,-1,52657,chr15_93284278_93336935
Zcrb1,15,93386097,93398334,protein_coding,-1,12237,chr15_93386097_93398334
Pphln1,15,93398350,93491510,protein_coding,1,93160,chr15_93398350_93491510
Prickle1,15,93499114,93595891,protein_coding,-1,96777,chr15_93499114_93595891
Adamts20,15,94270163,94465418,protein_coding,-1,195255,chr15_94270163_94465418
Pus7l,15,94522688,94543547,protein_coding,-1,20859,chr15_94522688_94543547
Irak4,15,94543643,94581815,protein_coding,1,38172,chr15_94543643_94581815
Twf1,15,94577951,94589889,protein_coding,-1,11938,chr15_94577951_94589889
Tmem117,15,94629232,95096098,protein_coding,1,466866,chr15_94629232_95096098
Nell2,15,95075230,95528559,protein_coding,-1,453329,chr15_95075230_95528559
Dbx2,15,95623563,95655960,protein_coding,-1,32397,chr15_95623563_95655960
Gm49169,15,95736415,95753732,lincRNA,-1,17317,chr15_95736415_95753732
A130051J06Rik,15,95787856,95791642,antisense,-1,3786,chr15_95787856_95791642
Ano6,15,95790843,95974751,protein_coding,1,183908,chr15_95790843_95974751
Gm49173,15,95802033,95804401,antisense,-1,2368,chr15_95802033_95804401
Gm17546,15,95824458,95830072,antisense,-1,5614,chr15_95824458_95830072
D030018L15Rik,15,96051603,96079553,lincRNA,-1,27950,chr15_96051603_96079553
2610037D02Rik,15,96134819,96284495,lincRNA,-1,149676,chr15_96134819_96284495
Arid2,15,96287518,96404992,protein_coding,1,117474,chr15_96287518_96404992
Scaf11,15,96411699,96460843,protein_coding,-1,49144,chr15_96411699_96460843
Slc38a1,15,96571418,96642913,protein_coding,-1,71495,chr15_96571418_96642913
Slc38a2,15,96687392,96699730,protein_coding,-1,12338,chr15_96687392_96699730
Slc38a4,15,96994820,97055956,protein_coding,-1,61136,chr15_96994820_97055956
Amigo2,15,97244125,97247287,protein_coding,-1,3162,chr15_97244125_97247287
Pced1b,15,97247107,97385680,protein_coding,1,138573,chr15_97247107_97385680
Rpap3,15,97675097,97705825,protein_coding,-1,30728,chr15_97675097_97705825
Endou,15,97711015,97731339,protein_coding,-1,20324,chr15_97711015_97731339
Rapgef3,15,97744770,97767972,protein_coding,-1,23202,chr15_97744770_97767972
Rapgef3os1,15,97760408,97766961,antisense,1,6553,chr15_97760408_97766961
Rapgef3os2,15,97766549,97768713,antisense,1,2164,chr15_97766549_97768713
Slc48a1,15,97778520,97792692,protein_coding,1,14172,chr15_97778520_97792692
Hdac7,15,97792664,97844502,protein_coding,-1,51838,chr15_97792664_97844502
Vdr,15,97854425,97910630,protein_coding,-1,56205,chr15_97854425_97910630
Tmem106c,15,97964200,97970275,protein_coding,1,6075,chr15_97964200_97970275
Col2a1,15,97975602,98004695,protein_coding,-1,29093,chr15_97975602_98004695
Senp1,15,98038744,98093744,protein_coding,-1,55000,chr15_98038744_98093744
Pfkm,15,98092589,98132451,protein_coding,1,39862,chr15_98092589_98132451
Asb8,15,98134637,98165625,protein_coding,-1,30988,chr15_98134637_98165625
Ccdc184,15,98167158,98170134,protein_coding,1,2976,chr15_98167158_98170134
Gm44579,15,98186017,98220977,protein_coding,-1,34960,chr15_98186017_98220977
Olfr286,15,98224308,98234450,protein_coding,-1,10142,chr15_98224308_98234450
Zfp641,15,98285585,98296161,protein_coding,-1,10576,chr15_98285585_98296161
Olfr285,15,98309203,98317353,protein_coding,-1,8150,chr15_98309203_98317353
Olfr282,15,98431225,98438638,protein_coding,1,7413,chr15_98431225_98438638
Olfr281,15,98452588,98460395,protein_coding,1,7807,chr15_98452588_98460395
OR5BS1P,15,98469896,98478982,protein_coding,1,9086,chr15_98469896_98478982
Olfr279,15,98492402,98502637,protein_coding,1,10235,chr15_98492402_98502637
Kansl2,15,98517658,98534264,protein_coding,-1,16606,chr15_98517658_98534264
Ccnt1,15,98538689,98570923,protein_coding,-1,32234,chr15_98538689_98570923
9330020H09Rik,15,98567324,98569583,antisense,1,2259,chr15_98567324_98569583
4930415O20Rik,15,98571004,98589580,protein_coding,1,18576,chr15_98571004_98589580
Adcy6,15,98589973,98610076,protein_coding,-1,20103,chr15_98589973_98610076
Gm29331,15,98589990,98591090,antisense,1,1100,chr15_98589990_98591090
Cacnb3,15,98630840,98644529,protein_coding,1,13689,chr15_98630840_98644529
Ddx23,15,98645134,98662894,protein_coding,-1,17760,chr15_98645134_98662894
Rnd1,15,98663421,98677461,protein_coding,-1,14040,chr15_98663421_98677461
Ccdc65,15,98708207,98723336,protein_coding,1,15129,chr15_98708207_98723336
Fkbp11,15,98724366,98728198,protein_coding,-1,3832,chr15_98724366_98728198
Arf3,15,98736634,98763214,protein_coding,-1,26580,chr15_98736634_98763214
Wnt10b,15,98770712,98778150,protein_coding,-1,7438,chr15_98770712_98778150
Wnt1,15,98789857,98793837,protein_coding,1,3980,chr15_98789857_98793837
Ddn,15,98803777,98809490,protein_coding,-1,5713,chr15_98803777_98809490
B130046B21Rik,15,98807024,98816077,antisense,1,9053,chr15_98807024_98816077
Prkag1,15,98812797,98831521,protein_coding,-1,18724,chr15_98812797_98831521
Kmt2d,15,98831669,98871204,protein_coding,-1,39535,chr15_98831669_98871204
Rhebl1,15,98877778,98894540,protein_coding,-1,16762,chr15_98877778_98894540
Lmbr1l,15,98903917,98918231,protein_coding,-1,14314,chr15_98903917_98918231
Tuba1b,15,98931425,98934565,protein_coding,-1,3140,chr15_98931425_98934565
Tuba1a,15,98949837,98953703,protein_coding,-1,3866,chr15_98949837_98953703
Tuba1c,15,99029891,99038110,protein_coding,1,8219,chr15_99029891_99038110
Prph,15,99055174,99058978,protein_coding,1,3804,chr15_99055174_99058978
Troap,15,99074575,99083409,protein_coding,1,8834,chr15_99074575_99083409
C1ql4,15,99084086,99087817,protein_coding,-1,3731,chr15_99084086_99087817
Dnajc22,15,99093170,99104737,protein_coding,1,11567,chr15_99093170_99104737
Spats2,15,99125916,99213215,protein_coding,1,87299,chr15_99125916_99213215
Kcnh3,15,99224861,99242817,protein_coding,1,17956,chr15_99224861_99242817
Mcrs1,15,99242817,99251961,protein_coding,-1,9144,chr15_99242817_99251961
Fam186b,15,99271018,99295888,protein_coding,-1,24870,chr15_99271018_99295888
Prpf40b,15,99295087,99317018,protein_coding,1,21931,chr15_99295087_99317018
Fmnl3,15,99317225,99370482,protein_coding,-1,53257,chr15_99317225_99370482
Tmbim6,15,99392882,99410049,protein_coding,1,17167,chr15_99392882_99410049
Nckap5l,15,99422035,99457748,protein_coding,-1,35713,chr15_99422035_99457748
Nckap5los,15,99427701,99435313,antisense,1,7612,chr15_99427701_99435313
Bcdin3d,15,99470079,99474730,protein_coding,-1,4651,chr15_99470079_99474730
Faim2,15,99497012,99528165,protein_coding,-1,31153,chr15_99497012_99528165
Aqp2,15,99579055,99584547,protein_coding,1,5492,chr15_99579055_99584547
Aqp5,15,99590782,99594829,protein_coding,1,4047,chr15_99590782_99594829
Aqp6,15,99601400,99605477,protein_coding,1,4077,chr15_99601400_99605477
Racgap1,15,99620496,99651656,protein_coding,-1,31160,chr15_99620496_99651656
Asic1,15,99670368,99701130,protein_coding,1,30762,chr15_99670368_99701130
Smarcd1,15,99702129,99713991,protein_coding,1,11862,chr15_99702129_99713991
Gm17349,15,99702176,99705490,protein_coding,-1,3314,chr15_99702176_99705490
Gm16537,15,99715543,99724474,antisense,-1,8931,chr15_99715543_99724474
Gpd1,15,99717515,99725005,protein_coding,1,7490,chr15_99717515_99725005
Cox14,15,99725647,99729532,protein_coding,1,3885,chr15_99725647_99729532
Cers5,15,99734881,99772885,protein_coding,-1,38004,chr15_99734881_99772885
Gm17058,15,99765991,99782332,antisense,1,16341,chr15_99765991_99782332
Lima1,15,99778470,99875456,protein_coding,-1,96986,chr15_99778470_99875456
Gm17057,15,99819020,99834570,antisense,1,15550,chr15_99819020_99834570
Fam186a,15,99918348,99967061,protein_coding,-1,48713,chr15_99918348_99967061
Gm21917,15,99931711,99953044,antisense,1,21333,chr15_99931711_99953044
Larp4,15,99970065,100016358,protein_coding,1,46293,chr15_99970065_100016358
2310068J16Rik,15,99972158,99973287,antisense,-1,1129,chr15_99972158_99973287
Dip2b,15,100038664,100219473,protein_coding,1,180809,chr15_100038664_100219473
Atf1,15,100227819,100261244,protein_coding,1,33425,chr15_100227819_100261244
Tmprss12,15,100280837,100293066,protein_coding,1,12229,chr15_100280837_100293066
Mettl7a1,15,100304140,100328662,protein_coding,1,24522,chr15_100304140_100328662
Mettl7a3,15,100334929,100340375,protein_coding,1,5446,chr15_100334929_100340375
Methig1,15,100353149,100384436,protein_coding,1,31287,chr15_100353149_100384436
Slc11a2,15,100387898,100425072,protein_coding,-1,37174,chr15_100387898_100425072
Gm5475,15,100422147,100428150,protein_coding,1,6003,chr15_100422147_100428150
Letmd1,15,100469023,100479164,protein_coding,1,10141,chr15_100469023_100479164
Csrnp2,15,100479570,100495488,protein_coding,-1,15918,chr15_100479570_100495488
Tfcp2,15,100498012,100552008,protein_coding,-1,53996,chr15_100498012_100552008
Pou6f1,15,100575318,100599984,protein_coding,-1,24666,chr15_100575318_100599984
Gm27209,15,100595416,100597293,antisense,1,1877,chr15_100595416_100597293
Dazap2,15,100615349,100620761,protein_coding,1,5412,chr15_100615349_100620761
Smagp,15,100621339,100636940,protein_coding,-1,15601,chr15_100621339_100636940
Bin2,15,100641077,100669553,protein_coding,-1,28476,chr15_100641077_100669553
Cela1,15,100674421,100687921,protein_coding,-1,13500,chr15_100674421_100687921
Galnt6,15,100691813,100729376,protein_coding,-1,37563,chr15_100691813_100729376
Galnt6os,15,100695773,100704896,antisense,1,9123,chr15_100695773_100704896
Slc4a8,15,100761747,100823968,protein_coding,1,62221,chr15_100761747_100823968
Scn8a,15,100869858,101045938,protein_coding,1,176080,chr15_100869858_101045938
Fignl2,15,101050194,101078567,protein_coding,-1,28373,chr15_101050194_101078567
Ankrd33,15,101115755,101120040,protein_coding,1,4285,chr15_101115755_101120040
Acvrl1,15,101128522,101145336,protein_coding,1,16814,chr15_101128522_101145336
Gm16031,15,101129916,101131592,antisense,-1,1676,chr15_101129916_101131592
Acvr1b,15,101174067,101213684,protein_coding,1,39617,chr15_101174067_101213684
A330009N23Rik,15,101221195,101225186,antisense,-1,3991,chr15_101221195_101225186
Grasp,15,101224188,101232756,protein_coding,1,8568,chr15_101224188_101232756
Nr4a1,15,101254269,101274795,protein_coding,1,20526,chr15_101254269_101274795
Atg101,15,101284272,101290945,protein_coding,1,6673,chr15_101284272_101290945
Krt80,15,101347444,101370162,protein_coding,-1,22718,chr15_101347444_101370162
Krt7,15,101411043,101430313,protein_coding,1,19270,chr15_101411043_101430313
Krt87,15,101431038,101438804,protein_coding,-1,7766,chr15_101431038_101438804
Krt88,15,101447744,101453907,protein_coding,1,6163,chr15_101447744_101453907
Krt86,15,101473478,101479986,protein_coding,1,6508,chr15_101473478_101479986
Krt82,15,101541214,101550667,protein_coding,-1,9453,chr15_101541214_101550667
Krt90,15,101552356,101562950,protein_coding,-1,10594,chr15_101552356_101562950
Krt75,15,101563345,101573904,protein_coding,-1,10559,chr15_101563345_101573904
Gm5414,15,101624028,101628188,protein_coding,-1,4160,chr15_101624028_101628188
Krt72,15,101776172,101786460,protein_coding,-1,10288,chr15_101776172_101786460
Krt73,15,101793308,101802346,protein_coding,-1,9038,chr15_101793308_101802346
Krt2,15,101810689,101818169,protein_coding,-1,7480,chr15_101810689_101818169
Krt1,15,101845426,101850794,protein_coding,-1,5368,chr15_101845426_101850794
Krt77,15,101858731,101869705,protein_coding,-1,10974,chr15_101858731_101869705
Krt79,15,101929332,101940324,protein_coding,-1,10992,chr15_101929332_101940324
Krt78,15,101946001,101954287,protein_coding,-1,8286,chr15_101946001_101954287
Krt8,15,101996698,102004482,protein_coding,-1,7784,chr15_101996698_102004482
Krt18,15,102028180,102032027,protein_coding,1,3847,chr15_102028180_102032027
Eif4b,15,102073773,102097173,protein_coding,1,23400,chr15_102073773_102097173
Tns2,15,102100413,102116401,protein_coding,1,15988,chr15_102100413_102116401
Spryd3,15,102116528,102136234,protein_coding,-1,19706,chr15_102116528_102136234
Igfbp6,15,102144362,102149511,protein_coding,1,5149,chr15_102144362_102149511
Soat2,15,102150526,102163469,protein_coding,1,12943,chr15_102150526_102163469
Csad,15,102176999,102204724,protein_coding,-1,27725,chr15_102176999_102204724
Zfp740,15,102203249,102215606,protein_coding,1,12357,chr15_102203249_102215606
Itgb7,15,102215995,102231944,protein_coding,-1,15949,chr15_102215995_102231944
Rarg,15,102234938,102257517,protein_coding,-1,22579,chr15_102234938_102257517
Gm9918,15,102270563,102274121,protein_coding,1,3558,chr15_102270563_102274121
Mfsd5,15,102279454,102281754,protein_coding,1,2300,chr15_102279454_102281754
Espl1,15,102296266,102324357,protein_coding,1,28091,chr15_102296266_102324357
Pfdn5,15,102326116,102331873,protein_coding,1,5757,chr15_102326116_102331873
Myg1,15,102331709,102338139,protein_coding,1,6430,chr15_102331709_102338139
Aaas,15,102338252,102350771,protein_coding,-1,12519,chr15_102338252_102350771
Sp7,15,102356606,102367182,protein_coding,-1,10576,chr15_102356606_102367182
Sp1,15,102406143,102436404,protein_coding,1,30261,chr15_102406143_102436404
Amhr2,15,102445367,102454633,protein_coding,1,9266,chr15_102445367_102454633
Prr13,15,102459028,102462806,protein_coding,1,3778,chr15_102459028_102462806
Pcbp2,15,102470539,102500061,protein_coding,1,29522,chr15_102470539_102500061
Map3k12,15,102497646,102517064,protein_coding,-1,19418,chr15_102497646_102517064
Gm10337,15,102503722,102503886,protein_coding,1,164,chr15_102503722_102503886
Tarbp2,15,102518192,102523676,protein_coding,1,5484,chr15_102518192_102523676
Npff,15,102523839,102524942,protein_coding,-1,1103,chr15_102523839_102524942
Gm28047,15,102523843,102625067,protein_coding,-1,101224,chr15_102523843_102625067
Atf7,15,102525946,102625464,protein_coding,-1,99518,chr15_102525946_102625464
Atp5g2,15,102662864,102672352,protein_coding,-1,9488,chr15_102662864_102672352
Calcoco1,15,102706777,102722178,protein_coding,-1,15401,chr15_102706777_102722178
Hoxc13,15,102921103,102928814,protein_coding,1,7711,chr15_102921103_102928814
Hoxc5,15,102967443,103017429,protein_coding,1,49986,chr15_102967443_103017429
Hoxc4,15,103018934,103036852,protein_coding,1,17918,chr15_103018934_103036852
Gm28876,15,103096151,103102111,lincRNA,-1,5960,chr15_103096151_103102111
Gm10830,15,103102237,103105069,lincRNA,1,2832,chr15_103102237_103105069
Gm28265,15,103102284,103104602,lincRNA,-1,2318,chr15_103102284_103104602
D930007P13Rik,15,103123070,103146828,lincRNA,-1,23758,chr15_103123070_103146828
Smug1,15,103153290,103167092,protein_coding,-1,13802,chr15_103153290_103167092
Cbx5,15,103191544,103239816,protein_coding,-1,48272,chr15_103191544_103239816
Hnrnpa1,15,103240432,103246692,protein_coding,1,6260,chr15_103240432_103246692
Nfe2,15,103248212,103258403,protein_coding,-1,10191,chr15_103248212_103258403
Copz1,15,103272714,103299868,protein_coding,1,27154,chr15_103272714_103299868
Gpr84,15,103308235,103310612,protein_coding,-1,2377,chr15_103308235_103310612
Zfp385a,15,103313895,103340093,protein_coding,-1,26198,chr15_103313895_103340093
Itga5,15,103344286,103366763,protein_coding,-1,22477,chr15_103344286_103366763
Gtsf1,15,103402405,103430470,protein_coding,-1,28065,chr15_103402405_103430470
Gtsf2,15,103438957,103448469,protein_coding,-1,9512,chr15_103438957_103448469
Nckap1l,15,103453794,103498810,protein_coding,1,45016,chr15_103453794_103498810
Pde1b,15,103503034,103530052,protein_coding,1,27018,chr15_103503034_103530052
Ppp1r1a,15,103530279,103538003,protein_coding,-1,7724,chr15_103530279_103538003
Glycam1,15,103562759,103565081,protein_coding,-1,2322,chr15_103562759_103565081
Gm49272,15,103649792,103655698,lincRNA,1,5906,chr15_103649792_103655698
Mucl2,15,103895855,104021151,protein_coding,-1,125296,chr15_103895855_104021151
Zfp263,16,3744093,3750790,protein_coding,1,6697,chr16_3744093_3750790
AC139347.1,16,3774780,3776826,unitary_pseudogene,1,2046,chr16_3774780_3776826
Olfr15,16,3830878,3844747,protein_coding,1,13869,chr16_3830878_3844747
Zfp174,16,3847268,3858880,protein_coding,1,11612,chr16_3847268_3858880
Zfp597,16,3858321,3884561,protein_coding,-1,26240,chr16_3858321_3884561
Naa60,16,3872375,3904770,protein_coding,1,32395,chr16_3872375_3904770
Gm20695,16,3884648,3919517,protein_coding,1,34869,chr16_3884648_3919517
1700037C18Rik,16,3895179,3908689,protein_coding,-1,13510,chr16_3895179_3908689
Cluap1,16,3908801,3941147,protein_coding,1,32346,chr16_3908801_3941147
Gm15537,16,3927789,3929357,antisense,-1,1568,chr16_3927789_3929357
Nlrc3,16,3945007,3976632,protein_coding,-1,31625,chr16_3945007_3976632
Slx4,16,3979105,4003770,protein_coding,-1,24665,chr16_3979105_4003770
Gm15879,16,4032839,4037847,antisense,-1,5008,chr16_4032839_4037847
Dnase1,16,4036942,4040024,protein_coding,1,3082,chr16_4036942_4040024
Trap1,16,4039971,4077827,protein_coding,-1,37856,chr16_4039971_4077827
Crebbp,16,4081328,4213997,protein_coding,-1,132669,chr16_4081328_4213997
Adcy9,16,4287529,4420498,protein_coding,-1,132969,chr16_4287529_4420498
Srl,16,4480216,4541816,protein_coding,-1,61600,chr16_4480216_4541816
Tfap4,16,4544661,4559854,protein_coding,-1,15193,chr16_4544661_4559854
Glis2,16,4594713,4624924,protein_coding,1,30211,chr16_4594713_4624924
Pam16,16,4616464,4624988,protein_coding,-1,8524,chr16_4616464_4624988
Coro7,16,4626133,4679777,protein_coding,-1,53644,chr16_4626133_4679777
Vasn,16,4639941,4650802,protein_coding,1,10861,chr16_4639941_4650802
Dnaja3,16,4639989,4707695,protein_coding,1,67706,chr16_4639989_4707695
Nmral1,16,4710059,4719356,protein_coding,-1,9297,chr16_4710059_4719356
Hmox2,16,4726361,4766742,protein_coding,1,40381,chr16_4726361_4766742
Cdip1,16,4750348,4790292,protein_coding,-1,39944,chr16_4750348_4790292
Gm15835,16,4777743,4779454,lincRNA,1,1711,chr16_4777743_4779454
4930562C15Rik,16,4835416,4867686,protein_coding,1,32270,chr16_4835416_4867686
Ubald1,16,4874778,4880315,protein_coding,-1,5537,chr16_4874778_4880315
Mgrn1,16,4886249,4938296,protein_coding,1,52047,chr16_4886249_4938296
Gm16861,16,4935049,4939633,antisense,-1,4584,chr16_4935049_4939633
Nudt16l1,16,4938761,4941032,protein_coding,1,2271,chr16_4938761_4941032
Anks3,16,4941436,4964205,protein_coding,-1,22769,chr16_4941436_4964205
Smim22,16,5007288,5008309,protein_coding,1,1021,chr16_5007288_5008309
Gm42477,16,5008370,5013418,antisense,1,5048,chr16_5008370_5013418
Rogdi,16,5008730,5013553,protein_coding,-1,4823,chr16_5008730_5013553
Glyr1,16,5013909,5049863,protein_coding,-1,35954,chr16_5013909_5049863
Ubn1,16,5050057,5086289,protein_coding,1,36232,chr16_5050057_5086289
Ppl,16,5086291,5132421,protein_coding,-1,46130,chr16_5086291_5132421
Sec14l5,16,5147109,5187271,protein_coding,1,40162,chr16_5147109_5187271
Nagpa,16,5195289,5204012,protein_coding,-1,8723,chr16_5195289_5204012
AU021092,16,5211823,5222299,protein_coding,-1,10476,chr16_5211823_5222299
Alg1,16,5233621,5244912,protein_coding,1,11291,chr16_5233621_5244912
Eef2kmt,16,5244152,5255983,protein_coding,-1,11831,chr16_5244152_5255983
Gm15983,16,5254786,5289621,antisense,1,34835,chr16_5254786_5289621
Rbfox1,16,5885355,7411526,protein_coding,1,1526171,chr16_5885355_7411526
Tmem114,16,8409275,8425136,protein_coding,-1,15861,chr16_8409275_8425136
Mettl22,16,8470788,8490684,protein_coding,1,19896,chr16_8470788_8490684
Abat,16,8513429,8621568,protein_coding,1,108139,chr16_8513429_8621568
Tmem186,16,8633229,8637712,protein_coding,-1,4483,chr16_8633229_8637712
Pmm2,16,8637674,8662467,protein_coding,1,24793,chr16_8637674_8662467
Carhsp1,16,8658580,8672155,protein_coding,-1,13575,chr16_8658580_8672155
Gm5767,16,8680770,8683911,protein_coding,1,3141,chr16_8680770_8683911
Usp7,16,8689595,8792308,protein_coding,-1,102713,chr16_8689595_8792308
1810013L24Rik,16,8830100,8858922,protein_coding,1,28822,chr16_8830100_8858922
Grin2a,16,9567898,9995560,protein_coding,-1,427662,chr16_9567898_9995560
Rpl39l,16,10170226,10174911,protein_coding,1,4685,chr16_10170226_10174911
Atf7ip2,16,10192712,10251478,protein_coding,1,58766,chr16_10192712_10251478
Emp2,16,10281749,10313968,protein_coding,-1,32219,chr16_10281749_10313968
Tekt5,16,10357948,10395490,protein_coding,-1,37542,chr16_10357948_10395490
Nubp1,16,10411948,10424428,protein_coding,1,12480,chr16_10411948_10424428
Tvp23a,16,10420557,10447362,protein_coding,-1,26805,chr16_10420557_10447362
Ciita,16,10480059,10528418,protein_coding,1,48359,chr16_10480059_10528418
Dexi,16,10502531,10543054,protein_coding,-1,40523,chr16_10502531_10543054
Clec16a,16,10545339,10744878,protein_coding,1,199539,chr16_10545339_10744878
Gm15558,16,10669248,10683539,antisense,-1,14291,chr16_10669248_10683539
Socs1,16,10782240,10785536,protein_coding,-1,3296,chr16_10782240_10785536
Tnp2,16,10787936,10788660,protein_coding,-1,724,chr16_10787936_10788660
Prm2,16,10791380,10796134,protein_coding,-1,4754,chr16_10791380_10796134
Prm1,16,10796326,10805839,protein_coding,-1,9513,chr16_10796326_10805839
Gm26822,16,10827927,10833507,lincRNA,1,5580,chr16_10827927_10833507
Rmi2,16,10835059,10892966,protein_coding,1,57907,chr16_10835059_10892966
Gm21859,16,10912012,10937306,processed_transcript,-1,25294,chr16_10912012_10937306
Litaf,16,10959275,11066157,protein_coding,-1,106882,chr16_10959275_11066157
Snn,16,11060945,11074985,protein_coding,1,14040,chr16_11060945_11074985
Txndc11,16,11074911,11134650,protein_coding,-1,59739,chr16_11074911_11134650
Zc3h7a,16,11136592,11176393,protein_coding,-1,39801,chr16_11136592_11176393
4930509G22Rik,16,11178176,11192292,lincRNA,1,14116,chr16_11178176_11192292
Rsl1d1,16,11192970,11203331,protein_coding,-1,10361,chr16_11192970_11203331
2610020C07Rik,16,11203366,11246201,antisense,1,42835,chr16_11203366_11246201
Gspt1,16,11219292,11254325,protein_coding,-1,35033,chr16_11219292_11254325
Tnfrsf17,16,11313812,11320074,protein_coding,1,6262,chr16_11313812_11320074
Snx29,16,11322908,11755472,protein_coding,1,432564,chr16_11322908_11755472
Gm4279,16,11688169,11691857,antisense,-1,3688,chr16_11688169_11691857
Cpped1,16,11803721,11909445,protein_coding,-1,105724,chr16_11803721_11909445
Gm9961,16,11901363,11930600,lincRNA,1,29237,chr16_11901363_11930600
Shisa9,16,11984113,12270902,protein_coding,1,286789,chr16_11984113_12270902
1700003L19Rik,16,12800579,12848653,lincRNA,1,48074,chr16_12800579_12848653
Ercc4,16,13109684,13150617,protein_coding,1,40933,chr16_13109684_13150617
Gm15738,16,13354374,13468755,antisense,-1,114381,chr16_13354374_13468755
2310015D24Rik,16,13514131,13521107,lincRNA,-1,6976,chr16_13514131_13521107
Parn,16,13537960,13668170,protein_coding,-1,130210,chr16_13537960_13668170
Bfar,16,13671858,13703612,protein_coding,1,31754,chr16_13671858_13703612
Pla2g10,16,13715057,13730983,protein_coding,-1,15926,chr16_13715057_13730983
Pla2g10os,16,13729836,13739471,antisense,1,9635,chr16_13729836_13739471
Rrn3,16,13780708,13814839,protein_coding,1,34131,chr16_13780708_13814839
Ntan1,16,13818845,13835451,protein_coding,1,16606,chr16_13818845_13835451
Pdxdc1,16,13833148,13903131,protein_coding,-1,69983,chr16_13833148_13903131
Mpv17l,16,13903161,13949619,protein_coding,1,46458,chr16_13903161_13949619
Ifitm7,16,13981699,13986888,protein_coding,-1,5189,chr16_13981699_13986888
Marf1,16,14109173,14163351,protein_coding,-1,54178,chr16_14109173_14163351
Nde1,16,14163275,14192928,protein_coding,1,29653,chr16_14163275_14192928
Myh11,16,14194535,14291372,protein_coding,-1,96837,chr16_14194535_14291372
Fopnl,16,14299244,14317405,protein_coding,-1,18161,chr16_14299244_14317405
Gm15868,16,14311841,14314014,antisense,1,2173,chr16_14311841_14314014
Abcc1,16,14361558,14475737,protein_coding,1,114179,chr16_14361558_14475737
A630010A05Rik,16,14562317,14634108,protein_coding,1,71791,chr16_14562317_14634108
Snai2,16,14705852,14709385,protein_coding,1,3533,chr16_14705852_14709385
Efcab1,16,14906606,14981371,protein_coding,1,74765,chr16_14906606_14981371
Gm21897,16,15317458,15318957,protein_coding,1,1499,chr16_15317458_15318957
Ube2v2,16,15552077,15595773,protein_coding,-1,43696,chr16_15552077_15595773
Mcm4,16,15623897,15637400,protein_coding,-1,13503,chr16_15623897_15637400
Prkdc,16,15637866,15842235,protein_coding,1,204369,chr16_15637866_15842235
Mzt2,16,15848441,15863369,protein_coding,-1,14928,chr16_15848441_15863369
Cebpd,16,15887286,15891031,protein_coding,1,3745,chr16_15887286_15891031
Spidr,16,15889224,16146851,protein_coding,-1,257627,chr16_15889224_16146851
Pkp2,16,16213318,16272712,protein_coding,1,59394,chr16_16213318_16272712
Yars2,16,16302965,16309640,protein_coding,1,6675,chr16_16302965_16309640
Dnm1l,16,16312230,16358959,protein_coding,-1,46729,chr16_16312230_16358959
Fgd4,16,16416917,16600549,protein_coding,-1,183632,chr16_16416917_16600549
4933404G15Rik,16,16707614,16718096,lincRNA,-1,10482,chr16_16707614_16718096
Spag6l,16,16753016,16829456,protein_coding,-1,76440,chr16_16753016_16829456
Igll1,16,16860671,16863985,protein_coding,-1,3314,chr16_16860671_16863985
Vpreb1,16,16868403,16870843,protein_coding,-1,2440,chr16_16868403_16870843
Top3b,16,16870736,16892990,protein_coding,1,22254,chr16_16870736_16892990
Ppm1f,16,16896469,16927364,protein_coding,1,30895,chr16_16896469_16927364
Mapk1,16,16983382,17047453,protein_coding,1,64071,chr16_16983382_17047453
1700056N10Rik,16,17047520,17049111,lincRNA,1,1591,chr16_17047520_17049111
Ypel1,16,17069696,17087045,protein_coding,1,17349,chr16_17069696_17087045
Ppil2,16,17086555,17111257,protein_coding,-1,24702,chr16_17086555_17111257
2610318N02Rik,16,17113398,17125167,protein_coding,-1,11769,chr16_17113398_17125167
Sdf2l1,16,17130138,17132383,protein_coding,-1,2245,chr16_17130138_17132383
Ccdc116,16,17139064,17147229,protein_coding,-1,8165,chr16_17139064_17147229
Ydjc,16,17144621,17160701,protein_coding,1,16080,chr16_17144621_17160701
Ube2l3,16,17152013,17202649,protein_coding,-1,50636,chr16_17152013_17202649
Rimbp3,16,17208603,17213982,protein_coding,1,5379,chr16_17208603_17213982
Hic2,16,17233572,17263430,protein_coding,1,29858,chr16_17233572_17263430
Tmem191c,16,17276077,17283229,protein_coding,1,7152,chr16_17276077_17283229
Pi4ka,16,17280351,17406314,protein_coding,-1,125963,chr16_17280351_17406314
Serpind1,16,17331371,17343575,protein_coding,1,12204,chr16_17331371_17343575
Snap29,16,17405986,17430827,protein_coding,1,24841,chr16_17405986_17430827
Crkl,16,17451987,17487434,protein_coding,1,35447,chr16_17451987_17487434
Aifm3,16,17489611,17507485,protein_coding,1,17874,chr16_17489611_17507485
Lztr1,16,17508688,17526333,protein_coding,1,17645,chr16_17508688_17526333
Thap7,16,17527982,17531136,protein_coding,-1,3154,chr16_17527982_17531136
Lrrc74b,16,17544465,17561247,protein_coding,-1,16782,chr16_17544465_17561247
P2rx6,16,17561885,17577800,protein_coding,1,15915,chr16_17561885_17577800
Slc7a4,16,17572018,17583214,protein_coding,-1,11196,chr16_17572018_17583214
Smpd4,16,17619354,17644828,protein_coding,1,25474,chr16_17619354_17644828
Ccdc74a,16,17646470,17650738,protein_coding,1,4268,chr16_17646470_17650738
Med15,16,17651208,17732891,protein_coding,-1,81683,chr16_17651208_17732891
Klhl22,16,17759618,17793382,protein_coding,1,33764,chr16_17759618_17793382
Scarf2,16,17797282,17808293,protein_coding,1,11011,chr16_17797282_17808293
Car15,16,17835276,17838364,protein_coding,-1,3088,chr16_17835276_17838364
Gm20518,16,17835277,17891671,protein_coding,-1,56394,chr16_17835277_17891671
Dgcr2,16,17839482,17898562,protein_coding,-1,59080,chr16_17839482_17898562
Tssk1,16,17894223,17897922,protein_coding,1,3699,chr16_17894223_17897922
Slc25a1,16,17925223,17928219,protein_coding,-1,2996,chr16_17925223_17928219
Dgcr6,16,18052860,18071632,protein_coding,1,18772,chr16_18052860_18071632
Prodh,16,18060357,18090203,protein_coding,-1,29846,chr16_18060357_18090203
Rtn4r,16,18127642,18152408,protein_coding,1,24766,chr16_18127642_18152408
4933432I09Rik,16,18207822,18213863,lincRNA;lncRNA,-1,6041,chr16_18207822_18213863
Ccdc188,16,18217879,18220348,protein_coding,1,2469,chr16_18217879_18220348
Zdhhc8,16,18220753,18235136,protein_coding,-1,14383,chr16_18220753_18235136
Ranbp1,16,18239784,18248732,protein_coding,-1,8948,chr16_18239784_18248732
Trmt2a,16,18248679,18254772,protein_coding,1,6093,chr16_18248679_18254772
Dgcr8,16,18253948,18289246,protein_coding,-1,35298,chr16_18253948_18289246
Tango2,16,18300825,18348103,protein_coding,-1,47278,chr16_18300825_18348103
Arvcf,16,18348182,18407958,protein_coding,1,59776,chr16_18348182_18407958
Comt,16,18406886,18427738,protein_coding,-1,20852,chr16_18406886_18427738
Txnrd2,16,18426384,18479959,protein_coding,1,53575,chr16_18426384_18479959
Gnb1l,16,18498713,18566679,protein_coding,1,67966,chr16_18498713_18566679
Tbx1,16,18580979,18590671,protein_coding,-1,9692,chr16_18580979_18590671
4930588K23Rik,16,18591992,18609751,lincRNA,1,17759,chr16_18591992_18609751
Gp1bb,16,18620317,18622403,protein_coding,-1,2086,chr16_18620317_18622403
Cldn5,16,18776847,18778262,protein_coding,1,1415,chr16_18776847_18778262
Cdc45,16,18780447,18811987,protein_coding,-1,31540,chr16_18780447_18811987
Ufd1,16,18811779,18835261,protein_coding,1,23482,chr16_18811779_18835261
2510002D24Rik,16,18836578,18840160,protein_coding,1,3582,chr16_18836578_18840160
Gm28539,16,18836584,18956247,protein_coding,1,119663,chr16_18836584_18956247
Mrpl40,16,18872018,18876862,protein_coding,-1,4844,chr16_18872018_18876862
Hira,16,18877037,18970309,protein_coding,1,93272,chr16_18877037_18970309
2010309G21Rik,16,19051367,19106749,antisense,1,55382,chr16_19051367_19106749
Iglc2,16,19198396,19200351,IG_C_gene,-1,1955,chr16_19198396_19200351
Gm43388,16,19212660,19236776,lincRNA,-1,24116,chr16_19212660_19236776
Olfr164,16,19284104,19314064,protein_coding,-1,29960,chr16_19284104_19314064
Olfr165,16,19406244,19423134,protein_coding,-1,16890,chr16_19406244_19423134
Olfr166,16,19483694,19489882,protein_coding,1,6188,chr16_19483694_19489882
Olfr167,16,19509558,19522266,protein_coding,-1,12708,chr16_19509558_19522266
Olfr168,16,19529274,19535555,protein_coding,-1,6281,chr16_19529274_19535555
Lamp3,16,19653378,19706375,protein_coding,-1,52997,chr16_19653378_19706375
B3gnt5,16,19760208,19772753,protein_coding,1,12545,chr16_19760208_19772753
A930003A15Rik,16,19876567,19884274,protein_coding,-1,7707,chr16_19876567_19884274
Klhl6,16,19946496,19983037,protein_coding,-1,36541,chr16_19946496_19983037
Klhl24,16,20097542,20129221,protein_coding,1,31679,chr16_20097542_20129221
Yeats2,16,20141063,20232573,protein_coding,1,91510,chr16_20141063_20232573
Map6d1,16,20233303,20241358,protein_coding,-1,8055,chr16_20233303_20241358
Parl,16,20279818,20302387,protein_coding,-1,22569,chr16_20279818_20302387
Cyp2ab1,16,20308387,20325404,protein_coding,-1,17017,chr16_20308387_20325404
Abcc5,16,20331303,20426394,protein_coding,-1,95091,chr16_20331303_20426394
Eif2b5,16,20498817,20509323,protein_coding,1,10506,chr16_20498817_20509323
Gm16618,16,20511133,20517766,antisense,-1,6633,chr16_20511133_20517766
Dvl3,16,20516982,20534010,protein_coding,1,17028,chr16_20516982_20534010
Ap2m1,16,20535478,20544909,protein_coding,1,9431,chr16_20535478_20544909
Abcf3,16,20548577,20561379,protein_coding,1,12802,chr16_20548577_20561379
Vwa5b2,16,20589471,20605377,protein_coding,1,15906,chr16_20589471_20605377
Alg3,16,20605374,20611735,protein_coding,-1,6361,chr16_20605374_20611735
Gm49333,16,20611610,20645920,protein_coding,1,34310,chr16_20611610_20645920
Camk2n2,16,20619215,20621287,protein_coding,-1,2072,chr16_20619215_20621287
Ece2,16,20629828,20646485,protein_coding,1,16657,chr16_20629828_20646485
Psmd2,16,20651652,20663414,protein_coding,1,11762,chr16_20651652_20663414
Eif4g1,16,20668313,20692884,protein_coding,1,24571,chr16_20668313_20692884
Fam131a,16,20693241,20703048,protein_coding,1,9807,chr16_20693241_20703048
Clcn2,16,20702964,20717746,protein_coding,-1,14782,chr16_20702964_20717746
Polr2h,16,20717665,20722267,protein_coding,1,4602,chr16_20717665_20722267
Thpo,16,20724454,20734511,protein_coding,-1,10057,chr16_20724454_20734511
Chrd,16,20733127,20742384,protein_coding,1,9257,chr16_20733127_20742384
Teddm3,16,21152655,21154000,protein_coding,-1,1345,chr16_21152655_21154000
Ephb3,16,21204755,21223305,protein_coding,1,18550,chr16_21204755_21223305
Gm16863,16,21247499,21296872,lincRNA,-1,49373,chr16_21247499_21296872
Vps8,16,21423118,21644680,protein_coding,1,221562,chr16_21423118_21644680
2510009E07Rik,16,21649045,21694665,protein_coding,-1,45620,chr16_21649045_21694665
Ehhadh,16,21761287,21787807,protein_coding,-1,26520,chr16_21761287_21787807
1300002E11Rik,16,21794318,21809040,lincRNA,1,14722,chr16_21794318_21809040
Map3k13,16,21794346,21933439,protein_coding,1,139093,chr16_21794346_21933439
Gm26744,16,21843451,21845776,lincRNA,-1,2325,chr16_21843451_21845776
Tmem41a,16,21934326,21947552,protein_coding,-1,13226,chr16_21934326_21947552
Liph,16,21953817,21995663,protein_coding,-1,41846,chr16_21953817_21995663
Senp2,16,22009484,22049269,protein_coding,1,39785,chr16_22009484_22049269
Igf2bp2,16,22059009,22163299,protein_coding,-1,104290,chr16_22059009_22163299
Tra2b,16,22244549,22266005,protein_coding,-1,21456,chr16_22244549_22266005
Etv5,16,22381309,22439719,protein_coding,-1,58410,chr16_22381309_22439719
Dgkg,16,22468461,22657221,protein_coding,-1,188760,chr16_22468461_22657221
9230117E06Rik,16,22511480,22517681,antisense,1,6201,chr16_22511480_22517681
Gm15651,16,22548553,22551149,antisense,1,2596,chr16_22548553_22551149
Tbccd1,16,22813214,22857669,protein_coding,-1,44455,chr16_22813214_22857669
Dnajb11,16,22857845,22879634,protein_coding,1,21789,chr16_22857845_22879634
Fetub,16,22918334,22939778,protein_coding,1,21444,chr16_22918334_22939778
Hrg,16,22951072,22961656,protein_coding,1,10584,chr16_22951072_22961656
Kng2,16,22985854,23029482,protein_coding,-1,43628,chr16_22985854_23029482
Kng1,16,23057865,23082078,protein_coding,1,24213,chr16_23057865_23082078
Eif4a2,16,23107444,23114136,protein_coding,1,6692,chr16_23107444_23114136
Rfc4,16,23113943,23127737,protein_coding,-1,13794,chr16_23113943_23127737
Adipoq,16,23146536,23158028,protein_coding,1,11492,chr16_23146536_23158028
B630019A10Rik,16,23175280,23224446,antisense,1,49166,chr16_23175280_23224446
St6gal1,16,23224740,23360350,protein_coding,1,135610,chr16_23224740_23360350
Masp1,16,23449417,23520815,protein_coding,-1,71398,chr16_23449417_23520815
Rtp4,16,23520291,23614222,protein_coding,1,93931,chr16_23520291_23614222
Sst,16,23889573,23890958,protein_coding,-1,1385,chr16_23889573_23890958
Rtp2,16,23925548,23932394,protein_coding,-1,6846,chr16_23925548_23932394
Bcl6,16,23965052,23988852,protein_coding,-1,23800,chr16_23965052_23988852
Gm37419,16,23988482,23988595,protein_coding,1,113,chr16_23988482_23988595
Lpp,16,24393507,24992578,protein_coding,1,599071,chr16_24393507_24992578
A230028O05Rik,16,25059639,25069058,lincRNA,1,9419,chr16_25059639_25069058
Tprg,16,25286817,25422344,protein_coding,1,135527,chr16_25286817_25422344
Trp63,16,25683763,25892102,protein_coding,1,208339,chr16_25683763_25892102
Gm4524,16,25956475,25960342,antisense,1,3867,chr16_25956475_25960342
P3h2,16,25959288,26105784,protein_coding,-1,146496,chr16_25959288_26105784
Cldn1,16,26356642,26371841,protein_coding,-1,15199,chr16_26356642_26371841
Cldn16,16,26463135,26482765,protein_coding,1,19630,chr16_26463135_26482765
Tmem207,16,26503656,26526769,protein_coding,-1,23113,chr16_26503656_26526769
Il1rap,16,26581704,26730117,protein_coding,1,148413,chr16_26581704_26730117
Gm20319,16,26714446,26755502,antisense,-1,41056,chr16_26714446_26755502
Gmnc,16,26913553,26991652,protein_coding,-1,78099,chr16_26913553_26991652
Ostn,16,27307489,27351212,protein_coding,1,43723,chr16_27307489_27351212
Uts2b,16,27353322,27370239,protein_coding,-1,16917,chr16_27353322_27370239
Ccdc50,16,27388869,27452218,protein_coding,1,63349,chr16_27388869_27452218
Fgf12,16,28160098,28753068,protein_coding,-1,592970,chr16_28160098_28753068
Mb21d2,16,28826176,28929673,protein_coding,-1,103497,chr16_28826176_28929673
Atp13a5,16,29231851,29378732,protein_coding,-1,146881,chr16_29231851_29378732
Atp13a4,16,29395853,29544864,protein_coding,-1,149011,chr16_29395853_29544864
Opa1,16,29579334,29654884,protein_coding,1,75550,chr16_29579334_29654884
Gm26834,16,29811058,29837814,lincRNA,1,26756,chr16_29811058_29837814
Gm26569,16,29907519,29946754,processed_transcript,-1,39235,chr16_29907519_29946754
Gm1968,16,29957927,29979184,lincRNA,-1,21257,chr16_29957927_29979184
4632428C04Rik,16,30008667,30021430,lincRNA,1,12763,chr16_30008667_30021430
9030404E10Rik,16,30021842,30039479,lincRNA,-1,17637,chr16_30021842_30039479
Hes1,16,30064384,30067796,protein_coding,1,3412,chr16_30064384_30067796
1700025H01Rik,16,30195071,30200299,lincRNA,1,5228,chr16_30195071_30200299
Gm26562,16,30200910,30205879,lincRNA,-1,4969,chr16_30200910_30205879
Cpn2,16,30256378,30267499,protein_coding,-1,11121,chr16_30256378_30267499
Lrrc15,16,30269302,30283256,protein_coding,-1,13954,chr16_30269302_30283256
Gp5,16,30307685,30310779,protein_coding,-1,3094,chr16_30307685_30310779
Atp13a3,16,30312423,30405975,protein_coding,-1,93552,chr16_30312423_30405975
Tmem44,16,30511855,30550842,protein_coding,-1,38987,chr16_30511855_30550842
Lsg1,16,30560494,30587592,protein_coding,-1,27098,chr16_30560494_30587592
Fam43a,16,30599723,30602797,protein_coding,1,3074,chr16_30599723_30602797
Xxylt1,16,30955144,31081432,protein_coding,-1,126288,chr16_30955144_31081432
Acap2,16,31092412,31201245,protein_coding,-1,108833,chr16_31092412_31201245
Ppp1r2,16,31251537,31275277,protein_coding,-1,23740,chr16_31251537_31275277
Apod,16,31296192,31314808,protein_coding,-1,18616,chr16_31296192_31314808
Bdh1,16,31422280,31458901,protein_coding,1,36621,chr16_31422280_31458901
Gm15743,16,31427876,31429776,antisense,-1,1900,chr16_31427876_31429776
Dlg1,16,31663443,31875129,protein_coding,1,211686,chr16_31663443_31875129
Meltf,16,31878810,31899020,protein_coding,1,20210,chr16_31878810_31899020
Pigz,16,31933851,31946046,protein_coding,1,12195,chr16_31933851_31946046
0610012G03Rik,16,31947050,31948494,protein_coding,-1,1444,chr16_31947050_31948494
Ncbp2,16,31948513,31961781,protein_coding,1,13268,chr16_31948513_31961781
Senp5,16,31959672,32003287,protein_coding,-1,43615,chr16_31959672_32003287
Pak2,16,32016290,32079342,protein_coding,-1,63052,chr16_32016290_32079342
Pigx,16,32084416,32099740,protein_coding,-1,15324,chr16_32084416_32099740
Cep19,16,32099800,32108069,protein_coding,1,8269,chr16_32099800_32108069
Gm15729,16,32108865,32113743,lincRNA,1,4878,chr16_32108865_32113743
Nrros,16,32142785,32165594,protein_coding,-1,22809,chr16_32142785_32165594
Bex6,16,32179823,32186972,protein_coding,1,7149,chr16_32179823_32186972
Fbxo45,16,32230112,32247158,protein_coding,-1,17046,chr16_32230112_32247158
Wdr53,16,32247227,32257083,protein_coding,1,9856,chr16_32247227_32257083
Smco1,16,32271468,32274781,protein_coding,1,3313,chr16_32271468_32274781
Rnf168,16,32277459,32301434,protein_coding,1,23975,chr16_32277459_32301434
Ubxn7,16,32332257,32393747,protein_coding,1,61490,chr16_32332257_32393747
Tm4sf19,16,32400506,32408227,protein_coding,1,7721,chr16_32400506_32408227
Tctex1d2,16,32419702,32429099,protein_coding,1,9397,chr16_32419702_32429099
Pcyt1a,16,32430921,32475070,protein_coding,1,44149,chr16_32430921_32475070
Slc51a,16,32474504,32487879,protein_coding,-1,13375,chr16_32474504_32487879
Zdhhc19,16,32496265,32561966,protein_coding,1,65701,chr16_32496265_32561966
Tfrc,16,32608920,32632794,protein_coding,1,23874,chr16_32608920_32632794
Tnk2,16,32643874,32683493,protein_coding,1,39619,chr16_32643874_32683493
Tnk2os,16,32665223,32668197,antisense,-1,2974,chr16_32665223_32668197
Muc4,16,32735886,32782391,protein_coding,1,46505,chr16_32735886_32782391
Muc20,16,32777419,32797435,protein_coding,-1,20016,chr16_32777419_32797435
Smbd1,16,32804760,32810477,protein_coding,-1,5717,chr16_32804760_32810477
Gm26769,16,32807483,32811206,antisense,1,3723,chr16_32807483_32811206
Rubcn,16,32821703,32877766,protein_coding,-1,56063,chr16_32821703_32877766
Fyttd1,16,32877500,32908875,protein_coding,1,31375,chr16_32877500_32908875
Lrch3,16,32914100,33015647,protein_coding,1,101547,chr16_32914100_33015647
Iqcg,16,33012683,33056218,protein_coding,-1,43535,chr16_33012683_33056218
Rpl35a,16,33056453,33060189,protein_coding,1,3736,chr16_33056453_33060189
Lmln,16,33062521,33127695,protein_coding,1,65174,chr16_33062521_33127695
Osbpl11,16,33185071,33243312,protein_coding,1,58241,chr16_33185071_33243312
Snx4,16,33251442,33300269,protein_coding,1,48827,chr16_33251442_33300269
Zfp148,16,33380836,33504363,protein_coding,1,123527,chr16_33380836_33504363
Slc12a8,16,33517328,33664135,protein_coding,1,146807,chr16_33517328_33664135
Heg1,16,33684370,33771576,protein_coding,1,87206,chr16_33684370_33771576
Gm15657,16,33770430,33796874,antisense,-1,26444,chr16_33770430_33796874
Muc13,16,33794037,33819934,protein_coding,1,25897,chr16_33794037_33819934
Itgb5,16,33829665,33949338,protein_coding,1,119673,chr16_33829665_33949338
Umps,16,33954782,33967038,protein_coding,-1,12256,chr16_33954782_33967038
Gm15829,16,33966239,33967312,antisense,1,1073,chr16_33966239_33967312
Kalrn,16,33969073,34573532,protein_coding,-1,604459,chr16_33969073_34573532
Ropn1,16,34649921,34678618,protein_coding,1,28697,chr16_34649921_34678618
Ccdc14,16,34690616,34725202,protein_coding,1,34586,chr16_34690616_34725202
Mylk,16,34745210,35002420,protein_coding,1,257210,chr16_34745210_35002420
1700119H24Rik,16,34935854,34939329,antisense,-1,3475,chr16_34935854_34939329
Hacd2,16,35022428,35109177,protein_coding,1,86749,chr16_35022428_35109177
Adcy5,16,35154877,35305738,protein_coding,1,150861,chr16_35154877_35305738
Sec22a,16,35311131,35363918,protein_coding,-1,52787,chr16_35311131_35363918
Pdia5,16,35397312,35490873,protein_coding,-1,93561,chr16_35397312_35490873
1600019K03Rik,16,35503170,35509419,lincRNA,-1,6249,chr16_35503170_35509419
Sema5b,16,35541145,35664732,protein_coding,1,123587,chr16_35541145_35664732
Hspbap1,16,35770375,35828477,protein_coding,1,58102,chr16_35770375_35828477
Gm26838,16,35805947,35808946,antisense,-1,2999,chr16_35805947_35808946
Parp14,16,35832874,35871544,protein_coding,-1,38670,chr16_35832874_35871544
Dtx3l,16,35926511,35939151,protein_coding,-1,12640,chr16_35926511_35939151
Parp9,16,35938470,35972605,protein_coding,1,34135,chr16_35938470_35972605
Gm15564,16,35966752,35983230,antisense,-1,16478,chr16_35966752_35983230
Kpna1,16,35978750,36037131,protein_coding,1,58381,chr16_35978750_36037131
Wdr5b,16,36041190,36043928,protein_coding,1,2738,chr16_36041190_36043928
Fam162a,16,36043761,36071594,protein_coding,-1,27833,chr16_36043761_36071594
Ccdc58,16,36071685,36092120,protein_coding,1,20435,chr16_36071685_36092120
Csta1,16,36119946,36131241,protein_coding,-1,11295,chr16_36119946_36131241
Stfa2l1,16,36156811,36161953,protein_coding,1,5142,chr16_36156811_36161953
Stfa1,16,36276951,36285373,protein_coding,1,8422,chr16_36276951_36285373
Gm15845,16,36367070,36387406,antisense,1,20336,chr16_36367070_36387406
Stfa2,16,36403992,36408457,protein_coding,-1,4465,chr16_36403992_36408457
Stfa3,16,36450537,36455392,protein_coding,-1,4855,chr16_36450537_36455392
Casr,16,36493696,36562141,protein_coding,-1,68445,chr16_36493696_36562141
Cd86,16,36603869,36666081,protein_coding,-1,62212,chr16_36603869_36666081
Ildr1,16,36693978,36726804,protein_coding,1,32826,chr16_36693978_36726804
Slc15a2,16,36750177,36784962,protein_coding,-1,34785,chr16_36750177_36784962
Eaf2,16,36792884,36875003,protein_coding,-1,82119,chr16_36792884_36875003
Iqcb1,16,36828385,36872721,protein_coding,1,44336,chr16_36828385_36872721
Golgb1,16,36875140,36933085,protein_coding,1,57945,chr16_36875140_36933085
4930565N06Rik,16,36880519,36897189,antisense,-1,16670,chr16_36880519_36897189
Hcls1,16,36934983,36963212,protein_coding,1,28229,chr16_36934983_36963212
Fbxo40,16,36963460,36990467,protein_coding,-1,27007,chr16_36963460_36990467
Polq,16,37011786,37095417,protein_coding,1,83631,chr16_37011786_37095417
Stxbp5l,16,37114942,37384962,protein_coding,-1,270020,chr16_37114942_37384962
Gtf2e1,16,37509790,37539789,protein_coding,-1,29999,chr16_37509790_37539789
Rabl3,16,37539885,37572385,protein_coding,1,32500,chr16_37539885_37572385
Hgd,16,37580153,37632020,protein_coding,1,51867,chr16_37580153_37632020
Ndufb4,16,37647170,37654453,protein_coding,-1,7283,chr16_37647170_37654453
Fstl1,16,37776873,37836514,protein_coding,1,59641,chr16_37776873_37836514
Gm36028,16,37850913,37861146,protein_coding,-1,10233,chr16_37850913_37861146
Lrrc58,16,37868389,37888858,protein_coding,1,20469,chr16_37868389_37888858
Gpr156,16,37916496,38007530,protein_coding,1,91034,chr16_37916496_38007530
Gsk3b,16,38089001,38246084,protein_coding,1,157083,chr16_38089001_38246084
Nr1i2,16,38248323,38294824,protein_coding,-1,46501,chr16_38248323_38294824
Maats1,16,38297754,38342143,protein_coding,-1,44389,chr16_38297754_38342143
Cox17,16,38346991,38352763,protein_coding,1,5772,chr16_38346991_38352763
Gm21987,16,38347040,38362297,protein_coding,1,15257,chr16_38347040_38362297
Popdc2,16,38362209,38378216,protein_coding,1,16007,chr16_38362209_38378216
Pla1a,16,38396117,38433145,protein_coding,-1,37028,chr16_38396117_38433145
Adprh,16,38444030,38452703,protein_coding,-1,8673,chr16_38444030_38452703
D930030I03Rik,16,38451982,38453494,antisense,1,1512,chr16_38451982_38453494
Cd80,16,38455561,38496335,protein_coding,1,40774,chr16_38455561_38496335
Timmdc1,16,38498347,38522663,protein_coding,-1,24316,chr16_38498347_38522663
Poglut1,16,38525137,38550258,protein_coding,-1,25121,chr16_38525137_38550258
Tmem39a,16,38558698,38592162,protein_coding,1,33464,chr16_38558698_38592162
Gm17103,16,38569323,38573300,antisense,-1,3977,chr16_38569323_38573300
Arhgap31,16,38598340,38713274,protein_coding,-1,114934,chr16_38598340_38713274
B4galt4,16,38742264,38769049,protein_coding,1,26785,chr16_38742264_38769049
Upk1b,16,38773184,38800328,protein_coding,-1,27144,chr16_38773184_38800328
Gm15802,16,38828906,38966070,antisense,1,137164,chr16_38828906_38966070
Igsf11,16,38892671,39027159,protein_coding,1,134488,chr16_38892671_39027159
Lsamp,16,39984361,42181679,protein_coding,1,2197318,chr16_39984361_42181679
Gm28750,16,41413166,41431092,antisense,-1,17926,chr16_41413166_41431092
Gap43,16,42248442,42340651,protein_coding,-1,92209,chr16_42248442_42340651
4932412D23Rik,16,42725702,42875762,lincRNA,-1,150060,chr16_42725702_42875762
Zbtb20,16,42875881,43642602,protein_coding,1,766721,chr16_42875881_43642602
Gm9968,16,43345887,43363666,antisense,-1,17779,chr16_43345887_43363666
Gm15713,16,43410518,43420196,antisense,-1,9678,chr16_43410518_43420196
Tigit,16,43648867,43664146,protein_coding,-1,15279,chr16_43648867_43664146
Drd3,16,43754026,43822932,protein_coding,1,68906,chr16_43754026_43822932
Qtrt2,16,43861407,43926809,protein_coding,-1,65402,chr16_43861407_43926809
Ccdc191,16,43889800,43964314,protein_coding,1,74514,chr16_43889800_43964314
Zdhhc23,16,43965033,43979791,protein_coding,-1,14758,chr16_43965033_43979791
Gramd1c,16,43980350,44063345,protein_coding,-1,82995,chr16_43980350_44063345
Atp6v1a,16,44085402,44139705,protein_coding,-1,54303,chr16_44085402_44139705
Naa50,16,44139830,44163366,protein_coding,1,23536,chr16_44139830_44163366
Usf3,16,44173246,44227465,protein_coding,1,54219,chr16_44173246_44227465
Sidt1,16,44240180,44333196,protein_coding,-1,93016,chr16_44240180_44333196
Spice1,16,44347121,44388497,protein_coding,1,41376,chr16_44347121_44388497
Cfap44,16,44394796,44482428,protein_coding,1,87632,chr16_44394796_44482428
Boc,16,44485049,44558897,protein_coding,-1,73848,chr16_44485049_44558897
Nepro,16,44724301,44737284,protein_coding,1,12983,chr16_44724301_44737284
Gtpbp8,16,44736768,44746363,protein_coding,-1,9595,chr16_44736768_44746363
Cd200r1,16,44765736,44794978,protein_coding,1,29242,chr16_44765736_44794978
Cd200r4,16,44811733,44839150,protein_coding,1,27417,chr16_44811733_44839150
Cd200r2,16,44867097,44915840,protein_coding,1,48743,chr16_44867097_44915840
Cd200r3,16,44943678,44981380,protein_coding,1,37702,chr16_44943678_44981380
Ccdc80,16,45093402,45128077,protein_coding,1,34675,chr16_45093402_45128077
Slc35a5,16,45139573,45158706,protein_coding,-1,19133,chr16_45139573_45158706
Atg3,16,45158785,45188538,protein_coding,1,29753,chr16_45158785_45188538
Btla,16,45224315,45257670,protein_coding,1,33355,chr16_45224315_45257670
Cd200,16,45382135,45409053,protein_coding,-1,26918,chr16_45382135_45409053
Gm609,16,45411768,45492969,protein_coding,-1,81201,chr16_45411768_45492969
Gm17783,16,45511791,45532050,protein_coding,-1,20259,chr16_45511791_45532050
Slc9c1,16,45535309,45607001,protein_coding,1,71692,chr16_45535309_45607001
Gcsam,16,45610380,45622867,protein_coding,1,12487,chr16_45610380_45622867
BC016579,16,45626848,45654068,protein_coding,-1,27220,chr16_45626848_45654068
Tmprss7,16,45656315,45693658,protein_coding,-1,37343,chr16_45656315_45693658
Tagln3,16,45711230,45724608,protein_coding,-1,13378,chr16_45711230_45724608
Abhd10,16,45729725,45742955,protein_coding,-1,13230,chr16_45729725_45742955
Gm15591,16,45736503,45737318,antisense,1,815,chr16_45736503_45737318
Phldb2,16,45746243,45953598,protein_coding,-1,207355,chr16_45746243_45953598
Gm15640,16,45936323,45939279,antisense,1,2956,chr16_45936323_45939279
Gm15638,16,45945606,45971370,antisense,1,25764,chr16_45945606_45971370
Plcxd2,16,45959263,46010218,protein_coding,-1,50955,chr16_45959263_46010218
Cd96,16,46035657,46120251,protein_coding,-1,84594,chr16_46035657_46120251
Gm4737,16,46152985,46155077,protein_coding,-1,2092,chr16_46152985_46155077
Nectin3,16,46387706,46498525,protein_coding,-1,110819,chr16_46387706_46498525
Dppa4,16,48283733,48294237,protein_coding,1,10504,chr16_48283733_48294237
Dppa2,16,48303908,48319723,protein_coding,1,15815,chr16_48303908_48319723
Gm5485,16,48399453,48412416,protein_coding,-1,12963,chr16_48399453_48412416
Morc1,16,48431237,48630900,protein_coding,1,199663,chr16_48431237_48630900
Trat1,16,48730774,48772021,protein_coding,-1,41247,chr16_48730774_48772021
Retnlb,16,48816856,48818892,protein_coding,1,2036,chr16_48816856_48818892
Retnla,16,48842551,48844461,protein_coding,1,1910,chr16_48842551_48844461
Retnlg,16,48872621,48874496,protein_coding,1,1875,chr16_48872621_48874496
Dzip3,16,48924232,48994165,protein_coding,-1,69933,chr16_48924232_48994165
Myh15,16,49057486,49199104,protein_coding,1,141618,chr16_49057486_49199104
1700026J12Rik,16,49210641,49255772,lincRNA,-1,45131,chr16_49210641_49255772
Ift57,16,49699233,49765126,protein_coding,1,65893,chr16_49699233_49765126
Gm15518,16,49758576,49798870,antisense,-1,40294,chr16_49758576_49798870
Cd47,16,49800533,49915010,protein_coding,1,114477,chr16_49800533_49915010
Bbx,16,50191844,50432390,protein_coding,-1,240546,chr16_50191844_50432390
G730013B05Rik,16,50526245,50559459,lincRNA,1,33214,chr16_50526245_50559459
Dubr,16,50719294,50732773,lincRNA,-1,13479,chr16_50719294_50732773
Cblb,16,52031225,52208048,protein_coding,1,176823,chr16_52031225_52208048
Alcam,16,52248996,52454074,protein_coding,-1,205078,chr16_52248996_52454074
Zpld1,16,55225175,55297986,protein_coding,-1,72811,chr16_55225175_55297986
Nfkbiz,16,55811375,55838899,protein_coding,-1,27524,chr16_55811375_55838899
Nxpe3,16,55839953,55895285,protein_coding,-1,55332,chr16_55839953_55895285
Cep97,16,55899888,55934855,protein_coding,-1,34967,chr16_55899888_55934855
Rpl24,16,55966275,55971435,protein_coding,1,5160,chr16_55966275_55971435
Zbtb11os1,16,55973268,55974617,antisense,-1,1349,chr16_55973268_55974617
Zbtb11,16,55973883,56008913,protein_coding,1,35030,chr16_55973883_56008913
Pcnp,16,56007245,56029739,protein_coding,-1,22494,chr16_56007245_56029739
Trmt10c,16,56032609,56037819,protein_coding,-1,5210,chr16_56032609_56037819
Senp7,16,56048338,56190012,protein_coding,1,141674,chr16_56048338_56190012
Impg2,16,56204313,56273756,protein_coding,1,69443,chr16_56204313_56273756
Abi3bp,16,56477878,56690135,protein_coding,1,212257,chr16_56477878_56690135
Tfg,16,56690332,56717450,protein_coding,-1,27118,chr16_56690332_56717450
Adgrg7,16,56724609,56795855,protein_coding,-1,71246,chr16_56724609_56795855
Tmem45a,16,56805161,56886166,protein_coding,-1,81005,chr16_56805161_56886166
Gm15839,16,56886367,56921506,antisense,1,35139,chr16_56886367_56921506
Lnp1,16,56914344,56928061,protein_coding,-1,13717,chr16_56914344_56928061
Tmem45a2,16,57036967,57071372,protein_coding,-1,34405,chr16_57036967_57071372
Tomm70a,16,57121703,57156705,protein_coding,1,35002,chr16_57121703_57156705
Nit2,16,57156665,57167341,protein_coding,-1,10676,chr16_57156665_57167341
Gm16892,16,57167401,57174413,antisense,1,7012,chr16_57167401_57174413
Tbc1d23,16,57168862,57231504,protein_coding,-1,62642,chr16_57168862_57231504
Tmem30c,16,57266139,57292865,protein_coding,-1,26726,chr16_57266139_57292865
Gm26800,16,57280890,57281496,antisense,1,606,chr16_57280890_57281496
Cmss1,16,57302000,57606864,protein_coding,-1,304864,chr16_57302000_57606864
Filip1l,16,57353093,57573126,protein_coding,1,220033,chr16_57353093_57573126
Col8a1,16,57624258,57754737,protein_coding,-1,130479,chr16_57624258_57754737
4930461C15Rik,16,58404878,58408276,lincRNA,-1,3398,chr16_58404878_58408276
Dcbld2,16,58408443,58469727,protein_coding,1,61284,chr16_58408443_58469727
St3gal6,16,58468125,58524243,protein_coding,-1,56118,chr16_58468125_58524243
Cpox,16,58670292,58717636,protein_coding,1,47344,chr16_58670292_58717636
Cldnd1,16,58727910,58734251,protein_coding,1,6341,chr16_58727910_58734251
Olfr172,16,58759544,58763176,protein_coding,-1,3632,chr16_58759544_58763176
Olfr177,16,58870955,58874768,protein_coding,-1,3813,chr16_58870955_58874768
Olfr190,16,59067140,59078005,protein_coding,-1,10865,chr16_59067140_59078005
Olfr204,16,59310206,59318248,protein_coding,-1,8042,chr16_59310206_59318248
Olfr205,16,59328005,59331138,protein_coding,-1,3133,chr16_59328005_59331138
Gabrr3,16,59407332,59464504,protein_coding,1,57172,chr16_59407332_59464504
Riox2,16,59471775,59492461,protein_coding,1,20686,chr16_59471775_59492461
Crybg3,16,59490775,59600979,protein_coding,-1,110204,chr16_59490775_59600979
Arl6,16,59612949,59639391,protein_coding,-1,26442,chr16_59612949_59639391
Epha6,16,59653483,60605531,protein_coding,-1,952048,chr16_59653483_60605531
Gm9017,16,60604766,60611236,antisense,1,6470,chr16_60604766_60611236
Nsun3,16,62732444,62786818,protein_coding,-1,54374,chr16_62732444_62786818
Arl13b,16,62793685,62847040,protein_coding,-1,53355,chr16_62793685_62847040
Stx19,16,62814676,62824346,protein_coding,1,9670,chr16_62814676_62824346
Pros1,16,62854307,62929346,protein_coding,1,75039,chr16_62854307_62929346
Epha3,16,63543534,63864175,protein_coding,-1,320641,chr16_63543534_63864175
Csnka2ip,16,64477810,64602408,protein_coding,-1,124598,chr16_64477810_64602408
4930453N24Rik,16,64751751,64771161,protein_coding,-1,19410,chr16_64751751_64771161
Zfp654,16,64780347,64851652,protein_coding,-1,71305,chr16_64780347_64851652
Cggbp1,16,64851996,64859507,protein_coding,1,7511,chr16_64851996_64859507
Htr1f,16,64924729,65105854,protein_coding,-1,181125,chr16_64924729_65105854
Pou1f1,16,65520511,65535005,protein_coding,1,14494,chr16_65520511_65535005
Chmp2b,16,65539128,65562726,protein_coding,-1,23598,chr16_65539128_65562726
Vgll3,16,65815257,65866368,protein_coding,1,51111,chr16_65815257_65866368
Cadm2,16,66655421,67620908,protein_coding,-1,965487,chr16_66655421_67620908
1700010K23Rik,16,66657118,66664626,antisense,1,7508,chr16_66657118_66664626
4933411O13Rik,16,66892503,66910841,antisense,1,18338,chr16_66892503_66910841
Speer2,16,69856874,69863744,protein_coding,-1,6870,chr16_69856874_69863744
Gbe1,16,70313949,70569716,protein_coding,1,255767,chr16_70313949_70569716
D16Ertd519e,16,70616425,70624824,lincRNA,1,8399,chr16_70616425_70624824
4931420L22Rik,16,71131076,71139029,lincRNA,1,7953,chr16_71131076_71139029
Robo1,16,72308306,73046095,protein_coding,1,737789,chr16_72308306_73046095
Robo2,16,73891839,74411825,protein_coding,-1,519986,chr16_73891839_74411825
Lipi,16,75540514,75586061,protein_coding,-1,45547,chr16_75540514_75586061
Rbm11,16,75592844,75602829,protein_coding,1,9985,chr16_75592844_75602829
Hspa13,16,75745431,75767104,protein_coding,-1,21673,chr16_75745431_75767104
Samsn1,16,75858793,76022281,protein_coding,-1,163488,chr16_75858793_76022281
Gm15555,16,76000784,76034602,antisense,1,33818,chr16_76000784_76034602
Nrip1,16,76287400,76373827,protein_coding,-1,86427,chr16_76287400_76373827
Gm45030,16,76427743,76502909,lincRNA,-1,75166,chr16_76427743_76502909
Gm45029,16,76680513,76741443,lincRNA,1,60930,chr16_76680513_76741443
Gm30790,16,76751793,76779092,lincRNA,-1,27299,chr16_76751793_76779092
1700041M19Rik,16,76819583,77010897,lincRNA,-1,191314,chr16_76819583_77010897
Usp25,16,77013706,77116780,protein_coding,1,103074,chr16_77013706_77116780
Gm11146,16,77588578,77602094,protein_coding,-1,13516,chr16_77588578_77602094
Gm17333,16,77846604,77853084,lincRNA,1,6480,chr16_77846604_77853084
Cxadr,16,78301489,78359774,protein_coding,1,58285,chr16_78301489_78359774
Btg3,16,78332637,78377192,protein_coding,-1,44555,chr16_78332637_78377192
D16Ertd472e,16,78540338,78576708,protein_coding,-1,36370,chr16_78540338_78576708
Chodl,16,78930948,78951733,protein_coding,1,20785,chr16_78930948_78951733
Tmprss15,16,78953008,79091097,protein_coding,-1,138089,chr16_78953008_79091097
1700066C05Rik,16,79999376,80000546,lincRNA,1,1170,chr16_79999376_80000546
Ncam2,16,81200697,81626828,protein_coding,1,426131,chr16_81200697_81626828
Gm21833,16,82828382,82829881,protein_coding,1,1499,chr16_82828382_82829881
A730009L09Rik,16,84515121,84523888,protein_coding,1,8767,chr16_84515121_84523888
Mir155hg,16,84703167,84715245,lincRNA,1,12078,chr16_84703167_84715245
Mrpl39,16,84717576,84735742,protein_coding,-1,18166,chr16_84717576_84735742
Jam2,16,84774123,84825928,protein_coding,1,51805,chr16_84774123_84825928
Atp5j,16,84827866,84835625,protein_coding,-1,7759,chr16_84827866_84835625
Gabpa,16,84834925,84863779,protein_coding,1,28854,chr16_84834925_84863779
App,16,84949685,85173766,protein_coding,-1,224081,chr16_84949685_85173766
Gm10791,16,84972214,84979451,antisense,1,7237,chr16_84972214_84979451
Gm49227,16,85080111,85083392,antisense,1,3281,chr16_85080111_85083392
Gm49226,16,85148829,85155274,antisense,1,6445,chr16_85148829_85155274
Cyyr1,16,85421533,85553397,protein_coding,-1,131864,chr16_85421533_85553397
Adamts1,16,85793827,85803113,protein_coding,-1,9286,chr16_85793827_85803113
Adamts5,16,85856173,85901828,protein_coding,-1,45655,chr16_85856173_85901828
N6amt1,16,87354185,87368742,protein_coding,1,14557,chr16_87354185_87368742
Ltn1,16,87376651,87432612,protein_coding,-1,55961,chr16_87376651_87432612
Rwdd2b,16,87433407,87440573,protein_coding,-1,7166,chr16_87433407_87440573
Usp16,16,87454703,87483517,protein_coding,1,28814,chr16_87454703_87483517
Cct8,16,87483326,87495873,protein_coding,-1,12547,chr16_87483326_87495873
Map3k7cl,16,87553330,87595336,protein_coding,1,42006,chr16_87553330_87595336
Bach1,16,87698945,87733346,protein_coding,1,34401,chr16_87698945_87733346
2810407A14Rik,16,87784075,87839293,lincRNA,1,55218,chr16_87784075_87839293
Grik1,16,87895900,88290265,protein_coding,-1,394365,chr16_87895900_88290265
Tiam1,16,89787111,90143769,protein_coding,-1,356658,chr16_89787111_90143769
Sod1,16,90220754,90226329,protein_coding,1,5575,chr16_90220754_90226329
Scaf4,16,90225680,90284503,protein_coding,-1,58823,chr16_90225680_90284503
Hunk,16,90386013,90499553,protein_coding,1,113540,chr16_90386013_90499553
1110008E08Rik,16,90554164,90554886,lincRNA,1,722,chr16_90554164_90554886
Mis18a,16,90719312,90727404,protein_coding,-1,8092,chr16_90719312_90727404
Mrap,16,90738207,90749785,protein_coding,1,11578,chr16_90738207_90749785
Urb1,16,90751527,90810413,protein_coding,-1,58886,chr16_90751527_90810413
Eva1c,16,90826719,90905109,protein_coding,1,78390,chr16_90826719_90905109
Synj1,16,90936092,91011308,protein_coding,-1,75216,chr16_90936092_91011308
Gm15965,16,90983907,90987237,antisense,1,3330,chr16_90983907_90987237
Paxbp1,16,91014037,91044543,protein_coding,-1,30506,chr16_91014037_91044543
4931406G06Rik,16,91044656,91056677,antisense,1,12021,chr16_91044656_91056677
4932438H23Rik,16,91053935,91095122,protein_coding,-1,41187,chr16_91053935_91095122
Olig2,16,91225457,91228677,protein_coding,1,3220,chr16_91225457_91228677
Olig1,16,91269772,91271933,protein_coding,1,2161,chr16_91269772_91271933
Gm15966,16,91271777,91329043,lincRNA,-1,57266,chr16_91271777_91329043
Ifnar2,16,91372783,91405589,protein_coding,1,32806,chr16_91372783_91405589
Gm21970,16,91391721,91419451,protein_coding,1,27730,chr16_91391721_91419451
Il10rb,16,91406164,91425834,protein_coding,1,19670,chr16_91406164_91425834
Ifnar1,16,91485238,91507441,protein_coding,1,22203,chr16_91485238_91507441
Ifngr2,16,91547072,91565623,protein_coding,1,18551,chr16_91547072_91565623
Tmem50b,16,91574503,91597800,protein_coding,-1,23297,chr16_91574503_91597800
Gm15964,16,91611468,91623861,antisense,1,12393,chr16_91611468_91623861
Dnajc28,16,91614254,91619026,protein_coding,-1,4772,chr16_91614254_91619026
Gart,16,91621186,91646952,protein_coding,-1,25766,chr16_91621186_91646952
Son,16,91647506,91679221,protein_coding,1,31715,chr16_91647506_91679221
Donson,16,91676808,91688770,protein_coding,-1,11962,chr16_91676808_91688770
Atp5o,16,91684398,91931687,protein_coding,-1,247289,chr16_91684398_91931687
Gm10785,16,91688898,91715642,antisense,1,26744,chr16_91688898_91715642
Itsn1,16,91729281,91920597,protein_coding,1,191316,chr16_91729281_91920597
Gm15976,16,91924438,91928635,antisense,1,4197,chr16_91924438_91928635
D430001F17Rik,16,91931237,91962915,antisense,1,31678,chr16_91931237_91962915
Mrps6,16,92058270,92112227,protein_coding,1,53957,chr16_92058270_92112227
Kcne2,16,92292389,92298129,protein_coding,1,5740,chr16_92292389_92298129
Smim11,16,92301286,92313041,protein_coding,1,11755,chr16_92301286_92313041
1700048M11Rik,16,92308716,92312468,antisense,-1,3752,chr16_92308716_92312468
Kcne1,16,92345982,92359468,protein_coding,-1,13486,chr16_92345982_92359468
Rcan1,16,92391953,92470867,protein_coding,-1,78914,chr16_92391953_92470867
Clic6,16,92485736,92541243,protein_coding,1,55507,chr16_92485736_92541243
Runx1,16,92601466,92826149,protein_coding,-1,224683,chr16_92601466_92826149
Gm26626,16,92612814,92620105,antisense,1,7291,chr16_92612814_92620105
1700029J03Rik,16,93391677,93458872,lincRNA,-1,67195,chr16_93391677_93458872
Setd4,16,93583457,93604063,protein_coding,-1,20606,chr16_93583457_93604063
Cbr1,16,93605853,93610505,protein_coding,1,4652,chr16_93605853_93610505
Gm5678,16,93628097,93630451,protein_coding,1,2354,chr16_93628097_93630451
Cbr3,16,93683215,93690990,protein_coding,1,7775,chr16_93683215_93690990
2310043M15Rik,16,93792136,93794901,antisense,-1,2765,chr16_93792136_93794901
Morc3,16,93832121,93876073,protein_coding,1,43952,chr16_93832121_93876073
Chaf1b,16,93883901,93906115,protein_coding,1,22214,chr16_93883901_93906115
Cldn14,16,93919031,94008837,protein_coding,-1,89806,chr16_93919031_94008837
Sim2,16,94084931,94127032,protein_coding,1,42101,chr16_94084931_94127032
Hlcs,16,94128882,94313571,protein_coding,-1,184689,chr16_94128882_94313571
Gm48984,16,94174541,94179198,antisense,1,4657,chr16_94174541_94179198
Ripply3,16,94328420,94336935,protein_coding,1,8515,chr16_94328420_94336935
Pigp,16,94358763,94371842,protein_coding,-1,13079,chr16_94358763_94371842
Ttc3,16,94370618,94469343,protein_coding,1,98725,chr16_94370618_94469343
Dyrk1a,16,94570010,94695517,protein_coding,1,125507,chr16_94570010_94695517
Kcnj6,16,94748636,94997701,protein_coding,-1,249065,chr16_94748636_94997701
Kcnj15,16,95257558,95300260,protein_coding,1,42702,chr16_95257558_95300260
Erg,16,95359169,95586593,protein_coding,-1,227424,chr16_95359169_95586593
Ets2,16,95702075,95721051,protein_coding,1,18976,chr16_95702075_95721051
Psmg1,16,95979933,95990960,protein_coding,-1,11027,chr16_95979933_95990960
Brwd1,16,95992092,96082526,protein_coding,-1,90434,chr16_95992092_96082526
Hmgn1,16,96120618,96127729,protein_coding,-1,7111,chr16_96120618_96127729
Lca5l,16,96158407,96192271,protein_coding,-1,33864,chr16_96158407_96192271
Sh3bgr,16,96200450,96228935,protein_coding,1,28485,chr16_96200450_96228935
B3galt5,16,96235801,96319859,protein_coding,1,84058,chr16_96235801_96319859
Igsf5,16,96361668,96422121,protein_coding,1,60453,chr16_96361668_96422121
Pcp4,16,96467606,96525793,protein_coding,1,58187,chr16_96467606_96525793
Dscam,16,96590840,97170752,protein_coding,-1,579912,chr16_96590840_97170752
Bace2,16,97356742,97442936,protein_coding,1,86194,chr16_97356742_97442936
Mx1,16,97447035,97462907,polymorphic_pseudogene,-1,15872,chr16_97447035_97462907
Fam3b,16,97470965,97514816,protein_coding,-1,43851,chr16_97470965_97514816
Tmprss2,16,97564682,97611195,protein_coding,-1,46513,chr16_97564682_97611195
Ripk4,16,97741933,97763787,protein_coding,-1,21854,chr16_97741933_97763787
Prdm15,16,97791467,97851850,protein_coding,-1,60383,chr16_97791467_97851850
C2cd2,16,97855209,97962598,protein_coding,-1,107389,chr16_97855209_97962598
Zbtb21,16,97943357,97962622,protein_coding,-1,19265,chr16_97943357_97962622
C030010L15Rik,16,97994596,97997419,antisense,-1,2823,chr16_97994596_97997419
B230307C23Rik,16,97997315,98031801,protein_coding,1,34486,chr16_97997315_98031801
A630089N07Rik,16,98001310,98082450,protein_coding,-1,81140,chr16_98001310_98082450
Scaf8,17,3114972,3198859,protein_coding,1,83887,chr17_3114972_3198859
Tiam2,17,3326573,3531344,protein_coding,1,204771,chr17_3326573_3531344
Tfb1m,17,3519256,3557781,protein_coding,-1,38525,chr17_3519256_3557781
Cldn20,17,3532554,3533213,protein_coding,1,659,chr17_3532554_3533213
1700102H20Rik,17,3557824,3559862,lincRNA,1,2038,chr17_3557824_3559862
Nox3,17,3635240,3696261,protein_coding,-1,61021,chr17_3635240_3696261
Arid1b,17,4994332,5347656,protein_coding,1,353324,chr17_4994332_5347656
Gm29050,17,5388763,5419652,antisense,1,30889,chr17_5388763_5419652
Tmem242,17,5410870,5440259,protein_coding,-1,29389,chr17_5410870_5440259
Zdhhc14,17,5492557,5753811,protein_coding,1,261254,chr17_5492557_5753811
3300005D01Rik,17,5798657,5803240,lincRNA,1,4583,chr17_5798657_5803240
Snx9,17,5841329,5931954,protein_coding,1,90625,chr17_5841329_5931954
Synj2,17,5941280,6044290,protein_coding,1,103010,chr17_5941280_6044290
Serac1,17,6042196,6079741,protein_coding,-1,37545,chr17_6042196_6079741
Gtf2h5,17,6079786,6086517,protein_coding,1,6731,chr17_6079786_6086517
Tulp4,17,6106437,6251128,protein_coding,1,144691,chr17_6106437_6251128
Tmem181a,17,6256860,6308314,protein_coding,1,51454,chr17_6256860_6308314
Dynlt1a,17,6306340,6317500,protein_coding,-1,11160,chr17_6306340_6317500
Dynlt1c,17,6601671,6609774,protein_coding,1,8103,chr17_6601671_6609774
Dynlt1f,17,6646602,6655900,protein_coding,-1,9298,chr17_6646602_6655900
Sytl3,17,6659093,6738044,protein_coding,1,78951,chr17_6659093_6738044
Ezr,17,6738041,6782784,protein_coding,-1,44743,chr17_6738041_6782784
1700122H20Rik,17,6895940,6901718,antisense,1,5778,chr17_6895940_6901718
Rsph3b,17,6904413,6948682,protein_coding,-1,44269,chr17_6904413_6948682
Tagap1,17,6955011,6961156,protein_coding,-1,6145,chr17_6955011_6961156
Rnaset2b,17,6970634,7011299,protein_coding,1,40665,chr17_6970634_7011299
Gm1604a,17,7982522,8101241,processed_transcript,-1,118719,chr17_7982522_8101241
Rps6ka2,17,7170115,7303315,protein_coding,1,133200,chr17_7170115_7303315
Tcp10a,17,7324646,7345974,protein_coding,1,21328,chr17_7324646_7345974
Ttll2,17,7350885,7352696,protein_coding,-1,1811,chr17_7350885_7352696
Fndc1,17,7738569,7827302,protein_coding,-1,88733,chr17_7738569_7827302
E430024P14Rik,17,7881106,7946426,antisense,-1,65320,chr17_7881106_7946426
Tagap,17,7926000,7934897,protein_coding,1,8897,chr17_7926000_7934897
Rsph3a,17,7945614,7979824,protein_coding,1,34210,chr17_7945614_7979824
Fgfr1op,17,8165501,8196804,protein_coding,1,31303,chr17_8165501_8196804
Ccr6,17,8236043,8257141,protein_coding,1,21098,chr17_8236043_8257141
Mpc1,17,8282904,8297661,protein_coding,1,14757,chr17_8282904_8297661
Sft2d1,17,8311102,8327442,protein_coding,1,16340,chr17_8311102_8327442
T2,17,8355992,8423513,protein_coding,1,67521,chr17_8355992_8423513
T,17,8434423,8442496,protein_coding,1,8073,chr17_8434423_8442496
Pde10a,17,8525372,8986648,protein_coding,1,461276,chr17_8525372_8986648
Gm17087,17,8565852,8566950,protein_coding,-1,1098,chr17_8565852_8566950
1700010I14Rik,17,8988333,9011949,protein_coding,1,23616,chr17_8988333_9011949
6530411M01Rik,17,9147719,9167836,lincRNA,-1,20117,chr17_9147719_9167836
Qk,17,10202601,10319854,protein_coding,-1,117253,chr17_10202601_10319854
1700110C19Rik,17,10324602,10329307,lincRNA,1,4705,chr17_10324602_10329307
Pacrg,17,10403012,10840311,protein_coding,-1,437299,chr17_10403012_10840311
A230009B12Rik,17,10456216,10493057,antisense,1,36841,chr17_10456216_10493057
Gm16168,17,10496446,10569396,antisense,1,72950,chr17_10496446_10569396
Gm28505,17,11082250,11089468,antisense,-1,7218,chr17_11082250_11089468
Agpat4,17,12118704,12219645,protein_coding,1,100941,chr17_12118704_12219645
Map3k4,17,12227621,12318796,protein_coding,-1,91175,chr17_12227621_12318796
4732491K20Rik,17,12318853,12327250,bidirectional_promoter_lncRNA,1,8397,chr17_12318853_12327250
Plg,17,12378608,12419385,protein_coding,1,40777,chr17_12378608_12419385
Slc22a3,17,12418960,12507704,protein_coding,-1,88744,chr17_12418960_12507704
Slc22a2,17,12584132,12628488,protein_coding,1,44356,chr17_12584132_12628488
Slc22a1,17,12648869,12675829,protein_coding,-1,26960,chr17_12648869_12675829
Igf2r,17,12682406,12769664,protein_coding,-1,87258,chr17_12682406_12769664
Airn,17,12741311,12860136,antisense,1,118825,chr17_12741311_12860136
Mas1,17,12841079,12868143,protein_coding,-1,27064,chr17_12841079_12868143
Pnldc1,17,12888729,12910230,protein_coding,-1,21501,chr17_12888729_12910230
Mrpl18,17,12911349,12916345,protein_coding,-1,4996,chr17_12911349_12916345
Tcp1,17,12915701,12925067,protein_coding,1,9366,chr17_12915701_12925067
Acat3,17,12923813,12940600,protein_coding,-1,16787,chr17_12923813_12940600
Acat2,17,12942890,12960747,protein_coding,-1,17857,chr17_12942890_12960747
Wtap,17,12966796,12994169,protein_coding,-1,27373,chr17_12966796_12994169
Sod2,17,13006846,13040063,protein_coding,1,33217,chr17_13006846_13040063
Tcp10b,17,13061104,13082481,protein_coding,1,21377,chr17_13061104_13082481
Unc93a,17,13108617,13131810,protein_coding,-1,23193,chr17_13108617_13131810
Smok2a,17,13221188,13227658,protein_coding,1,6470,chr17_13221188_13227658
Smok2b,17,13230257,13237184,protein_coding,1,6927,chr17_13230257_13237184
Tcp10c,17,13354572,13377223,protein_coding,1,22651,chr17_13354572_13377223
Tcte2,17,13712444,13761825,protein_coding,-1,49381,chr17_13712444_13761825
Gm16050,17,13500954,13511193,lincRNA,1,10239,chr17_13500954_13511193
Afdn,17,13760539,13906150,protein_coding,1,145611,chr17_13760539_13906150
Dact2,17,14195052,14204304,protein_coding,-1,9252,chr17_14195052_14204304
Smoc2,17,14279506,14404790,protein_coding,1,125284,chr17_14279506_14404790
Thbs2,17,14665500,14694235,protein_coding,-1,28735,chr17_14665500_14694235
Wdr27,17,14818519,14943158,protein_coding,-1,124639,chr17_14818519_14943158
1600012H06Rik,17,14943184,14959570,protein_coding,1,16386,chr17_14943184_14959570
Phf10,17,14945009,14961273,protein_coding,-1,16264,chr17_14945009_14961273
Gm3417,17,14964242,14978790,protein_coding,-1,14548,chr17_14964242_14978790
9030025P20Rik,17,14978468,14991572,protein_coding,1,13104,chr17_14978468_14991572
Gm3448,17,14995787,15041537,protein_coding,-1,45750,chr17_14995787_15041537
Gm3435,17,15010176,15022449,protein_coding,1,12273,chr17_15010176_15022449
Ermard,17,15041208,15090044,protein_coding,1,48836,chr17_15041208_15090044
Dll1,17,15367354,15376872,protein_coding,-1,9518,chr17_15367354_15376872
Fam120b,17,15396202,15433583,protein_coding,1,37381,chr17_15396202_15433583
Psmb1,17,15475021,15499751,protein_coding,-1,24730,chr17_15475021_15499751
Tbp,17,15499888,15528379,protein_coding,1,28491,chr17_15499888_15528379
Pdcd2,17,15519208,15527301,protein_coding,-1,8093,chr17_15519208_15527301
Prdm9,17,15543079,15564354,protein_coding,-1,21275,chr17_15543079_15564354
Chd1,17,15704967,15772610,protein_coding,1,67643,chr17_15704967_15772610
Rgmb,17,15803188,15831039,protein_coding,-1,27851,chr17_15803188_15831039
BC002059,17,16951539,16974157,lincRNA,1,22618,chr17_16951539_16974157
Zfp960,17,17064113,17089628,protein_coding,1,25515,chr17_17064113_17089628
Zfp97,17,17121415,17146831,protein_coding,1,25416,chr17_17121415_17146831
Gm6712,17,17294443,17319511,lincRNA,1,25068,chr17_17294443_17319511
AC154200.1,17,17340820,17374206,lincRNA,-1,33386,chr17_17340820_17374206
Riok2,17,17374309,17394899,protein_coding,1,20590,chr17_17374309_17394899
Gm26873,17,17389943,17411993,antisense,-1,22050,chr17_17389943_17411993
Lix1,17,17402672,17459387,protein_coding,1,56715,chr17_17402672_17459387
Lnpep,17,17521410,17625050,protein_coding,-1,103640,chr17_17521410_17625050
Vmn2r90,17,17703747,17735156,protein_coding,1,31409,chr17_17703747_17735156
Spaca6,17,17827158,17843009,protein_coding,1,15851,chr17_17827158_17843009
Has1,17,17843323,17855205,protein_coding,-1,11882,chr17_17843323_17855205
Fpr1,17,17876471,17883940,protein_coding,-1,7469,chr17_17876471_17883940
Fpr3,17,17887852,17971677,protein_coding,1,83825,chr17_17887852_17971677
Vmn2r124,17,18049424,18079732,protein_coding,1,30308,chr17_18049424_18079732
Vmn2r91,17,18085016,18136768,protein_coding,1,51752,chr17_18085016_18136768
Vmn2r92,17,18151887,18188886,protein_coding,1,36999,chr17_18151887_18188886
Vmn2r94,17,18241122,18277756,protein_coding,-1,36634,chr17_18241122_18277756
Vmn2r93,17,18298099,18331914,protein_coding,1,33815,chr17_18298099_18331914
Vmn2r95,17,18424078,18460905,protein_coding,1,36827,chr17_18424078_18460905
Vmn2r96,17,18573151,18616003,protein_coding,1,42852,chr17_18573151_18616003
Vmn2r-ps117,17,18810835,18841654,unprocessed_pseudogene,1,30819,chr17_18810835_18841654
Vmn2r97,17,18914300,18958087,protein_coding,1,43787,chr17_18914300_18958087
Vmn2r98,17,19053460,19082411,protein_coding,1,28951,chr17_19053460_19082411
Vmn2r99,17,19361949,19401098,protein_coding,1,39149,chr17_19361949_19401098
Vmn2r100,17,19504732,19535231,protein_coding,1,30499,chr17_19504732_19535231
Vmn2r101,17,19577227,19612317,protein_coding,1,35090,chr17_19577227_19612317
Vmn2r102,17,19660328,19709533,protein_coding,1,49205,chr17_19660328_19709533
Vmn2r103,17,19773363,19812536,protein_coding,1,39173,chr17_19773363_19812536
Vmn2r106,17,20266767,20285553,protein_coding,-1,18786,chr17_20266767_20285553
Vmn2r107,17,20345242,20383113,protein_coding,1,37871,chr17_20345242_20383113
Vmn2r108,17,20456327,20481331,protein_coding,-1,25004,chr17_20456327_20481331
Vmn2r109,17,20539969,20564756,protein_coding,-1,24787,chr17_20539969_20564756
Gm5145,17,20570369,20571198,processed_pseudogene,1,829,chr17_20570369_20571198
Vmn2r110,17,20567760,20596423,protein_coding,-1,28663,chr17_20567760_20596423
Ppp2r1a,17,20945311,20965916,protein_coding,1,20605,chr17_20945311_20965916
Zfp160,17,21008903,21043070,protein_coding,1,34167,chr17_21008903_21043070
Gm5092,17,21091208,21103347,lincRNA,1,12139,chr17_21091208_21103347
Zfp677,17,21383748,21399265,protein_coding,1,15517,chr17_21383748_21399265
Zfp54,17,21423227,21435640,protein_coding,1,12413,chr17_21423227_21435640
Zfp51,17,21450374,21465587,protein_coding,1,15213,chr17_21450374_21465587
Zfp53,17,21488998,21510473,protein_coding,1,21475,chr17_21488998_21510473
9330136K24Rik,17,21528194,21535878,lincRNA,-1,7684,chr17_21528194_21535878
Zfp52,17,21535539,21562601,protein_coding,1,27062,chr17_21535539_21562601
Zfp948,17,21567008,21588699,protein_coding,1,21691,chr17_21567008_21588699
Zfp983,17,21650624,21664966,protein_coding,1,14342,chr17_21650624_21664966
Gm10509,17,21690180,21691022,processed_pseudogene,1,842,chr17_21690180_21691022
Gm10226,17,21691860,21692114,protein_coding,1,254,chr17_21691860_21692114
Zfp760,17,21707741,21725636,protein_coding,1,17895,chr17_21707741_21725636
Zfp229,17,21730795,21769342,protein_coding,1,38547,chr17_21730795_21769342
Zfp820,17,21816885,21845772,protein_coding,-1,28887,chr17_21816885_21845772
Zfp995,17,21879570,21909926,protein_coding,-1,30356,chr17_21879570_21909926
Zfp942,17,21926960,21962464,protein_coding,-1,35504,chr17_21926960_21962464
Zfp943,17,21962552,22071168,protein_coding,1,108616,chr17_21962552_22071168
Gm9772,17,22005994,22007599,processed_pseudogene,-1,1605,chr17_22005994_22007599
Zfp947,17,22144359,22166190,protein_coding,-1,21831,chr17_22144359_22166190
Zfp994,17,22197265,22225616,protein_coding,-1,28351,chr17_22197265_22225616
Zfp944,17,22337989,22361400,protein_coding,-1,23411,chr17_22337989_22361400
Zfp758,17,22361453,22377281,protein_coding,1,15828,chr17_22361453_22377281
Zfp946,17,22424222,22456689,protein_coding,1,32467,chr17_22424222_22456689
Vmn2r111,17,22544504,22573482,protein_coding,-1,28978,chr17_22544504_22573482
Vmn2r112,17,22600951,22620842,protein_coding,1,19891,chr17_22600951_22620842
Gm9805,17,22687720,22690460,processed_pseudogene,1,2740,chr17_22687720_22690460
Gm5493,17,22739945,22751509,lincRNA,1,11564,chr17_22739945_22751509
Gm16386,17,22777217,22807736,processed_pseudogene,-1,30519,chr17_22777217_22807736
Zfp945,17,22846697,22867134,protein_coding,-1,20437,chr17_22846697_22867134
Vmn2r113,17,22942984,22965658,protein_coding,1,22674,chr17_22942984_22965658
Vmn2r-ps130,17,23061166,23082364,protein_coding,1,21198,chr17_23061166_23082364
Zfp40,17,23173869,23193252,protein_coding,-1,19383,chr17_23173869_23193252
Vmn2r114,17,23285392,23312537,protein_coding,-1,27145,chr17_23285392_23312537
Vmn2r115,17,23343741,23362538,protein_coding,1,18797,chr17_23343741_23362538
Vmn2r116,17,23384604,23404422,protein_coding,1,19818,chr17_23384604_23404422
Vmn2r117,17,23455173,23479699,protein_coding,-1,24526,chr17_23455173_23479699
Zfp213,17,23556767,23564238,protein_coding,-1,7471,chr17_23556767_23564238
Gm49092,17,23572492,23573427,lincRNA,-1,935,chr17_23572492_23573427
Zfp13,17,23575844,23599487,protein_coding,-1,23643,chr17_23575844_23599487
Zscan10,17,23600856,23611019,protein_coding,1,10163,chr17_23600856_23611019
Mmp25,17,23628311,23645277,protein_coding,-1,16966,chr17_23628311_23645277
Bicdl2,17,23660506,23668621,protein_coding,1,8115,chr17_23660506_23668621
Thoc6,17,23668614,23673882,protein_coding,-1,5268,chr17_23668614_23673882
Hcfc1r1,17,23673596,23675227,protein_coding,1,1631,chr17_23673596_23675227
Tnfrsf12a,17,23675445,23677468,protein_coding,-1,2023,chr17_23675445_23677468
Cldn9,17,23682584,23684026,protein_coding,-1,1442,chr17_23682584_23684026
1520401A03Rik,17,23704488,23722783,protein_coding,-1,18295,chr17_23704488_23722783
Pkmyt1,17,23726336,23736735,protein_coding,1,10399,chr17_23726336_23736735
Paqr4,17,23736186,23740867,protein_coding,-1,4681,chr17_23736186_23740867
Kremen2,17,23741197,23745833,protein_coding,-1,4636,chr17_23741197_23745833
9530082P21Rik,17,23743234,23754065,antisense,1,10831,chr17_23743234_23754065
Flywch1,17,23752793,23771602,protein_coding,-1,18809,chr17_23752793_23771602
Gm49163,17,23765261,23767118,antisense,1,1857,chr17_23765261_23767118
Gm16275,17,23771841,23777763,antisense,1,5922,chr17_23771841_23777763
Flywch2,17,23776916,23786081,protein_coding,-1,9165,chr17_23776916_23786081
Srrm2,17,23790532,23824741,protein_coding,1,34209,chr17_23790532_23824741
Elob,17,23824738,23829136,protein_coding,-1,4398,chr17_23824738_23829136
Prss33,17,23833347,23836056,protein_coding,-1,2709,chr17_23833347_23836056
Prss41,17,23836785,23844172,protein_coding,-1,7387,chr17_23836785_23844172
Prss32,17,23843855,23859779,protein_coding,1,15924,chr17_23843855_23859779
Dcpp2,17,23880880,23900788,protein_coding,1,19908,chr17_23880880_23900788
Prss30,17,23972126,23980566,protein_coding,-1,8440,chr17_23972126_23980566
Prss22,17,23993534,23998100,protein_coding,-1,4566,chr17_23993534_23998100
Prss27,17,24038144,24045954,protein_coding,1,7810,chr17_24038144_24045954
Kctd5,17,24047734,24073485,protein_coding,-1,25751,chr17_24047734_24073485
Pdpk1,17,24073680,24150924,protein_coding,-1,77244,chr17_24073680_24150924
Amdhd2,17,24155833,24163766,protein_coding,-1,7933,chr17_24155833_24163766
Tbc1d24,17,24175431,24205562,protein_coding,-1,30131,chr17_24175431_24205562
Tedc2,17,24215054,24220851,protein_coding,-1,5797,chr17_24215054_24220851
Ccnf,17,24222198,24251484,protein_coding,-1,29286,chr17_24222198_24251484
Abca17,17,24264259,24351068,protein_coding,-1,86809,chr17_24264259_24351068
Abca3,17,24351950,24410201,protein_coding,1,58251,chr17_24351950_24410201
Rnps1,17,24414565,24425901,protein_coding,1,11336,chr17_24414565_24425901
Eci1,17,24426641,24439348,protein_coding,1,12707,chr17_24426641_24439348
Dnase1l2,17,24440081,24443105,protein_coding,-1,3024,chr17_24440081_24443105
E4f1,17,24443778,24470313,protein_coding,-1,26535,chr17_24443778_24470313
Pgp,17,24470392,24473110,protein_coding,1,2718,chr17_24470392_24473110
Mlst8,17,24473551,24479078,protein_coding,-1,5527,chr17_24473551_24479078
Bricd5,17,24473884,24475469,protein_coding,1,1585,chr17_24473884_24475469
Caskin1,17,24488601,24508671,protein_coding,1,20070,chr17_24488601_24508671
Traf7,17,24508562,24527938,protein_coding,-1,19376,chr17_24508562_24527938
Rab26,17,24527241,24534210,protein_coding,-1,6969,chr17_24527241_24534210
Rab26os,17,24528248,24528744,antisense,1,496,chr17_24528248_24528744
Pkd1,17,24549834,24596508,protein_coding,1,46674,chr17_24549834_24596508
Tsc2,17,24595816,24632630,protein_coding,-1,36814,chr17_24595816_24632630
Nthl1,17,24632680,24638837,protein_coding,1,6157,chr17_24632680_24638837
Slc9a3r2,17,24639286,24650327,protein_coding,-1,11041,chr17_24639286_24650327
Npw,17,24657330,24658457,protein_coding,-1,1127,chr17_24657330_24658457
Zfp598,17,24669687,24682016,protein_coding,1,12329,chr17_24669687_24682016
Syngr3,17,24685092,24689955,protein_coding,-1,4863,chr17_24685092_24689955
Gfer,17,24693187,24696156,protein_coding,-1,2969,chr17_24693187_24696156
Noxo1,17,24696234,24700529,protein_coding,1,4295,chr17_24696234_24700529
Tbl3,17,24697949,24707660,protein_coding,-1,9711,chr17_24697949_24707660
Rnf151,17,24715839,24718063,protein_coding,-1,2224,chr17_24715839_24718063
Rps2,17,24718116,24721929,protein_coding,1,3813,chr17_24718116_24721929
Snhg9,17,24719531,24719965,antisense,-1,434,chr17_24719531_24719965
Ndufb10,17,24722060,24724478,protein_coding,-1,2418,chr17_24722060_24724478
Rpl3l,17,24727820,24736143,protein_coding,1,8323,chr17_24727820_24736143
Msrb1,17,24736642,24742778,protein_coding,1,6136,chr17_24736642_24742778
Hs3st6,17,24752988,24758684,protein_coding,1,5696,chr17_24752988_24758684
Meiob,17,24804289,24839788,protein_coding,1,35499,chr17_24804289_24839788
Hagh,17,24840143,24864450,protein_coding,1,24307,chr17_24840143_24864450
Fahd1,17,24848892,24850364,protein_coding,-1,1472,chr17_24848892_24850364
Igfals,17,24865997,24882010,protein_coding,1,16013,chr17_24865997_24882010
Nubp2,17,24882611,24886349,protein_coding,-1,3738,chr17_24882611_24886349
Spsb3,17,24886643,24892152,protein_coding,1,5509,chr17_24886643_24892152
Eme2,17,24888486,24895087,protein_coding,-1,6601,chr17_24888486_24895087
Mapk8ip3,17,24892153,24936977,protein_coding,-1,44824,chr17_24892153_24936977
Mrps34,17,24895116,24897502,protein_coding,1,2386,chr17_24895116_24897502
Nme3,17,24896500,24897522,protein_coding,1,1022,chr17_24896500_24897522
Jpt2,17,24937419,24960689,protein_coding,-1,23270,chr17_24937419_24960689
Cramp1l,17,24961226,25015788,protein_coding,-1,54562,chr17_24961226_25015788
Ift140,17,25016085,25099495,protein_coding,1,83410,chr17_25016085_25099495
Tmem204,17,25057702,25083591,protein_coding,-1,25889,chr17_25057702_25083591
Telo2,17,25099570,25115967,protein_coding,-1,16397,chr17_25099570_25115967
Ptx4,17,25120760,25125292,protein_coding,1,4532,chr17_25120760_25125292
Clcn7,17,25133391,25162104,protein_coding,1,28713,chr17_25133391_25162104
Ccdc154,17,25162461,25171913,protein_coding,1,9452,chr17_25162461_25171913
BC003965,17,25184554,25187662,protein_coding,1,3108,chr17_25184554_25187662
Unkl,17,25188397,25234443,protein_coding,1,46046,chr17_25188397_25234443
Gnptg,17,25233331,25240124,protein_coding,-1,6793,chr17_25233331_25240124
Tsr3,17,25240170,25242798,protein_coding,1,2628,chr17_25240170_25242798
Baiap3,17,25242659,25256364,protein_coding,-1,13705,chr17_25242659_25256364
Ube2i,17,25261916,25274622,protein_coding,-1,12706,chr17_25261916_25274622
Prss29,17,25318654,25322684,protein_coding,1,4030,chr17_25318654_25322684
Tpsg1,17,25369273,25374442,protein_coding,1,5169,chr17_25369273_25374442
Cacna1h,17,25374285,25433783,protein_coding,-1,59498,chr17_25374285_25433783
Tekt4,17,25454615,25476602,protein_coding,1,21987,chr17_25454615_25476602
Sox8,17,25565892,25570686,protein_coding,-1,4794,chr17_25565892_25570686
Lmf1,17,25579085,25662826,protein_coding,1,83741,chr17_25579085_25662826
Gng13,17,25717171,25719406,protein_coding,1,2235,chr17_25717171_25719406
Chtf18,17,25718926,25727419,protein_coding,-1,8493,chr17_25718926_25727419
Rpusd1,17,25727670,25731464,protein_coding,1,3794,chr17_25727670_25731464
Mslnl,17,25736042,25748330,protein_coding,1,12288,chr17_25736042_25748330
Msln,17,25748613,25754378,protein_coding,-1,5765,chr17_25748613_25754378
Haghl,17,25779843,25785673,protein_coding,-1,5830,chr17_25779843_25785673
Ccdc78,17,25786580,25790513,protein_coding,1,3933,chr17_25786580_25790513
Fam173a,17,25790080,25792901,protein_coding,-1,2821,chr17_25790080_25792901
Metrn,17,25793221,25797136,protein_coding,-1,3915,chr17_25793221_25797136
Stub1,17,25830505,25833404,protein_coding,-1,2899,chr17_25830505_25833404
Gm20683,17,25834465,25841763,protein_coding,-1,7298,chr17_25834465_25841763
Rhot2,17,25838457,25844851,protein_coding,-1,6394,chr17_25838457_25844851
Wdr90,17,25844771,25861501,protein_coding,-1,16730,chr17_25844771_25861501
Mcrip2,17,25863698,25868764,protein_coding,-1,5066,chr17_25863698_25868764
Wfikkn1,17,25877628,25880858,protein_coding,-1,3230,chr17_25877628_25880858
Rab40c,17,25882114,25919727,protein_coding,-1,37613,chr17_25882114_25919727
Pigq,17,25926421,25944936,protein_coding,-1,18515,chr17_25926421_25944936
A930017K11Rik,17,25946387,25952565,protein_coding,-1,6178,chr17_25946387_25952565
Capn15,17,25958364,25985796,protein_coding,-1,27432,chr17_25958364_25985796
1700022N22Rik,17,25985808,25991030,antisense,1,5222,chr17_25985808_25991030
Rab11fip3,17,25989036,26069555,protein_coding,-1,80519,chr17_25989036_26069555
Decr2,17,26081208,26090337,protein_coding,-1,9129,chr17_26081208_26090337
Nme4,17,26091734,26095602,protein_coding,-1,3868,chr17_26091734_26095602
Gm8186,17,26098991,26099221,processed_pseudogene,-1,230,chr17_26098991_26099221
Tmem8,17,26113299,26123254,protein_coding,1,9955,chr17_26113299_26123254
Mrpl28,17,26123500,26126613,protein_coding,1,3113,chr17_26123500_26126613
Axin1,17,26138688,26195811,protein_coding,1,57123,chr17_26138688_26195811
Pdia2,17,26195999,26199087,protein_coding,-1,3088,chr17_26195999_26199087
Arhgdig,17,26199183,26207786,protein_coding,-1,8603,chr17_26199183_26207786
Rgs11,17,26202951,26211324,protein_coding,1,8373,chr17_26202951_26211324
Fam234a,17,26211822,26244242,protein_coding,-1,32420,chr17_26211822_26244242
Luc7l,17,26252896,26285504,protein_coding,1,32608,chr17_26252896_26285504
Neurl1b,17,26414829,26446349,protein_coding,1,31520,chr17_26414829_26446349
Dusp1,17,26505590,26562128,protein_coding,-1,56538,chr17_26505590_26562128
Gm8225,17,26542760,26543715,processed_pseudogene,1,955,chr17_26542760_26543715
Ergic1,17,26561489,26656934,protein_coding,1,95445,chr17_26561489_26656934
Gm17218,17,26620358,26625100,antisense,-1,4742,chr17_26620358_26625100
Atp6v0e,17,26663231,26699647,protein_coding,1,36416,chr17_26663231_26699647
Crebrf,17,26715650,26776635,protein_coding,1,60985,chr17_26715650_26776635
Bnip1,17,26781066,26792565,protein_coding,1,11499,chr17_26781066_26792565
Gm17382,17,26860271,26886202,lincRNA,-1,25931,chr17_26860271_26886202
Gm20468,17,26861421,26898531,lincRNA,1,37110,chr17_26861421_26898531
Kifc5b,17,26917091,26932583,protein_coding,1,15492,chr17_26917091_26932583
Phf1,17,26933052,26937908,protein_coding,1,4856,chr17_26933052_26937908
Cuta,17,26933819,26939569,protein_coding,-1,5750,chr17_26933819_26939569
Syngap1,17,26941253,26972434,protein_coding,1,31181,chr17_26941253_26972434
Zbtb9,17,26973167,27008376,protein_coding,1,35209,chr17_26973167_27008376
Ggnbp1,17,27017987,27037624,protein_coding,1,19637,chr17_27017987_27037624
Bak1,17,27019810,27029009,protein_coding,-1,9199,chr17_27019810_27029009
Itpr3,17,27057304,27122223,protein_coding,1,64919,chr17_27057304_27122223
Uqcc2,17,27122663,27133916,protein_coding,-1,11253,chr17_27122663_27133916
Ip6k3,17,27143965,27167795,protein_coding,-1,23830,chr17_27143965_27167795
Lemd2,17,27189600,27204469,protein_coding,-1,14869,chr17_27189600_27204469
Gm26724,17,27201032,27203071,antisense,1,2039,chr17_27201032_27203071
Grm4,17,27422387,27521403,protein_coding,-1,99016,chr17_27422387_27521403
Hmga1,17,27556497,27563674,protein_coding,1,7177,chr17_27556497_27563674
AI413582,17,27563573,27565756,protein_coding,-1,2183,chr17_27563573_27565756
Nudt3,17,27579382,27623495,protein_coding,-1,44113,chr17_27579382_27623495
Rps10,17,27630418,27636669,protein_coding,-1,6251,chr17_27630418_27636669
Gm15420,17,27635343,27636868,antisense,1,1525,chr17_27635343_27636868
Pacsin1,17,27655509,27711482,protein_coding,1,55973,chr17_27655509_27711482
Spdef,17,27714352,27728955,protein_coding,-1,14603,chr17_27714352_27728955
Gm15458,17,27735220,27741492,lincRNA,1,6272,chr17_27735220_27741492
Snrpc,17,27838150,27851968,protein_coding,1,13818,chr17_27838150_27851968
Uhrf1bp1,17,27856441,27900041,protein_coding,1,43600,chr17_27856441_27900041
Taf11,17,27901122,27909844,protein_coding,-1,8722,chr17_27901122_27909844
Anks1,17,27909306,28062775,protein_coding,1,153469,chr17_27909306_28062775
Gm15597,17,27959615,27965316,antisense,-1,5701,chr17_27959615_27965316
Tcp11,17,28066745,28080639,protein_coding,-1,13894,chr17_28066745_28080639
Scube3,17,28142141,28174854,protein_coding,1,32713,chr17_28142141_28174854
Zfp523,17,28177129,28205886,protein_coding,1,28757,chr17_28177129_28205886
Def6,17,28207778,28228608,protein_coding,1,20830,chr17_28207778_28228608
Ppard,17,28232700,28301474,protein_coding,1,68774,chr17_28232700_28301474
Fance,17,28313519,28326572,protein_coding,1,13053,chr17_28313519_28326572
Rpl10a,17,28328471,28331033,protein_coding,1,2562,chr17_28328471_28331033
Tead3,17,28331671,28350817,protein_coding,-1,19146,chr17_28331671_28350817
Tulp1,17,28351515,28365222,protein_coding,-1,13707,chr17_28351515_28365222
Fkbp5,17,28399094,28517527,protein_coding,-1,118433,chr17_28399094_28517527
Gm20109,17,28522381,28523148,lincRNA,-1,767,chr17_28522381_28523148
E230001N04Rik,17,28522720,28525398,lincRNA,1,2678,chr17_28522720_28525398
Armc12,17,28530806,28539110,protein_coding,1,8304,chr17_28530806_28539110
Clpsl2,17,28549411,28552620,protein_coding,1,3209,chr17_28549411_28552620
Clps,17,28558149,28560766,protein_coding,-1,2617,chr17_28558149_28560766
Lhfpl5,17,28575641,28585679,protein_coding,1,10038,chr17_28575641_28585679
Srpk1,17,28587648,28622709,protein_coding,-1,35061,chr17_28587648_28622709
Slc26a8,17,28637783,28690233,protein_coding,-1,52450,chr17_28637783_28690233
Mapk14,17,28691329,28748406,protein_coding,1,57077,chr17_28691329_28748406
Mapk13,17,28769297,28780233,protein_coding,1,10936,chr17_28769297_28780233
Brpf3,17,28801090,28839949,protein_coding,1,38859,chr17_28801090_28839949
Pnpla1os,17,28852055,28859508,antisense,-1,7453,chr17_28852055_28859508
Pnpla1,17,28858411,28890309,protein_coding,1,31898,chr17_28858411_28890309
1700030A11Rik,17,28905265,28906771,antisense,1,1506,chr17_28905265_28906771
Gm16191,17,28925463,28937125,antisense,1,11662,chr17_28925463_28937125
Pxt1,17,28933984,28943840,protein_coding,-1,9856,chr17_28933984_28943840
Kctd20,17,28951950,28969549,protein_coding,1,17599,chr17_28951950_28969549
Stk38,17,28970880,29007995,protein_coding,-1,37115,chr17_28970880_29007995
Gm16196,17,29014642,29032568,bidirectional_promoter_lncRNA,-1,17926,chr17_29014642_29032568
Gm16195,17,29021293,29022402,lincRNA,1,1109,chr17_29021293_29022402
Srsf3,17,29032628,29043373,protein_coding,1,10745,chr17_29032628_29043373
Trp53cor1,17,29057430,29079179,lincRNA,-1,21749,chr17_29057430_29079179
Cdkn1a,17,29090976,29100727,protein_coding,1,9751,chr17_29090976_29100727
Rab44,17,29114145,29148980,protein_coding,1,34835,chr17_29114145_29148980
Cpne5,17,29155556,29238167,protein_coding,-1,82611,chr17_29155556_29238167
Ppil1,17,29250803,29264186,protein_coding,-1,13383,chr17_29250803_29264186
BC004004,17,29268788,29314065,protein_coding,1,45277,chr17_29268788_29314065
Pi16,17,29317680,29330593,protein_coding,1,12913,chr17_29317680_29330593
Mtch1,17,29332072,29347934,protein_coding,-1,15862,chr17_29332072_29347934
Fgd2,17,29360914,29379661,protein_coding,1,18747,chr17_29360914_29379661
Gm26885,17,29446919,29491925,antisense,-1,45006,chr17_29446919_29491925
Pim1,17,29490753,29496112,protein_coding,1,5359,chr17_29490753_29496112
Tmem217,17,29526007,29552385,protein_coding,-1,26378,chr17_29526007_29552385
Tbc1d22b,17,29549785,29606898,protein_coding,1,57113,chr17_29549785_29606898
Tbc1d22bos,17,29578816,29596305,antisense,-1,17489,chr17_29578816_29596305
Rnf8,17,29614790,29644991,protein_coding,1,30201,chr17_29614790_29644991
Gm28043,17,29614876,29703359,protein_coding,1,88483,chr17_29614876_29703359
Cmtr1,17,29660595,29705979,protein_coding,1,45384,chr17_29660595_29705979
Ccdc167,17,29687357,29717044,protein_coding,-1,29687,chr17_29687357_29717044
Mdga1,17,29827949,29970087,protein_coding,-1,142138,chr17_29827949_29970087
Zfand3,17,30004733,30210828,protein_coding,1,206095,chr17_30004733_30210828
Btbd9,17,30215524,30576488,protein_coding,-1,360964,chr17_30215524_30576488
Glo1,17,30584936,30626871,protein_coding,-1,41935,chr17_30584936_30626871
1700097N02Rik,17,30622441,30626905,bidirectional_promoter_lncRNA,-1,4464,chr17_30622441_30626905
Dnah8,17,30624354,30877365,protein_coding,1,253011,chr17_30624354_30877365
Glp1r,17,30901817,30940791,protein_coding,1,38974,chr17_30901817_30940791
Umodl1,17,30954640,31010710,protein_coding,1,56070,chr17_30954640_31010710
Abcg1,17,31057675,31117988,protein_coding,1,60313,chr17_31057675_31117988
Ubash3a,17,31207873,31246892,protein_coding,1,39019,chr17_31207873_31246892
Rsph1,17,31255019,31277383,protein_coding,-1,22364,chr17_31255019_31277383
Slc37a1,17,31286792,31350739,protein_coding,1,63947,chr17_31286792_31350739
Pde9a,17,31386210,31476310,protein_coding,1,90100,chr17_31386210_31476310
Wdr4,17,31494322,31519980,protein_coding,-1,25658,chr17_31494322_31519980
Ndufv3,17,31520115,31531331,protein_coding,1,11216,chr17_31520115_31531331
Pknox1,17,31564734,31607693,protein_coding,1,42959,chr17_31564734_31607693
Cbs,17,31608894,31637238,protein_coding,-1,28344,chr17_31608894_31637238
U2af1,17,31647081,31658892,protein_coding,-1,11811,chr17_31647081_31658892
Cryaa,17,31677807,31681733,protein_coding,1,3926,chr17_31677807_31681733
Sik1,17,31844250,31855804,protein_coding,-1,11554,chr17_31844250_31855804
Hsf2bp,17,31944769,32036349,protein_coding,-1,91580,chr17_31944769_32036349
Rrp1b,17,32036100,32062865,protein_coding,1,26765,chr17_32036100_32062865
Gm17276,17,32113411,32141843,antisense,1,28432,chr17_32113411_32141843
Notch3,17,32120820,32166852,protein_coding,-1,46032,chr17_32120820_32166852
Ephx3,17,32183770,32189549,protein_coding,-1,5779,chr17_32183770_32189549
Brd4,17,32196274,32284722,protein_coding,-1,88448,chr17_32196274_32284722
Akap8,17,32303672,32321238,protein_coding,-1,17566,chr17_32303672_32321238
Akap8l,17,32321424,32350607,protein_coding,-1,29183,chr17_32321424_32350607
Wiz,17,32354055,32389439,protein_coding,-1,35384,chr17_32354055_32389439
Rasal3,17,32390659,32403583,protein_coding,-1,12924,chr17_32390659_32403583
Pglyrp2,17,32412459,32424167,protein_coding,-1,11708,chr17_32412459_32424167
Cyp4f39,17,32452723,32493320,protein_coding,1,40597,chr17_32452723_32493320
Cyp4f17,17,32506050,32530143,protein_coding,1,24093,chr17_32506050_32530143
Cyp4f16,17,32536558,32551798,protein_coding,1,15240,chr17_32536558_32551798
Cyp4f37,17,32621309,32636184,protein_coding,1,14875,chr17_32621309_32636184
Cyp4f40,17,32658900,32676914,protein_coding,1,18014,chr17_32658900_32676914
Cyp4f15,17,32685627,32703352,protein_coding,1,17725,chr17_32685627_32703352
Zfp871,17,32765496,32788287,protein_coding,-1,22791,chr17_32765496_32788287
Gm17115,17,32788394,32789591,bidirectional_promoter_lncRNA,1,1197,chr17_32788394_32789591
Zfp811,17,32795676,32809931,protein_coding,-1,14255,chr17_32795676_32809931
Gm26693,17,32810144,32821697,antisense,1,11553,chr17_32810144_32821697
Zfp799,17,32815449,32830261,protein_coding,-1,14812,chr17_32815449_32830261
Zfp870,17,32879219,32891642,protein_coding,-1,12423,chr17_32879219_32891642
Cyp4f14,17,32905070,32917342,protein_coding,-1,12272,chr17_32905070_32917342
Cyp4f13,17,32924688,32947402,protein_coding,-1,22714,chr17_32924688_32947402
Zfp472,17,32965814,32979233,protein_coding,1,13419,chr17_32965814_32979233
Zfp952,17,32993129,33005457,protein_coding,1,12328,chr17_32993129_33005457
Zfp763,17,33016863,33033402,protein_coding,-1,16539,chr17_33016863_33033402
Zfp563,17,33089310,33110705,protein_coding,1,21395,chr17_33089310_33110705
Morc2b,17,33113351,33139683,protein_coding,-1,26332,chr17_33113351_33139683
Olfr55,17,33168447,33180753,protein_coding,1,12306,chr17_33168447_33180753
Olfr239,17,33191302,33202506,protein_coding,1,11204,chr17_33191302_33202506
Olfr1564,17,33211206,33221690,protein_coding,-1,10484,chr17_33211206_33221690
Zfp955a,17,33239718,33255145,protein_coding,-1,15427,chr17_33239718_33255145
Olfr63,17,33264676,33275644,protein_coding,1,10968,chr17_33264676_33275644
Zfp955b,17,33289544,33307241,protein_coding,1,17697,chr17_33289544_33307241
Zfp81,17,33329342,33358878,protein_coding,-1,29536,chr17_33329342_33358878
Zfp101,17,33360507,33394641,protein_coding,-1,34134,chr17_33360507_33394641
Actl9,17,33432896,33434268,protein_coding,1,1372,chr17_33432896_33434268
Adamts10,17,33524204,33553782,protein_coding,1,29578,chr17_33524204_33553782
Myo1f,17,33555707,33607764,protein_coding,1,52057,chr17_33555707_33607764
Zfp414,17,33629090,33631779,protein_coding,1,2689,chr17_33629090_33631779
Pram1,17,33638056,33645706,protein_coding,1,7650,chr17_33638056_33645706
Hnrnpm,17,33646233,33686860,protein_coding,-1,40627,chr17_33646233_33686860
Rab11b,17,33742484,33760530,protein_coding,-1,18046,chr17_33742484_33760530
Angptl4,17,33773750,33781830,protein_coding,-1,8080,chr17_33773750_33781830
4931413I07Rik,17,33783340,33785724,lincRNA,-1,2384,chr17_33783340_33785724
Kank3,17,33810519,33822918,protein_coding,1,12399,chr17_33810519_33822918
Rps28,17,33819027,33824562,protein_coding,-1,5535,chr17_33819027_33824562
Ndufa7,17,33824572,33838317,protein_coding,1,13745,chr17_33824572_33838317
Cd320,17,33843091,33849774,protein_coding,1,6683,chr17_33843091_33849774
Kifc1,17,33875659,33890661,protein_coding,-1,15002,chr17_33875659_33890661
BC051226,17,33908044,33909317,bidirectional_promoter_lncRNA,-1,1273,chr17_33908044_33909317
Daxx,17,33909414,33915590,protein_coding,1,6176,chr17_33909414_33915590
Tapbp,17,33915899,33929292,protein_coding,1,13393,chr17_33915899_33929292
Gm19412,17,33919279,33920485,antisense,-1,1206,chr17_33919279_33920485
Rgl2,17,33929543,33937687,protein_coding,1,8144,chr17_33929543_33937687
Pfdn6,17,33938821,33940343,protein_coding,-1,1522,chr17_33938821_33940343
Wdr46,17,33940660,33949697,protein_coding,1,9037,chr17_33940660_33949697
B3galt4,17,33949909,33951488,protein_coding,-1,1579,chr17_33949909_33951488
Rps18,17,33951999,33956001,protein_coding,-1,4002,chr17_33951999_33956001
Vps52,17,33955812,33967035,protein_coding,1,11223,chr17_33955812_33967035
H2-K1,17,33996017,34000347,protein_coding,-1,4330,chr17_33996017_34000347
Ring1,17,34020792,34024680,protein_coding,-1,3888,chr17_34020792_34024680
H2-Ke6,17,34026033,34028060,protein_coding,-1,2027,chr17_34026033_34028060
Slc39a7,17,34028269,34031682,protein_coding,-1,3413,chr17_34028269_34031682
Rxrb,17,34031812,34038399,protein_coding,1,6587,chr17_34031812_34038399
Col11a2,17,34039437,34066685,protein_coding,1,27248,chr17_34039437_34066685
BC051537,17,34083843,34095309,antisense,-1,11466,chr17_34083843_34095309
H2-Oa,17,34092340,34095234,protein_coding,1,2894,chr17_34092340_34095234
Brd2,17,34112023,34122634,protein_coding,-1,10611,chr17_34112023_34122634
H2-DMa,17,34119541,34139101,protein_coding,1,19560,chr17_34119541_34139101
H2-DMb2,17,34143307,34151555,protein_coding,1,8248,chr17_34143307_34151555
H2-DMb1,17,34153072,34160230,protein_coding,1,7158,chr17_34153072_34160230
Psmb9,17,34181987,34187764,protein_coding,-1,5777,chr17_34181987_34187764
Tap1,17,34187553,34197225,protein_coding,1,9672,chr17_34187553_34197225
Psmb8,17,34197721,34201454,protein_coding,1,3733,chr17_34197721_34201454
Gm20496,17,34199316,34205449,antisense,-1,6133,chr17_34199316_34205449
Tap2,17,34203527,34216321,protein_coding,1,12794,chr17_34203527_34216321
Gm15821,17,34211312,34214459,macro_lncRNA,-1,3147,chr17_34211312_34214459
H2-Ob,17,34238903,34254414,protein_coding,1,15511,chr17_34238903_34254414
H2-Ab1,17,34257689,34269419,protein_coding,1,11730,chr17_34257689_34269419
H2-Aa,17,34282744,34287823,protein_coding,-1,5079,chr17_34282744_34287823
Gm20513,17,34293073,34308070,antisense,-1,14997,chr17_34293073_34308070
H2-Eb1,17,34305867,34316674,protein_coding,1,10807,chr17_34305867_34316674
H2-Eb2,17,34325665,34341412,protein_coding,1,15747,chr17_34325665_34341412
Btnl2,17,34354822,34369495,protein_coding,1,14673,chr17_34354822_34369495
BC051142,17,34398820,34460734,protein_coding,1,61914,chr17_34398820_34460734
Notch4,17,34564268,34588503,protein_coding,1,24235,chr17_34564268_34588503
Gpsm3,17,34589806,34591754,protein_coding,1,1948,chr17_34589806_34591754
Pbx2,17,34591266,34597400,protein_coding,1,6134,chr17_34591266_34597400
Ager,17,34597862,34600936,protein_coding,1,3074,chr17_34597862_34600936
Rnf5,17,34601091,34603690,protein_coding,-1,2599,chr17_34601091_34603690
Gm20463,17,34601151,34601576,antisense,1,425,chr17_34601151_34601576
Agpat1,17,34604262,34613449,protein_coding,1,9187,chr17_34604262_34613449
Egfl8,17,34613349,34615971,protein_coding,-1,2622,chr17_34613349_34615971
Ppt2,17,34616662,34628510,protein_coding,-1,11848,chr17_34616662_34628510
Prrt1,17,34629533,34633126,protein_coding,1,3593,chr17_34629533_34633126
Gm20461,17,34640846,34643977,lincRNA,-1,3131,chr17_34640846_34643977
Fkbpl,17,34644764,34646324,protein_coding,1,1560,chr17_34644764_34646324
Atf6b,17,34647146,34655074,protein_coding,1,7928,chr17_34647146_34655074
Tnxb,17,34660457,34719815,protein_coding,1,59358,chr17_34660457_34719815
C4b,17,34728380,34743882,protein_coding,-1,15502,chr17_34728380_34743882
Cyp21a1,17,34801348,34804561,protein_coding,-1,3213,chr17_34801348_34804561
Stk19,17,34823993,34836945,protein_coding,-1,12952,chr17_34823993_34836945
Dxo,17,34837019,34839233,protein_coding,1,2214,chr17_34837019_34839233
Skiv2l,17,34839228,34850210,protein_coding,-1,10982,chr17_34839228_34850210
Nelfe,17,34850391,34856372,protein_coding,1,5981,chr17_34850391_34856372
C2,17,34862604,34898265,protein_coding,-1,35661,chr17_34862604_34898265
Zbtb12,17,34879483,34896867,protein_coding,1,17384,chr17_34879483_34896867
Ehmt2,17,34898469,34914052,protein_coding,1,15583,chr17_34898469_34914052
Slc44a4,17,34914466,34930436,protein_coding,1,15970,chr17_34914466_34930436
Neu1,17,34931253,34935953,protein_coding,1,4700,chr17_34931253_34935953
Hspa1b,17,34956436,34959238,protein_coding,-1,2802,chr17_34956436_34959238
Hspa1a,17,34969190,34972156,protein_coding,-1,2966,chr17_34969190_34972156
Gm20481,17,34969912,34972136,protein_coding,1,2224,chr17_34969912_34972136
Hspa1l,17,34972703,34979285,protein_coding,1,6582,chr17_34972703_34979285
Gm10501,17,34976899,34981788,antisense,-1,4889,chr17_34976899_34981788
Lsm2,17,34981862,34985891,protein_coding,1,4029,chr17_34981862_34985891
Vars,17,35000987,35016322,protein_coding,1,15335,chr17_35000987_35016322
Vwa7,17,35016579,35026741,protein_coding,1,10162,chr17_35016579_35026741
Sapcd1,17,35025959,35028016,protein_coding,-1,2057,chr17_35025959_35028016
Msh5,17,35028605,35046745,protein_coding,-1,18140,chr17_35028605_35046745
Clic1,17,35049966,35058749,protein_coding,1,8783,chr17_35049966_35058749
Ddah2,17,35059035,35062095,protein_coding,1,3060,chr17_35059035_35062095
Ly6g6d,17,35071443,35078065,protein_coding,-1,6622,chr17_35071443_35078065
Ly6g6e,17,35076902,35078804,protein_coding,1,1902,chr17_35076902_35078804
Ly6g6f,17,35080480,35085610,protein_coding,-1,5130,chr17_35080480_35085610
Abhd16a,17,35089263,35102987,protein_coding,1,13724,chr17_35089263_35102987
Ly6g5c,17,35108279,35111991,protein_coding,1,3712,chr17_35108279_35111991
Ly6g5b,17,35113948,35115428,protein_coding,-1,1480,chr17_35113948_35115428
Csnk2b,17,35116196,35122053,protein_coding,-1,5857,chr17_35116196_35122053
Gpank1,17,35121455,35124814,protein_coding,1,3359,chr17_35121455_35124814
Gm20522,17,35122738,35126440,antisense,-1,3702,chr17_35122738_35126440
D17H6S53E,17,35126373,35128855,protein_coding,1,2482,chr17_35126373_35128855
Apom,17,35128997,35132050,protein_coding,-1,3053,chr17_35128997_35132050
Bag6,17,35135178,35147322,protein_coding,1,12144,chr17_35135178_35147322
Prrc2a,17,35149076,35164897,protein_coding,-1,15821,chr17_35149076_35164897
Gm17705,17,35165119,35167186,lincRNA,1,2067,chr17_35165119_35167186
Aif1,17,35170991,35176068,protein_coding,-1,5077,chr17_35170991_35176068
Lst1,17,35185095,35188439,protein_coding,-1,3344,chr17_35185095_35188439
Ltb,17,35194439,35196320,protein_coding,1,1881,chr17_35194439_35196320
Tnf,17,35199381,35202007,protein_coding,-1,2626,chr17_35199381_35202007
Lta,17,35203165,35205351,protein_coding,-1,2186,chr17_35203165_35205351
Nfkbil1,17,35220175,35235792,protein_coding,-1,15617,chr17_35220175_35235792
Gm16181,17,35220834,35224134,protein_coding,1,3300,chr17_35220834_35224134
Atp6v1g2,17,35233660,35238767,protein_coding,1,5107,chr17_35233660_35238767
Ddx39b,17,35241746,35253707,protein_coding,1,11961,chr17_35241746_35253707
H2-D1,17,35262730,35267499,protein_coding,1,4769,chr17_35262730_35267499
H2-Q1,17,35320405,35325099,protein_coding,1,4694,chr17_35320405_35325099
H2-Q2,17,35342242,35346762,protein_coding,1,4520,chr17_35342242_35346762
Gm11131,17,35377021,35380292,antisense,-1,3271,chr17_35377021_35380292
H2-Q4,17,35379617,35385290,protein_coding,1,5673,chr17_35379617_35385290
H2-Q6,17,35424850,35430055,protein_coding,1,5205,chr17_35424850_35430055
H2-Q7,17,35439155,35443773,protein_coding,1,4618,chr17_35439155_35443773
H2-Q10,17,35470089,35474563,protein_coding,1,4474,chr17_35470089_35474563
Gm19553,17,35509077,35510551,antisense,-1,1474,chr17_35509077_35510551
Tcf19,17,35512734,35516824,protein_coding,-1,4090,chr17_35512734_35516824
Cchcr1,17,35517100,35531015,protein_coding,1,13915,chr17_35517100_35531015
Psors1c2,17,35533201,35534647,protein_coding,1,1446,chr17_35533201_35534647
Cdsn,17,35552128,35557180,protein_coding,1,5052,chr17_35552128_35557180
2300002M23Rik,17,35567450,35568952,protein_coding,1,1502,chr17_35567450_35568952
Sfta2,17,35601549,35650571,protein_coding,1,49022,chr17_35601549_35650571
Gm9573,17,35617923,35626637,protein_coding,-1,8714,chr17_35617923_35626637
Gm20483,17,35651828,35660367,antisense,1,8539,chr17_35651828_35660367
Vars2,17,35655634,35667592,protein_coding,-1,11958,chr17_35655634_35667592
Gtf2h4,17,35667730,35673739,protein_coding,-1,6009,chr17_35667730_35673739
Ddr1,17,35681567,35704621,protein_coding,-1,23054,chr17_35681567_35704621
Gm4577,17,35703896,35708244,antisense,1,4348,chr17_35703896_35708244
Gm20443,17,35737734,35739806,lincRNA,-1,2072,chr17_35737734_35739806
Gm20442,17,35743323,35764191,lincRNA,-1,20868,chr17_35743323_35764191
4833427F10Rik,17,35772450,35780687,lincRNA,1,8237,chr17_35772450_35780687
Ier3,17,35821684,35822923,protein_coding,1,1239,chr17_35821684_35822923
Flot1,17,35823230,35832791,protein_coding,1,9561,chr17_35823230_35832791
Tubb5,17,35833921,35838306,protein_coding,-1,4385,chr17_35833921_35838306
Mdc1,17,35841515,35859670,protein_coding,1,18155,chr17_35841515_35859670
Ppp1r18os,17,35860918,35866886,antisense,-1,5968,chr17_35860918_35866886
Nrm,17,35861318,35865402,protein_coding,1,4084,chr17_35861318_35865402
Ppp1r18,17,35865593,35875596,protein_coding,1,10003,chr17_35865593_35875596
Dhx16,17,35879819,35892670,protein_coding,1,12851,chr17_35879819_35892670
2310061I04Rik,17,35892677,35897431,protein_coding,-1,4754,chr17_35892677_35897431
Gm16279,17,35896946,35912215,antisense,1,15269,chr17_35896946_35912215
Atat1,17,35897595,35910075,protein_coding,-1,12480,chr17_35897595_35910075
Mrps18b,17,35910379,35916389,protein_coding,-1,6010,chr17_35910379_35916389
Ppp1r10,17,35916434,35932283,protein_coding,1,15849,chr17_35916434_35932283
Abcf1,17,35956819,35969761,protein_coding,-1,12942,chr17_35956819_35969761
Prr3,17,35972541,35980236,protein_coding,-1,7695,chr17_35972541_35980236
Gnl1,17,35979851,35989462,protein_coding,1,9611,chr17_35979851_35989462
Gm20508,17,35991867,35993738,lincRNA,1,1871,chr17_35991867_35993738
A930015D03Rik,17,35994453,36038435,antisense,1,43982,chr17_35994453_36038435
H2-T24,17,36005695,36020560,protein_coding,-1,14865,chr17_36005695_36020560
H2-T23,17,36029773,36032855,protein_coding,-1,3082,chr17_36029773_36032855
H2-T22,17,36037128,36042747,protein_coding,-1,5619,chr17_36037128_36042747
Gm6034,17,36042961,36058645,protein_coding,1,15684,chr17_36042961_36058645
Gm11127,17,36055816,36058371,protein_coding,-1,2555,chr17_36055816_36058371
Gm7030,17,36109719,36129425,protein_coding,-1,19706,chr17_36109719_36129425
BC023719,17,36111426,36117121,antisense,1,5695,chr17_36111426_36117121
Gm19684,17,36121678,36129692,protein_coding,1,8014,chr17_36121678_36129692
2410017I17Rik,17,36145018,36163176,lincRNA,1,18158,chr17_36145018_36163176
Gm8909,17,36164443,36168537,protein_coding,-1,4094,chr17_36164443_36168537
H2-T3,17,36185572,36190287,protein_coding,-1,4715,chr17_36185572_36190287
Gm20546,17,36248821,36253679,lincRNA,1,4858,chr17_36248821_36253679
Rpp21,17,36255645,36258069,protein_coding,-1,2424,chr17_36255645_36258069
Trim39,17,36258873,36272247,protein_coding,-1,13374,chr17_36258873_36272247
H2-M10.2,17,36284227,36286490,protein_coding,-1,2263,chr17_36284227_36286490
Trim26,17,36837134,36859398,protein_coding,1,22264,chr17_36837134_36859398
Trim15,17,36860691,36867210,protein_coding,-1,6519,chr17_36860691_36867210
Trim10,17,36869574,36877833,protein_coding,1,8259,chr17_36869574_36877833
Trim40,17,36881598,36890123,protein_coding,-1,8525,chr17_36881598_36890123
Trim31,17,36898118,36910214,protein_coding,1,12096,chr17_36898118_36910214
1700031A10Rik,17,36923792,36933432,antisense,1,9640,chr17_36923792_36933432
Rnf39,17,36942918,36947986,protein_coding,1,5068,chr17_36942918_36947986
Ppp1r11,17,36948356,36951741,protein_coding,-1,3385,chr17_36948356_36951741
Znrd1,17,36954356,36958559,protein_coding,-1,4203,chr17_36954356_36958559
Znrd1as,17,36958592,36965625,protein_coding,1,7033,chr17_36958592_36965625
2410137M14Rik,17,36977701,36981237,protein_coding,-1,3536,chr17_36977701_36981237
H2-M5,17,36984061,36989537,protein_coding,-1,5476,chr17_36984061_36989537
Zfp57,17,37001163,37010635,protein_coding,1,9472,chr17_37001163_37010635
Mog,17,37010743,37023398,protein_coding,-1,12655,chr17_37010743_37023398
Gabbr1,17,37045966,37075067,protein_coding,1,29101,chr17_37045966_37075067
Olfr90,17,37083871,37088499,protein_coding,-1,4628,chr17_37083871_37088499
Olfr91,17,37090618,37098278,protein_coding,-1,7660,chr17_37090618_37098278
Olfr92,17,37110512,37120088,protein_coding,-1,9576,chr17_37110512_37120088
Olfr93,17,37140423,37161494,protein_coding,-1,21071,chr17_37140423_37161494
Olfr94,17,37196425,37200994,protein_coding,-1,4569,chr17_37196425_37200994
Olfr95,17,37207950,37213118,protein_coding,-1,5168,chr17_37207950_37213118
H2-M3,17,37270220,37274484,protein_coding,1,4264,chr17_37270220_37274484
Olfr99,17,37279043,37283460,protein_coding,-1,4417,chr17_37279043_37283460
Olfr101,17,37297556,37304313,protein_coding,-1,6757,chr17_37297556_37304313
Olfr102,17,37311795,37317054,protein_coding,-1,5259,chr17_37311795_37317054
Olfr103,17,37334303,37339698,protein_coding,-1,5395,chr17_37334303_37339698
Olfr104-ps,17,37359582,37363993,protein_coding,1,4411,chr17_37359582_37363993
Olfr105-ps,17,37379033,37386208,protein_coding,1,7175,chr17_37379033_37386208
Olfr106-ps,17,37390393,37396252,protein_coding,1,5859,chr17_37390393_37396252
Olfr107,17,37399226,37407477,protein_coding,1,8251,chr17_37399226_37407477
Olfr109,17,37458916,37471590,protein_coding,1,12674,chr17_37458916_37471590
H2-M2,17,37480851,37483552,protein_coding,-1,2701,chr17_37480851_37483552
Olfr110,17,37492468,37500207,protein_coding,1,7739,chr17_37492468_37500207
Olfr111,17,37508030,37532449,protein_coding,1,24419,chr17_37508030_37532449
Olfr112,17,37561668,37569451,protein_coding,-1,7783,chr17_37561668_37569451
Olfr113,17,37573877,37577663,protein_coding,-1,3786,chr17_37573877_37577663
Olfr114,17,37589233,37592743,protein_coding,-1,3510,chr17_37589233_37592743
Olfr115,17,37608940,37627109,protein_coding,-1,18169,chr17_37608940_37627109
Olfr118,17,37666988,37673476,protein_coding,1,6488,chr17_37666988_37673476
Olfr119,17,37696564,37702124,protein_coding,1,5560,chr17_37696564_37702124
Olfr120,17,37721808,37727220,protein_coding,1,5412,chr17_37721808_37727220
Olfr122,17,37768607,37773749,protein_coding,1,5142,chr17_37768607_37773749
Olfr124,17,37799888,37808617,protein_coding,1,8729,chr17_37799888_37808617
Olfr125,17,37832949,37838490,protein_coding,1,5541,chr17_37832949_37838490
Olfr127,17,37900437,37906795,protein_coding,1,6358,chr17_37900437_37906795
Olfr129,17,38050857,38060079,protein_coding,-1,9222,chr17_38050857_38060079
Olfr131,17,38081624,38088693,protein_coding,-1,7069,chr17_38081624_38088693
Olfr138,17,38261035,38276410,protein_coding,1,15375,chr17_38261035_38276410
Crisp1,17,40293758,40319207,protein_coding,-1,25449,chr17_40293758_40319207
Esp8,17,40520022,40530421,protein_coding,1,10399,chr17_40520022_40530421
Gm44501,17,40561507,40579549,protein_coding,1,18042,chr17_40561507_40579549
Crisp2,17,40764020,40807003,protein_coding,-1,42983,chr17_40764020_40807003
Rhag,17,40811126,40840754,protein_coding,1,29628,chr17_40811126_40840754
9130008F23Rik,17,40875482,40880559,protein_coding,-1,5077,chr17_40875482_40880559
Glyatl3,17,40904618,40914350,protein_coding,-1,9732,chr17_40904618_40914350
Cenpq,17,40923051,40935047,protein_coding,-1,11996,chr17_40923051_40935047
Ptchd4,17,42315947,42505077,protein_coding,1,189130,chr17_42315947_42505077
Opn5,17,42556783,42611395,protein_coding,-1,54612,chr17_42556783_42611395
Adgrf4,17,42656891,42692284,protein_coding,-1,35393,chr17_42656891_42692284
Adgrf2,17,42696130,42742179,protein_coding,-1,46049,chr17_42696130_42742179
Cd2ap,17,42792951,42876665,protein_coding,-1,83714,chr17_42792951_42876665
Tnfrsf21,17,43016555,43089189,protein_coding,1,72634,chr17_43016555_43089189
Adgrf1,17,43270329,43324737,protein_coding,1,54408,chr17_43270329_43324737
Adgrf5,17,43360451,43459557,protein_coding,1,99106,chr17_43360451_43459557
Mep1a,17,43474324,43502812,protein_coding,-1,28488,chr17_43474324_43502812
Ankrd66,17,43534188,43543639,protein_coding,-1,9451,chr17_43534188_43543639
Pla2g7,17,43568098,43612201,protein_coding,1,44103,chr17_43568098_43612201
1700071M16Rik,17,43588340,43592442,antisense,-1,4102,chr17_43588340_43592442
Tdrd6,17,43615335,43630299,protein_coding,-1,14964,chr17_43615335_43630299
Slc25a27,17,43641891,43667214,protein_coding,-1,25323,chr17_43641891_43667214
Cyp39a1,17,43667425,43751431,protein_coding,1,84006,chr17_43667425_43751431
Rcan2,17,43801351,44039516,protein_coding,1,238165,chr17_43801351_44039516
Enpp5,17,44078813,44086567,protein_coding,1,7754,chr17_44078813_44086567
Enpp4,17,44096308,44105809,protein_coding,-1,9501,chr17_44096308_44105809
Clic5,17,44134768,44280172,protein_coding,1,145404,chr17_44134768_44280172
Runx2,17,44495987,44814797,protein_coding,-1,318810,chr17_44495987_44814797
Runx2os3,17,44561990,44563172,antisense,1,1182,chr17_44561990_44563172
Runx2os2,17,44710222,44713925,antisense,1,3703,chr17_44710222_44713925
Runx2os1,17,44735845,44737612,antisense,1,1767,chr17_44735845_44737612
Supt3,17,44777152,45119290,protein_coding,1,342138,chr17_44777152_45119290
Cdc5l,17,45391884,45433737,protein_coding,-1,41853,chr17_45391884_45433737
B230354K17Rik,17,45433598,45442544,bidirectional_promoter_lncRNA,1,8946,chr17_45433598_45442544
Spats1,17,45440578,45475415,protein_coding,-1,34837,chr17_45440578_45475415
Aars2,17,45506841,45520843,protein_coding,1,14002,chr17_45506841_45520843
Tcte1,17,45523434,45542680,protein_coding,1,19246,chr17_45523434_45542680
Tmem151b,17,45541952,45549677,protein_coding,-1,7725,chr17_45541952_45549677
Nfkbie,17,45555703,45563169,protein_coding,1,7466,chr17_45555703_45563169
Slc35b2,17,45563874,45567671,protein_coding,1,3797,chr17_45563874_45567671
Hsp90ab1,17,45567775,45573271,protein_coding,-1,5496,chr17_45567775_45573271
Slc29a1,17,45585200,45599606,protein_coding,-1,14406,chr17_45585200_45599606
Gm17080,17,45586120,45588377,antisense,1,2257,chr17_45586120_45588377
Capn11,17,45630204,45659325,protein_coding,-1,29121,chr17_45630204_45659325
Tmem63b,17,45660171,45686905,protein_coding,-1,26734,chr17_45660171_45686905
Gm16172,17,45663519,45666209,antisense,1,2690,chr17_45663519_45666209
Mrpl14,17,45686322,45698495,protein_coding,1,12173,chr17_45686322_45698495
F630040K05Rik,17,45734506,45788594,lincRNA,1,54088,chr17_45734506_45788594
Vegfa,17,46016993,46032369,protein_coding,-1,15376,chr17_46016993_46032369
Mrps18a,17,46110986,46128910,protein_coding,1,17924,chr17_46110986_46128910
Rsph9,17,46122035,46144216,protein_coding,-1,22181,chr17_46122035_46144216
Mad2l1bp,17,46147387,46153553,protein_coding,-1,6166,chr17_46147387_46153553
Gtpbp2,17,46161032,46169370,protein_coding,1,8338,chr17_46161032_46169370
Polh,17,46171355,46202645,protein_coding,-1,31290,chr17_46171355_46202645
Xpo5,17,46202782,46243598,protein_coding,1,40816,chr17_46202782_46243598
Polr1c,17,46243920,46248054,protein_coding,-1,4134,chr17_46243920_46248054
Yipf3,17,46248080,46252537,protein_coding,1,4457,chr17_46248080_46252537
Lrrc73,17,46253531,46257315,protein_coding,1,3784,chr17_46253531_46257315
Tjap1,17,46257851,46283026,protein_coding,-1,25175,chr17_46257851_46283026
Dlk2,17,46297421,46303271,protein_coding,1,5850,chr17_46297421_46303271
Abcc10,17,46303221,46328352,protein_coding,-1,25131,chr17_46303221_46328352
Zfp318,17,46383731,46420920,protein_coding,1,37189,chr17_46383731_46420920
Crip3,17,46428926,46431776,protein_coding,1,2850,chr17_46428926_46431776
Slc22a7,17,46432183,46438457,protein_coding,-1,6274,chr17_46432183_46438457
Gm5093,17,46439578,46440097,processed_pseudogene,-1,519,chr17_46439578_46440097
Ttbk1,17,46442448,46487675,protein_coding,-1,45227,chr17_46442448_46487675
Cul9,17,46500572,46546388,protein_coding,-1,45816,chr17_46500572_46546388
Srf,17,46548329,46556175,protein_coding,-1,7846,chr17_46548329_46556175
Ptk7,17,46564471,46629504,protein_coding,-1,65033,chr17_46564471_46629504
Klc4,17,46630624,46646022,protein_coding,-1,15398,chr17_46630624_46646022
Rrp36,17,46666324,46674352,protein_coding,-1,8028,chr17_46666324_46674352
Klhdc3,17,46674550,46680914,protein_coding,-1,6364,chr17_46674550_46680914
Ppp2r5d,17,46682991,46705111,protein_coding,-1,22120,chr17_46682991_46705111
Gnmt,17,46725664,46729168,protein_coding,-1,3504,chr17_46725664_46729168
Cnpy3,17,46735705,46752214,protein_coding,-1,16509,chr17_46735705_46752214
Ptcra,17,46755663,46763712,protein_coding,-1,8049,chr17_46755663_46763712
Rpl7l1,17,46773907,46782672,protein_coding,-1,8765,chr17_46773907_46782672
Bicral,17,46798120,46858482,protein_coding,-1,60362,chr17_46798120_46858482
Tbcc,17,46890684,46891847,protein_coding,1,1163,chr17_46890684_46891847
Prph2,17,46910459,46924933,protein_coding,1,14474,chr17_46910459_46924933
Ubr2,17,46928295,47010556,protein_coding,-1,82261,chr17_46928295_47010556
Mrps10,17,47368886,47381417,protein_coding,1,12531,chr17_47368886_47381417
Guca1b,17,47385392,47392967,protein_coding,1,7575,chr17_47385392_47392967
Guca1a,17,47394557,47400584,protein_coding,-1,6027,chr17_47394557_47400584
1700001C19Rik,17,47412733,47437376,protein_coding,-1,24643,chr17_47412733_47437376
AI661453,17,47436615,47470638,protein_coding,1,34023,chr17_47436615_47470638
Taf8,17,47483364,47502292,protein_coding,-1,18928,chr17_47483364_47502292
Ccnd3,17,47505051,47599691,protein_coding,1,94640,chr17_47505051_47599691
Bysl,17,47599331,47611492,protein_coding,-1,12161,chr17_47599331_47611492
Med20,17,47611582,47624418,protein_coding,1,12836,chr17_47611582_47624418
Gm20517,17,47611589,47683861,protein_coding,1,72272,chr17_47611589_47683861
Usp49,17,47630690,47686738,protein_coding,1,56048,chr17_47630690_47686738
Tomm6,17,47686646,47688386,protein_coding,-1,1740,chr17_47686646_47688386
Gm21981,17,47686739,47694455,protein_coding,-1,7716,chr17_47686739_47694455
Tomm6os,17,47687610,47691083,antisense,1,3473,chr17_47687610_47691083
Prickle4,17,47688517,47694736,protein_coding,-1,6219,chr17_47688517_47694736
Frs3,17,47689030,47704286,protein_coding,1,15256,chr17_47689030_47704286
Frs3os,17,47699971,47701996,antisense,-1,2025,chr17_47699971_47701996
Pgc,17,47726842,47734482,protein_coding,1,7640,chr17_47726842_47734482
Tfeb,17,47737030,47792419,protein_coding,1,55389,chr17_47737030_47792419
Mdfi,17,47815328,47834691,protein_coding,-1,19363,chr17_47815328_47834691
Foxp4,17,47867133,47924645,protein_coding,-1,57512,chr17_47867133_47924645
Gm15556,CHR_MG4200_PATCH,47922378,47923429,antisense;lncRNA,1,1051,chrCHR_MG4200_PATCH_47922378_47923429
1700067P10Rik,17,48088914,48090918,protein_coding,1,2004,chr17_48088914_48090918
A530064D06Rik,17,48149083,48167275,protein_coding,-1,18192,chr17_48149083_48167275
Trem3,17,48243880,48258841,protein_coding,1,14961,chr17_48243880_48258841
Treml4,17,48260398,48275360,protein_coding,1,14962,chr17_48260398_48275360
Treml2,17,48295601,48312533,protein_coding,1,16932,chr17_48295601_48312533
B430306N03Rik,17,48312244,48327024,protein_coding,1,14780,chr17_48312244_48327024
Trem2,17,48342504,48354147,protein_coding,1,11643,chr17_48342504_48354147
Treml1,17,48356019,48367176,protein_coding,1,11157,chr17_48356019_48367176
Nfya,17,48382988,48409906,protein_coding,-1,26918,chr17_48382988_48409906
Oard1,17,48406117,48417266,protein_coding,1,11149,chr17_48406117_48417266
Apobec2,17,48415334,48432930,protein_coding,-1,17596,chr17_48415334_48432930
Tspo2,17,48444010,48451522,protein_coding,-1,7512,chr17_48444010_48451522
Unc5cl,17,48451004,48539714,protein_coding,1,88710,chr17_48451004_48539714
Gm45330,17,48730399,48738746,lincRNA,-1,8347,chr17_48730399_48738746
Lrfn2,17,48932379,49097588,protein_coding,1,165209,chr17_48932379_49097588
1700008K24Rik,17,49112263,49113535,lincRNA,-1,1272,chr17_49112263_49113535
Mocs1,17,49428362,49455435,protein_coding,1,27073,chr17_49428362_49455435
Daam2,17,49456022,49564343,protein_coding,-1,108321,chr17_49456022_49564343
Kif6,17,49615136,49909847,protein_coding,1,294711,chr17_49615136_49909847
Gm16555,17,49817626,49821825,antisense,-1,4199,chr17_49817626_49821825
Gm16554,17,49894742,49895967,antisense,-1,1225,chr17_49894742_49895967
Rftn1,17,49992257,50190674,protein_coding,-1,198417,chr17_49992257_50190674
AY702103,17,50239208,50246316,lincRNA,1,7108,chr17_50239208_50246316
Dazl,17,50279395,50293636,protein_coding,-1,14241,chr17_50279395_50293636
Plcl2,17,50509403,50688484,protein_coding,1,179081,chr17_50509403_50688484
Gm7334,17,50698688,50699443,processed_pseudogene,1,755,chr17_50698688_50699443
Tbc1d5,17,50733124,51179352,protein_coding,-1,446228,chr17_50733124_51179352
Satb1,17,51736187,51833290,protein_coding,-1,97103,chr17_51736187_51833290
Gm19585,17,51986415,52163976,lincRNA,1,177561,chr17_51986415_52163976
Gm27217,17,52592981,52602660,antisense,-1,9679,chr17_52592981_52602660
Kcnh8,17,52602709,52979194,protein_coding,1,376485,chr17_52602709_52979194
Efhb,17,53398889,53463321,protein_coding,-1,64432,chr17_53398889_53463321
Rab5a,17,53479234,53507680,protein_coding,1,28446,chr17_53479234_53507680
Pp2d1,17,53507460,53539451,protein_coding,-1,31991,chr17_53507460_53539451
Kat2b,17,53566861,53672720,protein_coding,1,105859,chr17_53566861_53672720
Sgo1,17,53674786,53689333,protein_coding,-1,14547,chr17_53674786_53689333
Sult1c2,17,53829637,53846339,protein_coding,-1,16702,chr17_53829637_53846339
Sult1c1,17,53961615,53990674,protein_coding,-1,29059,chr17_53961615_53990674
Slc5a7,17,54273590,54299034,protein_coding,-1,25444,chr17_54273590_54299034
1700025K24Rik,17,54352583,54370074,lincRNA,-1,17491,chr17_54352583_54370074
St6gal2,17,55445355,55514581,protein_coding,1,69226,chr17_55445355_55514581
Vmn2r118,17,55590342,55625192,protein_coding,-1,34850,chr17_55590342_55625192
Pot1b,17,55651923,55712628,protein_coding,-1,60705,chr17_55651923_55712628
Adgre4,17,55749984,55853662,protein_coding,1,103678,chr17_55749984_55853662
Zfp119a,17,55864892,55878930,protein_coding,-1,14038,chr17_55864892_55878930
Zfp959,17,55892093,55898928,protein_coding,1,6835,chr17_55892093_55898928
Zfp119b,17,55938381,55949500,protein_coding,-1,11119,chr17_55938381_55949500
Ebi3,17,55952640,55957022,protein_coding,1,4382,chr17_55952640_55957022
Gm16712,17,55954771,55959381,antisense,-1,4610,chr17_55954771_55959381
Shd,17,55970467,55976625,protein_coding,1,6158,chr17_55970467_55976625
Fsd1,17,55986509,55996881,protein_coding,1,10372,chr17_55986509_55996881
Stap2,17,55997077,56005584,protein_coding,-1,8507,chr17_55997077_56005584
Mpnd,17,56005711,56016790,protein_coding,1,11079,chr17_56005711_56016790
Sh3gl1,17,56016750,56036635,protein_coding,-1,19885,chr17_56016750_56036635
Chaf1a,17,56040439,56072289,protein_coding,1,31850,chr17_56040439_56072289
Ubxn6,17,56067045,56075028,protein_coding,-1,7983,chr17_56067045_56075028
Hdgfl2,17,56079634,56100607,protein_coding,1,20973,chr17_56079634_56100607
Plin4,17,56100591,56109803,protein_coding,-1,9212,chr17_56100591_56109803
Plin5,17,56111601,56117596,protein_coding,-1,5995,chr17_56111601_56117596
Lrg1,17,56119678,56122001,protein_coding,-1,2323,chr17_56119678_56122001
Sema6b,17,56123085,56140343,protein_coding,-1,17258,chr17_56123085_56140343
Tnfaip8l1,17,56162477,56173955,protein_coding,1,11478,chr17_56162477_56173955
Mydgf,17,56175744,56183920,protein_coding,-1,8176,chr17_56175744_56183920
Dpp9,17,56186807,56218905,protein_coding,-1,32098,chr17_56186807_56218905
Fem1a,17,56256810,56263610,protein_coding,1,6800,chr17_56256810_56263610
Ticam1,17,56269319,56276786,protein_coding,-1,7467,chr17_56269319_56276786
Plin3,17,56277476,56292873,protein_coding,-1,15397,chr17_56277476_56292873
Arrdc5,17,56294111,56300286,protein_coding,-1,6175,chr17_56294111_56300286
Uhrf1,17,56303321,56323486,protein_coding,1,20165,chr17_56303321_56323486
Kdm4b,17,56326062,56402870,protein_coding,1,76808,chr17_56326062_56402870
Ptprs,17,56412426,56476483,protein_coding,-1,64057,chr17_56412426_56476483
Gm20219,17,56551414,56554387,protein_coding,-1,2973,chr17_56551414_56554387
Safb2,17,56560965,56584585,protein_coding,-1,23620,chr17_56560965_56584585
Safb,17,56584825,56606294,protein_coding,1,21469,chr17_56584825_56606294
Rpl36,17,56613416,56614243,protein_coding,1,827,chr17_56613416_56614243
Lonp1,17,56614297,56626887,protein_coding,-1,12590,chr17_56614297_56626887
Catsperd,17,56628143,56664456,protein_coding,1,36313,chr17_56628143_56664456
Ranbp3,17,56673294,56711764,protein_coding,1,38470,chr17_56673294_56711764
Vmac,17,56713936,56718022,protein_coding,-1,4086,chr17_56713936_56718022
Ndufa11,17,56717767,56722141,protein_coding,1,4374,chr17_56717767_56722141
Nrtn,17,56751325,56757530,protein_coding,-1,6205,chr17_56751325_56757530
Dus3l,17,56764757,56770093,protein_coding,1,5336,chr17_56764757_56770093
Prr22,17,56770250,56772208,protein_coding,1,1958,chr17_56770250_56772208
Rfx2,17,56775897,56831013,protein_coding,-1,55116,chr17_56775897_56831013
Acsbg2,17,56843103,56874447,protein_coding,-1,31344,chr17_56843103_56874447
Mllt1,17,56892611,56935415,protein_coding,-1,42804,chr17_56892611_56935415
Acer1,17,56953490,56982126,protein_coding,-1,28636,chr17_56953490_56982126
Clpp,17,56990305,56996188,protein_coding,1,5883,chr17_56990305_56996188
Alkbh7,17,56997339,56999322,protein_coding,1,1983,chr17_56997339_56999322
Pspn,17,56999457,57000018,protein_coding,-1,561,chr17_56999457_57000018
Gtf2f1,17,57003405,57011288,protein_coding,-1,7883,chr17_57003405_57011288
Gm17949,17,57011469,57021113,protein_coding,1,9644,chr17_57011469_57021113
Khsrp,17,57021051,57031522,protein_coding,-1,10471,chr17_57021051_57031522
Slc25a41,17,57032773,57041654,protein_coding,-1,8881,chr17_57032773_57041654
Gm17168,17,57041775,57047143,antisense,1,5368,chr17_57041775_57047143
Slc25a23,17,57043711,57059863,protein_coding,-1,16152,chr17_57043711_57059863
Crb3,17,57059105,57065918,protein_coding,1,6813,chr17_57059105_57065918
Dennd1c,17,57065905,57078514,protein_coding,-1,12609,chr17_57065905_57078514
Tubb4a,17,57080066,57087782,protein_coding,-1,7716,chr17_57080066_57087782
Gm11110,17,57091370,57105942,lincRNA,-1,14572,chr17_57091370_57105942
Tnfsf9,17,57105325,57107757,protein_coding,1,2432,chr17_57105325_57107757
Cd70,17,57145997,57149777,protein_coding,-1,3780,chr17_57145997_57149777
C3,17,57203970,57228136,protein_coding,-1,24166,chr17_57203970_57228136
Gpr108,17,57234635,57248446,protein_coding,-1,13811,chr17_57234635_57248446
Trip10,17,57249455,57263665,protein_coding,1,14210,chr17_57249455_57263665
Vav1,17,57279100,57328031,protein_coding,1,48931,chr17_57279100_57328031
Adgre1,17,57358691,57483527,protein_coding,1,124836,chr17_57358691_57483527
Vmn2r120,17,57506453,57545505,protein_coding,-1,39052,chr17_57506453_57545505
Cntnap5c,17,57769570,58410355,protein_coding,1,640785,chr17_57769570_58410355
Rpl7a-ps5,17,57838430,57839221,processed_pseudogene,-1,791,chr17_57838430_57839221
Pdzph1,17,58878808,58991375,protein_coding,-1,112567,chr17_58878808_58991375
Nudt12os,17,58996251,59024981,antisense,1,28730,chr17_58996251_59024981
Nudt12,17,58999618,59013372,protein_coding,-1,13754,chr17_58999618_59013372
Gm29051,17,60001418,60130875,lincRNA,-1,129457,chr17_60001418_60130875
Efna5,17,62604184,62881317,protein_coding,-1,277133,chr17_62604184_62881317
Fbxl17,17,63057452,63500017,protein_coding,-1,442565,chr17_63057452_63500017
Fer,17,63863062,64139496,protein_coding,1,276434,chr17_63863062_64139496
Pja2,17,64281005,64331916,protein_coding,-1,50911,chr17_64281005_64331916
AU016765,17,64514081,64555660,lincRNA,-1,41579,chr17_64514081_64555660
Man2a1,17,64600736,64755110,protein_coding,1,154374,chr17_64600736_64755110
Gm17133,17,64748850,64754096,antisense,-1,5246,chr17_64748850_64754096
4930583I09Rik,17,64832523,64836071,protein_coding,-1,3548,chr17_64832523_64836071
Tmem232,17,65255999,65540782,protein_coding,-1,284783,chr17_65255999_65540782
Vapa,17,65578327,65613555,protein_coding,-1,35228,chr17_65578327_65613555
Txndc2,17,65637507,65642168,protein_coding,-1,4661,chr17_65637507_65642168
Rab31,17,65651729,65772752,protein_coding,-1,121023,chr17_65651729_65772752
Ppp4r1,17,65782573,65841926,protein_coding,1,59353,chr17_65782573_65841926
Ralbp1,17,65848418,65885798,protein_coding,-1,37380,chr17_65848418_65885798
Twsg1,17,65921972,65951226,protein_coding,-1,29254,chr17_65921972_65951226
Ankrd12,17,65965698,66077089,protein_coding,-1,111391,chr17_65965698_66077089
Ndufv2,17,66078638,66101559,protein_coding,-1,22921,chr17_66078638_66101559
Washc1,17,66111545,66120503,protein_coding,1,8958,chr17_66111545_66120503
Ddx11,17,66123520,66152174,protein_coding,1,28654,chr17_66123520_66152174
Mtcl1,17,66336982,66449750,protein_coding,-1,112768,chr17_66336982_66449750
Rab12,17,66494512,66519729,protein_coding,-1,25217,chr17_66494512_66519729
Themis3,17,66554505,66594621,protein_coding,-1,40116,chr17_66554505_66594621
Ptprm,17,66666947,67354457,protein_coding,-1,687510,chr17_66666947_67354457
1700016K05Rik,17,66714454,66720485,antisense,1,6031,chr17_66714454_66720485
Gm47471,17,66738754,66746047,antisense,1,7293,chr17_66738754_66746047
Gm9984,17,67010485,67019394,antisense,1,8909,chr17_67010485_67019394
Lama1,17,67697259,67822647,protein_coding,1,125388,chr17_67697259_67822647
Arhgap28,17,67842713,68004120,protein_coding,-1,161407,chr17_67842713_68004120
L3mbtl4,17,68273797,68780086,protein_coding,1,506289,chr17_68273797_68780086
Tmem200c,17,68826623,68843139,protein_coding,1,16516,chr17_68826623_68843139
Epb41l3,17,69075683,69289989,protein_coding,1,214306,chr17_69075683_69289989
2410021H03Rik,17,69275362,69277208,antisense,-1,1846,chr17_69275362_69277208
Zbtb14,17,69383050,69391199,protein_coding,1,8149,chr17_69383050_69391199
A930029G22Rik,17,69416660,69439304,lincRNA,-1,22644,chr17_69416660_69439304
C030034I22Rik,17,69417402,69421632,lincRNA,1,4230,chr17_69417402_69421632
Akain1,17,69439326,69489233,protein_coding,1,49907,chr17_69439326_69489233
Dlgap1,17,69969073,70821413,protein_coding,1,852340,chr17_69969073_70821413
5031415H12Rik,17,70745329,70755582,antisense,-1,10253,chr17_70745329_70755582
Gm20703,17,70834664,70836044,lincRNA,1,1380,chr17_70834664_70836044
Tgif1,17,70844205,70853546,protein_coding,-1,9341,chr17_70844205_70853546
Gm26510,17,70874349,70924996,lincRNA,-1,50647,chr17_70874349_70924996
Myl12b,17,70973133,70990890,protein_coding,-1,17757,chr17_70973133_70990890
Myl12a,17,70993656,71002878,protein_coding,-1,9222,chr17_70993656_71002878
Emilin2,17,71252172,71311978,protein_coding,-1,59806,chr17_71252172_71311978
Smchd1,17,71344489,71475343,protein_coding,-1,130854,chr17_71344489_71475343
Ndc80,17,71496100,71526857,protein_coding,-1,30757,chr17_71496100_71526857
Spdya,17,71552061,71589533,protein_coding,1,37472,chr17_71552061_71589533
Wdr43,17,71615895,71659031,protein_coding,1,43136,chr17_71615895_71659031
Togaram2,17,71673261,71729669,protein_coding,1,56408,chr17_71673261_71729669
Clip4,17,71768473,71864273,protein_coding,1,95800,chr17_71768473_71864273
Alk,17,71868972,72604627,protein_coding,-1,735655,chr17_71868972_72604627
Ypel5,17,72836453,72851195,protein_coding,1,14742,chr17_72836453_72851195
Lbh,17,72918305,72941947,protein_coding,1,23642,chr17_72918305_72941947
Lclat1,17,73107985,73243368,protein_coding,1,135383,chr17_73107985_73243368
Capn13,17,73306464,73400866,protein_coding,-1,94402,chr17_73306464_73400866
Galnt14,17,73493228,73710453,protein_coding,-1,217225,chr17_73493228_73710453
Ehd3,17,73804134,73832094,protein_coding,1,27960,chr17_73804134_73832094
Xdh,17,73883895,73950196,protein_coding,-1,66301,chr17_73883895_73950196
Srd5a2,17,74016955,74047916,protein_coding,-1,30961,chr17_74016955_74047916
Memo1,17,74199036,74295521,protein_coding,-1,96485,chr17_74199036_74295521
Dpy30,17,74299474,74323944,protein_coding,-1,24470,chr17_74299474_74323944
Spast,17,74338987,74391115,protein_coding,1,52128,chr17_74338987_74391115
Slc30a6,17,74395608,74424221,protein_coding,1,28613,chr17_74395608_74424221
Nlrc4,17,74425438,74459142,protein_coding,-1,33704,chr17_74425438_74459142
Yipf4,17,74489493,74500277,protein_coding,1,10784,chr17_74489493_74500277
Birc6,17,74528295,74703356,protein_coding,1,175061,chr17_74528295_74703356
Gm26749,17,74575381,74617119,antisense,-1,41738,chr17_74575381_74617119
Ttc27,17,74717732,74863570,protein_coding,1,145838,chr17_74717732_74863570
Ltbp1,17,75005568,75392512,protein_coding,1,386944,chr17_75005568_75392512
Rasgrp3,17,75435896,75529054,protein_coding,1,93158,chr17_75435896_75529054
Fam98a,17,75537086,75551946,protein_coding,-1,14860,chr17_75537086_75551946
Crim1,17,78200248,78376592,protein_coding,1,176344,chr17_78200248_78376592
Fez2,17,78369212,78418152,protein_coding,-1,48940,chr17_78369212_78418152
Vit,17,78508064,78627408,protein_coding,1,119344,chr17_78508064_78627408
Strn,17,78649913,78737196,protein_coding,-1,87283,chr17_78649913_78737196
Heatr5b,17,78752898,78835364,protein_coding,-1,82466,chr17_78752898_78835364
Gpatch11,17,78835567,78848308,protein_coding,1,12741,chr17_78835567_78848308
Eif2ak2,17,78852564,78882573,protein_coding,-1,30009,chr17_78852564_78882573
Sult6b1,17,78883938,78906992,protein_coding,-1,23054,chr17_78883938_78906992
Cebpzos,17,78916500,78920306,protein_coding,1,3806,chr17_78916500_78920306
Cebpz,17,78919006,78937066,protein_coding,-1,18060,chr17_78919006_78937066
Ndufaf7,17,78937136,78948052,protein_coding,1,10916,chr17_78937136_78948052
Prkd3,17,78949405,79020816,protein_coding,-1,71411,chr17_78949405_79020816
Qpct,17,79051906,79090378,protein_coding,1,38472,chr17_79051906_79090378
Cdc42ep3,17,79333727,79355091,protein_coding,-1,21364,chr17_79333727_79355091
Rmdn2,17,79611863,79693192,protein_coding,1,81329,chr17_79611863_79693192
Cyp1b1,17,79701537,79715061,protein_coding,-1,13524,chr17_79701537_79715061
Atl2,17,79848390,79896123,protein_coding,-1,47733,chr17_79848390_79896123
Hnrnpll,17,80029487,80062334,protein_coding,-1,32847,chr17_80029487_80062334
Galm,17,80127471,80185101,protein_coding,1,57630,chr17_80127471_80185101
Srsf7,17,80200080,80207307,protein_coding,-1,7227,chr17_80200080_80207307
Ttc39d,17,80207460,80217936,protein_coding,1,10476,chr17_80207460_80217936
Gemin6,17,80224441,80228497,protein_coding,1,4056,chr17_80224441_80228497
Dhx57,17,80238309,80290476,protein_coding,-1,52167,chr17_80238309_80290476
Morn2,17,80290203,80297476,protein_coding,1,7273,chr17_80290203_80297476
Arhgef33,17,80307407,80400081,protein_coding,1,92674,chr17_80307407_80400081
Gm10190,17,80373218,80373541,protein_coding,-1,323,chr17_80373218_80373541
Sos1,17,80393751,80480453,protein_coding,-1,86702,chr17_80393751_80480453
Cdkl4,17,80523550,80577813,protein_coding,-1,54263,chr17_80523550_80577813
Map4k3,17,80580512,80728485,protein_coding,-1,147973,chr17_80580512_80728485
C230072F16Rik,17,80896793,80933045,lincRNA,1,36252,chr17_80896793_80933045
Tmem178,17,80944632,81001816,protein_coding,1,57184,chr17_80944632_81001816
Thumpd2,17,81026332,81065082,protein_coding,-1,38750,chr17_81026332_81065082
Slc8a1,17,81373105,81738377,protein_coding,-1,365272,chr17_81373105_81738377
Gm11096,17,81441763,81441923,protein_coding,1,160,chr17_81441763_81441923
Pkdcc,17,83215292,83225070,protein_coding,1,9778,chr17_83215292_83225070
Eml4,17,83350931,83480361,protein_coding,1,129430,chr17_83350931_83480361
Cox7a2l,17,83501918,83517330,protein_coding,-1,15412,chr17_83501918_83517330
Kcng3,17,83585957,83631895,protein_coding,-1,45938,chr17_83585957_83631895
Mta3,17,83706163,83821516,protein_coding,1,115353,chr17_83706163_83821516
Haao,17,83831156,83847963,protein_coding,-1,16807,chr17_83831156_83847963
C430042M11Rik,17,83851675,83854418,lincRNA,-1,2743,chr17_83851675_83854418
Zfp36l2,17,84183931,84187947,protein_coding,-1,4016,chr17_84183931_84187947
Thada,17,84190076,84466205,protein_coding,-1,276129,chr17_84190076_84466205
Plekhh2,17,84511895,84622138,protein_coding,1,110243,chr17_84511895_84622138
Dync2li1,17,84626496,84655588,protein_coding,1,29092,chr17_84626496_84655588
Abcg5,17,84658234,84683011,protein_coding,-1,24777,chr17_84658234_84683011
Abcg8,17,84676302,84700333,protein_coding,1,24031,chr17_84676302_84700333
Lrpprc,17,84705247,84790789,protein_coding,-1,85542,chr17_84705247_84790789
1110020A21Rik,17,84917182,84957710,bidirectional_promoter_lncRNA,-1,40528,chr17_84917182_84957710
Ppm1b,17,84956741,85023991,protein_coding,1,67250,chr17_84956741_85023991
Slc3a1,17,85028376,85064236,protein_coding,1,35860,chr17_85028376_85064236
Prepl,17,85063470,85090241,protein_coding,-1,26771,chr17_85063470_85090241
Camkmt,17,85090552,85458588,protein_coding,1,368036,chr17_85090552_85458588
Six3,17,85613608,85629302,protein_coding,1,15694,chr17_85613608_85629302
Six2,17,85684277,85688274,protein_coding,-1,3997,chr17_85684277_85688274
Gm29418,17,85796218,85824044,lincRNA,-1,27826,chr17_85796218_85824044
Srbd1,17,85984665,86145175,protein_coding,-1,160510,chr17_85984665_86145175
Prkce,17,86167785,86657919,protein_coding,1,490134,chr17_86167785_86657919
2010106C02Rik,17,86285164,86287178,antisense,-1,2014,chr17_86285164_86287178
Gm10309,17,86497732,86505232,protein_coding,-1,7500,chr17_86497732_86505232
Epas1,17,86753700,86833410,protein_coding,1,79710,chr17_86753700_86833410
Tmem247,17,86917348,86922374,protein_coding,1,5026,chr17_86917348_86922374
Atp6v1e2,17,86944109,86947897,protein_coding,-1,3788,chr17_86944109_86947897
Rhoq,17,86963082,87000069,protein_coding,1,36987,chr17_86963082_87000069
Pigf,17,86997256,87025406,protein_coding,-1,28150,chr17_86997256_87025406
Cript,17,87025550,87035810,protein_coding,1,10260,chr17_87025550_87035810
Socs5,17,87107679,87137839,protein_coding,1,30160,chr17_87107679_87137839
Mcfd2,17,87254443,87265935,protein_coding,-1,11492,chr17_87254443_87265935
4833418N02Rik,17,87274886,87282814,processed_transcript,-1,7928,chr17_87274886_87282814
Ttc7,17,87282886,87381769,protein_coding,1,98883,chr17_87282886_87381769
Gm15978,17,87329764,87332052,antisense,-1,2288,chr17_87329764_87332052
0610012D04Rik,17,87362239,87364462,antisense,-1,2223,chr17_87362239_87364462
Stpg4,17,87389571,87427741,protein_coding,-1,38170,chr17_87389571_87427741
Calm2,17,87433412,87446935,protein_coding,-1,13523,chr17_87433412_87446935
Gm28676,17,87490748,87502616,lincRNA,1,11868,chr17_87490748_87502616
Epcam,17,87635979,87651129,protein_coding,1,15150,chr17_87635979_87651129
Msh2,17,87672330,87723713,protein_coding,1,51383,chr17_87672330_87723713
Kcnk12,17,87745801,87797994,protein_coding,-1,52193,chr17_87745801_87797994
Rpl36-ps4,17,87920977,87921393,protein_coding,1,416,chr17_87920977_87921393
Msh6,17,87975062,87990892,protein_coding,1,15830,chr17_87975062_87990892
Fbxo11,17,87990859,88065291,protein_coding,-1,74432,chr17_87990859_88065291
Gm26612,17,88146084,88159761,lincRNA,-1,13677,chr17_88146084_88159761
Foxn2,17,88440711,88490533,protein_coding,1,49822,chr17_88440711_88490533
Ppp1r21,17,88530118,88588367,protein_coding,1,58249,chr17_88530118_88588367
Ston1,17,88597684,88662586,protein_coding,1,64902,chr17_88597684_88662586
Gtf2a1l,17,88668660,88715152,protein_coding,1,46492,chr17_88668660_88715152
Lhcgr,17,88716481,88791990,protein_coding,-1,75509,chr17_88716481_88791990
Fshr,17,88984952,89200675,protein_coding,-1,215723,chr17_88984952_89200675
Gm10184,17,89908462,89910449,protein_coding,-1,1987,chr17_89908462_89910449
Nrxn1,17,90033631,91093071,protein_coding,-1,1059440,chr17_90033631_91093071
Gm10308,17,91088493,91089391,3prime_overlapping_ncRNA,1,898,chr17_91088493_91089391
Gm6741,17,91236811,91237557,processed_pseudogene,1,746,chr17_91236811_91237557
Gm15404,17,91557127,91591927,lincRNA,1,34800,chr17_91557127_91591927
Adcyap1,17,93199017,93206537,protein_coding,1,7520,chr17_93199017_93206537
Mettl4,17,94722590,94750019,protein_coding,-1,27429,chr17_94722590_94750019
Gm1976,17,94759944,94834799,processed_transcript,-1,74855,chr17_94759944_94834799
Gm20939,17,94864918,94878321,lincRNA,1,13403,chr17_94864918_94878321
Zfy1,Y,725128,797409,protein_coding,-1,72281,chrY_725128_797409
Gm28588,Y,841783,847750,antisense,-1,5967,chrY_841783_847750
Kdm5d,Y,897788,956786,protein_coding,1,58998,chrY_897788_956786
Eif2s3y,Y,1010543,1028847,protein_coding,1,18304,chrY_1010543_1028847
Uty,Y,1096861,1245759,protein_coding,-1,148898,chrY_1096861_1245759
Ddx3y,Y,1260771,1286629,protein_coding,-1,25858,chrY_1260771_1286629
Usp9y,Y,1298961,1459782,protein_coding,-1,160821,chrY_1298961_1459782
Zfy2,Y,2106015,2170409,protein_coding,-1,64394,chrY_2106015_2170409
Gm10256,Y,2830699,2873492,protein_coding,1,42793,chrY_2830699_2873492
Gm21693,Y,3326750,3345329,protein_coding,-1,18579,chrY_3326750_3345329
Gm21704,Y,3367147,3410167,protein_coding,-1,43020,chrY_3367147_3410167
Gm29193,Y,6220975,6246362,lincRNA,1,25387,chrY_6220975_6246362
Gm28919,Y,6583546,6615511,protein_coding,1,31965,chrY_6583546_6615511
Gm28998,Y,7253787,7280017,protein_coding,1,26230,chrY_7253787_7280017
Gm28576,Y,7722941,7749195,protein_coding,1,26254,chrY_7722941_7749195
Gm29554,Y,12273932,12306702,protein_coding,1,32770,chrY_12273932_12306702
Gm21454,Y,13252442,13378804,protein_coding,1,126362,chrY_13252442_13378804
Gm20831,Y,17874741,17967603,protein_coding,1,92862,chrY_17874741_17967603
Gm21094,Y,32588415,32620443,protein_coding,-1,32028,chrY_32588415_32620443
Gm20838,Y,33511116,33543164,protein_coding,-1,32048,chrY_33511116_33543164
Gm28595,Y,40104656,40112547,lincRNA,1,7891,chrY_40104656_40112547
Gm21865,Y,40290790,40316903,protein_coding,-1,26113,chrY_40290790_40316903
Gm29433,Y,40367506,40372751,lincRNA,1,5245,chrY_40367506_40372751
Gm21739,Y,44232123,44264444,protein_coding,-1,32321,chrY_44232123_44264444
Gm28887,Y,44818410,44827383,lincRNA,-1,8973,chrY_44818410_44827383
Gm29221,Y,56420276,56429767,lincRNA,1,9491,chrY_56420276_56429767
Gm28709,Y,57343729,57354175,lincRNA,-1,10446,chrY_57343729_57354175
Gm28961,Y,57705697,57731932,protein_coding,1,26235,chrY_57705697_57731932
Gm28891,Y,60241202,60273250,protein_coding,1,32048,chrY_60241202_60273250
Gm29206,Y,61556222,61583931,lincRNA,-1,27709,chrY_61556222_61583931
Gm29343,Y,61789649,61815122,lincRNA,-1,25473,chrY_61789649_61815122
Gm29209,Y,62874899,62885362,lincRNA,-1,10463,chrY_62874899_62885362
Gm29060,Y,63680536,63691008,lincRNA,-1,10472,chrY_63680536_63691008
Gm28137,Y,66079219,66138693,lincRNA;lncRNA,1,59474,chrY_66079219_66138693
Gm29380,Y,66551277,66558067,lincRNA,-1,6790,chrY_66551277_66558067
Gm28612,Y,67150595,67156992,lincRNA,-1,6397,chrY_67150595_67156992
Gm29082,Y,67675333,67685792,lincRNA,1,10459,chrY_67675333_67685792
Gm29644,Y,70271306,70303343,protein_coding,-1,32037,chrY_70271306_70303343
Gm20888,Y,70441882,70468158,protein_coding,1,26276,chrY_70441882_70468158
Gm28482,Y,71626238,71636635,lincRNA,-1,10397,chrY_71626238_71636635
Gm20843,Y,72220863,72247118,protein_coding,-1,26255,chrY_72220863_72247118
Gm29110,Y,74470531,74496958,protein_coding,1,26427,chrY_74470531_74496958
Gm28702,Y,77476817,77481943,lincRNA,-1,5126,chrY_77476817_77481943
Gm21650,Y,77692808,77719038,protein_coding,1,26230,chrY_77692808_77719038
Gm29566,Y,78147088,78157505,lincRNA,-1,10417,chrY_78147088_78157505
Gm28664,Y,78356809,78367279,lincRNA,-1,10470,chrY_78356809_78367279
Gm21317,Y,82225227,82251419,protein_coding,1,26192,chrY_82225227_82251419
Gm21095,Y,84097279,84123494,protein_coding,1,26215,chrY_84097279_84123494
Gm29090,Y,85661766,85672245,lincRNA,-1,10479,chrY_85661766_85672245
Gm28103,Y,87987924,87994644,lincRNA,-1,6720,chrY_87987924_87994644
Gm21996,Y,89713424,89745532,protein_coding,-1,32108,chrY_89713424_89745532
Gm28930,Y,89927120,89935013,lincRNA,-1,7893,chrY_89927120_89935013
Gm47283,Y,90784738,90816465,lincRNA,1,31727,chrY_90784738_90816465
Crem,18,3266048,3337748,protein_coding,-1,71700,chr18_3266048_3337748
Gm6225,18,3336680,3366863,processed_transcript,1,30183,chr18_3336680_3366863
Cul2,18,3382988,3436377,protein_coding,1,53389,chr18_3382988_3436377
Bambi,18,3507923,3516404,protein_coding,1,8481,chr18_3507923_3516404
Lyzl1,18,4165832,4182232,protein_coding,1,16400,chr18_4165832_4182232
Map3k8,18,4331327,4353015,protein_coding,-1,21688,chr18_4331327_4353015
Gm26865,18,4373669,4379985,antisense,-1,6316,chr18_4373669_4379985
Mtpap,18,4375592,4397330,protein_coding,1,21738,chr18_4375592_4397330
Jcad,18,4634878,4682869,protein_coding,1,47991,chr18_4634878_4682869
Gm10556,18,4812486,4850959,lincRNA,1,38473,chr18_4812486_4850959
Svil,18,4920540,5119299,protein_coding,1,198759,chr18_4920540_5119299
Gm26682,18,5162839,5165731,lincRNA,-1,2892,chr18_5162839_5165731
Zfp438,18,5210029,5334807,protein_coding,-1,124778,chr18_5210029_5334807
Zeb1,18,5591860,5775467,protein_coding,1,183607,chr18_5591860_5775467
Arhgap12,18,6024427,6136098,protein_coding,-1,111671,chr18_6024427_6136098
Kif5b,18,6201002,6242174,protein_coding,-1,41172,chr18_6201002_6242174
Gm17036,18,6213913,6227324,antisense,1,13411,chr18_6213913_6227324
Rpl27-ps3,18,6332632,6333042,processed_pseudogene,1,410,chr18_6332632_6333042
Epc1,18,6435951,6516108,protein_coding,-1,80157,chr18_6435951_6516108
Gm28529,18,6490143,6496962,antisense,1,6819,chr18_6490143_6496962
4921524L21Rik,18,6603629,6638970,protein_coding,1,35341,chr18_6603629_6638970
Rab18,18,6733905,6794429,protein_coding,1,60524,chr18_6733905_6794429
Mkx,18,6934518,7004780,protein_coding,-1,70262,chr18_6934518_7004780
Armc4,18,7088209,7297936,protein_coding,-1,209727,chr18_7088209_7297936
Mpp7,18,7347959,7626866,protein_coding,-1,278907,chr18_7347959_7626866
Wac,18,7868832,7929028,protein_coding,1,60196,chr18_7868832_7929028
Gm5819,18,8694099,8694537,processed_pseudogene,1,438,chr18_8694099_8694537
Fzd8,18,9212163,9218136,protein_coding,1,5973,chr18_9212163_9218136
Gjd4,18,9278607,9282809,protein_coding,-1,4202,chr18_9278607_9282809
Ccny,18,9312304,9450154,protein_coding,-1,137850,chr18_9312304_9450154
Colec12,18,9707595,9882644,protein_coding,1,175049,chr18_9707595_9882644
Gm17430,18,9726205,9726670,processed_pseudogene,-1,465,chr18_9726205_9726670
Thoc1,18,9957906,9995489,protein_coding,1,37583,chr18_9957906_9995489
Usp14,18,9993066,10045119,protein_coding,-1,52053,chr18_9993066_10045119
Rock1,18,10064401,10182045,protein_coding,-1,117644,chr18_10064401_10182045
Greb1l,18,10325177,10562940,protein_coding,1,237763,chr18_10325177_10562940
Esco1,18,10566507,10610352,protein_coding,-1,43845,chr18_10566507_10610352
Snrpd1,18,10617775,10642079,protein_coding,1,24304,chr18_10617775_10642079
Abhd3,18,10642092,10706771,protein_coding,-1,64679,chr18_10642092_10706771
4930563E18Rik,18,10706860,10711832,bidirectional_promoter_lncRNA,1,4972,chr18_10706860_10711832
Mib1,18,10725548,10818704,protein_coding,1,93156,chr18_10725548_10818704
Mir133a-1hg,18,10781723,10785883,antisense,-1,4160,chr18_10781723_10785883
Gata6,18,11052064,11085635,protein_coding,1,33571,chr18_11052064_11085635
Rbbp8,18,11633276,11745221,protein_coding,1,111945,chr18_11633276_11745221
Gm6277,18,11820671,11840869,antisense,-1,20198,chr18_11820671_11840869
Cables1,18,11839220,11945630,protein_coding,1,106410,chr18_11839220_11945630
Tmem241,18,11964450,12121537,protein_coding,-1,157087,chr18_11964450_12121537
Riok3,18,12128741,12157387,protein_coding,1,28646,chr18_12128741_12157387
Npc1,18,12189692,12236400,protein_coding,-1,46708,chr18_12189692_12236400
Gm15956,18,12193768,12198675,antisense,1,4907,chr18_12193768_12198675
Ankrd29,18,12252362,12305797,protein_coding,-1,53435,chr18_12252362_12305797
Lama3,18,12333819,12583013,protein_coding,1,249194,chr18_12333819_12583013
Gm29200,18,12501190,12504426,antisense,-1,3236,chr18_12501190_12504426
Ttc39c,18,12599896,12738863,protein_coding,1,138967,chr18_12599896_12738863
Cabyr,18,12740322,12755260,protein_coding,1,14938,chr18_12740322_12755260
Osbpl1a,18,12755314,12941841,protein_coding,-1,186527,chr18_12755314_12941841
Impact,18,12955852,12992950,protein_coding,1,37098,chr18_12955852_12992950
Hrh4,18,13006990,13022882,protein_coding,1,15892,chr18_13006990_13022882
Zfp521,18,13687013,13972787,protein_coding,-1,285774,chr18_13687013_13972787
Ss18,18,14624198,14682914,protein_coding,-1,58716,chr18_14624198_14682914
Psma8,18,14706151,14762301,protein_coding,1,56150,chr18_14706151_14762301
Taf4b,18,14783245,14900359,protein_coding,1,117114,chr18_14783245_14900359
Kctd1,18,14968685,15151446,protein_coding,-1,182761,chr18_14968685_15151446
Aqp4,18,15389496,15410982,protein_coding,-1,21486,chr18_15389496_15410982
Chst9,18,15451924,15760157,protein_coding,-1,308233,chr18_15451924_15760157
Gm10036,18,15832794,15833327,processed_pseudogene,1,533,chr18_15832794_15833327
Cdh2,18,16588877,16809246,protein_coding,-1,220369,chr18_16588877_16809246
Gm15485,18,16728733,16729678,antisense,1,945,chr18_16728733_16729678
Gm15328,18,16815721,16822783,lincRNA,1,7062,chr18_16815721_16822783
1700001G01Rik,18,17019051,17137559,lincRNA,1,118508,chr18_17019051_17137559
Dsc3,18,19960930,20002351,protein_coding,-1,41421,chr18_19960930_20002351
Dsc2,18,20030633,20059554,protein_coding,-1,28921,chr18_20030633_20059554
Dsc1,18,20084184,20114871,protein_coding,-1,30687,chr18_20084184_20114871
Dsg1c,18,20247340,20285031,protein_coding,1,37691,chr18_20247340_20285031
Dsg1a,18,20310811,20343350,protein_coding,1,32539,chr18_20310811_20343350
Dsg1b,18,20376729,20410196,protein_coding,1,33467,chr18_20376729_20410196
Dsg4,18,20436175,20471821,protein_coding,1,35646,chr18_20436175_20471821
Dsg3,18,20510274,20547459,protein_coding,1,37185,chr18_20510274_20547459
Dsg2,18,20558074,20604521,protein_coding,1,46447,chr18_20558074_20604521
Gm16090,18,20597964,20665260,antisense,-1,67296,chr18_20597964_20665260
Ttr,18,20665280,20674321,protein_coding,1,9041,chr18_20665280_20674321
Gm10269,18,20682594,20682963,processed_pseudogene,-1,369,chr18_20682594_20682963
B4galt6,18,20684599,20746404,protein_coding,-1,61805,chr18_20684599_20746404
Trappc8,18,20817223,20896093,protein_coding,-1,78870,chr18_20817223_20896093
Rnf125,18,20944625,20983862,protein_coding,1,39237,chr18_20944625_20983862
Rnf138,18,21001341,21028224,protein_coding,1,26883,chr18_21001341_21028224
Mep1b,18,21061923,21100199,protein_coding,1,38276,chr18_21061923_21100199
Garem1,18,21127201,21300138,protein_coding,-1,172937,chr18_21127201_21300138
Klhl14,18,21550377,21654718,protein_coding,-1,104341,chr18_21550377_21654718
4930426D05Rik,18,21651448,21656105,antisense,1,4657,chr18_21651448_21656105
Ccdc178,18,21810893,22171442,protein_coding,-1,360549,chr18_21810893_22171442
Asxl3,18,22344246,22530227,protein_coding,1,185981,chr18_22344246_22530227
Nol4,18,22693181,23041653,protein_coding,-1,348472,chr18_22693181_23041653
Dtna,18,23415135,23659715,protein_coding,1,244580,chr18_23415135_23659715
Gm47898,18,23645326,23651837,antisense,-1,6511,chr18_23645326_23651837
Gm15972,18,23750447,23752305,antisense,-1,1858,chr18_23750447_23752305
Mapre2,18,23752333,23893861,protein_coding,1,141528,chr18_23752333_23893861
Zfp397,18,23954692,23964673,protein_coding,1,9981,chr18_23954692_23964673
Zfp35,18,23989632,24005376,protein_coding,1,15744,chr18_23989632_24005376
Zfp24,18,24009702,24020810,protein_coding,-1,11108,chr18_24009702_24020810
Ino80c,18,24104757,24121953,protein_coding,-1,17196,chr18_24104757_24121953
Galnt1,18,24205344,24286818,protein_coding,1,81474,chr18_24205344_24286818
2700062C07Rik,18,24470850,24477798,protein_coding,1,6948,chr18_24470850_24477798
Rprd1a,18,24484960,24530204,protein_coding,-1,45244,chr18_24484960_24530204
Slc39a6,18,24579881,24603817,protein_coding,-1,23936,chr18_24579881_24603817
Elp2,18,24602866,24639507,protein_coding,1,36641,chr18_24602866_24639507
Mocos,18,24653691,24701575,protein_coding,1,47884,chr18_24653691_24701575
Gm9955,18,24709040,24709348,protein_coding,-1,308,chr18_24709040_24709348
Fhod3,18,24708623,25133501,protein_coding,1,424878,chr18_24708623_25133501
Tpgs2,18,25127223,25169007,protein_coding,-1,41784,chr18_25127223_25169007
AW554918,18,25168999,25467321,protein_coding,1,298322,chr18_25168999_25467321
Celf4,18,25477632,25754157,protein_coding,-1,276525,chr18_25477632_25754157
Gm3227,18,25597490,25603833,antisense,1,6343,chr18_25597490_25603833
0710001A04Rik,18,25713770,25719147,antisense,1,5377,chr18_25713770_25719147
Pik3c3,18,30272747,30348126,protein_coding,1,75379,chr18_30272747_30348126
Rit2,18,30973489,31317290,protein_coding,-1,343801,chr18_30973489_31317290
Syt4,18,31437808,31447406,protein_coding,-1,9598,chr18_31437808_31447406
Gm26658,18,31440318,31449099,antisense,1,8781,chr18_31440318_31449099
Slc25a46,18,31556111,31609911,protein_coding,-1,53800,chr18_31556111_31609911
B930094E09Rik,18,31609512,31610751,protein_coding,1,1239,chr18_31609512_31610751
Sap130,18,31634371,31723061,protein_coding,1,88690,chr18_31634371_31723061
Ammecr1l,18,31759826,31782743,protein_coding,1,22917,chr18_31759826_31782743
Gm26533,18,31781226,31789045,antisense,-1,7819,chr18_31781226_31789045
Polr2d,18,31789159,31796701,protein_coding,1,7542,chr18_31789159_31796701
Wdr33,18,31804090,31907397,protein_coding,1,103307,chr18_31804090_31907397
Gm6665,18,31819862,31820519,processed_pseudogene,-1,657,chr18_31819862_31820519
Sft2d3,18,31909098,31911824,protein_coding,-1,2726,chr18_31909098_31911824
Lims2,18,31922290,31958619,protein_coding,1,36329,chr18_31922290_31958619
Gpr17,18,31942997,31949636,protein_coding,-1,6639,chr18_31942997_31949636
Myo7b,18,31959234,32036961,protein_coding,-1,77727,chr18_31959234_32036961
Gm16344,18,32021740,32026610,antisense,1,4870,chr18_32021740_32026610
Iws1,18,32067741,32104328,protein_coding,1,36587,chr18_32067741_32104328
Proc,18,32123126,32139570,protein_coding,-1,16444,chr18_32123126_32139570
Gm26717,18,32153476,32160427,lincRNA,1,6951,chr18_32153476_32160427
Map3k2,18,32163089,32236751,protein_coding,1,73662,chr18_32163089_32236751
Ercc3,18,32240300,32270151,protein_coding,1,29851,chr18_32240300_32270151
A830052D11Rik,18,32359053,32378278,lincRNA,-1,19225,chr18_32359053_32378278
Bin1,18,32377230,32435737,protein_coding,1,58507,chr18_32377230_32435737
Gm35060,18,32458083,32472589,protein_coding,-1,14506,chr18_32458083_32472589
Gypc,18,32528322,32560034,protein_coding,-1,31712,chr18_32528322_32560034
Tslp,18,32815383,32819797,protein_coding,1,4414,chr18_32815383_32819797
Wdr36,18,32837225,32867594,protein_coding,1,30369,chr18_32837225_32867594
2310026I22Rik,18,32915826,32939229,antisense,-1,23403,chr18_32915826_32939229
Camk4,18,32934931,33191228,protein_coding,1,256297,chr18_32934931_33191228
Stard4,18,33199355,33213862,protein_coding,-1,14507,chr18_33199355_33213862
Nrep,18,33437019,33464029,protein_coding,-1,27010,chr18_33437019_33464029
Gm10549,18,33464163,33474710,lincRNA,1,10547,chr18_33464163_33474710
Epb41l4aos,18,33794892,33795986,lincRNA,1,1094,chr18_33794892_33795986
Epb41l4a,18,33796327,34006966,protein_coding,-1,210639,chr18_33796327_34006966
Apc,18,34220924,34322552,protein_coding,1,101628,chr18_34220924_34322552
Srp19,18,34330847,34336599,protein_coding,1,5752,chr18_34330847_34336599
Reep5,18,34344885,34374070,protein_coding,-1,29185,chr18_34344885_34374070
Pkd2l2,18,34408489,34444116,protein_coding,1,35627,chr18_34408489_34444116
Fam13b,18,34442351,34506831,protein_coding,-1,64480,chr18_34442351_34506831
Wnt8a,18,34542313,34548273,protein_coding,1,5960,chr18_34542313_34548273
Nme5,18,34562634,34579115,protein_coding,-1,16481,chr18_34562634_34579115
Brd8,18,34598615,34624601,protein_coding,-1,25986,chr18_34598615_34624601
Kif20a,18,34624613,34633277,protein_coding,1,8664,chr18_34624613_34633277
Cdc23,18,34630951,34651735,protein_coding,-1,20784,chr18_34630951_34651735
Gfra3,18,34689898,34720387,protein_coding,-1,30489,chr18_34689898_34720387
Cdc25c,18,34732993,34751533,protein_coding,-1,18540,chr18_34732993_34751533
Gm3550,18,34736359,34738014,protein_coding,1,1655,chr18_34736359_34738014
2010110K18Rik,18,34751809,34758685,lincRNA,1,6876,chr18_34751809_34758685
Fam53c,18,34758906,34773760,protein_coding,1,14854,chr18_34758906_34773760
Kdm3b,18,34777047,34838660,protein_coding,1,61613,chr18_34777047_34838660
Reep2,18,34840589,34847463,protein_coding,1,6874,chr18_34840589_34847463
Egr1,18,34859823,34864984,protein_coding,1,5161,chr18_34859823_34864984
Etf1,18,34902785,34932007,protein_coding,-1,29222,chr18_34902785_34932007
Hspa9,18,34937414,34954357,protein_coding,-1,16943,chr18_34937414_34954357
Ctnna1,18,35118859,35254779,protein_coding,1,135920,chr18_35118859_35254779
Lrrtm2,18,35209003,35215024,protein_coding,-1,6021,chr18_35209003_35215024
Sil1,18,35266396,35499780,protein_coding,-1,233384,chr18_35266396_35499780
Gm5239,18,35536583,35536947,processed_pseudogene,1,364,chr18_35536583_35536947
Matr3,18,35562138,35593835,protein_coding,1,31697,chr18_35562138_35593835
Paip2,18,35598617,35617187,protein_coding,1,18570,chr18_35598617_35617187
Slc23a1,18,35614604,35627244,protein_coding,-1,12640,chr18_35614604_35627244
Mzb1,18,35647267,35649367,protein_coding,-1,2100,chr18_35647267_35649367
Prob1,18,35650351,35655238,protein_coding,-1,4887,chr18_35650351_35655238
Spata24,18,35656689,35662186,protein_coding,-1,5497,chr18_35656689_35662186
Dnajc18,18,35671103,35708414,protein_coding,-1,37311,chr18_35671103_35708414
1700066B19Rik,18,35703225,35730869,protein_coding,1,27644,chr18_35703225_35730869
Ecscr,18,35713086,35722356,protein_coding,-1,9270,chr18_35713086_35722356
Ube2d2a,18,35771558,35809494,protein_coding,1,37936,chr18_35771558_35809494
Cxxc5,18,35829397,35861688,protein_coding,1,32291,chr18_35829397_35861688
Gm29417,18,35830389,35831093,antisense,-1,704,chr18_35830389_35831093
Psd2,18,35964830,36014715,protein_coding,1,49885,chr18_35964830_36014715
Nrg2,18,36017652,36197380,protein_coding,-1,179728,chr18_36017652_36197380
Pura,18,36281097,36292535,protein_coding,1,11438,chr18_36281097_36292535
Igip,18,36298679,36301517,protein_coding,1,2838,chr18_36298679_36301517
Cystm1,18,36342520,36403097,protein_coding,1,60577,chr18_36342520_36403097
Pfdn1,18,36403676,36454524,protein_coding,-1,50848,chr18_36403676_36454524
Hbegf,18,36504927,36515805,protein_coding,-1,10878,chr18_36504927_36515805
Slc4a9,18,36528147,36556273,protein_coding,1,28126,chr18_36528147_36556273
Ankhd1,18,36559987,36658913,protein_coding,1,98926,chr18_36559987_36658913
Sra1,18,36666681,36670815,protein_coding,-1,4134,chr18_36666681_36670815
Slc35a4,18,36679215,36683861,protein_coding,1,4646,chr18_36679215_36683861
E230025N22Rik,18,36684923,36695925,protein_coding,-1,11002,chr18_36684923_36695925
Cd14,18,36725067,36726798,protein_coding,-1,1731,chr18_36725067_36726798
Tmco6,18,36735039,36742397,protein_coding,1,7358,chr18_36735039_36742397
Ndufa2,18,36742332,36744557,protein_coding,-1,2225,chr18_36742332_36744557
Ik,18,36744656,36757639,protein_coding,1,12983,chr18_36744656_36757639
Wdr55,18,36760220,36763810,protein_coding,1,3590,chr18_36760220_36763810
Dnd1,18,36763671,36766214,protein_coding,-1,2543,chr18_36763671_36766214
Hars,18,36766528,36783205,protein_coding,-1,16677,chr18_36766528_36783205
Hars2,18,36783008,36792562,protein_coding,1,9554,chr18_36783008_36792562
Zmat2,18,36793876,36799666,protein_coding,1,5790,chr18_36793876_36799666
Pcdha1,18,36930184,37187661,protein_coding,1,257477,chr18_36930184_37187661
Gm37751,18,36933952,36935149,antisense,-1,1197,chr18_36933952_36935149
Gm38225,18,36952651,36953043,antisense,-1,392,chr18_36952651_36953043
Gm37753,18,36967591,36968148,antisense,-1,557,chr18_36967591_36968148
Gm10545,18,37008868,37020679,antisense,-1,11811,chr18_37008868_37020679
Gm38097,18,37172126,37172564,antisense,-1,438,chr18_37172126_37172564
Gm37446,18,37433412,37437547,antisense,-1,4135,chr18_37433412_37437547
Slc25a2,18,37637378,37638723,protein_coding,-1,1345,chr18_37637378_37638723
Taf7,18,37640491,37644204,protein_coding,-1,3713,chr18_37640491_37644204
Gm37118,18,37661952,37662632,antisense,-1,680,chr18_37661952_37662632
Gm37165,18,37714279,37726121,antisense,-1,11842,chr18_37714279_37726121
BC037039,18,37805718,37807922,antisense,-1,2204,chr18_37805718_37807922
Gm29994,18,37829008,37830200,antisense,-1,1192,chr18_37829008_37830200
Diaph1,18,37843601,37935476,protein_coding,-1,91875,chr18_37843601_37935476
Hdac3,18,37935844,37955016,protein_coding,-1,19172,chr18_37935844_37955016
Rell2,18,37955079,37959179,protein_coding,1,4100,chr18_37955079_37959179
Fchsd1,18,37957431,37969774,protein_coding,-1,12343,chr18_37957431_37969774
Arap3,18,37972628,37998969,protein_coding,-1,26341,chr18_37972628_37998969
Pcdh1,18,38185914,38212053,protein_coding,-1,26139,chr18_38185914_38212053
1700086O06Rik,18,38238405,38250565,lincRNA,-1,12160,chr18_38238405_38250565
Pcdh12,18,38267089,38284402,protein_coding,-1,17313,chr18_38267089_38284402
Rnf14,18,38284537,38317849,protein_coding,1,33312,chr18_38284537_38317849
Gnpda1,18,38327535,38339003,protein_coding,-1,11468,chr18_38327535_38339003
Ndfip1,18,38410396,38465303,protein_coding,1,54907,chr18_38410396_38465303
Spry4,18,38586247,38601415,protein_coding,-1,15168,chr18_38586247_38601415
Arhgap26,18,38676718,39376284,protein_coding,1,699566,chr18_38676718_39376284
Fgf1,18,38838673,38929472,protein_coding,-1,90799,chr18_38838673_38929472
Gm15334,18,38993635,38994192,antisense,-1,557,chr18_38993635_38994192
Gm15336,18,39246247,39302690,antisense,-1,56443,chr18_39246247_39302690
Gm15337,18,39367038,39389425,antisense,-1,22387,chr18_39367038_39389425
Nr3c1,18,39410545,39519421,protein_coding,-1,108876,chr18_39410545_39519421
Pabpc2,18,39773497,39776082,protein_coding,1,2585,chr18_39773497_39776082
Yipf5,18,40203896,40219429,protein_coding,-1,15533,chr18_40203896_40219429
Kctd16,18,40256962,40531630,protein_coding,1,274668,chr18_40256962_40531630
Prelid2,18,41875600,41951242,protein_coding,-1,75642,chr18_41875600_41951242
Grxcr2,18,41985323,41999049,protein_coding,-1,13726,chr18_41985323_41999049
Sh3rf2,18,42053667,42158960,protein_coding,1,105293,chr18_42053667_42158960
Plac8l1,18,42178683,42196709,protein_coding,-1,18026,chr18_42178683_42196709
Lars,18,42202298,42262194,protein_coding,-1,59896,chr18_42202298_42262194
Rbm27,18,42275353,42341542,protein_coding,1,66189,chr18_42275353_42341542
Pou4f3,18,42394539,42397249,protein_coding,1,2710,chr18_42394539_42397249
Tcerg1,18,42511487,42575793,protein_coding,1,64306,chr18_42511487_42575793
Gpr151,18,42577881,42579652,protein_coding,-1,1771,chr18_42577881_42579652
Ppp2r2b,18,42637432,43083127,protein_coding,-1,445695,chr18_42637432_43083127
4933407I08Rik,18,42935470,42938887,antisense,1,3417,chr18_42935470_42938887
Stk32a,18,43207583,43318682,protein_coding,1,111099,chr18_43207583_43318682
Dpysl3,18,43320984,43438286,protein_coding,-1,117302,chr18_43320984_43438286
Eif3j2,18,43475418,43477796,protein_coding,-1,2378,chr18_43475418_43477796
Jakmip2,18,43531407,43687773,protein_coding,-1,156366,chr18_43531407_43687773
Spink1,18,43728082,43737557,protein_coding,-1,9475,chr18_43728082_43737557
Gm94,18,43777196,43792878,protein_coding,-1,15682,chr18_43777196_43792878
Spink5,18,43963235,44022501,protein_coding,1,59266,chr18_43963235_44022501
Spink14,18,44027869,44032417,protein_coding,1,4548,chr18_44027869_44032417
Spink6,18,44071393,44083611,protein_coding,1,12218,chr18_44071393_44083611
Gm10267,18,44156395,44159885,protein_coding,-1,3490,chr18_44156395_44159885
Spinkl,18,44166356,44175074,protein_coding,-1,8718,chr18_44166356_44175074
Spink11,18,44190045,44196177,protein_coding,-1,6132,chr18_44190045_44196177
Npy6r,18,44270127,44277700,protein_coding,1,7573,chr18_44270127_44277700
Myot,18,44334074,44355724,protein_coding,1,21650,chr18_44334074_44355724
Dcp2,18,44380502,44424969,protein_coding,1,44467,chr18_44380502_44424969
Mcc,18,44425060,44812182,protein_coding,-1,387122,chr18_44425060_44812182
A930012L18Rik,18,44661665,44676271,antisense,1,14606,chr18_44661665_44676271
Ythdc2,18,44827746,44889724,protein_coding,1,61978,chr18_44827746_44889724
Kcnn2,18,45268860,45686024,protein_coding,1,417164,chr18_45268860_45686024
A330093E20Rik,18,45683487,46045260,antisense,-1,361773,chr18_45683487_46045260
Trim36,18,46165300,46212607,protein_coding,-1,47307,chr18_46165300_46212607
Pggt1b,18,46235351,46280993,protein_coding,-1,45642,chr18_46235351_46280993
Ccdc112,18,46282151,46311928,protein_coding,-1,29777,chr18_46282151_46311928
Fem1c,18,46501746,46525971,protein_coding,-1,24225,chr18_46501746_46525971
Tmed7,18,46560235,46597535,protein_coding,-1,37300,chr18_46560235_46597535
Eif1a,18,46597701,46616456,protein_coding,1,18755,chr18_46597701_46616456
Cdo1,18,46713193,46728395,protein_coding,-1,15202,chr18_46713193_46728395
Atg12,18,46730144,46741580,protein_coding,-1,11436,chr18_46730144_46741580
Ap3s1,18,46741876,46790826,protein_coding,1,48950,chr18_46741876_46790826
Lvrn,18,46850038,46907242,protein_coding,1,57204,chr18_46850038_46907242
Arl14epl,18,46921815,46934232,protein_coding,1,12417,chr18_46921815_46934232
Commd10,18,46958816,47234284,protein_coding,1,275468,chr18_46958816_47234284
Sema6a,18,47235598,47368870,protein_coding,-1,133272,chr18_47235598_47368870
Eno1b,18,48045335,48048412,protein_coding,1,3077,chr18_48045335_48048412
Dtwd2,18,49696145,49755601,protein_coding,-1,59456,chr18_49696145_49755601
1700065O20Rik,18,49803326,49817958,lincRNA,-1,14632,chr18_49803326_49817958
Dmxl1,18,49832670,49965473,protein_coding,1,132803,chr18_49832670_49965473
Tnfaip8,18,49979427,50107173,protein_coding,1,127746,chr18_49979427_50107173
Hsd17b4,18,50128201,50196269,protein_coding,1,68068,chr18_50128201_50196269
Fam170a,18,50278369,50283020,protein_coding,1,4651,chr18_50278369_50283020
Prr16,18,51117733,51420044,protein_coding,1,302311,chr18_51117733_51420044
Gm4950,18,51865267,51865881,processed_pseudogene,-1,614,chr18_51865267_51865881
Srfbp1,18,52465693,52491931,protein_coding,1,26238,chr18_52465693_52491931
Lox,18,52516067,52529867,protein_coding,-1,13800,chr18_52516067_52529867
Zfp474,18,52615915,52639830,protein_coding,1,23915,chr18_52615915_52639830
1700034E13Rik,18,52646209,52663733,protein_coding,1,17524,chr18_52646209_52663733
Sncaip,18,52767709,52915935,protein_coding,1,148226,chr18_52767709_52915935
Snx2,18,53176316,53220865,protein_coding,1,44549,chr18_53176316_53220865
Snx24,18,53245662,53390920,protein_coding,1,145258,chr18_53245662_53390920
Ppic,18,53406332,53418115,protein_coding,-1,11783,chr18_53406332_53418115
Prdm6,18,53463583,53575907,protein_coding,1,112324,chr18_53463583_53575907
Cep120,18,53681723,53744608,protein_coding,-1,62885,chr18_53681723_53744608
Csnk1g3,18,53862122,53955548,protein_coding,1,93426,chr18_53862122_53955548
Redrum,18,54422295,54453294,lincRNA,1,30999,chr18_54422295_54453294
Zfp608,18,54888048,54992555,protein_coding,-1,104507,chr18_54888048_54992555
Gm4221,18,54990265,55079414,antisense,1,89149,chr18_54990265_55079414
Gramd3,18,56400337,56503792,protein_coding,1,103455,chr18_56400337_56503792
Aldh7a1,18,56509687,56572951,protein_coding,-1,63264,chr18_56509687_56572951
Phax,18,56562443,56587712,protein_coding,1,25269,chr18_56562443_56587712
Tex43,18,56588350,56594782,protein_coding,1,6432,chr18_56588350_56594782
Lmnb1,18,56707813,56753424,protein_coding,1,45611,chr18_56707813_56753424
Gm15345,18,56769717,56801688,antisense,1,31971,chr18_56769717_56801688
C330018D20Rik,18,56955833,56975368,protein_coding,-1,19535,chr18_56955833_56975368
Megf10,18,57133090,57297467,protein_coding,1,164377,chr18_57133090_57297467
Prrc1,18,57354741,57392956,protein_coding,1,38215,chr18_57354741_57392956
Ctxn3,18,57468516,57478133,protein_coding,1,9617,chr18_57468516_57478133
Slc12a2,18,57878678,57946821,protein_coding,1,68143,chr18_57878678_57946821
Fbn2,18,58008623,58210487,protein_coding,-1,201864,chr18_58008623_58210487
Slc27a6,18,58556257,58612773,protein_coding,1,56516,chr18_58556257_58612773
Isoc1,18,58659466,58680368,protein_coding,1,20902,chr18_58659466_58680368
Adamts19,18,58836667,59054060,protein_coding,1,217393,chr18_58836667_59054060
Chsy3,18,59175401,59535999,protein_coding,1,360598,chr18_59175401_59535999
Gm4951,18,60212080,60247820,protein_coding,1,35740,chr18_60212080_60247820
Gm4841,18,60268305,60273272,protein_coding,-1,4967,chr18_60268305_60273272
F830016B08Rik,18,60293380,60303016,protein_coding,1,9636,chr18_60293380_60303016
Iigp1,18,60376027,60392634,protein_coding,1,16607,chr18_60376027_60392634
Smim3,18,60474191,60501987,protein_coding,-1,27796,chr18_60474191_60501987
Dctn4,18,60526185,60558766,protein_coding,1,32581,chr18_60526185_60558766
Rbm22,18,60560736,60572810,protein_coding,1,12074,chr18_60560736_60572810
Myoz3,18,60573750,60591788,protein_coding,-1,18038,chr18_60573750_60591788
Synpo,18,60593973,60660142,protein_coding,-1,66169,chr18_60593973_60660142
Ndst1,18,60684494,60748650,protein_coding,-1,64156,chr18_60684494_60748650
Rps14,18,60747098,60778546,protein_coding,1,31448,chr18_60747098_60778546
Cd74,18,60803848,60812652,protein_coding,1,8804,chr18_60803848_60812652
Tcof1,18,60813755,60848971,protein_coding,-1,35216,chr18_60813755_60848971
Arsi,18,60911780,60918561,protein_coding,1,6781,chr18_60911780_60918561
Camk2a,18,60925618,60988152,protein_coding,1,62534,chr18_60925618_60988152
Slc6a7,18,60995380,61014222,protein_coding,-1,18842,chr18_60995380_61014222
Cdx1,18,61018862,61036199,protein_coding,-1,17337,chr18_61018862_61036199
Pdgfrb,18,61045150,61085061,protein_coding,1,39911,chr18_61045150_61085061
Csf1r,18,61100598,61132149,protein_coding,1,31551,chr18_61100598_61132149
Hmgxb3,18,61131277,61177050,protein_coding,-1,45773,chr18_61131277_61177050
Slc26a2,18,61192919,61211612,protein_coding,-1,18693,chr18_61192919_61211612
Pde6a,18,61220315,61289924,protein_coding,1,69609,chr18_61220315_61289924
Ppargc1b,18,61298136,61400431,protein_coding,-1,102295,chr18_61298136_61400431
Arhgef37,18,61491657,61536594,protein_coding,-1,44937,chr18_61491657_61536594
Csnk1a1,18,61555274,61590061,protein_coding,1,34787,chr18_61555274_61590061
Bvht,18,61639542,61647472,lincRNA,1,7930,chr18_61639542_61647472
Carmn,18,61649625,61665537,lincRNA,-1,15912,chr18_61649625_61665537
Il17b,18,61684887,61692538,protein_coding,1,7651,chr18_61684887_61692538
Gm38165,18,61691046,61692384,antisense,-1,1338,chr18_61691046_61692384
Pcyox1l,18,61696837,61707635,protein_coding,-1,10798,chr18_61696837_61707635
Grpel2,18,61712424,61726325,protein_coding,-1,13901,chr18_61712424_61726325
1500015A07Rik,18,61726390,61735917,antisense,1,9527,chr18_61726390_61735917
Afap1l1,18,61730261,61786702,protein_coding,-1,56441,chr18_61730261_61786702
Ablim3,18,61799392,61911824,protein_coding,-1,112432,chr18_61799392_61911824
Sh3tc2,18,61953075,62024402,protein_coding,1,71327,chr18_61953075_62024402
Adrb2,18,62177816,62179959,protein_coding,-1,2143,chr18_62177816_62179959
Gm9949,18,62180126,62184405,lincRNA,1,4279,chr18_62180126_62184405
Htr4,18,62324204,62496577,protein_coding,1,172373,chr18_62324204_62496577
Fbxo38,18,62504155,62548695,protein_coding,-1,44540,chr18_62504155_62548695
Spink10,18,62548911,62668070,protein_coding,1,119159,chr18_62548911_62668070
Gm36368,18,62566410,62579152,protein_coding,-1,12742,chr18_62566410_62579152
Spink7,18,62592194,62596327,protein_coding,-1,4133,chr18_62592194_62596327
Spink13,18,62607535,62741387,protein_coding,-1,133852,chr18_62607535_62741387
2700046A07Rik,18,62751674,62756347,lincRNA,-1,4673,chr18_62751674_62756347
Apcdd1,18,62922231,62961179,protein_coding,1,38948,chr18_62922231_62961179
Napg,18,62977831,62999450,protein_coding,1,21619,chr18_62977831_62999450
Piezo2,18,63010213,63387183,protein_coding,-1,376970,chr18_63010213_63387183
Gm26972,18,63399214,63421197,lincRNA,1,21983,chr18_63399214_63421197
Txnl1,18,63661094,63708801,protein_coding,-1,47707,chr18_63661094_63708801
Wdr7,18,63708685,63989776,protein_coding,1,281091,chr18_63708685_63989776
St8sia3os,18,64157721,64333706,antisense,-1,175985,chr18_64157721_64333706
St8sia3,18,64254359,64279611,protein_coding,1,25252,chr18_64254359_64279611
Onecut2,18,64340020,64400987,protein_coding,1,60967,chr18_64340020_64400987
Fech,18,64452914,64490251,protein_coding,-1,37337,chr18_64452914_64490251
Nars,18,64499647,64516652,protein_coding,-1,17005,chr18_64499647_64516652
Atp8b1,18,64528967,64661267,protein_coding,-1,132300,chr18_64528967_64661267
A330084C13Rik,18,64884475,64888491,antisense,-1,4016,chr18_64884475_64888491
Nedd4l,18,64887705,65217828,protein_coding,1,330123,chr18_64887705_65217828
Alpk2,18,65265529,65394066,protein_coding,-1,128537,chr18_65265529_65394066
Malt1,18,65430938,65479067,protein_coding,1,48129,chr18_65430938_65479067
Zfp532,18,65579912,65689443,protein_coding,1,109531,chr18_65579912_65689443
Oacyl,18,65698268,65751601,protein_coding,1,53333,chr18_65698268_65751601
Sec11c,18,65800515,65817684,protein_coding,1,17169,chr18_65800515_65817684
Grp,18,65872820,65886596,protein_coding,1,13776,chr18_65872820_65886596
Cplx4,18,65955722,65970237,protein_coding,-1,14515,chr18_65955722_65970237
Lman1,18,65980738,66022580,protein_coding,-1,41842,chr18_65980738_66022580
Ccbe1,18,66045302,66302741,protein_coding,-1,257439,chr18_66045302_66302741
Pmaip1,18,66458533,66465565,protein_coding,1,7032,chr18_66458533_66465565
Mc4r,18,66857704,66860506,protein_coding,-1,2802,chr18_66857704_66860506
Gnal,18,67088216,67226792,protein_coding,1,138576,chr18_67088216_67226792
Mppe1,18,67225043,67245830,protein_coding,-1,20787,chr18_67225043_67245830
Impa2,18,67289186,67322472,protein_coding,1,33286,chr18_67289186_67322472
Cidea,18,67343604,67367785,protein_coding,1,24181,chr18_67343604_67367785
Tubb6,18,67390717,67402749,protein_coding,1,12032,chr18_67390717_67402749
Afg3l2,18,67404764,67449172,protein_coding,-1,44408,chr18_67404764_67449172
Prelid3a,18,67464866,67479835,protein_coding,1,14969,chr18_67464866_67479835
Spire1,18,67488209,67610790,protein_coding,-1,122581,chr18_67488209_67610790
Gm17669,18,67562394,67562835,processed_pseudogene,1,441,chr18_67562394_67562835
Cep76,18,67617800,67641336,protein_coding,-1,23536,chr18_67617800_67641336
Psmg2,18,67641599,67654162,protein_coding,1,12563,chr18_67641599_67654162
Ptpn2,18,67665511,67724595,protein_coding,-1,59084,chr18_67665511_67724595
Gm26910,18,67773712,67774857,bidirectional_promoter_lncRNA,-1,1145,chr18_67773712_67774857
Seh1l,18,67774876,67795487,protein_coding,1,20611,chr18_67774876_67795487
Cep192,18,67800107,67885170,protein_coding,1,85063,chr18_67800107_67885170
Ldlrad4,18,67933257,68268630,protein_coding,1,335373,chr18_67933257_68268630
Fam210a,18,68260187,68300333,protein_coding,-1,40146,chr18_68260187_68300333
Rnmt,18,68300355,68324852,protein_coding,1,24497,chr18_68300355_68324852
Mc5r,18,68337596,68342446,protein_coding,1,4850,chr18_68337596_68342446
Mc2r,18,68406907,68429320,protein_coding,-1,22413,chr18_68406907_68429320
Gm31294,18,69193336,69195744,lincRNA,-1,2408,chr18_69193336_69195744
Tcf4,18,69343356,69689079,protein_coding,1,345723,chr18_69343356_69689079
Ccdc68,18,69925426,69969484,protein_coding,1,44058,chr18_69925426_69969484
1700061H18Rik,18,69943320,69969609,antisense,-1,26289,chr18_69943320_69969609
Rab27b,18,69979131,70141605,protein_coding,-1,162474,chr18_69979131_70141605
4930503L19Rik,18,70452212,70472509,protein_coding,-1,20297,chr18_70452212_70472509
Stard6,18,70472454,70501066,protein_coding,1,28612,chr18_70472454_70501066
Poli,18,70508680,70530620,protein_coding,-1,21940,chr18_70508680_70530620
Mbd2,18,70568189,70626131,protein_coding,1,57942,chr18_70568189_70626131
Dcc,18,71253634,72351069,protein_coding,-1,1097435,chr18_71253634_72351069
Mex3c,18,73573044,73592575,protein_coding,1,19531,chr18_73573044_73592575
Smad4,18,73639009,73703780,protein_coding,-1,64771,chr18_73639009_73703780
Elac1,18,73735038,73754479,protein_coding,-1,19441,chr18_73735038_73754479
Me2,18,73769903,73815449,protein_coding,-1,45546,chr18_73769903_73815449
Mro,18,73859385,73881333,protein_coding,1,21948,chr18_73859385_73881333
Mapk4,18,73928486,74065359,protein_coding,-1,136873,chr18_73928486_74065359
D730045A05Rik,18,74017907,74020088,lincRNA,1,2181,chr18_74017907_74020088
Gm9925,18,74065102,74065584,protein_coding,1,482,chr18_74065102_74065584
Ska1,18,74195299,74207818,protein_coding,-1,12519,chr18_74195299_74207818
Cxxc1,18,74216124,74221496,protein_coding,1,5372,chr18_74216124_74221496
Mbd1,18,74267605,74282732,protein_coding,1,15127,chr18_74267605_74282732
Cfap53,18,74283090,74359986,protein_coding,1,76896,chr18_74283090_74359986
Myo5b,18,74440936,74771493,protein_coding,1,330557,chr18_74440936_74771493
1700120E14Rik,18,74525140,74531124,antisense,-1,5984,chr18_74525140_74531124
Acaa2,18,74779197,74806208,protein_coding,1,27011,chr18_74779197_74806208
Lipg,18,74939322,74961263,protein_coding,-1,21941,chr18_74939322_74961263
Rpl17,18,74998558,75003381,protein_coding,1,4823,chr18_74998558_75003381
BC031181,18,75005868,75010152,protein_coding,1,4284,chr18_75005868_75010152
Dym,18,75018781,75286964,protein_coding,1,268183,chr18_75018781_75286964
Smad7,18,75367529,75395935,protein_coding,1,28406,chr18_75367529_75395935
Ctif,18,75431224,75697554,protein_coding,-1,266330,chr18_75431224_75697554
Gm10532,18,75514645,75522806,antisense,1,8161,chr18_75514645_75522806
Zbtb7c,18,75820178,76148564,protein_coding,1,328386,chr18_75820178_76148564
Smad2,18,76241580,76310963,protein_coding,1,69383,chr18_76241580_76310963
Skor2,18,76856405,76900342,protein_coding,1,43937,chr18_76856405_76900342
Ier3ip1,18,76930017,76941612,protein_coding,1,11595,chr18_76930017_76941612
Hdhd2,18,76944092,76975307,protein_coding,1,31215,chr18_76944092_76975307
Katnal2,18,76977148,77047308,protein_coding,-1,70160,chr18_76977148_77047308
Pias2,18,77065208,77153800,protein_coding,1,88592,chr18_77065208_77153800
Gm7276,18,77184269,77186363,bidirectional_promoter_lncRNA,-1,2094,chr18_77184269_77186363
St8sia5,18,77185839,77258771,protein_coding,1,72932,chr18_77185839_77258771
Loxhd1,18,77281958,77442930,protein_coding,1,160972,chr18_77281958_77442930
Rnf165,18,77456110,77565161,protein_coding,-1,109051,chr18_77456110_77565161
8030462N17Rik,18,77631497,77714486,protein_coding,-1,82989,chr18_77631497_77714486
A330094K24Rik,18,77729496,77732739,lincRNA;lncRNA,-1,3243,chr18_77729496_77732739
Haus1,18,77757567,77773886,protein_coding,-1,16319,chr18_77757567_77773886
Atp5a1,18,77773729,77782869,protein_coding,1,9140,chr18_77773729_77782869
Pstpip2,18,77789914,77882879,protein_coding,1,92965,chr18_77789914_77882879
Epg5,18,77893980,78035013,protein_coding,1,141033,chr18_77893980_78035013
Siglec15,18,77999129,78057395,protein_coding,-1,58266,chr18_77999129_78057395
Slc14a1,18,78055606,78142119,protein_coding,-1,86513,chr18_78055606_78142119
Slc14a2,18,78146148,78596942,protein_coding,-1,450794,chr18_78146148_78596942
Gm6133,18,78349754,78350701,protein_coding,1,947,chr18_78349754_78350701
Setbp1,18,78750380,79109391,protein_coding,-1,359011,chr18_78750380_79109391
Pard6g,18,80046890,80119639,protein_coding,1,72749,chr18_80046890_80119639
Gm21886,18,80089297,80089962,protein_coding,-1,665,chr18_80089297_80089962
Adnp2,18,80126311,80151482,protein_coding,-1,25171,chr18_80126311_80151482
Rbfa,18,80192265,80200658,protein_coding,-1,8393,chr18_80192265_80200658
Txnl4a,18,80206795,80225855,protein_coding,1,19060,chr18_80206795_80225855
Hsbp1l1,18,80229758,80247102,protein_coding,-1,17344,chr18_80229758_80247102
Kcng2,18,80294546,80364254,protein_coding,-1,69708,chr18_80294546_80364254
Gm26676,18,80323335,80326605,antisense,1,3270,chr18_80323335_80326605
Ctdp1,18,80407959,80469695,protein_coding,-1,61736,chr18_80407959_80469695
Nfatc1,18,80606205,80713071,protein_coding,-1,106866,chr18_80606205_80713071
Atp9b,18,80734141,80934060,protein_coding,-1,199919,chr18_80734141_80934060
Gm47272,18,80822247,80838491,antisense,1,16244,chr18_80822247_80838491
Sall3,18,80966376,80986771,protein_coding,-1,20395,chr18_80966376_80986771
Gm27239,18,80987456,80988575,lincRNA,1,1119,chr18_80987456_80988575
4930594M17Rik,18,81226204,81236066,lincRNA,-1,9862,chr18_81226204_81236066
Galr1,18,82392380,82406777,protein_coding,-1,14397,chr18_82392380_82406777
Mbp,18,82475146,82585637,protein_coding,1,110491,chr18_82475146_82585637
Zfp236,18,82593593,82692883,protein_coding,-1,99290,chr18_82593593_82692883
2210420H20Rik,18,82754505,82759041,lincRNA,-1,4536,chr18_82754505_82759041
4930445N18Rik,18,82855894,82870604,lincRNA,1,14710,chr18_82855894_82870604
Zfp516,18,82910663,83005314,protein_coding,1,94651,chr18_82910663_83005314
Tshz1,18,84011627,84087706,protein_coding,-1,76079,chr18_84011627_84087706
Zadh2,18,84088063,84097528,protein_coding,1,9465,chr18_84088063_84097528
Zfp407,18,84128027,84589725,protein_coding,-1,461698,chr18_84128027_84589725
Cndp1,18,84610509,84650095,protein_coding,-1,39586,chr18_84610509_84650095
Cndp2,18,84667465,84685702,protein_coding,-1,18237,chr18_84667465_84685702
Cyb5a,18,84838704,84879871,protein_coding,1,41167,chr18_84838704_84879871
Gm16146,18,84857917,84859586,antisense,-1,1669,chr18_84857917_84859586
Fbxo15,18,84934782,84981473,protein_coding,1,46691,chr18_84934782_84981473
Timm21,18,84946191,84951524,protein_coding,-1,5333,chr18_84946191_84951524
Neto1,18,86394952,86506718,protein_coding,1,111766,chr18_86394952_86506718
Cbln2,18,86711110,86718283,protein_coding,1,7173,chr18_86711110_86718283
Socs6,18,88665224,88927481,protein_coding,-1,262257,chr18_88665224_88927481
Rttn,18,88971790,89131016,protein_coding,1,159226,chr18_88971790_89131016
Cd226,18,89176967,89272229,protein_coding,1,95262,chr18_89176967_89272229
Dok6,18,89292424,89769528,protein_coding,-1,477104,chr18_89292424_89769528
Tmx3,18,90510154,90543267,protein_coding,1,33113,chr18_90510154_90543267
Gm45871,18,90579777,90592528,protein_coding,1,12751,chr18_90579777_90592528
1700030N03Rik,19,3053071,3197732,lincRNA,-1,144661,chr19_3053071_3197732
Ighmbp2,19,3259076,3283017,protein_coding,-1,23941,chr19_3259076_3283017
Mrpl21,19,3282901,3292837,protein_coding,1,9936,chr19_3282901_3292837
Cpt1a,19,3322334,3385733,protein_coding,1,63399,chr19_3322334_3385733
Tesmin,19,3388857,3407823,protein_coding,1,18966,chr19_3388857_3407823
Gal,19,3409915,3414544,protein_coding,-1,4629,chr19_3409915_3414544
Ppp6r3,19,3454928,3575749,protein_coding,-1,120821,chr19_3454928_3575749
Gm48683,19,3527104,3528613,antisense,1,1509,chr19_3527104_3528613
Lrp5,19,3584828,3686564,protein_coding,-1,101736,chr19_3584828_3686564
1810055G02Rik,19,3708293,3717881,protein_coding,1,9588,chr19_3708293_3717881
Kmt5b,19,3767421,3818303,protein_coding,1,50882,chr19_3767421_3818303
Chka,19,3851773,3894369,protein_coding,1,42596,chr19_3851773_3894369
Tcirg1,19,3896050,3907133,protein_coding,-1,11083,chr19_3896050_3907133
Ndufs8,19,3908863,3912774,protein_coding,-1,3911,chr19_3908863_3912774
Aldh3b1,19,3913491,3929808,protein_coding,-1,16317,chr19_3913491_3929808
Unc93b1,19,3935186,3949340,protein_coding,1,14154,chr19_3935186_3949340
Aldh3b3,19,3958645,3972103,protein_coding,1,13458,chr19_3958645_3972103
Aldh3b2,19,3972328,3981646,protein_coding,1,9318,chr19_3972328_3981646
Acy3,19,3986570,3990007,protein_coding,1,3437,chr19_3986570_3990007
Tbx10,19,3992752,3999512,protein_coding,1,6760,chr19_3992752_3999512
Nudt8,19,4000580,4002103,protein_coding,1,1523,chr19_4000580_4002103
Gm16312,19,4000758,4001232,antisense,-1,474,chr19_4000758_4001232
Doc2g,19,4003313,4007005,protein_coding,1,3692,chr19_4003313_4007005
Ndufv1,19,4007384,4012806,protein_coding,-1,5422,chr19_4007384_4012806
Gstp1,19,4035407,4037985,protein_coding,-1,2578,chr19_4035407_4037985
Gstp3,19,4057477,4059569,protein_coding,-1,2092,chr19_4057477_4059569
Cdk2ap2,19,4097182,4099019,protein_coding,1,1837,chr19_4097182_4099019
Pitpnm1,19,4099998,4113965,protein_coding,1,13967,chr19_4099998_4113965
Aip,19,4114446,4125858,protein_coding,-1,11412,chr19_4114446_4125858
Cabp4,19,4135422,4144033,protein_coding,-1,8611,chr19_4135422_4144033
Gpr152,19,4139786,4145740,protein_coding,1,5954,chr19_4139786_4145740
Coro1b,19,4148618,4154035,protein_coding,1,5417,chr19_4148618_4154035
Ptprcap,19,4153603,4156751,protein_coding,1,3148,chr19_4153603_4156751
Rps6kb2,19,4153990,4163354,protein_coding,-1,9364,chr19_4153990_4163354
Carns1,19,4164323,4175479,protein_coding,-1,11156,chr19_4164323_4175479
Gm17552,CHR_MG153_PATCH,4169565,4174284,antisense;lncRNA,1,4719,chrCHR_MG153_PATCH_4169565_4174284
Tbc1d10c,19,4183410,4191284,protein_coding,-1,7874,chr19_4183410_4191284
Ppp1ca,19,4192064,4195420,protein_coding,1,3356,chr19_4192064_4195420
Rad9a,19,4195195,4201662,protein_coding,-1,6467,chr19_4195195_4201662
Clcf1,19,4214237,4223490,protein_coding,1,9253,chr19_4214237_4223490
Pold4,19,4231898,4233634,protein_coding,1,1736,chr19_4231898_4233634
Ssh3,19,4261668,4269180,protein_coding,-1,7512,chr19_4261668_4269180
Ankrd13d,19,4270180,4283137,protein_coding,-1,12957,chr19_4270180_4283137
Grk2,19,4286001,4306222,protein_coding,-1,20221,chr19_4286001_4306222
Kdm2a,19,4314419,4398285,protein_coding,-1,83866,chr19_4314419_4398285
Rhod,19,4425459,4439432,protein_coding,-1,13973,chr19_4425459_4439432
Syt12,19,4445908,4477447,protein_coding,-1,31539,chr19_4445908_4477447
Pcx,19,4510472,4621752,protein_coding,1,111280,chr19_4510472_4621752
Lrfn4,19,4611785,4615667,protein_coding,-1,3882,chr19_4611785_4615667
Rce1,19,4622591,4625641,protein_coding,-1,3050,chr19_4622591_4625641
Gm960,19,4625734,4698668,protein_coding,-1,72934,chr19_4625734_4698668
Sptbn2,19,4711167,4752360,protein_coding,1,41193,chr19_4711167_4752360
Gm21992,19,4742913,4811612,protein_coding,-1,68699,chr19_4742913_4811612
Rbm4b,19,4756497,4767065,protein_coding,1,10568,chr19_4756497_4767065
Rbm14,19,4800569,4811634,protein_coding,-1,11065,chr19_4800569_4811634
Gm21844,19,4801512,4805784,antisense,1,4272,chr19_4801512_4805784
Ccs,19,4825366,4839332,protein_coding,-1,13966,chr19_4825366_4839332
Ccdc87,19,4839366,4842528,protein_coding,1,3162,chr19_4839366_4842528
Ctsf,19,4855130,4860918,protein_coding,1,5788,chr19_4855130_4860918
Actn3,19,4861216,4877909,protein_coding,-1,16693,chr19_4861216_4877909
Zdhhc24,19,4878668,4885397,protein_coding,1,6729,chr19_4878668_4885397
Bbs1,19,4886878,4906628,protein_coding,-1,19750,chr19_4886878_4906628
Dpp3,19,4907229,4928287,protein_coding,-1,21058,chr19_4907229_4928287
Peli3,19,4929717,4943127,protein_coding,-1,13410,chr19_4929717_4943127
Mrpl11,19,4962147,4966999,protein_coding,1,4852,chr19_4962147_4966999
Npas4,19,4984355,4990316,protein_coding,-1,5961,chr19_4984355_4990316
Slc29a2,19,5023860,5031972,protein_coding,1,8112,chr19_5023860_5031972
B4gat1,19,5038826,5041131,protein_coding,1,2305,chr19_5038826_5041131
Brms1,19,5041354,5049917,protein_coding,1,8563,chr19_5041354_5049917
Rin1,19,5050481,5057071,protein_coding,1,6590,chr19_5050481_5057071
Cd248,19,5068078,5070682,protein_coding,1,2604,chr19_5068078_5070682
Tmem151a,19,5070859,5085531,protein_coding,-1,14672,chr19_5070859_5085531
Yif1a,19,5088538,5092881,protein_coding,1,4343,chr19_5088538_5092881
Cnih2,19,5092868,5098521,protein_coding,-1,5653,chr19_5092868_5098521
Rab1b,19,5099205,5107072,protein_coding,-1,7867,chr19_5099205_5107072
Klc2,19,5107746,5118560,protein_coding,-1,10814,chr19_5107746_5118560
Pacs1,19,5133158,5273119,protein_coding,-1,139961,chr19_5133158_5273119
Sf3b2,19,5273932,5295455,protein_coding,-1,21523,chr19_5273932_5295455
Gal3st3,19,5298331,5308738,protein_coding,1,10407,chr19_5298331_5308738
Catsper1,19,5335741,5344280,protein_coding,1,8539,chr19_5335741_5344280
Cst6,19,5344705,5349574,protein_coding,-1,4869,chr19_5344705_5349574
Banf1,19,5364638,5367168,protein_coding,-1,2530,chr19_5364638_5367168
Eif1ad,19,5366741,5371526,protein_coding,1,4785,chr19_5366741_5371526
Sart1,19,5377523,5388703,protein_coding,-1,11180,chr19_5377523_5388703
Tsga10ip,19,5390049,5402526,protein_coding,-1,12477,chr19_5390049_5402526
4930481A15Rik,19,5406740,5422847,antisense,1,16107,chr19_5406740_5422847
Drap1,19,5422805,5424979,protein_coding,-1,2174,chr19_5422805_5424979
AI837181,19,5425144,5427313,protein_coding,1,2169,chr19_5425144_5427313
Fosl1,19,5447547,5455946,protein_coding,1,8399,chr19_5447547_5455946
Ccdc85b,19,5453180,5457894,protein_coding,-1,4714,chr19_5453180_5457894
Fibp,19,5460615,5465051,protein_coding,1,4436,chr19_5460615_5465051
Ctsw,19,5465043,5468507,protein_coding,-1,3464,chr19_5465043_5468507
Efemp2,19,5473954,5482517,protein_coding,1,8563,chr19_5473954_5482517
Mus81,19,5482345,5488402,protein_coding,-1,6057,chr19_5482345_5488402
Cfl1,19,5490455,5495201,protein_coding,1,4746,chr19_5490455_5495201
Snx32,19,5492235,5510538,protein_coding,-1,18303,chr19_5492235_5510538
Ovol1,19,5549136,5560646,protein_coding,-1,11510,chr19_5549136_5560646
Ap5b1,19,5568025,5571261,protein_coding,1,3236,chr19_5568025_5571261
Rnaseh2c,19,5601873,5607019,protein_coding,1,5146,chr19_5601873_5607019
Kat5,19,5603014,5610237,protein_coding,-1,7223,chr19_5603014_5610237
Rela,19,5637483,5648130,protein_coding,1,10647,chr19_5637483_5648130
Sipa1,19,5651185,5663707,protein_coding,-1,12522,chr19_5651185_5663707
Pcnx3,19,5664635,5688908,protein_coding,-1,24273,chr19_5664635_5688908
Map3k11,19,5688742,5702865,protein_coding,1,14123,chr19_5688742_5702865
Kcnk7,19,5704367,5707109,protein_coding,1,2742,chr19_5704367_5707109
Ehbp1l1,19,5707376,5726317,protein_coding,-1,18941,chr19_5707376_5726317
Gm16538,19,5727206,5731627,antisense,1,4421,chr19_5727206_5731627
Fam89b,19,5728087,5729653,protein_coding,-1,1566,chr19_5728087_5729653
Ltbp3,19,5740904,5758532,protein_coding,1,17628,chr19_5740904_5758532
Scyl1,19,5758351,5771419,protein_coding,-1,13068,chr19_5758351_5771419
Malat1,19,5795690,5802672,lincRNA,-1,6982,chr19_5795690_5802672
Neat1,19,5824708,5845478,lincRNA,-1,20770,chr19_5824708_5845478
Frmd8os,19,5845623,5851388,antisense,1,5765,chr19_5845623_5851388
Frmd8,19,5849702,5875274,protein_coding,-1,25572,chr19_5849702_5875274
Slc25a45,19,5877808,5885878,protein_coding,1,8070,chr19_5877808_5885878
Tigd3,19,5891138,5894149,protein_coding,-1,3011,chr19_5891138_5894149
Dpf2,19,5896516,5913010,protein_coding,-1,16494,chr19_5896516_5913010
Gm42067,19,5912822,5914829,antisense,1,2007,chr19_5912822_5914829
Cdc42ep2,19,5915636,5924816,protein_coding,-1,9180,chr19_5915636_5924816
Pola2,19,5940542,5964202,protein_coding,-1,23660,chr19_5940542_5964202
Slc22a20,19,5970234,5986143,protein_coding,-1,15909,chr19_5970234_5986143
Capn1,19,5988545,6015897,protein_coding,-1,27352,chr19_5988545_6015897
Gm10814,19,6012620,6018462,antisense,1,5842,chr19_6012620_6018462
Syvn1,19,6046576,6053712,protein_coding,1,7136,chr19_6046576_6053712
Mrpl49,19,6053622,6057785,protein_coding,-1,4163,chr19_6053622_6057785
Fau,19,6057844,6059524,protein_coding,1,1680,chr19_6057844_6059524
Znhit2,19,6061192,6062472,protein_coding,1,1280,chr19_6061192_6062472
Tm7sf2,19,6062821,6068373,protein_coding,-1,5552,chr19_6062821_6068373
Gm28374,19,6076945,6082256,protein_coding,-1,5311,chr19_6076945_6082256
Tmem262,19,6080033,6080788,protein_coding,1,755,chr19_6080033_6080788
Zfpl1,19,6080762,6084956,protein_coding,-1,4194,chr19_6080762_6084956
Cdca5,19,6084983,6091777,protein_coding,1,6794,chr19_6084983_6091777
Naaladl1,19,6105782,6115792,protein_coding,1,10010,chr19_6105782_6115792
Sac3d1,19,6116000,6118650,protein_coding,-1,2650,chr19_6116000_6118650
Snx15,19,6119399,6128304,protein_coding,-1,8905,chr19_6119399_6128304
Arl2,19,6134374,6141548,protein_coding,-1,7174,chr19_6134374_6141548
Batf2,19,6140983,6172476,protein_coding,1,31493,chr19_6140983_6172476
Majin,19,6184388,6224225,protein_coding,1,39837,chr19_6184388_6224225
Gpha2,19,6226380,6227768,protein_coding,1,1388,chr19_6226380_6227768
Ppp2r5b,19,6227765,6235872,protein_coding,-1,8107,chr19_6227765_6235872
Atg2a,19,6241668,6262335,protein_coding,1,20667,chr19_6241668_6262335
Ehd1,19,6276725,6300096,protein_coding,1,23371,chr19_6276725_6300096
Cdc42bpg,19,6306456,6325652,protein_coding,1,19196,chr19_6306456_6325652
Men1,19,6334979,6340891,protein_coding,1,5912,chr19_6334979_6340891
Map4k2,19,6341135,6355615,protein_coding,1,14480,chr19_6341135_6355615
Gm14966,CHR_MG4249_PATCH,6355522,6363759,antisense;lncRNA,-1,8237,chrCHR_MG4249_PATCH_6355522_6363759
Sf1,19,6363690,6378030,protein_coding,1,14340,chr19_6363690_6378030
Pygm,19,6384399,6398459,protein_coding,1,14060,chr19_6384399_6398459
Rasgrp2,19,6399340,6415216,protein_coding,1,15876,chr19_6399340_6415216
Nrxn2,19,6418731,6544169,protein_coding,1,125438,chr19_6418731_6544169
Gm14964,CHR_MG4249_PATCH,6530711,6532011,antisense;lncRNA,-1,1300,chrCHR_MG4249_PATCH_6530711_6532011
Slc22a12,19,6535845,6543032,protein_coding,-1,7187,chr19_6535845_6543032
Rps6ka4,19,6829085,6840636,protein_coding,-1,11551,chr19_6829085_6840636
Ccdc88b,19,6844623,6858211,protein_coding,-1,13588,chr19_6844623_6858211
Prdx5,19,6906697,6910106,protein_coding,-1,3409,chr19_6906697_6910106
Trmt112,19,6909698,6911049,protein_coding,1,1351,chr19_6909698_6911049
Esrra,19,6910977,6921840,protein_coding,-1,10863,chr19_6910977_6921840
Catsperz,19,6922371,6925380,protein_coding,-1,3009,chr19_6922371_6925380
Kcnk4,19,6923966,6934515,protein_coding,-1,10549,chr19_6923966_6934515
Gpr137,19,6938057,6942480,protein_coding,-1,4423,chr19_6938057_6942480
Bad,19,6941861,6951899,protein_coding,1,10038,chr19_6941861_6951899
Plcb3,19,6952325,6976470,protein_coding,-1,24145,chr19_6952325_6976470
Ppp1r14b,19,6974968,6977324,protein_coding,1,2356,chr19_6974968_6977324
Fkbp2,19,6977741,6980501,protein_coding,-1,2760,chr19_6977741_6980501
Vegfb,19,6982473,6987651,protein_coding,-1,5178,chr19_6982473_6987651
Dnajc4,19,6987911,6992572,protein_coding,-1,4661,chr19_6987911_6992572
Nudt22,19,6993018,6996117,protein_coding,-1,3099,chr19_6993018_6996117
Trpt1,19,6996131,6999046,protein_coding,1,2915,chr19_6996131_6999046
Fermt3,19,6998958,7019469,protein_coding,-1,20511,chr19_6998958_7019469
Stip1,19,7020702,7039967,protein_coding,-1,19265,chr19_7020702_7039967
Macrod1,19,7056810,7198057,protein_coding,1,141247,chr19_7056810_7198057
Flrt1,19,7092001,7105729,protein_coding,-1,13728,chr19_7092001_7105729
Otub1,19,7198202,7206316,protein_coding,-1,8114,chr19_7198202_7206316
Cox8a,19,7215153,7217616,protein_coding,-1,2463,chr19_7215153_7217616
Naa40,19,7225668,7241183,protein_coding,-1,15515,chr19_7225668_7241183
Rcor2,19,7267325,7275225,protein_coding,1,7900,chr19_7267325_7275225
Mark2,19,7275396,7341860,protein_coding,-1,66464,chr19_7275396_7341860
Gm17227,19,7297658,7304528,antisense,1,6870,chr19_7297658_7304528
Spindoc,19,7354078,7382994,protein_coding,-1,28916,chr19_7354078_7382994
1700105P06Rik,19,7382537,7383561,antisense,1,1024,chr19_7382537_7383561
2700081O15Rik,19,7417625,7425904,protein_coding,1,8279,chr19_7417625_7425904
Rtn3,19,7425901,7483281,protein_coding,-1,57380,chr19_7425901_7483281
Atl3,19,7494040,7539674,protein_coding,1,45634,chr19_7494040_7539674
Lgals12,19,7596660,7607193,protein_coding,-1,10533,chr19_7596660_7607193
Slc22a19,19,7673061,7711310,protein_coding,-1,38249,chr19_7673061_7711310
Slc22a26,19,7781041,7802667,protein_coding,-1,21626,chr19_7781041_7802667
Slc22a27,19,7864388,7966027,protein_coding,-1,101639,chr19_7864388_7966027
Slc22a28,19,8062209,8131982,protein_coding,-1,69773,chr19_8062209_8131982
Slc22a29,19,8160165,8218900,protein_coding,-1,58735,chr19_8160165_8218900
Slc22a30,19,8335371,8405111,protein_coding,-1,69740,chr19_8335371_8405111
Slc22a8,19,8591254,8611835,protein_coding,1,20581,chr19_8591254_8611835
Slc22a6,19,8618039,8628299,protein_coding,1,10260,chr19_8618039_8628299
Chrm1,19,8663789,8683587,protein_coding,1,19798,chr19_8663789_8683587
Slc3a2,19,8706882,8723369,protein_coding,-1,16487,chr19_8706882_8723369
Wdr74,19,8735827,8740624,protein_coding,1,4797,chr19_8735827_8740624
1700092M07Rik,19,8740718,8741225,protein_coding,1,507,chr19_8740718_8741225
Stx5a,19,8741413,8756069,protein_coding,1,14656,chr19_8741413_8756069
Nxf1,19,8757073,8770922,protein_coding,1,13849,chr19_8757073_8770922
Taf6l,19,8774487,8786417,protein_coding,-1,11930,chr19_8774487_8786417
Polr2g,19,8793127,8798577,protein_coding,-1,5450,chr19_8793127_8798577
Zbtb3,19,8802555,8804846,protein_coding,1,2291,chr19_8802555_8804846
Ttc9c,19,8809075,8819333,protein_coding,-1,10258,chr19_8809075_8819333
Hnrnpul2,19,8820010,8834143,protein_coding,1,14133,chr19_8820010_8834143
Gng3,19,8836933,8839194,protein_coding,-1,2261,chr19_8836933_8839194
Bscl2,19,8837467,8848683,protein_coding,1,11216,chr19_8837467_8848683
Lrrn4cl,19,8850768,8853909,protein_coding,1,3141,chr19_8850768_8853909
Ubxn1,19,8871496,8875863,protein_coding,1,4367,chr19_8871496_8875863
Uqcc3,19,8880014,8880923,protein_coding,-1,909,chr19_8880014_8880923
Lbhd1,19,8883732,8892627,protein_coding,1,8895,chr19_8883732_8892627
Ints5,19,8893005,8897888,protein_coding,1,4883,chr19_8893005_8897888
Ganab,19,8898071,8916672,protein_coding,1,18601,chr19_8898071_8916672
B3gat3,19,8920374,8927236,protein_coding,1,6862,chr19_8920374_8927236
Rom1,19,8927391,8929356,protein_coding,-1,1965,chr19_8927391_8929356
Eml3,19,8929552,8941582,protein_coding,1,12030,chr19_8929552_8941582
Gm10353,19,8936975,8940864,antisense,-1,3889,chr19_8936975_8940864
Mta2,19,8941875,8952303,protein_coding,1,10428,chr19_8941875_8952303
Tut1,19,8953847,8966210,protein_coding,1,12363,chr19_8953847_8966210
Eef1g,19,8967041,8978479,protein_coding,1,11438,chr19_8967041_8978479
Ahnak,19,8989284,9076914,protein_coding,1,87630,chr19_8989284_9076914
Scgb1a1,19,9083636,9087958,protein_coding,-1,4322,chr19_9083636_9087958
Asrgl1,19,9109868,9135636,protein_coding,-1,25768,chr19_9109868_9135636
Pcna-ps2,19,9283380,9284160,processed_pseudogene,1,780,chr19_9283380_9284160
Scgb2a2,19,9847562,9852808,protein_coding,1,5246,chr19_9847562_9852808
Incenp,19,9872296,9899551,protein_coding,-1,27255,chr19_9872296_9899551
Fth1,19,9980598,9985098,protein_coding,1,4500,chr19_9980598_9985098
Best1,19,9985174,10001633,protein_coding,-1,16459,chr19_9985174_10001633
Rab3il1,19,10001669,10038380,protein_coding,1,36711,chr19_10001669_10038380
Fads3,19,10041569,10060110,protein_coding,1,18541,chr19_10041569_10060110
Fads2,19,10062765,10101746,protein_coding,-1,38981,chr19_10062765_10101746
Fads1,19,10182888,10196877,protein_coding,1,13989,chr19_10182888_10196877
Fen1,19,10199132,10204169,protein_coding,-1,5037,chr19_10199132_10204169
Tmem258,19,10204014,10207824,protein_coding,1,3810,chr19_10204014_10207824
Myrf,19,10208272,10240748,protein_coding,-1,32476,chr19_10208272_10240748
Dagla,19,10245265,10304877,protein_coding,-1,59612,chr19_10245265_10304877
Syt7,19,10389090,10453180,protein_coding,1,64090,chr19_10389090_10453180
Lrrc10b,19,10455371,10457473,protein_coding,-1,2102,chr19_10455371_10457473
Ppp1r32,19,10474235,10482928,protein_coding,-1,8693,chr19_10474235_10482928
Sdhaf2,19,10500534,10526142,protein_coding,-1,25608,chr19_10500534_10526142
Cpsf7,19,10525266,10547653,protein_coding,1,22387,chr19_10525266_10547653
Tmem216,19,10533865,10556238,protein_coding,-1,22373,chr19_10533865_10556238
Tmem138,19,10570478,10577362,protein_coding,-1,6884,chr19_10570478_10577362
Cyb561a3,19,10577172,10595961,protein_coding,1,18789,chr19_10577172_10595961
Tkfc,19,10587791,10605654,protein_coding,-1,17863,chr19_10587791_10605654
Ddb1,19,10605327,10629819,protein_coding,1,24492,chr19_10605327_10629819
Vwce,19,10634213,10666213,protein_coding,1,32000,chr19_10634213_10666213
Pga5,19,10668956,10678071,protein_coding,-1,9115,chr19_10668956_10678071
Vps37c,19,10688735,10714627,protein_coding,1,25892,chr19_10688735_10714627
Cd5,19,10717116,10739002,protein_coding,-1,21886,chr19_10717116_10739002
Cd6,19,10789341,10830058,protein_coding,-1,40717,chr19_10789341_10830058
Slc15a3,19,10839727,10859362,protein_coding,1,19635,chr19_10839727_10859362
Tmem132a,19,10857822,10869940,protein_coding,-1,12118,chr19_10857822_10869940
Tmem109,19,10870660,10882001,protein_coding,-1,11341,chr19_10870660_10882001
Prpf19,19,10895231,10909559,protein_coding,1,14328,chr19_10895231_10909559
Zp1,19,10914287,10920632,protein_coding,-1,6345,chr19_10914287_10920632
Ptgdr2,19,10937160,10942511,protein_coding,1,5351,chr19_10937160_10942511
Ccdc86,19,10941481,10949266,protein_coding,-1,7785,chr19_10941481_10949266
Ms4a18,19,10997025,11018031,protein_coding,-1,21006,chr19_10997025_11018031
AW112010,19,11047612,11055808,lincRNA,-1,8196,chr19_11047612_11055808
Ms4a8a,19,11067471,11081102,protein_coding,-1,13631,chr19_11067471_11081102
Ms4a13,19,11169418,11196737,protein_coding,-1,27319,chr19_11169418_11196737
4930526L06Rik,19,11196817,11299886,antisense,1,103069,chr19_11196817_11299886
Ms4a12,19,11214082,11232448,protein_coding,-1,18366,chr19_11214082_11232448
Ms4a1,19,11249675,11266241,protein_coding,-1,16566,chr19_11249675_11266241
Ms4a14,19,11301249,11314454,protein_coding,-1,13205,chr19_11301249_11314454
Ms4a7,19,11321039,11336146,protein_coding,-1,15107,chr19_11321039_11336146
Ms4a4a,19,11375523,11392790,protein_coding,1,17267,chr19_11375523_11392790
Ms4a4c,19,11404770,11427246,protein_coding,1,22476,chr19_11404770_11427246
Ms4a4b,19,11443553,11467055,protein_coding,1,23502,chr19_11443553_11467055
Ms4a6c,19,11469366,11482192,protein_coding,1,12826,chr19_11469366_11482192
Gm8369,19,11485938,11512577,protein_coding,1,26639,chr19_11485938_11512577
Ms4a6b,19,11516512,11531256,protein_coding,1,14744,chr19_11516512_11531256
Ms4a4d,19,11536801,11558467,protein_coding,1,21666,chr19_11536801_11558467
Ms4a6d,19,11586604,11604849,protein_coding,-1,18245,chr19_11586604_11604849
Ms4a2,19,11615523,11623719,protein_coding,-1,8196,chr19_11615523_11623719
Ms4a3,19,11629496,11640851,protein_coding,-1,11355,chr19_11629496_11640851
Oosp2,19,11647279,11660559,protein_coding,-1,13280,chr19_11647279_11660559
Oosp1,19,11667460,11691150,protein_coding,-1,23690,chr19_11667460_11691150
Oosp3,19,11697055,11711874,protein_coding,1,14819,chr19_11697055_11711874
Mrpl16,19,11770391,11774960,protein_coding,1,4569,chr19_11770391_11774960
Stx3,19,11775118,11819403,protein_coding,-1,44285,chr19_11775118_11819403
Olfr1417,19,11826803,11839219,protein_coding,-1,12416,chr19_11826803_11839219
Olfr1418,19,11852587,11861066,protein_coding,-1,8479,chr19_11852587_11861066
Olfr1419,19,11868613,11875106,protein_coding,-1,6493,chr19_11868613_11875106
Olfr1420,19,11886565,11898079,protein_coding,1,11514,chr19_11886565_11898079
Patl1,19,11912399,11945091,protein_coding,1,32692,chr19_11912399_11945091
Osbp,19,11965941,11994112,protein_coding,1,28171,chr19_11965941_11994112
Olfr1423,19,12031787,12041317,protein_coding,-1,9530,chr19_12031787_12041317
Olfr1425,19,12073234,12077731,protein_coding,-1,4497,chr19_12073234_12077731
Olfr1426,19,12086746,12092013,protein_coding,-1,5267,chr19_12086746_12092013
Olfr1427,19,12098006,12103334,protein_coding,-1,5328,chr19_12098006_12103334
Olfr1428,19,12107716,12115897,protein_coding,-1,8181,chr19_12107716_12115897
Olfr76,19,12117996,12123203,protein_coding,-1,5207,chr19_12117996_12123203
Olfr1555-ps1,19,12164424,12170112,protein_coding,-1,5688,chr19_12164424_12170112
Olfr1431,19,12200634,12212191,protein_coding,1,11557,chr19_12200634_12212191
Olfr1432,19,12227755,12232596,protein_coding,-1,4841,chr19_12227755_12232596
Olfr235,19,12261032,12270387,protein_coding,1,9355,chr19_12261032_12270387
Olfr1434,19,12279854,12285626,protein_coding,1,5772,chr19_12279854_12285626
Olfr1437,19,12319207,12325101,protein_coding,-1,5894,chr19_12319207_12325101
Olfr1438-ps1,19,12329422,12335910,protein_coding,-1,6488,chr19_12329422_12335910
Olfr1440,19,12387279,12401584,protein_coding,1,14305,chr19_12387279_12401584
Olfr1441,19,12417433,12423569,protein_coding,1,6136,chr19_12417433_12423569
Mpeg1,19,12460779,12465283,protein_coding,1,4504,chr19_12460779_12465283
Dtx4,19,12466338,12501454,protein_coding,-1,35116,chr19_12466338_12501454
Gm47243,19,12519800,12523576,lincRNA,1,3776,chr19_12519800_12523576
Gm47242,19,12539588,12540823,lincRNA,-1,1235,chr19_12539588_12540823
Fam111a,19,12545740,12589768,protein_coding,1,44028,chr19_12545740_12589768
Gm4952,19,12599974,12628251,protein_coding,1,28277,chr19_12599974_12628251
Glyat,19,12633308,12653911,protein_coding,1,20603,chr19_12633308_12653911
Keg1,19,12695786,12719902,protein_coding,1,24116,chr19_12695786_12719902
Gm15962,19,12706055,12721247,antisense,-1,15192,chr19_12706055_12721247
Zfp91,19,12763660,12796126,protein_coding,-1,32466,chr19_12763660_12796126
Lpxn,19,12796193,12833807,protein_coding,1,37614,chr19_12796193_12833807
Olfr1448,19,12916661,12924419,protein_coding,-1,7758,chr19_12916661_12924419
Olfr1458,19,13101593,13106775,protein_coding,-1,5182,chr19_13101593_13106775
Olfr1459,19,13138021,13149549,protein_coding,-1,11528,chr19_13138021_13149549
Olfr1461,19,13163000,13168130,protein_coding,1,5130,chr19_13163000_13168130
Olfr1469,19,13407849,13414540,protein_coding,1,6691,chr19_13407849_13414540
Olfr1471,19,13443409,13451527,protein_coding,1,8118,chr19_13443409_13451527
Olfr1472,19,13453280,13456086,protein_coding,-1,2806,chr19_13453280_13456086
Olfr1487,19,13617375,13623072,protein_coding,1,5697,chr19_13617375_13623072
Olfr1489,19,13631621,13643987,protein_coding,1,12366,chr19_13631621_13643987
Olfr1490,19,13651091,13659545,protein_coding,1,8454,chr19_13651091_13659545
Olfr1491,19,13697268,13706127,protein_coding,1,8859,chr19_13697268_13706127
Olfr1494,19,13739728,13750479,protein_coding,1,10751,chr19_13739728_13750479
Olfr1499,19,13814275,13819447,protein_coding,-1,5172,chr19_13814275_13819447
Olfr1501,19,13835033,13850692,protein_coding,-1,15659,chr19_13835033_13850692
Olfr1505,19,13913530,13921866,protein_coding,1,8336,chr19_13913530_13921866
Tle4,19,14448150,14598051,protein_coding,-1,149901,chr19_14448150_14598051
Psat1,19,15904678,15947337,protein_coding,-1,42659,chr19_15904678_15947337
Cep78,19,15955773,15984989,protein_coding,-1,29216,chr19_15955773_15984989
C130060C02Rik,19,15985078,16010696,bidirectional_promoter_lncRNA,1,25618,chr19_15985078_16010696
Gnaq,19,16132831,16387463,protein_coding,1,254632,chr19_16132831_16387463
Gna14,19,16435762,16610820,protein_coding,1,175058,chr19_16435762_16610820
Vps13a,19,16615366,16780933,protein_coding,-1,165567,chr19_16615366_16780933
Prune2,19,16956118,17223932,protein_coding,1,267814,chr19_16956118_17223932
Gcnt1,19,17326141,17372844,protein_coding,-1,46703,chr19_17326141_17372844
Rfk,19,17394043,17401349,protein_coding,1,7306,chr19_17394043_17401349
Pcsk5,19,17432319,17837632,protein_coding,-1,405313,chr19_17432319_17837632
Ostf1,19,18516137,18631823,protein_coding,-1,115686,chr19_18516137_18631823
Nmrk1,19,18631950,18652428,protein_coding,1,20478,chr19_18631950_18652428
Carnmt1,19,18670764,18707200,protein_coding,1,36436,chr19_18670764_18707200
D030056L22Rik,19,18713193,18718428,protein_coding,1,5235,chr19_18713193_18718428
Trpm6,19,18749983,18892511,protein_coding,1,142528,chr19_18749983_18892511
Rorb,19,18930605,19111196,protein_coding,-1,180591,chr19_18930605_19111196
Anxa1,19,20373428,20390944,protein_coding,-1,17516,chr19_20373428_20390944
1500015L24Rik,19,20324856,20444883,lincRNA,1,120027,chr19_20324856_20444883
Aldh1a1,19,20492715,20643465,protein_coding,1,150750,chr19_20492715_20643465
C730002L08Rik,19,20410544,20552330,processed_transcript,-1,141786,chr19_20410544_20552330
Aldh1a7,19,20692953,20727562,protein_coding,-1,34609,chr19_20692953_20727562
Tmc1,19,20783458,20954202,protein_coding,-1,170744,chr19_20783458_20954202
Zfand5,19,21272278,21286840,protein_coding,1,14562,chr19_21272278_21286840
Gda,19,21391307,21473445,protein_coding,-1,82138,chr19_21391307_21473445
Gm3443,19,21552204,21557867,transcribed_unitary_pseudogene,1,5663,chr19_21552204_21557867
1110059E24Rik,19,21581202,21652976,protein_coding,-1,71774,chr19_21581202_21652976
Abhd17b,19,21653185,21685637,protein_coding,1,32452,chr19_21653185_21685637
Trpm3,19,22139046,22995410,protein_coding,1,856364,chr19_22139046_22995410
Gm27151,19,22438520,22448865,antisense,-1,10345,chr19_22438520_22448865
C330002G04Rik,19,22978230,23075924,lincRNA,-1,97694,chr19_22978230_23075924
2410080I02Rik,19,23134900,23135717,lincRNA,1,817,chr19_23134900_23135717
Klf9,19,23141226,23168134,protein_coding,1,26908,chr19_23141226_23168134
Smc5,19,23206451,23273897,protein_coding,-1,67446,chr19_23206451_23273897
Mamdc2,19,23302609,23448442,protein_coding,-1,145833,chr19_23302609_23448442
1700028P14Rik,19,23558753,23652812,protein_coding,-1,94059,chr19_23558753_23652812
Gm9493,19,23619749,23620319,processed_pseudogene,1,570,chr19_23619749_23620319
Gm6563,19,23675848,23676480,processed_pseudogene,1,632,chr19_23675848_23676480
Ptar1,19,23687429,23731668,protein_coding,1,44239,chr19_23687429_23731668
Apba1,19,23758887,23949596,protein_coding,1,190709,chr19_23758887_23949596
Fam189a2,19,23972750,24031019,protein_coding,-1,58269,chr19_23972750_24031019
Tjp2,19,24094505,24225030,protein_coding,-1,130525,chr19_24094505_24225030
Fxn,19,24261453,24280605,protein_coding,-1,19152,chr19_24261453_24280605
Pip5k1b,19,24294794,24555872,protein_coding,-1,261078,chr19_24294794_24555872
Pip5k1bos,19,24416009,24430329,antisense,1,14320,chr19_24416009_24430329
Tmem252,19,24674008,24682233,protein_coding,1,8225,chr19_24674008_24682233
Pgm5,19,24683016,24861855,protein_coding,-1,178839,chr19_24683016_24861855
Gm10053,19,24875686,24876631,protein_coding,1,945,chr19_24875686_24876631
Cbwd1,19,24919916,24961610,protein_coding,-1,41694,chr19_24919916_24961610
Dock8,19,24999534,25202432,protein_coding,1,202898,chr19_24999534_25202432
Kank1,19,25236975,25434496,protein_coding,1,197521,chr19_25236975_25434496
Dmrt1,19,25505618,25604329,protein_coding,1,98711,chr19_25505618_25604329
Dmrt3,19,25610301,25623921,protein_coding,1,13620,chr19_25610301_25623921
2610016A17Rik,19,25671134,25672253,antisense,-1,1119,chr19_25671134_25672253
Dmrt2,19,25672411,25678991,protein_coding,1,6580,chr19_25672411_25678991
Gm48775,19,26572996,26584672,lincRNA,1,11676,chr19_26572996_26584672
Smarca2,19,26605050,26778322,protein_coding,1,173272,chr19_26605050_26778322
Gm815,19,26885881,26888647,protein_coding,1,2766,chr19_26885881_26888647
Vldlr,19,27216484,27254231,protein_coding,1,37747,chr19_27216484_27254231
Kcnv2,19,27322588,27337179,protein_coding,1,14591,chr19_27322588_27337179
Pum3,19,27388698,27429825,protein_coding,-1,41127,chr19_27388698_27429825
Rfx3,19,27761721,28011166,protein_coding,-1,249445,chr19_27761721_28011166
Glis3,19,28258851,28680077,protein_coding,-1,421226,chr19_28258851_28680077
D930032P07Rik,19,28678224,28720027,lincRNA,1,41803,chr19_28678224_28720027
Slc1a1,19,28835049,28913960,protein_coding,1,78911,chr19_28835049_28913960
4430402I18Rik,19,28893042,28967800,protein_coding,-1,74758,chr19_28893042_28967800
Plpp6,19,28963953,28966811,protein_coding,1,2858,chr19_28963953_28966811
Cdc37l1,19,28990352,29026681,protein_coding,1,36329,chr19_28990352_29026681
Ak3,19,29020833,29047961,protein_coding,-1,27128,chr19_29020833_29047961
1700018L02Rik,19,29046245,29048729,antisense,1,2484,chr19_29046245_29048729
Rcl1,19,29101375,29143929,protein_coding,1,42554,chr19_29101375_29143929
Jak2,19,29251828,29313080,protein_coding,1,61252,chr19_29251828_29313080
Insl6,19,29321344,29325356,protein_coding,-1,4012,chr19_29321344_29325356
Rln1,19,29331170,29334670,protein_coding,-1,3500,chr19_29331170_29334670
Plgrkt,19,29348599,29367390,protein_coding,-1,18791,chr19_29348599_29367390
Cd274,19,29367455,29388095,protein_coding,1,20640,chr19_29367455_29388095
Pdcd1lg2,19,29410919,29471161,protein_coding,1,60242,chr19_29410919_29471161
A930007I19Rik,19,29464750,29523159,antisense,-1,58409,chr19_29464750_29523159
Ric1,19,29522282,29606829,protein_coding,1,84547,chr19_29522282_29606829
Ermp1,19,29608214,29648415,protein_coding,-1,40201,chr19_29608214_29648415
Mlana,19,29697824,29708634,protein_coding,1,10810,chr19_29697824_29708634
9930021J03Rik,19,29714402,29805989,protein_coding,-1,91587,chr19_29714402_29805989
Ranbp6,19,29808400,29812974,protein_coding,-1,4574,chr19_29808400_29812974
Il33,19,29925114,29960718,protein_coding,1,35604,chr19_29925114_29960718
Uhrf2,19,30030513,30093722,protein_coding,1,63209,chr19_30030513_30093722
Gldc,19,30098447,30175429,protein_coding,-1,76982,chr19_30098447_30175429
Mbl2,19,30232942,30239687,protein_coding,1,6745,chr19_30232942_30239687
Dkk1,19,30545863,30549665,protein_coding,-1,3802,chr19_30545863_30549665
Prkg1,19,30564489,31765033,protein_coding,-1,1200544,chr19_30564489_31765033
Cstf2t,19,31082837,31087069,protein_coding,1,4232,chr19_31082837_31087069
A1cf,19,31868764,31948995,protein_coding,1,80231,chr19_31868764_31948995
Asah2,19,31982597,32108211,protein_coding,-1,125614,chr19_31982597_32108211
Sgms1,19,32122727,32389714,protein_coding,-1,266987,chr19_32122727_32389714
2700046G09Rik,19,32389216,32391190,bidirectional_promoter_lncRNA,1,1974,chr19_32389216_32391190
Rpl9-ps6,19,32465865,32466578,protein_coding,-1,713,chr19_32465865_32466578
Minpp1,19,32485769,32515364,protein_coding,1,29595,chr19_32485769_32515364
Papss2,19,32595790,32667187,protein_coding,1,71397,chr19_32595790_32667187
Atad1,19,32671638,32739786,protein_coding,-1,68148,chr19_32671638_32739786
Pten,19,32757497,32826160,protein_coding,1,68663,chr19_32757497_32826160
Rnls,19,33137747,33392295,polymorphic_pseudogene,-1,254548,chr19_33137747_33392295
Gm7237,19,33409131,33420642,unprocessed_pseudogene,-1,11511,chr19_33409131_33420642
Lipo5,19,33459609,33473191,unprocessed_pseudogene,-1,13582,chr19_33459609_33473191
Lipo4,19,33498037,33517780,protein_coding,-1,19743,chr19_33498037_33517780
Lipo3,19,33555160,33761951,protein_coding,-1,206791,chr19_33555160_33761951
Lipo2,19,33719670,33751359,protein_coding,-1,31689,chr19_33719670_33751359
Lipo1,19,33775498,33787459,protein_coding,-1,11961,chr19_33775498_33787459
Gm5519,19,33822908,33825068,processed_pseudogene,1,2160,chr19_33822908_33825068
Lipf,19,33961187,33976810,protein_coding,1,15623,chr19_33961187_33976810
Lipk,19,34008290,34047835,protein_coding,1,39545,chr19_34008290_34047835
Lipn,19,34067358,34084918,protein_coding,1,17560,chr19_34067358_34084918
Lipm,19,34100933,34122687,protein_coding,1,21754,chr19_34100933_34122687
Ankrd22,19,34121469,34166053,protein_coding,-1,44584,chr19_34121469_34166053
Stambpl1,19,34192229,34240333,protein_coding,1,48104,chr19_34192229_34240333
Acta2,19,34241090,34255590,protein_coding,-1,14500,chr19_34241090_34255590
Fas,19,34290666,34327772,protein_coding,1,37106,chr19_34290666_34327772
Ch25h,19,34473778,34475164,protein_coding,-1,1386,chr19_34473778_34475164
Gm26902,19,34474808,34481546,bidirectional_promoter_lncRNA,1,6738,chr19_34474808_34481546
Lipa,19,34492318,34527474,protein_coding,-1,35156,chr19_34492318_34527474
Ifit2,19,34550694,34576419,protein_coding,1,25725,chr19_34550694_34576419
Ifit3,19,34583531,34588731,protein_coding,1,5200,chr19_34583531_34588731
Ifit1bl1,19,34592891,34601956,protein_coding,-1,9065,chr19_34592891_34601956
Ifit3b,19,34607970,34613401,protein_coding,1,5431,chr19_34607970_34613401
Ifit1bl2,19,34617049,34640743,protein_coding,-1,23694,chr19_34617049_34640743
Ifit1,19,34640871,34650009,protein_coding,1,9138,chr19_34640871_34650009
Slc16a12,19,34668403,34747289,protein_coding,-1,78886,chr19_34668403_34747289
Pank1,19,34806940,34879455,protein_coding,-1,72515,chr19_34806940_34879455
Kif20b,19,34922361,34975745,protein_coding,1,53384,chr19_34922361_34975745
Gm5248,19,35051962,35052677,processed_pseudogene,-1,715,chr19_35051962_35052677
A830019P07Rik,19,35835217,35924578,lincRNA,-1,89361,chr19_35835217_35924578
Htr7,19,35958734,36057507,protein_coding,-1,98773,chr19_35958734_36057507
Rpp30,19,36083716,36104777,protein_coding,1,21061,chr19_36083716_36104777
Ankrd1,19,36111961,36120099,protein_coding,-1,8138,chr19_36111961_36120099
Gm47735,19,36347614,36348298,antisense,-1,684,chr19_36347614_36348298
Pcgf5,19,36348309,36460970,protein_coding,1,112661,chr19_36348309_36460970
F530104D19Rik,19,36448992,36451157,antisense,-1,2165,chr19_36448992_36451157
Hectd2,19,36554639,36621135,protein_coding,1,66496,chr19_36554639_36621135
Ppp1r3c,19,36731731,36736653,protein_coding,-1,4922,chr19_36731731_36736653
Tnks2,19,36834232,36893477,protein_coding,1,59245,chr19_36834232_36893477
Fgfbp3,19,36917550,36919615,protein_coding,-1,2065,chr19_36917550_36919615
Btaf1,19,36926079,37012752,protein_coding,1,86673,chr19_36926079_37012752
Cpeb3,19,37021291,37208601,protein_coding,-1,187310,chr19_37021291_37208601
A330032B11Rik,19,37173843,37196541,antisense,1,22698,chr19_37173843_37196541
Ide,19,37268743,37337852,protein_coding,-1,69109,chr19_37268743_37337852
Kif11,19,37376403,37432908,protein_coding,1,56505,chr19_37376403_37432908
Hhex,19,37434810,37451780,protein_coding,1,16970,chr19_37434810_37451780
Exoc6,19,37520879,37684059,protein_coding,1,163180,chr19_37520879_37684059
Cyp26c1,19,37685581,37693398,protein_coding,1,7817,chr19_37685581_37693398
Cyp26a1,19,37697798,37701536,protein_coding,1,3738,chr19_37697798_37701536
Myof,19,37899036,38043577,protein_coding,-1,144541,chr19_37899036_38043577
I830134H01Rik,19,38051774,38054528,lincRNA,-1,2754,chr19_38051774_38054528
Cep55,19,38055011,38074423,protein_coding,1,19412,chr19_38055011_38074423
Ffar4,19,38097071,38114263,protein_coding,1,17192,chr19_38097071_38114263
Rbp4,19,38116629,38125281,protein_coding,-1,8652,chr19_38116629_38125281
Pde6c,19,38132781,38183958,protein_coding,1,51177,chr19_38132781_38183958
Fra10ac1,19,38188481,38224156,protein_coding,-1,35675,chr19_38188481_38224156
Lgi1,19,38264536,38312214,protein_coding,1,47678,chr19_38264536_38312214
Gm42723,19,38300083,38315270,antisense,-1,15187,chr19_38300083_38315270
Slc35g1,19,38395980,38405610,protein_coding,1,9630,chr19_38395980_38405610
Plce1,19,38481109,38785030,protein_coding,1,303921,chr19_38481109_38785030
Gm28991,19,38748760,38752645,antisense,-1,3885,chr19_38748760_38752645
Noc3l,19,38788128,38819237,protein_coding,-1,31109,chr19_38788128_38819237
Tbc1d12,19,38836579,38919923,protein_coding,1,83344,chr19_38836579_38919923
Hells,19,38930915,38971051,protein_coding,1,40136,chr19_38930915_38971051
Cyp2c55,19,39007019,39042693,protein_coding,1,35674,chr19_39007019_39042693
Cyp2c65,19,39061015,39093944,protein_coding,1,32929,chr19_39061015_39093944
Cyp2c66,19,39113898,39187072,protein_coding,1,73174,chr19_39113898_39187072
Cyp2c29,19,39269405,39330713,protein_coding,1,61308,chr19_39269405_39330713
Cyp2c38,19,39389556,39463075,protein_coding,-1,73519,chr19_39389556_39463075
Cyp2c39,19,39510862,39568529,protein_coding,1,57667,chr19_39510862_39568529
Cyp2c67,19,39608842,39649051,protein_coding,-1,40209,chr19_39608842_39649051
Cyp2c68,19,39688834,39741054,protein_coding,-1,52220,chr19_39688834_39741054
Cyp2c40,19,39767071,39812814,protein_coding,-1,45743,chr19_39767071_39812814
Cyp2c69,19,39842814,39886799,protein_coding,-1,43985,chr19_39842814_39886799
Cyp2c54,19,40037940,40073827,protein_coding,-1,35887,chr19_40037940_40073827
Cyp2c50,19,40089688,40113950,protein_coding,1,24262,chr19_40089688_40113950
Cyp2c70,19,40153353,40187333,protein_coding,-1,33980,chr19_40153353_40187333
Pdlim1,19,40221173,40271842,protein_coding,-1,50669,chr19_40221173_40271842
Sorbs1,19,40294753,40513779,protein_coding,-1,219026,chr19_40294753_40513779
A930028N01Rik,19,40297971,40299555,antisense,1,1584,chr19_40297971_40299555
Aldh18a1,19,40550257,40588463,protein_coding,-1,38206,chr19_40550257_40588463
Gm27042,19,40589435,40594862,lincRNA,1,5427,chr19_40589435_40594862
Tctn3,19,40596446,40612233,protein_coding,-1,15787,chr19_40596446_40612233
Entpd1,19,40612366,40741602,protein_coding,1,129236,chr19_40612366_40741602
Cc2d2b,19,40748753,40827743,protein_coding,1,78990,chr19_40748753_40827743
Ccnj,19,40831279,40848572,protein_coding,1,17293,chr19_40831279_40848572
E030044B06Rik,19,40868304,40882639,lincRNA,1,14335,chr19_40868304_40882639
Zfp518a,19,40894705,40917947,protein_coding,1,23242,chr19_40894705_40917947
Blnk,19,40928927,40994535,protein_coding,-1,65608,chr19_40928927_40994535
Dntt,19,41029275,41059525,protein_coding,1,30250,chr19_41029275_41059525
Opalin,19,41061710,41077113,protein_coding,-1,15403,chr19_41061710_41077113
Tll2,19,41082753,41206835,protein_coding,-1,124082,chr19_41082753_41206835
Tm9sf3,19,41210844,41263997,protein_coding,-1,53153,chr19_41210844_41263997
Pik3ap1,19,41272377,41385102,protein_coding,-1,112725,chr19_41272377_41385102
Lcor,19,41482637,41586536,protein_coding,1,103899,chr19_41482637_41586536
Slit1,19,41600257,41743665,protein_coding,-1,143408,chr19_41600257_41743665
Arhgap19,19,41766588,41802047,protein_coding,-1,35459,chr19_41766588_41802047
Frat1,19,41829970,41832583,protein_coding,1,2613,chr19_41829970_41832583
Frat2,19,41845972,41848132,protein_coding,-1,2160,chr19_41845972_41848132
Rrp12,19,41862851,41896173,protein_coding,-1,33322,chr19_41862851_41896173
Pgam1,19,41911923,41918660,protein_coding,1,6737,chr19_41911923_41918660
Exosc1,19,41922292,41933423,protein_coding,-1,11131,chr19_41922292_41933423
Zdhhc16,19,41933480,41944104,protein_coding,1,10624,chr19_41933480_41944104
Mms19,19,41941086,41981157,protein_coding,-1,40071,chr19_41941086_41981157
Ubtd1,19,41981763,42034643,protein_coding,1,52880,chr19_41981763_42034643
Ankrd2,19,42036000,42045110,protein_coding,1,9110,chr19_42036000_42045110
Hoga1,19,42045610,42070953,protein_coding,1,25343,chr19_42045610_42070953
Morn4,19,42074939,42086357,protein_coding,-1,11418,chr19_42074939_42086357
Pi4k2a,19,42090470,42122087,protein_coding,1,31617,chr19_42090470_42122087
Avpi1,19,42123273,42129059,protein_coding,-1,5786,chr19_42123273_42129059
Marveld1,19,42147400,42151703,protein_coding,1,4303,chr19_42147400_42151703
Zfyve27,19,42163951,42194590,protein_coding,1,30639,chr19_42163951_42194590
Sfrp5,19,42197971,42202252,protein_coding,-1,4281,chr19_42197971_42202252
Golga7b,19,42247574,42270348,protein_coding,1,22774,chr19_42247574_42270348
Crtac1,19,42268287,42431785,protein_coding,-1,163498,chr19_42268287_42431785
R3hcc1l,19,42518759,42592343,protein_coding,1,73584,chr19_42518759_42592343
Gm16541,19,42536850,42563108,antisense,-1,26258,chr19_42536850_42563108
Loxl4,19,42593982,42612813,protein_coding,-1,18831,chr19_42593982_42612813
Pyroxd2,19,42725858,42752775,protein_coding,-1,26917,chr19_42725858_42752775
Hps1,19,42755105,42779978,protein_coding,-1,24873,chr19_42755105_42779978
Hpse2,19,42786539,43388355,protein_coding,-1,601816,chr19_42786539_43388355
Gm47936,19,43434610,43440460,antisense,-1,5850,chr19_43434610_43440460
Cnnm1,19,43440436,43497210,protein_coding,1,56774,chr19_43440436_43497210
Gm47938,19,43457444,43469758,antisense,-1,12314,chr19_43457444_43469758
Got1,19,43499752,43524605,protein_coding,-1,24853,chr19_43499752_43524605
Slc25a28,19,43663801,43674881,protein_coding,-1,11080,chr19_43663801_43674881
Entpd7,19,43689672,43733697,protein_coding,1,44025,chr19_43689672_43733697
Cox15,19,43733254,43753000,protein_coding,-1,19746,chr19_43733254_43753000
Cutc,19,43752996,43768638,protein_coding,1,15642,chr19_43752996_43768638
Abcc2,19,43782192,43840740,protein_coding,1,58548,chr19_43782192_43840740
Dnmbp,19,43846821,43940191,protein_coding,-1,93370,chr19_43846821_43940191
Cpn1,19,43956307,43986556,protein_coding,-1,30249,chr19_43956307_43986556
Cyp2c23,19,44005022,44029208,protein_coding,-1,24186,chr19_44005022_44029208
Erlin1,19,44034944,44069785,protein_coding,-1,34841,chr19_44034944_44069785
Chuk,19,44073335,44107480,protein_coding,-1,34145,chr19_44073335_44107480
Cwf19l1,19,44108637,44135876,protein_coding,-1,27239,chr19_44108637_44135876
Bloc1s2,19,44139246,44146446,protein_coding,-1,7200,chr19_44139246_44146446
Pkd2l1,19,44147637,44192442,protein_coding,-1,44805,chr19_44147637_44192442
Scd3,19,44203269,44244016,protein_coding,1,40747,chr19_44203269_44244016
Scd2,19,44293674,44306864,protein_coding,1,13190,chr19_44293674_44306864
Scd4,19,44333092,44346743,protein_coding,1,13651,chr19_44333092_44346743
Scd1,19,44394455,44407879,protein_coding,-1,13424,chr19_44394455_44407879
Wnt8b,19,44493472,44514273,protein_coding,1,20801,chr19_44493472_44514273
Sec31b,19,44516957,44545864,protein_coding,-1,28907,chr19_44516957_44545864
Gm20538,19,44543722,44552831,protein_coding,-1,9109,chr19_44543722_44552831
Ndufb8,19,44548572,44555440,protein_coding,-1,6868,chr19_44548572_44555440
Hif1an,19,44562850,44576274,protein_coding,1,13424,chr19_44562850_44576274
Gm26644,19,44685811,44695460,lincRNA,-1,9649,chr19_44685811_44695460
Pax2,19,44756045,44837871,protein_coding,1,81826,chr19_44756045_44837871
1700039E22Rik,19,44828493,44835938,antisense,-1,7445,chr19_44828493_44835938
Slf2,19,44931151,44983299,protein_coding,1,52148,chr19_44931151_44983299
Sema4g,19,44989101,45003397,protein_coding,1,14296,chr19_44989101_45003397
Mrpl43,19,45004829,45006442,protein_coding,-1,1613,chr19_45004829_45006442
Twnk,19,45005663,45012762,protein_coding,1,7099,chr19_45005663_45012762
Lzts2,19,45014414,45027111,protein_coding,1,12697,chr19_45014414_45027111
Pdzd7,19,45026906,45045717,protein_coding,-1,18811,chr19_45026906_45045717
Sfxn3,19,45047503,45056383,protein_coding,1,8880,chr19_45047503_45056383
Kazald1,19,45075241,45079289,protein_coding,1,4048,chr19_45075241_45079289
Gm29594,19,45317893,45318429,lincRNA,1,536,chr19_45317893_45318429
Gm28578,19,45300455,45338435,lincRNA,-1,37980,chr19_45300455_45338435
1700016H03Rik,19,45363213,45363649,antisense,-1,436,chr19_45363213_45363649
Btrc,19,45363734,45530013,protein_coding,1,166279,chr19_45363734_45530013
Poll,19,45552275,45560531,protein_coding,-1,8256,chr19_45552275_45560531
Gm17018,19,45560615,45579763,protein_coding,1,19148,chr19_45560615_45579763
Fbxw4,19,45578254,45660312,protein_coding,-1,82058,chr19_45578254_45660312
Npm3,19,45747734,45749591,protein_coding,-1,1857,chr19_45747734_45749591
Gm15491,19,45749508,45752310,antisense,1,2802,chr19_45749508_45752310
Kcnip2,19,45791839,45816061,protein_coding,-1,24222,chr19_45791839_45816061
4930505N22Rik,19,45998137,46013386,bidirectional_promoter_lncRNA,1,15249,chr19_45998137_46013386
Ldb1,19,46031570,46045214,protein_coding,-1,13644,chr19_46031570_46045214
Pprc1,19,46044886,46072915,protein_coding,1,28029,chr19_46044886_46072915
Nolc1,19,46075863,46085530,protein_coding,1,9667,chr19_46075863_46085530
Elovl3,19,46131897,46135694,protein_coding,1,3797,chr19_46131897_46135694
Pitx3,19,46135685,46148326,protein_coding,-1,12641,chr19_46135685_46148326
Gbf1,19,46152509,46286510,protein_coding,1,134001,chr19_46152509_46286510
Nfkb2,19,46304320,46312385,protein_coding,1,8065,chr19_46304320_46312385
Psd,19,46312087,46327156,protein_coding,-1,15069,chr19_46312087_46327156
Fbxl15,19,46328184,46330446,protein_coding,1,2262,chr19_46328184_46330446
Cuedc2,19,46329812,46338702,protein_coding,-1,8890,chr19_46329812_46338702
Mfsd13a,19,46341121,46375252,protein_coding,1,34131,chr19_46341121_46375252
2310034G01Rik,19,46348201,46350302,protein_coding,-1,2101,chr19_46348201_46350302
Actr1a,19,46376811,46395748,protein_coding,-1,18937,chr19_46376811_46395748
Sufu,19,46396896,46488804,protein_coding,1,91908,chr19_46396896_46488804
Trim8,19,46501702,46516848,protein_coding,1,15146,chr19_46501702_46516848
Arl3,19,46531096,46573198,protein_coding,-1,42102,chr19_46531096_46573198
Sfxn2,19,46573365,46598066,protein_coding,1,24701,chr19_46573365_46598066
Wbp1l,19,46599084,46657389,protein_coding,1,58305,chr19_46599084_46657389
Cyp17a1,19,46667165,46673172,protein_coding,-1,6007,chr19_46667165_46673172
Borcs7,19,46689906,46703382,protein_coding,1,13476,chr19_46689906_46703382
As3mt,19,46707458,46741099,protein_coding,1,33641,chr19_46707458_46741099
Cnnm2,19,46761596,46880192,protein_coding,1,118596,chr19_46761596_46880192
Nt5c2,19,46883317,47015153,protein_coding,-1,131836,chr19_46883317_47015153
Ina,19,47014698,47025327,protein_coding,1,10629,chr19_47014698_47025327
Pcgf6,19,47033617,47050906,protein_coding,-1,17289,chr19_47033617_47050906
Taf5,19,47067746,47083479,protein_coding,1,15733,chr19_47067746_47083479
Pdcd11,19,47090768,47131865,protein_coding,1,41097,chr19_47090768_47131865
Calhm2,19,47105353,47138294,protein_coding,-1,32941,chr19_47105353_47138294
Calhm1,19,47140909,47144254,protein_coding,-1,3345,chr19_47140909_47144254
Calhm3,19,47151609,47157764,protein_coding,-1,6155,chr19_47151609_47157764
Neurl1a,19,47178820,47259441,protein_coding,1,80621,chr19_47178820_47259441
Sh3pxd2a,19,47260174,47464401,protein_coding,-1,204227,chr19_47260174_47464401
Stn1,19,47501033,47537507,protein_coding,-1,36474,chr19_47501033_47537507
Gm19557,19,47512982,47516578,antisense,1,3596,chr19_47512982_47516578
Slk,19,47579678,47645246,protein_coding,1,65568,chr19_47579678_47645246
Gm16068,19,47606144,47617106,antisense,-1,10962,chr19_47606144_47617106
Col17a1,19,47646344,47692094,protein_coding,-1,45750,chr19_47646344_47692094
Sfr1,19,47731682,47735588,protein_coding,1,3906,chr19_47731682_47735588
Cfap43,19,47736857,47919287,protein_coding,-1,182430,chr19_47736857_47919287
Gsto1,19,47854970,47864790,protein_coding,1,9820,chr19_47854970_47864790
Gsto2,19,47865534,47886324,protein_coding,1,20790,chr19_47865534_47886324
Cfap58,19,47937675,48035387,protein_coding,1,97712,chr19_47937675_48035387
Sorcs3,19,48206025,48805505,protein_coding,1,599480,chr19_48206025_48805505
Rpl13a-ps1,19,50030124,50030735,processed_pseudogene,-1,611,chr19_50030124_50030735
Sorcs1,19,50143299,50678646,protein_coding,-1,535347,chr19_50143299_50678646
Gm45352,19,50146938,50180652,antisense,1,33714,chr19_50146938_50180652
Gm26629,19,50677406,50778662,antisense,1,101256,chr19_50677406_50778662
Xpnpep1,19,52931926,53040214,protein_coding,-1,108288,chr19_52931926_53040214
1700054A03Rik,19,53033648,53084516,processed_transcript,1,50868,chr19_53033648_53084516
Add3,19,53140443,53247399,protein_coding,1,106956,chr19_53140443_53247399
Mxi1,19,53310518,53375810,protein_coding,1,65292,chr19_53310518_53375810
Smndc1,19,53379390,53390578,protein_coding,-1,11188,chr19_53379390_53390578
Mirt1,19,53443230,53464796,processed_transcript,-1,21566,chr19_53443230_53464796
4833407H14Rik,19,53460622,53462723,lincRNA,1,2101,chr19_53460622_53462723
Dusp5,19,53529109,53542431,protein_coding,1,13322,chr19_53529109_53542431
Nutf2-ps1,19,53588168,53589068,protein_coding,-1,900,chr19_53588168_53589068
Smc3,19,53600398,53645833,protein_coding,1,45435,chr19_53600398_53645833
Rbm20,19,53677306,53867080,protein_coding,1,189774,chr19_53677306_53867080
Gm16299,19,53819354,53825128,antisense,-1,5774,chr19_53819354_53825128
Pdcd4,19,53892231,53929860,protein_coding,1,37629,chr19_53892231_53929860
Bbip1,19,53929861,53944627,protein_coding,-1,14766,chr19_53929861_53944627
Shoc2,19,53944306,54033133,protein_coding,1,88827,chr19_53944306_54033133
Adra2a,19,54044151,54048982,protein_coding,1,4831,chr19_54044151_54048982
Gpam,19,55067268,55127238,protein_coding,-1,59970,chr19_55067268_55127238
Tectb,19,55180733,55196313,protein_coding,1,15580,chr19_55180733_55196313
Gucy2g,19,55198099,55241236,protein_coding,-1,43137,chr19_55198099_55241236
Acsl5,19,55251938,55297720,protein_coding,1,45782,chr19_55251938_55297720
Zdhhc6,19,55271291,55316032,protein_coding,-1,44741,chr19_55271291_55316032
Vti1a,19,55316295,55627309,protein_coding,1,311014,chr19_55316295_55627309
Tcf7l2,19,55741820,55933654,protein_coding,1,191834,chr19_55741820_55933654
Habp2,19,56287137,56320822,protein_coding,1,33685,chr19_56287137_56320822
Nrap,19,56320035,56390037,protein_coding,-1,70002,chr19_56320035_56390037
Gm17197,19,56364262,56366241,antisense,1,1979,chr19_56364262_56366241
Casp7,19,56397129,56442344,protein_coding,1,45215,chr19_56397129_56442344
Plekhs1,19,56461640,56486752,protein_coding,1,25112,chr19_56461640_56486752
Dclre1a,19,56529167,56548222,protein_coding,-1,19055,chr19_56529167_56548222
Nhlrc2,19,56548261,56603503,protein_coding,1,55242,chr19_56548261_56603503
Adrb1,19,56722199,56733113,protein_coding,1,10914,chr19_56722199_56733113
Ccdc186,19,56787481,56822190,protein_coding,-1,34709,chr19_56787481_56822190
Tdrd1,19,56826209,56870012,protein_coding,1,43803,chr19_56826209_56870012
Vwa2,19,56874249,56912078,protein_coding,1,37829,chr19_56874249_56912078
Afap1l2,19,56912361,57008228,protein_coding,-1,95867,chr19_56912361_57008228
Ablim1,19,57032733,57314919,protein_coding,-1,282186,chr19_57032733_57314919
B230217O12Rik,19,57323193,57360775,processed_transcript,-1,37582,chr19_57323193_57360775
Fam160b1,19,57360680,57389586,protein_coding,1,28906,chr19_57360680_57389586
Trub1,19,57452912,57491005,protein_coding,1,38093,chr19_57452912_57491005
Atrnl1,19,57611034,58133343,protein_coding,1,522309,chr19_57611034_58133343
Gm16277,19,58204139,58236047,antisense,1,31908,chr19_58204139_58236047
Gfra1,19,58235604,58455909,protein_coding,-1,220305,chr19_58235604_58455909
Ccdc172,19,58511993,58553085,protein_coding,1,41092,chr19_58511993_58553085
1810007D17Rik,19,58606329,58629753,lincRNA,1,23424,chr19_58606329_58629753
Pnlip,19,58652498,58681788,protein_coding,1,29290,chr19_58652498_58681788
Pnliprp1,19,58728887,58744169,protein_coding,1,15282,chr19_58728887_58744169
Pnliprp2,19,58759719,58777534,protein_coding,1,17815,chr19_58759719_58777534
1700019N19Rik,19,58785803,58794461,protein_coding,-1,8658,chr19_58785803_58794461
Hspa12a,19,58795750,58943654,protein_coding,-1,147904,chr19_58795750_58943654
Eno4,19,58943425,58971421,protein_coding,1,27996,chr19_58943425_58971421
Shtn1,19,58973356,59076100,protein_coding,-1,102744,chr19_58973356_59076100
Vax1,19,59166187,59170056,protein_coding,-1,3869,chr19_59166187_59170056
Kcnk18,19,59219214,59237374,protein_coding,1,18160,chr19_59219214_59237374
Gm29261,19,59259512,59261419,antisense,-1,1907,chr19_59259512_59261419
Slc18a2,19,59260896,59296012,protein_coding,1,35116,chr19_59260896_59296012
Pdzd8,19,59297178,59345780,protein_coding,-1,48602,chr19_59297178_59345780
Rps12-ps3,19,59322371,59322766,processed_pseudogene,1,395,chr19_59322371_59322766
Gm33756,19,59389784,59399207,lincRNA,1,9423,chr19_59389784_59399207
Emx2os,19,59425104,59458635,antisense,-1,33531,chr19_59425104_59458635
Emx2,19,59458372,59465357,protein_coding,1,6985,chr19_59458372_59465357
2700089I24Rik,19,59493136,59559391,lincRNA,1,66255,chr19_59493136_59559391
Gm17203,19,59896241,59901062,lincRNA,-1,4821,chr19_59896241_59901062
Rab11fip2,19,59902884,59943654,protein_coding,-1,40770,chr19_59902884_59943654
E330013P04Rik,19,60144675,60162591,lincRNA,1,17916,chr19_60144675_60162591
Fam204a,19,60198586,60226701,protein_coding,-1,28115,chr19_60198586_60226701
Cacul1,19,60524696,60581025,protein_coding,-1,56329,chr19_60524696_60581025
Nanos1,19,60755987,60759914,protein_coding,1,3927,chr19_60755987_60759914
Eif3a,19,60761117,60790658,protein_coding,-1,29541,chr19_60761117_60790658
Fam45a,19,60811585,60836227,protein_coding,1,24642,chr19_60811585_60836227
Sfxn4,19,60837277,60861479,protein_coding,-1,24202,chr19_60837277_60861479
Prdx3,19,60864051,60874556,protein_coding,-1,10505,chr19_60864051_60874556
Grk5,19,60889749,61095968,protein_coding,1,206219,chr19_60889749_61095968
Zfp950,19,61053840,61140840,protein_coding,-1,87000,chr19_61053840_61140840
Gm7102,19,61174686,61176309,protein_coding,-1,1623,chr19_61174686_61176309
Csf2ra,19,61223957,61228429,protein_coding,-1,4472,chr19_61223957_61228429
mt-Nd1,MT,2751,3707,protein_coding,1,956,chrMT_2751_3707
mt-Nd2,MT,3914,4951,protein_coding,1,1037,chrMT_3914_4951
mt-Co1,MT,5328,6872,protein_coding,1,1544,chrMT_5328_6872
mt-Co2,MT,7013,7696,protein_coding,1,683,chrMT_7013_7696
mt-Atp8,MT,7766,7969,protein_coding,1,203,chrMT_7766_7969
mt-Atp6,MT,7927,8607,protein_coding,1,680,chrMT_7927_8607
mt-Co3,MT,8607,9390,protein_coding,1,783,chrMT_8607_9390
mt-Nd3,MT,9459,9806,protein_coding,1,347,chrMT_9459_9806
mt-Nd4l,MT,9877,10173,protein_coding,1,296,chrMT_9877_10173
mt-Nd4,MT,10167,11544,protein_coding,1,1377,chrMT_10167_11544
mt-Nd5,MT,11742,13565,protein_coding,1,1823,chrMT_11742_13565
mt-Nd6,MT,13552,14070,protein_coding,-1,518,chrMT_13552_14070
mt-Cytb,MT,14145,15288,protein_coding,1,1143,chrMT_14145_15288
